21: اَکوُہ_ _اَکوُہِیُٛم
27: سَتووُہ
53: تُرٛوَنٛزاہ تُرٛوَنٛزَہ _۵۳
6: شَےٚ_ _شَیٚہ_ _شیٚیُٛم
68: ارہٲٹھ
79: کُن_شیٖتھ _۸۹
अंकीत: لیٚکھِت لیبٕلہِ_دار _لیبلہِ_وول
अंगरक्षक: رٲچھۍ_در _باڑی_گاڑ
अंगोलायी: اَنٛگولاہُک اَنٛگولَن
अंडज: ٹھوٗل_ترٛاوَن_وٲلۍ
अंतरयामी: دِلَن_ہُنٛد_حال_زانَن_وول
अंतरवक्र: محدِف کَنکیو
अंतरीम: عارضی
अंतर्गत: شٲمل
अंतर्निश्ट: پیدٲیشی
अंतर्मुखी: أنٛدرٕہُمَل
अंतर्वक्र: محدِف کَنکیو کَنکیو
अंत्य: مہاشَنٛکھ
अंधविश्वासी: تۄہمَت_پَرَست
अंधश्रद्धाळू: کَٹَر فِرسوٗدٕ_ دٔقیانوٗسی
अंधूक: گوٚٹ گوٚم
अंयशांवें: شیٖتِھم
अंयशीं: شیٖتھ
अंशीक: قسطہٕ
अकथनीय: غٲر_مُعین
अकबराचें: اَکبر_سُنٛد
अकबरी: اَکبر_سُنٛد
अकर्मक: فعلِ_لازِم اَتٔرۍ
अकर्मी: نہ_کَروُن
अकलात्मक: بےٚ_ذوق_ _بَد_ذوق
अकल्पीत: تَصَوُر_روٚژھ_خَیالہٕ_بَغٲر
अकल्याणकारी: بد_شگون نامُبارَکھ مَنحوٗس بَد بد_نیت_ _بَد
अकस्मात: اَچانَک_ _غٲر_مُتَوَقع
अकारण: بِلا_وَجَہہ
अकारांती: اَ__اَچَھر_وول
अकार्यक्षम: نابہٕ_کار_ نالایَق
अकाळीक: وقتہٕ_برٛوٚںٛہہ خام بےٚ_وَقت
अकुळीन: کَم_ذات
अकूशळ: اَنٲڑۍ _ناقٲبِل
अकृत: کَرنَے _نَہ_کٔرمٕژ نہ_بَنٲوۍ_مٕتۍ خَراب پَھش_پھِرِتھ
अकृतज्ञ: نا_شُکران_ _ناشِناس
अकृतार्थ: ناکام
अकृत्य: نہ_کَرنَس_لایَق نہ_کَرُن_لایَق
अक्री: بےٚ_کار بِہِتھ
अक्षम्य: ناقٲبِلہِ_معٲفی
अक्षय: لافٲنی
अक्षरी: اَصٕل_تحریٖر_وول اَصٕل_خۄشنویسی_وول
अक्षीय: اٮ۪کسِس_ہُںٛد مٔنزۍ_رِکھہِ_ہُںٛد
अखंड: مَحفوٗظ_ بےٚ_خَطرٕ_ مَضبوٗط_ مُستَحکَم_ دوٚر دوٚر واٹہٕ_روس مُسَلسَل
अखंडीत: حِصہٕ_بَغٲر_ٛ حِصہٕ_روٚژھ پھٕٹنہٕ_بَغٲر_ پھٕٹنہٕ_روٚژھ بےٚ_تَقسیٖم نہ_ترٛاوٕوُن نہ_ترٛاوٕنہٕ__آمُت
अखाद्य: نَہ_کھیوٚن_لایَق کھیوٚن_نہٕ_لایَق
अखेरचें: عبوٗری
अखेरच्या: ٲخری _پٔتیُم
अग्निशामक: نار_ژھیٚتہٕ_کَرَن_وول_ نار_ژٔھیوراوَن_وول
अग्नीचें: زالَن_وول_ آتشی _وُتِشَل
अग्नीवर्धक: بۄچھِ_بَڑاوَن_وول بۄچھِ_بٔڑراوَن_وول
अग्नीशामक: پُر_سَکوٗن
अग्रगामी: تَرقی_پَسَنٛد
अग्रणी: برٛوٚنٛہہ_پَکَن_وول
अग्रेसर: ترقی_یافتہٕ
अघटीत: نہ_گَژھہٕ_وٕنۍ نَہ_سَپدَن_وول
अघोशीत: غٲر_اعلانِیہ _غٲر_واضح
अचंचळ: مُستَحکَم_ _مَضبوٗط
अचंबीत: عٔجیٖب حٲران_ پَریشان
अचकीत: اَچانَک_ _غٲر_مُتَوَقع
अचल: نہ_پَکوٕنۍ _روٗزِتھ _بِہِتھ رُکِتھ
अचूक: اَٹَل_ بِلکُل_صحیح
अचेतन: زُوٕ_روٚژھ _بےٚحٮ۪س_ _سُست_ _بےٚ_حرکت _گُپتھ
अजमानती: زمانتہٕ_روٚس
अजय: نافٲبلہِ_تَسخیٖر
अजरंवर: لافٲنی پایدار_ _مَضبوٗط
अजरबॅजानी: آزَربای_جٲنۍ اَزَربٲییٖجٲنۍ اَزَربٲییٖجٲنی
अजरामर: نہ_بَدَلُوُن غٲر_مبدِل
अजागळ: بےٚ_صفت _بےٚ_ؤتیٖر _بےٚشور
अजाण: ناقٲبلہِ_سَمَج ناسَمَجھ بےٚ_خَبَر انزٲنۍ
अजातशत्रू: دُشمَنَو_روٚستُے
अजाप: آفتٲبی آکھتٲبی
अजापाचें: بینظیر
अजापीत: غیر_مُتوَقع حٲران_ پَریشان
अजितेंद्री: بےٚقرار بےٚ_قابوٗ
अजीर्ण: محفوٗظ سالِم نوٚو تازٕ بےٚ_نۄقُص
अजैत: ہٲرنہٕ_بَغٲر نافٲبلہِ_تَسخیٖر
अज्ञात: بےٚزٲنۍ _اَنجان غٲر _اَنجان اَجنٔبی
अज्ञानी: ناقٲبلہِ_سَمَج جٲہِل_ _ناوٲقِف_ بےٚخَبَر
अज्ञेय: ناقٲبلہِ_سَمَج
अटूट: قریٖبی حِصہٕ_بَغٲر_ٛ حِصہٕ_روٚژھ دوٚر
अठरा: اَردَہ_ _اَرداہ اَردٲہِم
अठ्ठावन: ارونزاہ
अठ्ठावनावें: ارونزٕہم _اَروَنٛزاہ
अठ्ठाविसावो: اَٹھووُہِیُٛم
अठ्ठावीस: اَٹھووُہ
अठ्ठेचाळिसावें: اَرتٲجِیُٛم
अठ्ठेचाळीस: اَرتٲجی
अठ्ठ्यांयशीं: ارشیٖت
अठ्ठ्यांयश्यांवें: ارٕ_شیٖتِم
अठ्ठ्याण्णव: ارنٔمتھ _اَرنَمَت
अठ्ठ्याण्णवावें: ار_نمتِم
अठ्ठ्यात्तर: ارسَتتھ
अठ्ठ्यात्तरावें: ارستتھم
अडचणीन_भरिल्लें: رُکیمٕژ_کٲم
अडांगी: نہِ_ڈَر_ _بےٚ_خوف
अडाणी: اَنٲڑۍ _ناقٲبِل اَنپَڑ جٲہِل_ _ناوٲقِف_ بےٚخَبَر بیقٕل _عقلہِ_روٚس
अडेचें: بناوٹی _نَقلی
अडेज: ڑاے ڈاے
अणकार_करपा_सारकें: قٲبلہِ_ترجَم ترجَمَس_لایق
अणकार_करपाचें: تَرجَمہٕ_گَژھَن_وول
अणकार_करपी: تَرجُمہٕ_کار
अणकार_करी_सारकें: ترجُمہٕ_کَرنَس_لایق
अणकारक: تَرجُمہٕ_کار
अणकारपी: تَرجُمہٕ_کار
अणकाराचें: ترجُمہٕ_کَرنَس_لایق
अणकारीत: تَرجَمہٕ
अणभव: تجرُبہٕ_دار_ مَحصوٗس
अणभवदिणें: تَجرُبہٕ_کَرناوَن_وول تَجرُبہٕ_گَژھَن_وول
अणभवशुन्य: ناتجرُبہٕ_کار _کوٚچ
अणभवहीण: ناتجرُبہٕ_کار _کوٚچ
अणभवी: تجرُبہٕ_کار _مٲہِر عٲدی وٲقٕف_ _آگاہ_ زٲنۍکار_ _زٲنۍیاب
अणभावी: تَجرُبہٕ_کار
अतंत्रीक: بےٚ_تَکنیٖکی_ _بےٚ_ٹٮ۪کنیٖکی
अतिंद्रीय: ناقٲبلہِ_اِدراک_ غٲر_مَحسوٗس
अतिक्रमी: خٕلاف_وَرزی_کَرَن_وول
अतिक्रमीत: بِسِیار _وارِیاہ _گُتُل حدٕ_روٚس _بے_شُمار _آنٛتہٕ_روٚس قَبضہِ_کٔرِتھ دباونہٕ_آمٕتۍ
अतिरिक्त: مَزید
अतिलाल: اِنفرٛارٮ۪ڑ
अती: خطرناکھ
अती_धाडशी: تیز_ _جَلٕد_باز
अतीरागिश्ट: شَرارتہٕ_ہوٚت واریاہ_شَرارتہٕ_وول_ _واریاہ_تیز
अतुलनीय: اَنمول
अतुल्य: اَنمول
अतुळीत: اَتوٗل_تہٕ_بے_توٗل
अतूट: مَحفوٗظ_ بےٚ_خَطرٕ_ مَضبوٗط_ مُستَحکَم_ دوٚر اَٹوٗٹ
अतृप्त: غٲر_مُطمین
अत्तर_लायिल्लें: خۄشبوٚے_دار
अत्याचारी: جٲبِر ظٲلم ظٲلِم _اِزَہ_کھور
अत्याधुनीक: انتہٲی_جدیٖد جدیٖد_تریٖن
अत्युत्तम: واریاہ_اصل سٮ۪ٹھاہ_جان زَبَر جان
अथक: تھکنہٕ_بَغٲر واریاہ_محنتی
अथांग: آنٛتھہٕ_روٚستُے سرٛوٚن
अदमासखर्चाचें: بَجٹُک
अदमासाचें: اَندازِٕٕ_کٔرِتھ _اَنٛداز_دار قیاس_آرٲے
अदानी: کنجوٗسکوٚنڑبٔخیٖل
अदाह्य: نہ_دَزوُن
अदीम: پتھ سارِوٕے_کھۄتہٕ_پرون
अदृश्य: نظر_نہٕ_یِنہٕ_وول
अद्वैत: وحدِیتِ_جوہَر
अद्वैतवादी: وحدانِیت_پسَںٛد
अधर: ہُتٮ۪تھ _ہُتھ_جایہِ
अधर्मी: لامَزہبلادین
अधाशिल्ले: لالچی
अधाशी: لالچی خۄدغَرٕض مَطلٔبی یٔڈَل
अधिकार_नाशिल्लें: حَقہٕ_روٚژھ_ _حَقہٕ_بَغٲر
अधिकारहीण: حَقہٕ_روٚژھ_ _حَقہٕ_بَغٲر بےٚ_دخٕل ناحق
अधिकारा_भायरें: حقہٕ_روٚس _اِختیارٕ_روٚس ناحق
अधिकाराची: با_اِختِیار
अधिकारिकी: اِختِیار_وول_ اِختِیار_دار_ اِقتِدار_وول_ اِقتِدار_دار
अधिकारी: حقدار
अधिकारीक: مَجاز مُختار
अधिकृत: اِختِیار_وول_ اِختِیار_دار_ اِقتِدار_وول_ اِقتِدار_دار
अधीन: ماتحَت ماتحَت
अधीनहीण: بےٚ_قابوٗ بےٚ_اِختِیار یُس_نہٕ_کاژِ_ہیٚکوَن_رٔٹِتھ یُس_نہٕ_قوبوٗوَس_ہیٚکَون_کٔرِتھ
अधोगतीक: پَتھ وَکار
अधोगामी: ہوٚل_ _ڈوٚلمُت
अध्यक्ष: ضٲبطہٕ_دار
अध्यक्षा_विरयत: سربرہ_روٚس _زِٹھہِ_روٚس
अध्यक्षीय: صدارتی
अध्यात्मज्ञानी: روٗحٲنی
अनंत: حدٕروٚستُے
अनंतरुपी: واریاہ_جلوٕ_وول
अनंताचो: لامَحدوٗد
अनधिकृत: حقہٕ_روٚس _اِختیارٕ_روٚس
अननुवंशीक: غٲر_وَرٲثتی غٲر_ماروٗثی
अनन्यभाव: یِندرٲزی
अनन्यवृत्ती: پس_پایہِ _سَفید_پوش
अनन्यार्थ: جورٕ_روٚس
अनपेक्षीत: غیر_مُتوَقع غٲر_مُتَوَقع__ _اَچانَک
अनभिप्रेत: مطلب_روٚس _نٔتیٖجہٕ_روٚس٠
अनमननासपी: پَتھ_نہٕ_پَکَن_وول ڈٔٹِِتھ
अनमन्या_बगर: بے_مَنٛدَچھ_ مَنٛدچھٕ_بَغٲر
अनर्जीत: قبضہٕ_روٚس
अनर्थकारी: تَبٲہی_کُن
अनर्थनाशी: بُرٲیی_خَتٕم_کَرَن_وول _بٔدی_ناش_کَرَن_وول
अनळंकृत: سادٕ
अनवळखी: بےٚزٲنۍ _اَنجان غٲر _اَنجان اَجنٔبی غٲر غٲر_تصوُر_ _خیالہٕ_نٮ۪بَر
अनवाणी: نَنہٕ_وور
अनवाळें: نٔوۍ
अनसाचें: انن_ناسیپین_اٮ۪پلُک پین_اٮ۪پلُکانن_ناسُک
अनाज्ञाकारी: نافرمان
अनात्म: فٲنی
अनात्मदर्शी: ٹاس_پَٹٲسۍ
अनाथ: ییٚتیٖم _سٔگیٖر _بےٚکَس ییٚتیٖم _سٔگیٖر
अनाथांउपेगी: ییٚتیٖمَن_سَرپَرَستی_کَرَن_وول _سٔگیٖرَن_سَرپَرَستی_کَرَن_وول
अनादरी: بےٚ_عِزَت
अनादरीत: بےٚ_عِزَت
अनादी: دٲیمی اَبدی
अनामी: اَنٲمۍ اَنامُک اَنٲمیٖز اَنٲمیٖس اَنامی اَنامِِز اَنامِس
अनामीक: بےٚ_ناوناوٕ_روٚس ناوٕ_روٚس_ گُم_نام
अनासक्त: غٲرجٲنِبدارانہٕ
अनासीक: نَستہِ_روٚس
अनिंदनी: جان _رُت
अनितीक: غلط
अनित्सूक: بِلا_تحقیقات بےٚ_غرض _بےٚ_مٲل
अनिमंत्रीत: بےٚ_سال
अनियंत्रीत: بےٚ_قوبوٗ_ _بےٚ_لگام حَدٕ_روٚس میٖژٕ_روٚس لامحدوٗد
अनियमीत: بےٚ_وقت بےٚ_قٲیِدٕ
अनिर्णीत: غٲر_طے_شُدٕ
अनिर्धारीत: غیر_مُقرَر
अनिर्मीत: نہ_بَنٲوۍ_مٕتۍ
अनिवासी: عارضی
अनिश्चीत: تَمہ_روٚس تَمہ_بَغٲر بےٚ_وقت
अनिश्टसुचक: پھیٚشِل
अनिश्र्वर: پَژھِ_روٚس عقیٖدَت_روٚس
अनुकंपीत: اَحسان_مَنٛد_ مَنٛموٗن
अनुकरण_करपी: نقلہٕ_گوٚر_ _لاگَن_گوٚر
अनुकरणावपी: نقلہٕ_گوٚر_ _لاگَن_گوٚر
अनुकरणीय: مِشالہٕ_دار_ _مِشالَس_لایَق
अनुकृतीत: نَقلی
अनुक्रमान: لَگاتار_ _مُسَلسَل
अनुक्रमीत: لَگاتار پَےدَر_پَے مُسَسَل
अनुग्रहीत: اَحسان_مَنٛد_ مَنٛموٗن
अनुचीत: غلط
अनुत्तीर्ण: فیل _ناکام
अनुदक: ہوٚکھ خۄشٕک _آبہٕ_وَرٲے
अनुनासीक: نٔسۍ
अनुपकारादीक: آزٲری
अनुपचारीक: غٲر_رَسمی
अनुपलब्ध: نایاب نابوٗد _نَہ_میلوُن
अनुपस्थीत: غٲر_حٲضِر _غٲر_موجوٗد _نابوٗد
अनुपेक्षीत: دھیان_دِتھ
अनुपेगी: فضوٗل
अनुमतीत: منٛظوٗر_کوٚرمُت _اِجازَت_دیُتمُت
अनुमतीप्राप्त: منٛظوٗر_کوٚرمُت _اِجازَت_دیُتمُت
अनुमोदीत: حِمایَت_کَرنہٕ_آمُت
अनुयायी: پٲرَوکار_ _حمایتی_ _پٔلوٕ_ _مُرید
अनुवंशीक: خانٛدٲنی
अनुवादक: تَرجُمہٕ_کار
अनुवादपी: تَرجُمہٕ_کار
अनुवादीत: تَرجَمہٕ
अनुशासक: ضٲبطہٕ_دار
अनुशीक: کَم_ _کَمٕے_ _قٔلیٖل
अनुसरून: مُطٲبِق _پَسَنٛد
अनेक: واریاہ _بِسِیار
अनेकार्थी: بِسِیار_جٔہژَل
अनैतीक: غلط
अनैत्शीक: جَبری
अन्न_खावपी: کھٮ۪نہٕ_وول
अन्न_मागपी: بَتہٕ_منٛگَن_وول_ _مُسافِر
अन्नहारी: کھٮ۪نہٕ_وول
अन्नाचें: غَلہٕ_پٮ۪ٹھہٕ_وۄپدَن_وول
अन्नान_भरिल्लें: کھٮ۪نہٕ_سۭتۍ_پوٗرِتھ _کھٮ۪نہٕ_سۭتۍ_پوٗرنہٕ_آمُت
अन्य.: باقٕے _دٔیمہِ
अन्याय_संबंदी: نااِنصٲفی_واجِنۍ
अन्यायपुर्ण: بے_رحم _بے_اِنصاف
अन्यायी: جٲبِر ظٲلم
अपंग: نوتوان _موزوٗر _اَڑلیوٚک نوتوان_ _ناتوان
अपंगूळ: نوتوان _موزوٗر _اَڑلیوٚک نوتٕوان _اَڑلیوٚک موزوٗر
अपक्ष.: آزاد
अपक्षपाती: تعصُب_بَغٲر
अपठनीय: ووتُھن_نہٕ_ _مٔکٕر_ _ناقٲبلہِ_فہم
अपथ्य: مُضِر مُضِر_ _مُضرِ_صحت
अपभ्रंश: _خراب بِگڑیومُت_ _اَبتَر
अपमान: زٔلیٖل_ بےٚ_عَزَت
अपमान_करपी: زَلالت_کَرن_وول_ _توہیٖن_کَرن_وول بےٚعزتی_کَرن_وول
अपमानकर्तो: زَلالت_کَرن_وول_ _توہیٖن_کَرن_وول
अपमानकारक: بےٚعزتی_ہُنٛد_ _ناقٲبلہِ_عزت
अपमानकारी: لانہٕ_تانہٕ_ک۔رن_وول_ _بےٚوٲری_کَرن_وول بےٚعزتی_ہُنٛد_ _ناقٲبلہِ_عزت
अपमानाचें: لانہٕ_تانہٕ_ک۔رن_وول_ _بےٚوٲری_کَرن_وول
अपरंपार: حَدٕ_روٚس میٖژٕ_روٚس لامحدوٗد
अपराजीत: ہٲرنہٕ_بَغٲر
अपराधी: گۄناہ_گارقصوٗروارجُرُم_وارخطہہ_وارمُجرِم گۄناہ_گار _قٕصوٗروار جُرُم_یافتہٕ جُرم_یافتہٕ
अपरिवर्तनशील: نہ_بَدلن_وول _اَٹَل
अपरिवर्तीत: نہ_بدلیومُت _تبدیٖلی_بغٲر
अपरिवारीक: غٲرگَریلو
अपरूप: لاجواب
अपरोक्त: پٔتۍ_کِنۍ_وَننہٕ_آمُت
अपवादीत: شِکایتہٕ_بوٚرُت شِکایتہٕ_ہوٚت پُر_شِکایت
अपवित्र: ناصاف _خَراب _گَنٛدٕ موٚکُر _ناپاکھ _گَنٛدٕ
अपसव्य: دٔچُھن
अपहरण_केल्लें: اَغوا_کوٚرمُت_ _غٲب_کوٚرمُت_ _کٔٹھِتھ_تھومُت
अपात्र: ناقٲبِل _نالایَق ناقٲبِل _نَہ_لایقہِ_کار
अपारदर्शक: نہَ_گاش_تَرَن_وول
अपीलेचें: أپیٖلہِ_دار
अपुजक: پوٗزا_نہٕ_کَرَن_وول
अपुज्य: پوٗزایہِ_لایق
अपुरबायेचें: خانہٕ_مول
अपुरें: اڑلیٚچ أڑٕے کَم
अपूर्ण: اڑلیٚچ أڑٕے اوٚڑٕے_ نامُکَمَل
अपेक्षा_नासतना: غیر_مُتوَقع
अपेक्षाहीण: لاطمع
अपेक्षीत: یوٚژھمُت _اُمیٖد_کوٚرمُت _وۄمید_کوٚرمُت توقعہس_لایَق _اُمیٖدِ_لایَق
अपेक्षे_भायलें: غٲر_مُتَوَقع__ _اَچانَک
अपेक्षेचें: پُراُمید خوٲہِش_مَنٛد
अपेशी: بَدنٲمی_دار شَرَمناک رُسواکُن شہرتہٕ_روٚس
अपैतृक: غٲر_وَرٲثتی
अप्रकाशीत: چھاپنٔے نہ_چھاپَنَس_لایَق
अप्रगट: کھٔٹِتھ ژوٗرِ کھٔٹِتھ ژوٗرِ
अप्रचलीत: فرسوٗدٕ _نالَگہار
अप्रतिकार: حَلہٕ_بَغٲر
अप्रतिकारी: تَتبیٖرنہ_کَرَن_وول
अप्रतियोगी: غٲر_مُقٲبلی
अप्रतिश्ठीत: بےٚ_وٮ۪قار_ وٮ۪قارٕ_روٚژھ
अप्रतीम: بِدوٗن_ _کُنے_ _وٲحِد
अप्रत्यक्ष: پھِرِتھ ؤلِتھ بِلا_واسط
अप्रभावी: بےٚ_اثر
अप्रभावीत: بےٚ_اَثر
अप्रमत्त: نَشہِ_روٚس
अप्रमाणीक: دونٛکھہٕ_باز _تِگڑَم_باز بے_ایٖمان
अप्रमाणीत: نا_قٲبلہِ_تَصدیٖق یُس_نہٕ_ثٲبِت_آسِہ_گوٚمُت
अप्रमादी: غلطی_روٚس اَتُر_روٚس خَطا_روٚس
अप्रयत्नशील: کوٗشِش_نَہ_کَرَن_وول
अप्रयोजक: نامُنٲسِب_ _غٲر_ضَروٗری_ _غٲر_موزوٗن اِستعمال_نہٕ_کَرَن_وول کامہِ_مَںٛز_نہٕ_اَنَن_وول
अप्रवर्तक: جوشہٕ_روٚس جَزبہٕ_روٚس
अप्रवृत्त: بیٚکار بِہِتھ
अप्रवेश्य: نہ_اَژوٕنۍ
अप्रशिक्षीत: غٲر_پیشہَ_وَر
अप्रसन्न: غمگیٖن _دِل_مٔلوٗل _اُداس
अप्रसिद्ध: نامعلوٗم
अप्राकृतीक: مثنوٗعی
अप्राप्त: نامُمکِن
अप्राप्य: نَہکُک _فٔضوٗل
अप्रामाणीक: جٲہِل_ _بدتمیٖز
अप्रासंगीक: نامُنٲسِب_ _غٲر_ضَروٗری_ _غٲر_موزوٗن غٲر_موضوٗن غٲر_مُتٲبِق غٲر_مُتعلِق مَضموٗنَس_بَر_خٕلاف
अप्रीय: نا_پَسنٛد کَھروُن
अफगाणी: اَفغٲنۍ اَٚفغٲنۍ اَٚفغٲنِستانُک
अफवा: اَفواہ_واجِنۍ
अफिमाचें_सेवन_करपी: أفیم_اِستعمال_کَرَن_وول نَشہِ_باز
अफीम_घेवपी: أفیم_اِستعمال_کَرَن_وول نَشہِ_باز
अफेण: پٔسہِ_بَگٲر پٔسہِ_روٚستُے
अबध्य: نَہ_مَروُن
अबादीत: زَخمہٕ_روٚژھ_ _زَخمہٕ_بَغٲر
अबुद्ध: ناسَمَجھ
अबोध्य: حٲران_کُن
अबोल: ژھوٚپ
अब्ज: عَرَبہٕ_بوٚد_ عَربہٕ_وادٕ
अभंग: مُسَلسَل
अभक्ष: بےٚ_مَزٕ
अभक्ष्य: نا_فٲبِل_خۄراک نَہ_کھیوٚن_لایَق کھیوٚن_نہٕ_لایَق
अभलायकेवंत: غٲر_صحتمندانہٕ
अभागी: بَدقٕسمَت
अभिनंदीत: سَلٲمی_دِنَس_لایَق
अभिप्राया_आड: مطلب_روٚس _نٔتیٖجہٕ_روٚس٠
अभिव्यक्त: اِظہار_ _ظٲہِر _ونُن _بولُن
अभेद्य: مَحفوٗظ_ بےٚ_خَطرٕ_ مَضبوٗط_ مُستَحکَم_ دوٚر ناقٲبلہ_گُزَر ناقٲبلہ_فَہَم واریاہ_سَرۄن
अभोज्य: نا_فٲبِل_خۄراک
अभौतीक: لافٲنی اَمَر
अभ्यासमोगी: محنتی _قٲبِل _پَرَن_وول
अभ्यासहीण: مَشقہِ_بَغٲر
अभ्यासू: عٲدی محنتی _قٲبِل _پَرَن_وول پرن_وٲلۍ
अमंगळ: یُس_نہٕ_پروٗژھ_آسِہ_ _پھیٚشِل _بَد
अमतिक्रमीत: قَبضہٕ_بَغٲر
अमर: لافٲنی لافٲنی پایدار_ _مَضبوٗط
अमानती: امانت_تھاونہٕ_آمُت اَمانتی
अमानवी: حَیوٲنی غیبی_ _آسمٲنی
अमानूश: حَیوٲنی
अमान्य: ٹھاکھ _مَنَہہ ناقٲبلہِ_قَبوٗل حرام_ _منع_کَرنہٕ_آمُت_ _رُکاونہٕ_آمُت
अमापीत: اَتوٗل_تہٕ_بے_توٗل
अमिश्रीत: مِلاوٹہِ_روٚس
अमीट: نَہ_مِٹَن_وول
अमुक्त: بِلا_سٕکوٗن
अमुरपिकें: اَڑٕ_پوٚپ
अमुर्त: شَکلہِ_صوٗرتہِ_روٚس _جِسمہٕ_روٚس
अमुल्य: بیش_قٕمتی بےٚ_مۄل
अमूर्त: ناقٲبلہِ_اِدراک_ غٲر_مَحسوٗس روٗحٲنی
अमेरिकन: امریکی_ _امریٖکُک
अमेरिकी: امریکی_ _امریٖکُک
अमोघ: اَٹَل_ بِلکُل_صحیح
अयशस्वी: ناکام شہرتہٕ_روٚس
अयाचक: خۄددار _غٲرَت_مَنٛد
अयोग्य: ناقٲبِل _نالایَق غلط خٕلاف نابہٕ_کار_ نالایَق
अरचीत: نہ_بَنٲوۍ_مٕتۍ
अरबी: عَربُک
अरमेनियायी: أرمِنِیاہُک
अरसीक: خۄشٕک_انسان جٲہِل بدتٔمیٖز
अराजक: لا_حکوٗمتی_ _بَد_نظٲمی بَد_نظٲمی_ _لاحکوٗمتی
अराजपत्रीत: غٲرحَقہ_اِختِیار غٲراِقتِدار غٲر_تحریٖری_عَہد_نامہٕ
अरिश्टनिवारक: آرام_دیہہ _مُشکِل_کُشا
अरिश्टमय: مُشکِل_ _دُشوٲری _پریشٲنی
अरिश्टाचें: مُشکِل_ _دُشوٲری _پریشٲنی
अरुचीक: بےٚ_مزٕ _بٔلۍ بےٚ_مٲل
अरुणाचलाचें: أرُناچلُک
अरुणाचली: أرُناچلُک
अरूंद: نیُکزٲویُلتَنٛگ
अरेखीत: سَرحَد_بَغٲر
अर्ज_करपी: فٔریٲدۍ عَرض_کَرَن_وول دَرخَواست_دَنہٕ_وول
अर्ज_केल्लें: عٔرضی_دٕنہٕ_وول دَرخواست_دٕنہٕ_وول
अर्जदार: عٔرضی_دٕنہٕ_وول دَرخواست_دٕنہٕ_وول فٔریٲدۍ عَرض_کَرَن_وول دَرخَواست_دَنہٕ_وول
अर्जेन्टिनी: اَرجَنٹیٖٖنِیاہُک
अर्थगत: مفہوٗمیاتی
अर्थपूर्ण: مَطلَب_دار_ _وَزَن_دار
अर्थशास्त्राचें: مٔعٲشی
अर्थशास्त्रीय: مٔعٲشی
अर्थशुन्य: فٕضوٗل
अर्थहीन: فٕضوٗل
अर्थाचें: مَطلَب_دار_ _وَزَن_دار
अर्थीक: مَعٲشی
अर्द: نیٚصف _اوٚڑ پَنٛژَہ_پٔرسَنٛٹ _پَنٛژَہ_فیٖسَد
अर्द_आड_पडिल्लो: لرِ_بِہتھلر_ترٛٲوِتھ
अर्द_न्हिदिल्लें: لرِ_بِہتھلر_ترٛٲوِتھ
अर्दउकतें: اَڑِووٚتھ
अर्दकच्चें: اڑٕ_پٔھٹ _اَڑٕ_کوٚچ اَڈٕ_اومُے اۄڈُے_گرٔکھ_وول
अर्दकुटिल्लें: اڈٕ_برٛوٚک
अर्दकुटें: اڑلیٚچ أڑٕے اوٚڑٕے_ نامُکَمَل
अर्दचेतन: بےٚحٮ۪س بےٚ_ہوش
अर्दपिकें: اَڑٕ_پوٚپ
अर्दमेलो: اَڑِمور
अर्दवट: اڑلیٚچ أڑٕے
अर्दवर्सुकी: شٮ۪شماہی_ شےٚ_ریوٚت
अर्दवेळ: پاٹ_ٹَیِم
अर्दशिक्षीत: کَم_لیٚوکھمُت_پوٚرمُت کوٚچ نامُکمَل خام
अर्दशिजिल्लें: اَڈٕ_پوک اَڈٕ_اومُے اۄڈُے_گرٔکھ_وول
अर्दुकुटें: اڑلیٚچ أڑٕے
अर्दे_तकलेचें: بیوقوٗف بٖیٚقٕل اَحمَق کَھر_دٮ۪ماغ
अर्धपारदर्शक: شیٖشہٕ_ہیوٗ صاف
अर्पीत: وَقٕف_کَرنہٕ_آمُت نَزٕر_کَرنہٕ_آمُت
अर्भक: زا _زاے _شیٖر_خوار
अलंकृत: عِزَت_یافتہٕ _خٕطاب_یافتہٕ
अलबानियन: ایٚلبینِیاہُک ایٚلبینِیٲیۍ ایٚلبِینِیَن ایٚلبیٖنِیٲیۍ ایٚلبینِِیَل
अलभ्य: نامُمکِن
अलिखीत: لٮ۪کھنٔے
अलोकीक: بیاکھ_دُنِیاہ
अलौकीक: غیبی_ _آسمٲنی
अल्प_काळीन: _عارضی_ کیٚنٛہہ_کالُک _کیٚنٛژھَس_کالَس
अल्पआहारी: نَفسہِ_نوزُک
अल्पप्राण: پھوردار
अल्परक्तक: خوٗنٕچ_کٔمی_وول أنیٖمِکۍ
अल्पशिक्षीत: کَم_لیٚوکھمُت_پوٚرمُت
अल्पसंख्यांक: کَم_پایہِ _ؤسۍ_پایہِ
अल्पायुशी: کَم_وٲنٛس
अल्मजात: غٲر_پٲدٲیشی
अळंकारहीण: سادٕ
अळंकारा_बगरचें: سادٕ
अळंकारीत: پٲرٲوِتھ _سَجٲوِتھ
अवगुणी: بَد_صِفت_ _عٲب_دار
अवयस्क: نا_بالینٛغ
अवर्णनी: وَننَے
अवर्णनीय: ناقٲبلہِ_بَیان غٲر_تٔعریٖف_پٔزیٖر اَلفاظَن_نِش_ماوَر
अवश: بےٚ_قابوٗ بےٚ_اِختِیار یُس_نہٕ_کاژِ_ہیٚکوَن_رٔٹِتھ یُس_نہٕ_قوبوٗوَس_ہیٚکَون_کٔرِتھ بےٚ_قابوٗ بےٚ_اِختِیار
अवाचनीय: پرنس_لایق
अविचारी: فضوٗل_اِنسان
अविचारीक: فضوٗل مَشوَر_بَغٲر
अविज्ञानीक: غٲر_ساینَسی غٲر_ساینٔسی
अविभाज्य: نہ_ترٛاوٕوُن نہ_ترٛاوٕنہٕ__آمُت ناقٲبلِ_تقسیٖم باگنَے_روٚس تَقسیٖم_روٚس غٲر_تقسیٖٖم
अविवाहीत: اَنہور_ _انۂرِش_ _کھانٛدرٕ_روٚس_ _نیترٕ_روٚس
अविश्वासी: شٔکی
अविश्वासू: نہ_بِہِنۍ_لایق
अवेवस्थीत: وٲران تکلیف_دیہہ_ _عذاب_دیہہ_ دُشوار_ _مُشکِل
अवेव्हारी: بےٚطور
अवेव्हारीक: نوٚو_ _تازٕ
अव्यक्त: کھٔٹِتھ ژوٗرِ ونہٕ_نیہ_کَتھ
अव्यस्त: خٲلی_ یَلہٕ
अशक्त: کمزور نوزُک نَرٕم ٲویُل کَم_پایہِ__ بِچٲرۍ ہوٚکھمُت _زٲوِیُٛل_ _نِیُٛک_ _کمزور
अशक्य: نامُمکِن _نَہ_گَژھہٕ_وُن ذٔریعہٕ_روٚس
अशांत: بےٚقرار
अशिक्षीत: اَنپَڑ
अशिमांकीत: سَرحَد_بَغٲر
अशीम: حدٕروٚستُے
अशीर: نیُکزٲویُلتَنٛگ تَنٛگ_ لۄکٕٹ
अशुद्ध: ناصاف _خَراب _گَنٛدٕ مِلاوَٹہِ_دار _ؤسِتھ مٲلہٕموٚکُرگَنٛدٕناصافناپاکھ غلط مل_دار
अशूभ: یُس_نہٕ_پروٗژھ_آسِہ_ _پھیٚشِل _بَد بد_شگون نامُبارَکھ مَنحوٗس بَد
अशे_तरेचो: یُتھ_ _ییٚمِس_ہیو_ _ییٚمہِ_شَکلہِ_ہُنٛد
अशें-तशें: آنجٲرۍ_مانٛجٲرۍ_ ناچیٖز
अशेंच: یُتُھے_ _ییٚتھۍ_ہِیوٗ
अश्टकोणी: ٲٹھٕ_کوٗنَل
अश्टभुजी: ٲٹھٕ_نَریٚل
अश्टांगी: ٲٹھ_حِصہٕ_وول
अश्राव्य: نا_قٲبلہِ_سماعت_ _بوزنس_لایق_نہٕ
अश्र्वारोही: گُرۍ_سوار
अश्लील: موٚکُر_ گَنٛدٕ
असंख्य: بےٚ_شُمار _یَسلہٕ _اَرسات
असंतुश्ट: غٲر_مُطمین
असंतोशजनक: غٲر_مُتمعین
असंप्रदायीक: غٲر_فَرقہٕ_وارانہٕ
असंबंदीत: نامُمکِن
असंबंद्द: غٲر_موضوٗن غٲر_مُتٲبِق غٲر_مُتعلِق مَضموٗنَس_بَر_خٕلاف
असंयमी: بے_اعتِدال غٲر_مٔعیٲری
असंस्कृत: ناشٲیستہٕ نامعقوٗل رَف
असत्य: اَپُزغلط
असत्यपणाचें: اَپُزغلط
असत्यापीत: نا_قٲبلہِ_تَصدیٖق
असफळ: ناکام ناکام_ _ناکامیاب
असभावीक: بَدلٕے _بَناوٹی _نَقلی
असभ्य: جٲہِل_ _بدتمیٖز
असमंजस: بیقٕل _عقلہِ_روٚس
असमजिकाय: بۄکھٕ_نۄسُر
असमजुतदार: ناسَمَجھ
असमतल: ہیوٚر_بۄن
असमाजीक: غٲر_سمٲجی
असमाधानी: حَل_گَژھنے
असमृद्धिदिणें: عیش_تہٕ_عشرَت_نہ_دِنہٕ_وول
असलें: تیُتھ
असलेंच: یُتُھے_ _ییٚتھۍ_ہِیوٗ
असलो: یُتھ_ _ییٚمِس_ہیو_ _ییٚمہِ_شَکلہِ_ہُنٛد
असहनशील: بَرداش_روٚس _تابہٕ_روٚس بےٚ_تاب
असहमत: مُخٲلِف _بَرخٕلاف نا_اِتفٲقی _مُخٲلِف اعتراض_تھاون_وٲلۍ
असहाय्य: ناقٲبلہِ_برداش ژالُن_نہٕ
असहाय्यताप्राप्त: اِمدادِ_بَغٲر اِمدادِ_روٚس مَدتہِ_روٚس مَدتہِ_بَغٲر
असादारण: خاص
असाध्य: ذٔریعہٕ_روٚس لااعلاج
असामान्य: خاص
असुरी: جِنہٕ دیٚوَن_ہٕںٛز جَنٛنَن_ہٕنٛز
असुसंस्कृत: جٲہِل_ _بدتمیٖز
असैमीक: مثنوٗعی
असोच: یُتھ_ _ییٚمِس_ہیو_ _ییٚمہِ_شَکلہِ_ہُنٛد
अस्कळीत: وٲران
अस्तंती: مَغرِبی مَغرِِبی
अस्ता-व्यस्त: بےٚ_تَرتیٖب _تَرتیٖبہِ_روٚس
अस्ताचें: لۄسوُن
अस्ताव्यस्त: وٲران
अस्तित्व_नाशिल्लें: بےٚ_بُنیاد _اَپُز _بٔلۍ
अस्तित्वहीण: بےٚ_بُنیاد _اَپُز _بٔلۍ
अस्तित्वांत_आशिल्लें: موجوٗدٕ حٲضِر آسہٕ_وُن
अस्तुरी: مادٕ
अस्तुरेचें: زنانہ
अस्तूंक_नाशिल्लें: افتاب_لوسوٕنہِ_بروٛنہہ
अस्थायी: عٲرضی
अस्थावर: اورٕیور_پَکناوُن_لایَق _پِھرُن_لایَق
अस्थिहीण: أڑِجو_بَغٲر_ _أڑِجو_روٚس أڑِجو_روٚژھ أڑِجو_روٚستُے
अस्थीमय: أڑجِدار _أڑِجوٗ
अस्थीर: پَکوُن _چَلوُن ڈیرٕ_ڈیرٕ_پھیرَن_وول دَربٕدرۍ رٔزیٖلہٕشَرارتی ڈٔٹِتھ_نہ_روزَن_وول
अस्पश्ट: غٲر_واضح گوٚٹ گوٚم
अस्पृश्य: اَچھوٗتۍ
अस्वच्छ: مل_دار
अस्वस्थ: بےٚتاب
अस्विकृत: نامنٛظوٗر
अस्सल: صافشوٚد صاف
अहंकारी: خۄد_پسنٛد
अहिंसक: شٔریف
अहीतकारी: پَستی_وول بد_نیت_ _بَد
आंकरिल्लें: پٔھلۍمٕتۍ
आंकवार: اَنہور _خانٛدرٕ_روٚس _نیتھرٕ_روٚس اَنہور_ _انۂرِش_ _کھانٛدرٕ_روٚس_ _نیترٕ_روٚس اَنۂرِش_ پاک_دامن __خانٛدرٕ_روٚس_ _نیتھرٕر_وٚس
आंगाचें: جِسمہٕ_مَںٛز__وۄپدیومُت جِسمہٕ_مَنٛز_درٛامُت
आंगीक: جِسمہٕ_مَںٛز__وۄپدیومُت جِسمہٕ_مَنٛز_درٛامُت
आंटलेलें: ژمیمُتشرپیومُت
आंटिल्लें: ژمیمُتشرپیومُت
आंतकड्यांचें: أنٛدرَمُک
आंतरदेशी: قومی اَنٛدروٗنی دٲخلی
आंतरराज्य: اَنٛدروٗنی_رِیاستی
आंतरराष्ट्रीय: بین_ا_لاَقوامی
आंतरीक: أنٛدروٗنی _أنٛدرِم
आंतर्जाती: ژٲژَن_درمیان
आंतर्जातीय: مُختلِف_زٲژَن_ہُںٛد وارِیاہَن_زۭٲژَن_ہُںٛد
आंतर्राष्ट्रीय: بین_الاقوٲمی_ _عالَمگیٖر
आंदोलक: احتجاج_کَرن_وول احتجٲجی
आंधळो: اوٚن
आंबट: ژوٚک
आंबट_गोड: یَکہٕ_موٚدُر
आंब्या_रोसाच्या_कोराचें: اَمبہِ_رَسَس_ہیوٗ
आंवुळिल्ल्या: ژَمٹیومُت
आकर्शक: خۄشوُن_ خۄش_گَوار_ اَصٕل لوٗب_وُن دِل_نِنہٕ_وول_ دِل_نِو_وُن _دِلچسپ_ خۄشوٕنۍ
आकर्शीत: رٲغِب بَد_حال_ جَزبٲتۍ
आकलनीय: گٔنٛزرَنَس_لایق
आकसपी: چارنہٕ_یِنہٕ_وول
आकस्मीक: اَچانَک_ _غٲر_مُتَوَقع
आकांतवादी: دَہشت_پَسنٛدانہٕ
आकारांती: آ_اَچَھر_وول
आकाराचें: کٔھنِتھ
आकारीक: اَلبعادی
आकारीत: کھۄرو_روٚس کھۄرو_بَغٲر
आकालीक: بےٚ_وَقتُک _کۄوَقتُک غٲر_معقوٗل
आकाशी: آسمٲنۍ
आक्रमक: حَملہٕ_دار_ حَملہٕ_واجین
आक्रमणकारी: حَملہٕ_کَرَن_وول
आक्रमणा_बगरचें: حملہٕ_روٚس
आक्रमणा_विरयत: حملہٕ_روٚس
आक्रांत: حملہٕ_زد
आख्खें: سروٗنٛٹُے_ _سورُے_ _پوٗرِ_پوٗر_ _ثوبوٗت مُکَمَل پوٗرٕٕ
आगंतूक: فلٲنۍ
आगळीक_करपी: عَصمَت_دٔری_کَرَن_وول
आगळें: مُختٔلِف_ بر_عکس
आगळो: لاجواب
आगामी: یِنہٕ_وول _برٛۄنٛہہ_کُن_سَپدَن_وول
आगीचें: زالَن_وول_ آتشی _وُتِشَل
आग्रही: زور_دِنہٕ_وول _اہمِیَتھ_دِنہٕ_وول _اہمِیَت_دِنہٕ_وول
आचमनाचें: پوٗرایہِ_برۄنٛہہ_چٮ۪نَس_لایَق آچمَنَس_لایَق
आचारवान: تٔمیزداراَصٕلجان
आजापीत: عٔجیٖب
आजो: بُڈۍبَب_سُنٛد
आज्ञा_करपी: حُکُم_دِنہٕ_وول حُکُم_کَڑَن_وول
आज्ञा_पाळपी: فَرمابَردار
आज्ञाकारी: حُکُم_دِنہٕ_وول حُکُم_کَڑَن_وول فَرمابَردار
आज्ञातीत: جٲری_کوٚرمُت ضٲبط_بنٛد ترَتیب_دیٚتمُت مقصَد_کوٚرمُت حُکُم_دُیٚتمُت
आज्ञापाळक: فَرمابَردار
आज्ञाभंगी: نافرمان
आज्ञेचें: جٲری_کوٚرمُت ضٲبط_بنٛد ترَتیب_دیٚتمُت مقصَد_کوٚرمُت حُکُم_دُیٚتمُت
आटक: گِرِفتار
आटिल्ल्या_दुदाचें: دۄدٕ_روٚستُے_وَچھ_واجیٚنۍ
आठ: ٲٹھ_ _۸
आठ_कुशींचें: ٲٹھ_پاسہٕ_وول ٲٹھ_پاسوٗ
आठ_म्हयन्यांचें: ٲٹھہٕ_ریٚتُک ٲٹھہٕ_ریوٚت ٲٹھنٕے_رٮ۪تَن_ہُنٛد
आठवड्याचें: ہَفتہٕ_وار
आठवें: اوٗٹھِم
आठसठ: ارہٲٹھ
आठसठावें: ارہٲٹھِم
आठेक: لَگ_بَگ_ٲٹھ
आठोळें: ٲٹھہٕ_ریٚتُک ٲٹھہٕ_ریوٚت ٲٹھنٕے_رٮ۪تَن_ہُنٛد
आठ्ठिसावें: اَرترٕٛہِیُٛم
आठ्ठीस: اَرترٕٛہ
आड_पडिल्लें: لر_ترٲوِتھ
आडखळ_हाडपी: رُکاوَٹ_دار_ _تھوٚر_دار
आडखळहीण: تھَپہِ_بَغٲر
आडखळिल्लें: کُھرۍ_دار
आडखळिल्लो: پھسیومُت _بَنٛد_گوٚمُت بنٛد
आडखळीन_भरिल्लें: رُکیمٕژ_کٲم
आडखळीबगरचें: تھَپہِ_بَغٲر
आडनदर: نِظر_اَنٛداز نَظراَنٛدازَس_لایَق تَگوفُلَس_لایَق
आडमेळी_हाडपी: رُکاوَٹ_دار_ _تھوٚر_دار
आडवादा_बगरचें: بِلا_اعتِراز
आडवें-उबें: قطع_دار_تہٕ_جُکھِتھ
आडवें-तिडवें: قطع_دار_تہٕ_جُکھِتھ
आडावपा_भायरें: فٲنی _اَٹَل
आतंकवादी: دَہشت_پَسنٛدانہٕ
आतांचें: موجوٗدٕ_وَقت اَزکال _موجوٗد_زَمانہٕ
आतिरिक्त: علاوٕہُرٮ۪مانہٕ
आतूर: بےٚ_قَرار_ بےٚ_چین_ _بےٚ_تاب
आते: پوٚپھتُر پۄپھتُر
आत्मकथनात्मक: سوانہِ_حیات _پَنٕنۍ_سَرگُزشت
आत्मघातक: خۄدکٔشی_وول
आत्मघातकी: خۄدکٔشی_وول
आत्मघाती: خۄدکٔشی_وول
आत्मनिर्भर: خۄدکٔفیٖل
आत्मपरक: پَنُن ذٲتی
आत्मविस्वासू: پانَس_پٮ۪ٹھ_یقیٖن_تھاوَن_وول _پانَس_پٮ۪ٹھ_پَژھ_تھاوَن_وول
आत्मसंतुश्ट: مُطمَعِن
आत्माभिमानी: خۄد_دار_ _غٲرتمنٛد
आत्म्या_विशींचें: روٗحٲنی
आदखळीचे: سَکھ_ _مُشکِل
आदर्श: مِثٲلی _معیٲری _بہتٔریٖن شانٛدار _مُنفَرِد عینی
आदर्शवादी: اوٚصوٗل_پَرَست
आदलें: خستہٕ_گوٚمُت _مۄقلیومُت پرٛونبرٛو٘نٛہہ_کالُک پتھ
आदलो: پٔتِم_ برونٛٹھ_کالُک پٕرون
आदारप्राप्त: اِمدٲدۍ
आदारवान: آسرٕ_وول سَہارٕ_وول
आदारहीण: اڈنٛجہِ
आदारहीन: بےٚ_بُنِیاد
आदारा_बगर: بےٚ_بُنِیاد
आदारा_बगरचें: اڈنٛجہِ
आदारीत: محتاج
आदिवासी: قٔبیٖلُک کرٛامہِ_ہُنٛد
आदी: وغٲرٕ_وغٲرٕ
आदेशपूर्ण: اَشَد_ضَروٗری_ زیٛادٕ_ضَروٗری
आदेशीत: اَشَد_ضَروٗری_ زیٛادٕ_ضَروٗری جٲری_کوٚرمُت ضٲبط_بنٛد ترَتیب_دیٚتمُت مقصَد_کوٚرمُت حُکُم_دُیٚتمُت
आधीन: ماتحَت
आधुनीक: أزیُک _اَزکَلُک وٕنٛکٮ۪نُک
आध्यात्मीक: روٗحٲنی
आनंद_दिवपी: پُر_مُتمعین
आनंददायी: مََزٕ_دار _پُر_مَسرَت
आनंददिणें: پُر_مُتمعین
आनंदी: خۄش_حالخۄش_مِزازخۄش_باش پُر_جوش_ _جوش_دار_ _حوصلہٕ_منٛد_ _سَر_گَرم
आनंदीत: پُر_لُطُف _پُر_سٔکوٗن خۄش دِل_رنٛزنوومُت_ _مَن_رنٛزنوومُت
आनिकूय: بییٚہِباقٕے
आनिवार्य: دُشوٲری_سان مُشکِلی_سان
आनीक: بییٚہِباقٕے
आनीक_कोणूय: بییٚہِباقٕے
आनुश्ठानीक: ورزِش_ہُںٛد ورزِش_مُتعلِق
आपखोसयेचें: آرام_مُطٲبِق
आपणायिल्ली: منٛظوٗر
आपणायिल्लें: اِختِیٲری_ _قبوٗل_کوٚرمُت
आपयिल्लें: مُخٲتِب
आपरोसहीण: فَضوٗل مۄلہٕ_روٚس بےٚ_مۄلہٕ مۄلہٕ_بَغٲر فَضوٗل بٮ۪کار
आपलें: ذٲتی _پَنُن
आपल्या_पक्षाचो: پَنُن
आपसांतलें: زٲتی
आपसुवार्थी: خۄدغرَض_ غَرَض_اوٚن مطلٔبی
आपार: حَدٕ_روٚس میٖژٕ_روٚس لامحدوٗد
आपोवंक_नाशिल्ले: بےٚ_سال
आफडिल्लें: اتھ_لوٚگمُت
आफडीचें: ماہ_وٲری_گَژھَن_واجٕنۍ
आफडूंक_नाशिल्लें: صاف سِر _اَتھہٕ_لاگنَے
आफताबी: آفتٲبی آکھتٲبی
आफ्रिकी: اَفریٖکی اَفریٖکاہُک اَفریٖکَن
आबुझाद: ڈوٚلمُت
आबूज: پریشان _اوٗرنہِ_یوٗرۍ
आबूझ: ڈوٚلمُت
आभारी: احسان_منٛد _شُکُرگُزار
आभुशीत: پٲرٲوِتھ _سَجٲوِتھ
आम: عام_ _معموٗلی_ سادٕ
आमंत्रीत: دعوتی دعوت_دِنہٕ_آمُت
आमट-चींच: ژوٚک_آتش
आमल: تیزآب_دار
आमिझाद: دوستانہٕ
आमीग_आशिल्लो: رٔسوٗک_وول
आम्लाचें: تیزابو
आम्लीक: تیزابو تیزآب_دار
आयकपा_सारको: قٲبلہِ_سماعت_ _بوزنس_لایق
आयकल्यो: بوزٕمَژٕ
आयकुपा_सारकें: ناقٲبلہِ_سماعت _بوزنس_لایق_نہٕ
आयकूंक_नाशिल्ली: نَہ_بوٗزمُت
आयचो_काळ: موجوٗدٕ _حالٕے
आयच्या_काळांतलें: أزیُک _اَزکَلُک وٕنٛکٮ۪نُک
आयताकार: زیوٗٹھ_ _مُستَتیٖل
आयदनाचें: ٹھانٛٹَھر
आयरिश: اَیَرلینڑُک اَییرِش
आयसलॅण्डाचें: اَیِِسلینٛڑُک
आयसलॅण्डी: اَیِِسلینٛڑُک
आयात_करपी: درامَد_کَن_وول
आयाती: درامَد_کَن_وول
आयातीत: برامَد_کوٚرمُت
आयामी: اَلبعادی
आयिल्लें: نٮ۪بَر_درٛامُت نوٚن_درٛامُت
आयिल्लो: آمُت
आयुर्वेदीक: آیوٗرویدِک
आयोजीत: مُنقد
आरंभहीण: دٲیمی اَبدی
आरक्षीत: مَحفوٗظ_ _مَخصوٗص
आरतें_परतें: اولہٕ_دولہٕ_ ہوٚل_کوٚل
आरमेनियी: اَرمیٖنِیٲیی اَرمیٖنِیٲیۍ اَرمیٖنِیَن
आराधक: عِبادَت_کَرَن_وول پوٗزا_کَرَن_وول
आराधीत: عبادتَس_لایقبَنٛدٕگی_لایق
आरामदिणी: آرام_دِہ سۄکھ_واتناوَن_وول
आरास: سجاوٹی
आरूढ: سوار
आरोग्याक_बरें: صَیحَت_بَِخٕش
आरोप_करपी: اِلزام_رَٹَن_وول
आरोपमुक्त: رِہا
आरोपी: مُلزِم خَطاکار اِلزام_یافتہٕ
आरोही: کَھسَن_وول
आर्काचें: محراب_دار
आर्काट्याचें: محراب_دار
आर्थीक: مَعٲشی
आर्य_जातीचें: آریَن_زٲژٕ
आर्यसमाजाचें: آریا_سَمٲجی
आर्यसमाजी: آریا_سَمٲجی
आलतडचें: اَپور_نَہ_تَرَن_وول
आलमपेड्ड्यार: بےٚکار
आलायतें: علاوٕہُرٮ۪مانہٕ مَزید
आलाशिरो_दिवपी: مُحٲفِظ رٲچھۍ_راوَٹ_کَرَن_وول
आल्जेरियी: اَلجیٖرِیاہُک اَلجیٖرِیَن
आल्त: تھوٚد تَھدِ_قَدُکھ
आल्मिखुशाल: بے_فِکر
आल्मीखुशाल: بےٚ_فِکِر
आळशी: کٲہِلسُست دُپہرَس_تام_شیۄنٛگَن_وول
आवटें: بیوقوٗفچوراَحمَکباورٕ پاگَل دیوانہٕ ڈوٚلمُت
आवटो: پاگَل دٮ۪وانہٕ موٚت ڈوٚلمُت پاگَل باورٕ
आवडना_अशें: بےٚمَزٕ_ _بَد_مَزٕ_ _بَد_دِل
आवडनाशिल्लें: نا_پَسنٛد بےٚ_مزٕ _بٔلۍ بےٚمَزٕ_ _بَد_مَزٕ_ _بَد_دِل
आवडीचें: یوٚژھمُت _اُمیٖد_کوٚرمُت _وۄمید_کوٚرمُت ٹوٹھ _دِلَس_مُوٲفیٖق _مَن_پَسَنٛد ٹٲٹھعزیز لٔزیٖز_ _مَزٕدات
आवय_नाशिल्लो: ماجہِ_یٔتیٖم یٔتیٖم
आवरणहीण: ووٚتُھےیَلَےٹھانٛڑٕ_روٚس
आवरणाचें: جِلدٕ_کٔرِتھ
आवर्तक: لگاتار _مُسلسَل ہمیشہِ_ _بار_بار
आवेगपूर्ण: پَریشٲنی_کُن_پَریشٲنی_دار
आशावादी: پُر_اُمیٖد_ پُر_وۄمید وومیدوار_ _خٲہِش_منٛد پُر_اُمیٖد رِجایَت_پَسَنٛد
आशियायी: ایشِیٲے اَیشِیاہُک
आशेखोर: لالچی خۄدغَرٕض مَطلٔبی
आशेचें: خوٲہِش_مَنٛد یٔڈَل
आशेभगत: لالچی خۄدغَرٕض مَطلٔبی
आशेल्ले: لالچی
आशेल्लो: خۄدغِرٕض_ _لالچی
आश्चर्य: آفتٲبی آکھتٲبی
आश्चर्याचें: بینظیر
आश्रमहीण: آشرَمہٕ_وَرٲے آشرَمہٕ_روٚستُے
आश्रमा_बगरचें: آشرَمہٕ_وَرٲے آشرَمہٕ_روٚستُے
आश्वस्त: پُر_یٔقیٖن
आश्वासनीय: دِلاسَس_قٲبِل
आसक्त: کٔشِش _رٲغِب
आसपतीचें: جٲگیٖرُک_ دۄلَتُک
आसपावीत: رلہٕ_مِلہٕ _گٔنٛڑِتھ _رٲبطہٕ_دار
आसा: واقع
आसामी: آسامُک آسامُک_ _آسٲمۍ آسٲمۍ
आस्ट्रियायी: آسٹرٛیٲیۍ آسٹرِٛیَن
आस्तीक: مزہب_پرست
आस्पाविल्ले: شٲمِل
आस्वासक: تسلی_بخش_ _دِلاسہٕ_وول
आस्वासनां_दिवपी: تسلی_بخش_ _دِلاسہٕ_وول
आहाराचें: کھٮ۪نس_لایق
इंग्रजी: انٛگریٖزۍ انگریٖزۍ
इंग्लीश: انگریٖزۍ
इंग्लेज: انٛگریٖزۍ انگریٖزۍ
इंद्रियनिग्रही: پرہیزگار
इंद्रीयगम्य: قٲبلہِ_اِدراک
इंद्रीयगोचर: قٲبلہِ_اِدراک
इकरा: کاہ
इकरावें: کٔہِم
इकारांती: اِ_اَچَھر_وول
इक्कें: یوٗتاہ
इजिप्ती: مِصرُک اِ_جِپٹُک
इटाली: اِٹیلِیَن اٹالوی
इटालीयन: اِٹلی_ہُںٛد اِٹیلِیَن اِٹیلِیَن اٹالوی
इतकें: یوٗتاہ
इतलें: بَرابَرہِویہم_رۄتبہٕہم_پَلہٕ یوٗتاہ
इतिहासीक: تَواریٖخی
इत्शीक: اِختِیارٲتی
इत्शीत: منہٕ_مُطٲبِق
इत्सा_नासतना: جَبری
इत्साहीण: خوایشہِ_روٚس بےٚ_غرض _بےٚ_مٲل
इत्सीत: یوٚژھمُت _اُمیٖد_کوٚرمُت _وۄمید_کوٚرمُت
इत्सुक: وۄمیدوار
इत्सूक: خوٲہِش_مَنٛد
इत्से_बगर: جَبری
इथियोपियायी: اِتھوپیٲے_ _یالٹوپیٲے_ _أبایسِسنیٲے
इनामी: اِنعٲمی
इबाडिल्लें: خراب_ _سڈیومُت_ _ہوٚتمُت_ _دۄدریو_مُت
इबाडिल्लो: _خراب بِگڑیومُت_ _اَبتَر
इमानी: شریٖف
इमामी: اِمام_سُنٛد
इमारतीचें: عِمٲرتی
इराकी: ایٖراقُک
इराणी: ایرٲنۍ ایرٲنۍ
इर्शेन_भरिल्लें: بۄگزی اَزَروٕنۍ دودُ
इलेक्ट्रॉनीक: پاورَس_پٮ۪ٹھ_پَکَن_وول ایٚلَکٹرانِک
इल्लें: کم _کینٛہہ
इल्लेशें: کَم _رَژھ
इल्लोशें: پِنٛتہٕ_کَلہٕ_ پینٛتہٕ_کَلہٕ_ _پِتہٕ_کَلہٕ
इश्कोलाचें: مَدرَسُکھ _مَدرَسُک
इश्ट_आशिल्लो: رٔسوٗک_وول
इश्टागत: رَلوُن دوستانہٕ
इश्टाबगरचो: دوستہٕ_روٚس
इश्टाविरयतचो: دوستہٕ_روٚس
इश्वरी: خدٲیی خۄدٲیی
इश्वरीदेणें: خۄدٲیی_دِیُت
इस्रायली: اِسرٲیلُک اِسرٲیلی
इस्लामी: اِسلٲمی اِسلامُک
इहलोकीक: دُنیٲوی
ईकारांती: ایٖی_اَچَھر_وول
ईश्वरवादी: مزہب_پرست
ईश्वरा_बगरचें: پَژھِ_روٚس عقیٖدَت_روٚس
ईश्वरी: دیوتاہَن_ہُںٛد_دِیُت
उंचलो: پیٚٹھیُم ہیٚریُم
उंचल्या_कुळातलो: تھَدِ_قٔبیٖلُک
उंचवटो: تھوٚد_ _ہیوٚر_ _تھزر
उंचेलें: تھوٚد
उकडिल्लें: سِوٕتھ
उकतायिल्लें: اِظہار_ _ظٲہِر _ونُن _بولُن
उकती: رازٕ_بَغٲر
उकतें: ووٚتُھےیَلَےٹھانٛڑٕ_روٚس عام یہِ_نہٕ_سِر_آسہِ واضح _صاف کھوٗلِتھ_ یَلہٕ مٕژرِتھ یَلہٕ ؤسیع
उकतेपणीचें: عیان
उकतो: ننگہٕنٮ۪تھہٕ_نوٚن
उकत्या_पांयाचें: نَنہٕ_وور
उकत्या_हाताचें: ؤسۍ_دِل_ بوڈ_دِلوؤل _دِل_وؤل
उकारांती: اُ_اَچَھر_وول
उक्तें: نوٚن
उखलपी: تولُن
उखलिल्लें: تُلُن
उगडास_नाशिल्लें: مٔشٕد_گومُت
उगडें: ووٚتُھےیَلَےٹھانٛڑٕ_روٚس
उग्रवादी: اِنتِہا_پَسنٛد _دِہشَت_گَرٕد
उचांबळ: بےٚتاب بےٚ_قَرار_ بےٚ_چین_ _بےٚ_تاب
उचांबळीत: رٔزیٖلہٕشَرارتی
उचीत: اِخلٲقی مُنٲسِبمعقوٗل صحیح_ _ٹھیٖک_ _دُرست معموٗل
उच्च: زُیٹھ
उच्च_कुळीन: خاندانۍ
उच्चारिल्लें: تَلَفُظ_کٔرمُت ہَجیہ_کورمُت
उजबेकिस्तानी: اُزبٔکِستانُک اُزبٔکِستٲنۍ
उजबेकी: اُۭزبیکِستانُک اُزبیکِستٲنۍ اُزبیکۍ اُزبیکُک اُزبیکُک اُزبیکی اُزبیکۍ
उजळ: صاف _چٔھلِتھ پرٛزلوُن
उजळणी: دوٚہروومُت
उजवाडायिल्लें: چھٲپِتھ
उजवें: دٔچُھن
उजू: ایمانٛداررُت
उजो_पालोवपी: پُر_سَکوٗن نار_ژھیٚتہٕ_کَرَن_وول_ نار_ژٔھیوراوَن_وول
उजोलायणें: دزن_وول
उज्याचें: زالَن_وول_ آتشی _وُتِشَل
उठवणेचें: ہَڑدَرٕم
उडनासपी: گوبہ
उडपी: وِڑَن_وول
उडयिल्लें: ضایہِ_ _برباد_ _فضوٗل لاوارِس _دیتمُت پَتھر_پیوٚمُت
उडिया: اُڑیا _اُڑیٖسی_نَژُن اوریٖسٲۍ
उणे_पिरायेचें: کَم_وٲنٛس
उणें: کَم کم _کینٛہہ کم_پایہِ ؤسۍ_پایہ
उणें_उलोवपी: کَم_کَتھہٕ_کَرَن_وول_ کَم_سُخَن_ کَم_رَلوُن
उणें_केल्लें: برخاست
उणें_जाल्लें: سَستہٕ_ _کم
उण्या_आयुश्याचें: کَم_وٲنٛس
उण्यांतउणें: کم_کھۄتہٕ_کَم__ کَمی _کَم
उतरांखेळाचो: اَثَردارالفاظ
उतरांचें: لَفظی
उताणें: سیوٚد
उतावळें: جلدباز
उतावळो: رٔزیٖلہٕشَرارتی
उत्कृश्ठ: جان_ _زَبَر_ _رُت
उत्तम: اَصٕل _جان _رُت _بِہتٔریٖن _لایقہِ_کار
उत्तर_अमेरीकी: شُمٲلی_امریٖکاہُک
उत्तर_कोरियायी: شُۭمٲلی_کوریاہُک شُمٲلی_کوریٲی
उत्तरकाळीन: پَتھ_کالُک
उत्तरदायी: ذِمہٕ_دار_ قٲبلہِ_اعتِماد
उत्तरी: شُمٲلی
उत्तीर्ण: کامیاب _پاس
उत्तेजक: اِشتعٲلی
उत्तेजीत: شرارتی_ _ناراض
उत्पन्न: وۄپدیومُت _کھوٚتمُت درامُتنیرُن
उत्पादक: پٲداوٲری
उत्पादीत_जाल्लें: وۄپدیومُت _کھوٚتمُت
उत्सर्जीत: تراوُن
उत्साहपूर्ण: جوشہٕ_ہوٚت
उत्साहहीण: بِلا_تحقیقات
उत्साही: پُر_جوش_ _جوش_دار_ _حوصلہٕ_منٛد_ _سَر_گَرم جوشہٕ_ہوٚت_ _جوشہٕ_دار جوشہٕ_وول_ سَرگَرٕم
उत्सुक: خٲہِش_مَنٛد
उथळ: _وۄگُن
उदक_भरशिल्लें: آبہٕ_دار
उदकांतली: ٲبی
उदकाचें: آبہٕ_دار ٲبی _آبہٕ_دار _آبہٕ_بوٚرُت
उदकाभरवण: پھوٚٹمُت
उदकाळ: ٲبی آبہٕ_دار ٲبی _آبہٕ_دار _آبہٕ_بوٚرُت آبہٕ_سٔرۍ _آبہٕ_بُزۍ
उदय_जाल्लो: کھوٚتمُت
उदार: سٔخی_ _فِراخ_دِل ؤسعی_دِل_ فَراخ_دِل وۄزُم
उदारें: سیوٚد
उदेंती: مَشرِقی
उदेल्लो: کھوٚتمُت
उद्देगी: وُژھ
उद्धट: نہِ_ڈَر_ _بےٚ_خوف
उद्धार_केल्लें: نَرٕم _نَرٕم_دِل _نَرٕم_مِزاز _رحم_دِل _خۄلکی
उद्युक्त: قبضہٕ_روٚس
उद्येगीक: صَنَعتی
उद्येगीकरण: صنعتی
उध्वस्त: تباہ _فان وٲران_ _چَھلہٕ_چھانٛگٕر
उनी: ییرُو
उन्नत: تَرقی_یافتہٕ
उन्नतीकारक: تَرقی_پَسَنٛد
उपकारहीण: منتھِ_ورٲے
उपकारा_बगरचें: منتھِ_ورٲے
उपकारादीक: فٲیدٕ_دِہت_نفر _سۄچھہِ_کُل
उपकारी: احسان_منٛد _شُکُرگُزار احسان_مَنٛد _شُکُرگُزار
उपचार_केल्लें: علاج_کٔرِتھ
उपचारा_बगरचें: علاج_روٚس عَلاج_بَغٲر
उपदेश_करपी: نٔصیٖحَت_کَرَن_وول
उपदेशक: نٔصیٖحَت_کَرَن_وول
उपदेशी: نٔصیٖحَت_کَرَن_وول
उपद्रवग्रस्त: بےٚ_سُکوٗن_ _پریشان_کُن
उपद्रवी: بَدماش_ لَڑایہٕ_گٔرۍ_ دَنٛگہٕ_باز
उपभोगी: قٲبلہِ_خرچ
उपमेय: تقابلی _مُشابتی
उपयुक्त: مُنٲسِبمعقوٗل
उपयोगी: فٲیدٕ_مَنٛد
उपरांतचें: پٔتِیُٛم_ _أنٛدِیُٛم_ ٲخری دوٚیِم
उपरो: تھوٚد_ _ہیوٚر_ _تھزر
उपस्थीत: حٲضِر _موجوٗد
उपहासात्मक: اَسہٕ_وُن مَزاکِیہ
उपाट: واریاہ _سٮ۪ٹھاہ واریاہ _کٲفی بےٚ_لَگام پوٗرِ_پوٗر_ _بَر_پوٗر بٔرِتھ_ _ٹیپہِ_ __بَرپوٗر
उपाड्यांत_घातिल्लें: سانٛچہٕ_دار
उपाधीत: عِزَت_یافتہٕ _خٕطاب_یافتہٕ
उपाशी: فاقَے
उपाशीं: بۄچِھٕ_ہوٚت_ فاقٕے
उपासक: عِبادَت_کَرَن_وول پوٗزا_کَرَن_وول
उपासगामी: وَرتھَس_مَںٛزجِنسی_تعلُقات_تھاوَن_وول
उपासमारो: فاقے_فُقرے_ فاقہٕ_مَرُن
उपेक्षा: نَظراَنٛدازَس_لایَق تَگوفُلَس_لایَق
उपेक्षित: نَظَراَنٛداز_کَرنہٕ_آمٕتۍ
उपेक्षीत: نِظر_اَنٛداز
उपेगाचें: مُفید فٲیدٕمَنٛد
उपेगी: قٲبِلہُنر_منٛدمٲہِِر فٲیدٕ_مَنٛد کامہِ_کار عَملی
उपोश्णकटीबंधीय: نیٖم_اِستِوایی
उप्तादीत: وۄپدیومُت _کھوٚتمُت
उप्राशिल्लें: حٲضِر
उबगणें: مایوٗس_کُن مایوٗس_کرَن_وول دِل_تَںٛگ__کَرَن_وول دِل_شِکشتہٕ_کَرَن_وول شکَستہٕ_کُن
उबगल्लें: تنگ_آمُت_ _تنگ_گوٚمُت_ _بیزار_ _پریشان_ _جیرٕ_آمُت
उबारपी: تولُن
उबारिल्लें: تُلُن
उबें: سیٚود
उबें_केल्लें: بنیومُت
उबेवपी: ییٖروُن
उभयचर: زٔمیٖنَس_تہٕ_آبَس_منٛز_روزَن_وول
उमथें: دُبہٕ _پھِرِتھ _اُلٹہٕ
उमेदी: خۄش خۄش_حالخۄش_مِزازخۄش_باش دِل_رنٛزنوومُت_ _مَن_رنٛزنوومُت پُر_جوش_ _جوش_دار_ _حوصلہٕ_منٛد_ _سَر_گَرم جوشہٕ_ہوٚت
उमेदी_बगरचें: بِلا_تحقیقات
उरपी: پایہٕ_دار
उरफाटे: مُخٲلِف_ _اُلٹہٕ_ _اَدلہٕ_بَدل_ _مُخٲلِف
उरफाटें: پھِرِتھ_ _اُلٹہٕ پِھرِتھ
उरफाटो_चलपी: پھِرِتھ_کٲم_کَرَن_وول _پھِرِتھ_پَکَن_وول
उरफाट्या_अर्थाचें: ضد
उरफाट्या_काळजाचो: سنٛگ_دِل_ بےٚ_انصاف _بےٚ_رحم _بےٚعار کٔنیوٗ _سنٛگدِل_ _بےٚرحَم
उरबेवंत: جوشہٕ_ہوٚت_ _جوشہٕ_دار جوشہٕ_وول_ سَرگَرٕم
उरमट: دوٚر_ _سَخٕت
उरिल्लें: خَرٕچ_کَرنے ہُریومُت_ بَچومُت_ ژَڈیومُت باقٕے_ بَقایہ ٹھٕہرِِتھ_ _رُکِتھ_ _بنٛد بَچیومُت _ہُریومُت _روٗدٕمُت
उरिल्लें_रीण: بَقایہہ
उरुग्वेयी: اُروٗگوٖیہُک اُروٗگوییَن
उर्दू: اُردوٗ
उर्बेभरीत: حوصلہٕ_وول آمادٕ_ _رٲغِب
उर्मट: بُتھۍ_پھیُربد_لِحاظہٕ نہِ_ڈَر_ _بےٚ_خوف
उलट_सुलट: اولہٕ_دولہٕ_ ہوٚل_کوٚل
उलटें: مُخٲلِف_ _اُلٹہٕ_ _اَدلہٕ_بَدل_ _مُخٲلِف
उलटें_सुलटें: بَکوٲسۍ
उलयतें: گرٛزُن
उलयिल्लें: تَلَفُظ_کٔرمُت ہَجیہ_کورمُت
उलोवपी: کَتھٕ_کَرَن_وول
उल्लेखनीय: قٲبلِ_تَوَجہ قٲبلِ_ذِکر قٲبلہِ_تحریٖر
उल्लेखीत: وَننہٕ_آمُت_ _وَننہٕ_پٲٹھۍ
उशीर_जाल्लें: ترٛوومُت
उश्टावंक_नाशिल्लें: شوٗژصافپاک
उश्टें: ژھیوٚٹ ژھیوٹ _اِستعمال_کَرنہٕ__آمُت
उश्ट्याचें: ژھیوٚٹ ژھیوٹ _اِستعمال_کَرنہٕ__آمُت
उश्ण: توٚتگرٕموٕشُن وٕشنیردار توٚت تیز شوخ
उश्णकटिबंधी: مَنطقہ_حارُک
उश्मागतीक: تٔھرموڈاینَمِکٕس
ऊंच: تھوٚد اَصٕل _تھوٚد تھوٚد تَھدِ_قَدُکھ
ऊंच_इमारतीचें: بَجہِ_عِمارَژ_وول تَھزٕعِمارَژٕ_وول
ऊकारांती: اوٗ_اَچَھر_وول
ऍनेमीक: خوٗنٕچ_کٔمی_وول أنیٖمِکۍ
एक: اَکھ _اَکوے _کُنُے
एक_करोड: کَرور
एक_जेवणाचें: اَکھ_کال_کھٮ۪نہٕ_وول
एक_तृतियांश: تٔرٛٮ۪یِم
एकक: اَکٲے
एकचाकी: اَکھ_ٹٲر_وول اَکھ_پٔہیہِ_دار اُک__ٹٲر_وول اُک_پٔہیہِدار اَکھ__ٹٲر_دار
एकचारवादी: رلہٕ_مِلہِ
एकचित्त: مَحنتی
एकटक: سٔنِتھ_گٔمٕژ _سَزیامٕژ
एकट्याचें: اوٚک_طرفی_ _اَکی_طرفُک
एकठांय: سوٚمبرٲوِتھ_ _جَمع_کٔرتھ یَکجاہ_ یَکجوٚت کُنی_بَنٲومٕژ _اِکہٕ_وَٹہٕ_کٔرمٕژ
एकतर्फी: اَکے_طَرفی_ _اُک_طَرفُک_ اَکھ_اَنٛدٕ_دار اوٚک_طرفی_ _اَکی_طرفُک اوٚک_طرفی_ _اَکی_طرفُک
एकतायपूर्ण: اِتفاق_پَسَنٛد اعتِدال_پَسَنٛد
एकतिसावें: اَکہٕترٕٛہِیُٛم
एकतीस: اَکترٕٛہ
एकतोंडी: اَکھ_بُتھ_وول اُک_بُتھِ_وول_م_یَک_بُتھِ_وول
एकत्र: سوٚمبرٲوِتھ_ _جَمع_کٔرتھ
एकत्रीत: اِتفاق_پَسَنٛد اعتِدال_پَسَنٛد سوٚمبرٲوِتھ_ _جَمع_کٔرتھ کُنی_بَنٲومٕژ _اِکہٕ_وَٹہٕ_کٔرمٕژ
एकदम: پَکہٕ _سَراسَر _پوٗرٕ
एकदेशी: اَکہِ_مِلکُک
एकनिश्ठ: وَفادار وفادار_خاندار تٔمۍ_سُندے_یوت
एकपिकी: کُنی_فَصلہِ_دار
एकभशेनचें: ہَم_معنی
एकमत: کُنی_راے
एकमताचें: پوٗرٕ_متفق_کٲم
एकमती: پوٗرٕ_متفق_کٲم
एकमुखी: اَکھ_بُتھ_وول اُک_بُتھِ_وول_م_یَک_بُتھِ_وول
एकमुळी: کُنُے_زوٚنکُنُے
एकमुळें: بۄكھہٕ_نَثُر
एकरुपी: ہِشے _ہیوٗ _ہِوُے
एकलें: اَکھ _اَکوے _کُنُے
एकलें-दुकलें: اَکھ_زٕ
एकलेंच: کُنُے _کُن _اَکوے
एकल्याचें: اوٚک_طرفی_ _اَکی_طرفُک
एकवटिल्लें: سوٚمبرٲوِتھ_ _جَمع_کٔرتھ
एकवटीत: یَکجاہ_ یَکجوٚت
एकविसावें: اَکوُہِیُٛم
एकवीस: اَکوُہ_ _اَکوُہِیُٛم
एकशिंग: ہیٚنٛگہٕ_پھُٹمُت
एकशिंगी: اُکہٕ_ہٮ۪نٛگَل
एकशिवडी: نِیُک زٲوِیُل
एकशें_एक: اَکھ_ہَتہٕ_اَکھ_ _اَکھ_ہَتھ_تہٕ_اَکھ_ _۱٠۱
एकसठ: اکحٲٹھ
एकसठावें: اکحٲٹھِم
एकसारकें: ہَم_معنی
एकसारकें_येवपी: بار-_بار_یِِنہٕ_وول پھِر_پھِر_یِنہِ_وول
एकसुरी: کُنُے_زوٚنکُنُے
एकसुरें: بۄكھہٕ_نَثُر
एका_चाकाचें: اَکھ_ٹٲر_وول اَکھ_پٔہیہِ_دار اُک__ٹٲر_وول اُک_پٔہیہِدار اَکھ__ٹٲر_دار
एका_दाराचें: اُک_دروازٕ_وول اَکوے_دَروازٕ_وول کُن_دروازٕ_وول کُنُے_دروازٕ_وول اَکوے_بَرٕ_وول
एका_वर्साचें: اَکہِ_ؤرِیُک
एका_शिंगाचें: ہیٚنٛگہٕ_پھُٹمُت
एकांत: خلوَخ ویٖران _سُنسان
एकांतवासी: کَھلوَکھ_روزَن_وول
एकाक्षरी: اوٚک_لغظڑ اوٚک_لفظی
एकाग्र: مرکزی
एकाग्रताय: مَحنتی
एकाच_काळांतलें: وَقتاًفَوَقتاً
एकाद्रें: اکھ_زٕ
एकारांती: اے_اَچَھر_وول
एकार्थी: اَکوے_مطلب_وول اُک_مَطلب_وول
एकावडो: اوٚگُن
एकावन: اَکوَنٛزاہ _اَکوَنٛزَہ
एकावनावें: اکوَنٛزٕہِم _اَکوَنٛزٕہیُم
एकासारकें: ہِویکُنی
एकुणअंयशीं: کُن_شیٖتھ _۸۹
एकुणअंयश्यांवें: کُن_شیٖتِھم
एकुणचाळिसावें: کُنتٲجِیُم
एकुणचाळीस: کُنتٲجی
एकुणणव्वद: کُنَمَتھ
एकुणतिसावो: کُنترٕٛہِیُٛم
एकुणतीस: کُنترِٛہ
एकुणपन्नास.: کُنٛوَنزاہ
एकुणपन्नासावें: کُنٛوَنٛزاہِیُٛم
एकुणसत्तर: کُنہٕ_سَتَتھ
एकुणसत्तरावें: کُنستھِم
एकुणसाठ: کُنہٕ_ہٲٹھ
एकुणसाठावें: کُنٛونٛزٔہِِم _کُنٛوَنٛزٔہیُم
एकुणीस: کُنوُہ کُنوٕہِم
एकुलगें: بۄكھہٕ_نَثُر
एकुलतें: بۄكھہٕ_نَثُر
एकूच: کُنُے _کُن _اَکوے
एकूलगी: کُنُے_زوٚنکُنُے
एकूलयी: کُنُے_زوٚنکُنُے
एके_वटेनचें: اوٚک_طرفی_ _اَکی_طرفُک
एकेचाळिसावें: اَکتٲجِیُٛم
एकेचाळीस: اَکتٲجی
एकोडें: کُنی_لٔر
एकोणअंयशीं: کُنہٕ_شیٖتھ
एक्यांयशीं: اکہٕ_شیٖتھ
एक्यांयश्यांवें: اکہِ_شیٖتِم
एक्याण्णव: اکہٕ_نمتھ
एक्याण्णवावें: اکہٕ_نمتھ
एक्यात्तर: اَکسَتتھ
एक्यात्तरावें: اکستتھِم _اَکسَتتھیُم
एक्वादोरी: اِکواڑورُک اِکواڑورِیَن
एण्टिगुवाचें: ایٚنٹِگُواہُک ایٚتِگوۭٲیۍ
एण्टिगुवायी: ایٚنٹِگُواہُک ایٚتِگوۭٲیۍ
एण्डोरी: اَنٛڑوراہُک اَنٛڑوٗرۍ اَنٛڑورِیَن
एतिहासीक: تَواریٖخی
एरिट्रियायी: اٮ۪ریٖٹَرٛیٲے اٮ۪ریٖٹرٛیاہُک
ऐंद्रजालीक: بٲزۍگٔر تِلِسمی_جادوٗیی
ऑफिसरा_भशेन: اَفسٔری
ऑफिसाचें: اَفسٔری
ऑस्ट्रियन: آسٹرِیُک آسٹرِیٲیۍ آسٹرٛیَن
ऑस्ट्रेलियायी: آسٹرٛٔلِیاہُلک
ओंठये: شفوی_ حروفِ_شفوی
ओंपिल्लें: وَقٕف وَقٕف_کَرنہٕ_آمُت نَزٕر_کَرنہٕ_آمُت
ओंश्ठ्य: شفوی_ حروفِ_شفوی
ओगोत_जाल्लें: ترٛوومُت
ओजस्वी: تابن_وول چمکدار
ओडलायणें: دِل_نِنہٕ_وول_ دِل_نِو_وُن _دِلچسپ_ خۄشوٕنۍ
ओपेरासांव_केल्ले: مُنتقٕل_کوٚرمُت بَدلوومُت
ओपेरासांवाचें: زَرِ_کٲم تِلہٕ_کٲم
ओपेरासावीं: سٔرجِکَل
ओबड_धोबड: پُھہَر
ओबडधोबड: ہیوٚر_بۄن ژھوٚٹ_تہٕ_موٚٹ
ओमथें: دُبہٕ _پھِرِتھ _اُلٹہٕ
ओमानी: اوٚمٲنۍ اوٚمانُک
ओरिया: اوریٖسٲۍ
ओलें: اوٚدُر
ओल्ताचें: موڑٕ_دار
ओवळें: سرٛانہٕ_روٚس سرٛان_کَرنَے_غۄسلہٕ_روٚس غۄسُل_کَرنَے
औपचारीक: ظٲہِری
औरस: جٲیِز
कंगाल: لاچار بٮ۪کَس غٔریٖب
कंजूस: کوٚنٛڑ کٔنٛجوٗس کٔنٛجوٗسکوٚنٛڑ
कंठ्य: اوٚژھ_تٲلۍ
कंपमान: تَھر_تَھرِ_دار _اَلہٕ_اَلہٕ_گَژھوُن نٔٹِنہِ_دار
कंपीत: تَھر_تَھرِ_دار _اَلہٕ_اَلہٕ_گَژھوُن نٔٹِنہِ_دار
कंवळें: پِشُل _پِشول _آبہٕ_تَھپھ _نَرٕم_پَھمٛب _مُلٲیِم
कचेरीक: دفتری
कचेरेचें: دَفتَری آفِشَل
कच्चें: خامکوٚچنیوٗلُے کوٚچ_ _نیوٗلُے کوٚچ_ _اومُے اَڈٕ_پوک گَرنَے کوٚچ نامُکمَل خام
कच्छी: کَچھُک کَچھُک_روزَن_وول
कजाकी: کَزٲکِستٲنۍ کَزاکِستانُک
कट्टर: مِسمار_کٔرِتھ شِٹھہٕ کَٹَر
कट्टरवादी: کَٹَر فِرسوٗدٕ_ دٔقیانوٗسی
कट्ट्या_विणें: کنٛجہِ_روٚس_ _دٮ۪لہٕ_روٚس_ _گۄلرِ_روٚس
कट्ट्याचें: کَنٛجہِ_وول_ _گۄلَردار_ _کنٛجہِ_دار
कठीण: سَکھ_ _مُشکِل پیچیٖدٕمُشکِلسَخ پیچیٖدٕ _مُشکِل کُھرۍ_لَد مُشکِل کروٗٹھ مُشکِل_ _دُشوار سخ _مُشکِل مُشکِل مُشکِل پیچیٖدٕ
कठोर: بےٚرحمظٲلِمبےٚ_آر ٹیوٚٹھ_ سخت خۄد_غرض_ بَد_لیحاظٕ__ احسان_فراموش
कडक: تیز خوفناک_ _دَہشَتناک تیزوٕلٹہٕ سخت_ _روب_داب سٔنگیٖن_ خراب_ خوف_ناکھ کھوٚژٕوُن
कडकडीत: توٚت_توٚت_ _گَرٕم_گَرٕم_ _گَرما_گَرٕم
कडें: ژھوٚٹ_تہٕ_موٚٹ گول_مَٹول
कडेनचें: قریٖبی _نَزدیٖکی
कड्डणाचें: غَلُک
कणकीचें: بٲنسوٗ
कणखर: تیز بُلَنٛد شاہانہٕ دَمدار
कणिल्ली: کٔنِتھ
कणीक: ویوٚٹھ
कण्याचें: ؤرٹِبریٹ
कथनीय: وَننَس_لایق
कदें: ویوٚٹھہُنیومُت
कनवाळू: رحم_دِلاِنصٲفی رَحَم_دِل
कनिश्ट: کم_پایہِ_ _ؤسۍ_پایہِ
कनिश्ठ: کوٗنس_ لۄکُٹ
कन्नड: کَنَڑ_کَرناٹکُک کَنَڑ کَنَڑ
कपटहीण: روٗپ_نہٕ_بَدلاوَن_وول
कपटी: دونٛکھہٕ_بوٚرُتھ بَدنِیت _کھوٚٹ_نِیَت _کھٔٹ_نِیَت بےٚ_ایمان_ _بےٚ_بروسہٕ دوکھہٕ_باز_ فَرٲبۍ_ جال_ساز _چالاک ہوشیار
कपडे_घाल्लें: پوشاکھ_وول_ پَلو_پوشاکھ_وول
कफल्लक: غریبمِسکیٖنسَفید_پوش
कबलातीचें: مُہادٕ_وول
कबाब_खावपी: کَبان_کھٮ۪نہٕ_وول
कबाब_विकपी: کَباب_کٕنَن_وول
कबीरपंथी: قٔبیٖر_فِرقُک
कमजोर: کَم_پایہِ__ بِچٲرۍ
कमयिल्लें: زیٖوٗنمُت _کَموومُت
कमळनेत्री: پَمپوش_چالہِ_ٲچھ_وول
कमळमुखी: پَمپوش_روے_وول پَمپوش_بُتھ_وول
कमी: کَم کم _کینٛہہ کم_پایہِ ؤسۍ_پایہ
कमी_उलोवपी: کَم_کَتھہٕ_کَرَن_وول_ کَم_سُخَن_ کَم_رَلوُن
कमोवंक_नाशिल्लें: زینٛنَے زیننہٕ_روٚس زیننہٕ_ورٲے
कमोवपी: زینہٕ_وُن
कम्युनिस्ट: اِتحاد_پسنٛد سماجی_مساوات اشتراکی
कर_आशिल्लो: ٹیکسہٕ_دار
करंगळी: کِس لَکُٹ
करणारो: کَرتا_دَرتا
करपाचें: کَرَن_لایَق کَرنَس_لایَق
करपी: کَرتا_دَرتا سَبَب
करमुक्त: ٹٮ۪کسہٕ_بَغٲر ٹٮ۪کسہٕ_روٚس_ ٹٮ۪کسہٕ_بَغٲر
करयुक्त: ٹیکسہٕ_دار
करहीण: ٹٮ۪کسہٕ_بَغٲر
करामती: چَمَتکٲری_ کَرامٔتی_ کٔرِشمٲتی
कराराचें: مُہادٕ_وول
करी_सारकें: کَرَن_لایَق کَرنَس_لایَق
करूंक_नाशिल्लें: کَرنَے _نَہ_کٔرمٕژ
करूंकनाशिल्लें: خَراب پَھش_پھِرِتھ
कर्कश: کرٛیٚکھ چِکھ
कर्तव्यवादी: کامہِ_پٮ۪ٹھ_یٔقیٖن_تھاوَن_وول اعمالَن_پٮ۪ٹھ_یٔقیٖن_تھاوَن_وول
कर्तृत्ववादी: کامہِ_پٮ۪ٹھ_یٔقیٖن_تھاوَن_وول اعمالَن_پٮ۪ٹھ_یٔقیٖن_تھاوَن_وول
कर्तृत्वी: ہُنٛرمَںٛد کامہِ_وول
कर्तो: کَرتا_دَرتا سَبَب
कर्नाटकी: کَرناٹکُک
कर्मवादी: کامہِ_پٮ۪ٹھ_یٔقیٖن_تھاوَن_وول اعمالَن_پٮ۪ٹھ_یٔقیٖن_تھاوَن_وول
कलंकीत: بَدنام _داغ_دار
कलम: قَلمی
कलय_काडिल्लें: کَلاےدار کَلاے_وول گِلَٹھ_وول
कलय_केल्लें: کَلاےدار کَلاے_وول گِلَٹھ_وول
कलयेचें: کَلاےدار کَلاے_وول گِلَٹھ_وول
कलात्मक: فَنکارانہٕ
कलापूर्ण: فَنکارانہٕ
कलाप्रेमी: ہۄنر_پسنٛد_ _فَن_پسنٛد
कलामोगी: ہۄنر_پسنٛد_ _فَن_پسنٛد
कलावंतीण: ہُنَرمَند فَن_وول قصٕب_وول صِفتہٕ_وول
कलावती: ہُنَرمَند فَن_وول قصٕب_وول صِفتہٕ_وول
कलाहीण: بےٚ_ذوق_ _بَد_ذوق
कल्पनेंतलें: خیٲلی _اَپُز
कल्पनेभायलें: غٲر_تصوُر_ _خیالہٕ_نٮ۪بَر
कल्पीत: تَصَوُری _خَیٲلی
कल्याणकारी: فٲیدٕ_مَنٛد
कळवळप: اثَر_گوٚمُت
कळाव_जाल्लें: ترٛوومُت
कवच_घाल्लें: بَکتَر_بَنٛدٕ_دار
कवचधारी: بَکتَر_بَنٛدٕ_دار
कवचाळ: وونٛٹ کَنٛجہِ_وول_ _گۄلَردار_ _کنٛجہِ_دار
कवितामोगी: نَظٕم_پَسنٛد
कव्हराचें: جِلدٕ_کٔرِتھ
कशाय_कशें: اولہٕ_دولہٕ_ ہوٚل_کوٚل
कशे_तरेचें: کِیُتھ_ کیاہ
कशें: کِیُتھ_ کیاہ
कश्टकरी: محنتی
कश्टदिणें: اِزاہ_خور _تکلیف_دیٖہہ_ شدیٖد_عذاب _دۄکھ
कश्टाची: دُکھی _غَمہٕ_ہوٚت دۄکھہٕ_دار
कश्टी: مُصیٖبت_زَد_ _پریشان
कसरती: وَرزِشی
कसलें: کِیُتھ_ کیاہ
कस्तुरीत: خۄشبوےدار
कांटयारें: کٔنٛڑۍ_دار
कांटे_नाशिल्लें: کَنٛڑٮ۪و_روٚستُے _کَنٛڑٮ۪و_بَغٲر
कांटेहीण: کَنٛڑٮ۪و_روٚستُے _کَنٛڑٮ۪و_بَغٲر
कांट्याबगरचें: کَنٛڑٮ۪و_روٚستُے _کَنٛڑٮ۪و_بَغٲر
कांठा_वयलें: بٔٹھِس_پٮ۪ٹھ_واقعہ _بٔٹھِس_پٮ۪ٹھ_آباد
कांठाचें: دٕنٛدٕرِدار
कांतिमान: پرٛزلوُن
कांतीमय: تابن_وول چمکدار
कांय: واریاہ _بِسِیار کم _کینٛہہ کَم_ _کَمٕے_ _قٔلیٖل کیٚنٛہہ
कांयच: کانٛہہ_کانٛہہ_ اَکھ_زٕ
कांश्याचें: سَرتَلوٗ سَرتَلہِ_ہُںٛد
काकुटी: چَلاون_وٲلۍ_ _خدمت_گار_ _تیٖماردار
कागदपत्री: دَستاویزی
कागदी: کاغزی کاغزی_ _کاغذُو_ _کاغذُک_ _کاکدی کاغزی
कागाळ: شِکایتہٕ_بوٚرُت شِکایتہٕ_ہوٚت پُر_شِکایت
कागाळ_करपी: فٔریٲدۍ
कागाळकार: فٔریٲدۍ تضادٕ_وول نیٛایہِ_لَد
काचाबूल: پریشان _اوٗرنہِ_یوٗرۍ
काजराचें: خانٛدَر
काजळ_घातिल्ले: سۄرمہٕ_دار
काजळहीण: سۄرمہٕ_ورٲے سۄرمہٕ_روٚس سۄرمہٕ_بَغٲر
काजळा_बगरचें: سۄرمہٕ_ورٲے سۄرمہٕ_روٚس سۄرمہٕ_بَغٲر
काजळाचे: سۄرمہٕ_دار
काजळी: سۄرمٲے ہَلکہٕ_نیوٗل
काजारी: خانٛدرٕ_وول
काटकसरी: کنٛجوٗس
काटू: کٔنٛجوٗسکوٚنٛڑ
काटूक: کٔنٛجوٗسکوٚنٛڑ
काठाचें: تِلہٕ_دار
काठियावाडी: زین_وول زین_دار
काडपी: ژٔلراوَن_وول ژٔلراوَن_وول دوٗر_کرَن_وول
काडिल्लें: برخاست اَلگ_کَرنہٕ_آمُت دوٗر_کَرنہٕ_آمُت ہَٹاونہٕ_آمُت
काणो: کون
कातरिल्लें: ژھیوٚنمُت
कातारी: قَترُک
कातीचो: مٕسلُک_ ژَمہِ_ہُنٛد
कात्र्यांचें: پیچہٕ_وول_ _پیچ_دار
कादंबरीक: ناولہِ_مَںٛز_شُمار_کَرنَس_لایَق ناولِ_مَںٛز_بَیان_کَرنَس_لایَق
कादंबरेचें: ناولہِ_ہٕںٛدۍ ناولہِ_مُطٲبِق
कादयेचे: ہوالٲتی
कान_फोडपी: کرٛیٚکھ چِکھ
कानकातरो: کَنہٕ_ژوٚٹ
कानकापो: کَنہٕ_ژوٚٹ
कानडी: کَرناٹکُک کَنَڑ کَنَڑ
कापरा_कोराचें: کوٚفوٗرکہِ_رَںٛگُک کوٚفوٗری
कापराचें: کوٚفوٗرُک کوٚفوٗرُک کوٚفورٕچ کوٚفوٗرَس_ہیوٗ
कापसाळ: سٕتھرٕدار_ پھَمبہٕ_دار
कापिल्लें: ژھیوٚنمُت
कापीत: واریاہ_بٕڈٕ
कापूंक_नाशिल्लें: اوٚر ٹھیٖک
काप्पी: واریاہ_بٕڈٕ
काफीर: کٲفِر
काबार: سَپدیومُت _مۄکلیومُت وٲران_ _چَھلہٕ_چھانٛگٕر
काबीज: قَبضہِ_کٔرِتھ
काबुली: کابُلۍ قوبٕلۍ قابُلُک
काम_करपी: کٲم_کَرنَس_لایَق
कामचोर: کامہِ_ژوٗر
कामनेचें: خوٲہِش_مَنٛد یوٚژھمُت _اُمیٖد_کوٚرمُت _وۄمید_کوٚرمُت
कामसू: وُژھ
कामहीण: پاک
कामाचें: کٲم_کَرنَس_لایَق
कायदेशीर: پُر_اِنصاف
कायद्याचें: قانوٗنی قونوٗنی
कायम: مُستقِل
कायरोचें: کوہِرٲہی
कारक: سَبَب
कारण_नासतना: بِلا_وَجَہہ
कारणा_बगर: بِلا_وَجَہہ
कारणां_करपी: بَہانہٕ_باز
कारबारी: کامہِ_کاج کارساز کامہِ_کار عَملی
कारस्थानी: بےٚ_ایمان_ _بےٚ_بروسہٕ
कार्यकारी: عٲرضی
कार्यरत: لاگوٗ_کَرنہٕ_آمُت عَملہِ_مَںٛز_اوٚنمُت مصروٗف
कार्यालयीन: دفتری دَفتَری آفِشَل
कालजयी: لافٲنی
काल्पनीक: خیٲلی _اَپُز تَصَوُری _خَیٲلی قیاس_آرٲے
काळ_सोंपिल्लें: وَقت_گوٚمُت وَقت_مۄکلیومُت ایٚکٕسپَیَر_گوٚمُت
काळंगा_कोराचें: ہیٚندٕوَند_رَنٛگ
काळंगी: ہیٚندٕوَند_رَنٛگ
काळखी: اَنہِ_گوٚٹ
काळजांतल्यान: وَژھہِ_وٲنٛجہِ دِلی
काळजाक_लागपी: جَزبٲتۍ
काळजाथावन: وَژھہِ_وٲنٛجہِ دِلی
काळजेचें: پریشان_کَرٕوُن_ _دۄکھ_واتناوَن_وول_ _فِکِر_منٛد_کَرَن_وول
काळवाचक: وقتی زمٲنی
काळींगकार: أمیٖررۄپیہِ_وولسَرمایہِ_دار
काळीज_चिरपी: اِنتِہٲیی_جَزبٲتی
काळीज_पिंजपी: دُکھی _بُرٕ
काळे_जिबेचो: کرِہٕنٛۍ_زِٮ۪وِ_وول
काळें: کرٛہُن _سِیاہ
काळें_कुळकुळीत: کُرٛہُن_واتُل_ہیوٗ
काळो: کرٛہُن
काव्यप्रेमी: نَظٕم_پَسنٛد
काव्यमोगी: نَظٕم_پَسنٛد
काव्यात्मक: شٲعرانہٕ_ _مَنظوٗم
काशीचें: بنارَسُک کٲشی_ہُںٛد
काश्मिरी: کٲشُر_ _کٔشیٖرِ_ہُنٛد کٲشُر کٲشُر
कासाचें: شِکار_کَرنَس_لایَق
कासादोर: شِکٲرۍ شِکٲرۍ شِکار_کَرَن_وول
कास्तिसांवाचें: پیچیٖدٕ _مُشکِل کُھرۍ_لَد
किंकोत: نَظراَنٛدازَس_لایَق تَگوفُلَس_لایَق
किक्के: کوٗتاہ
किजिली: لَڑایہِ_گٔرِنۍ لَڑایہِ_گوٚر لَڑایہِ_گٔرۍ_ دَنٛگہٕ_باز بۄغضی _حَسدی
किटकनाशक: کیٚمۍمارنُک
किटनाशक: کیٚمۍ_دوا
किटभक्षी: کیٚمۍ_کھٮ۪نہٕ_وول
किडकिडीत: أڑِجہِ_کرٛنٛز زٲویُلنیُک أڑِجوٗ ہوٚکھمُت _زٲوِیُٛل_ _نِیُٛک_ _کمزور
किडकिडें: نوزُک نَرٕم ٲویُل
किडेल्लें: کیٚمۍ_لدکیٚمۍدار
किड्यांचें_वखद: کیٚمۍ_دوا
किण्ण: خاموش ژھۄپہٕ_کٔرِتھ
कितले: کوٗتاہ
कितल्योश्योच: واریاہ _بِسِیار
किमती: درٛوٚگ _قۭمتی
किरंगळी: لَکُٹ
किरकिरो: نَسہٕ_نٲس_ ترٛوٚش_مِزان_ تُن_مِزاز_ موٗڈی
किरकोळ: پرچوٗن رِٹیل اَمہِ_یَمہِ رَلہٕ_مِلہٕ لۄکٕٹۍ_مۄکٕٹۍ _ہَلکہٕ_پُھلکہٕ _کینٛہہ_کینٛہہ _تھوڑا_بُہوٚت
किर्तशाळी: مشہوٗر ناو_وول_ قٲبلِ_تَوَجَہ قٲبلِ_ذِکر
किसमिसाचें: کِشمِش_دار کِشمِشہِ_واجِنۍ کِشمِش_ہِش
किसमीश_कोराचें: کِشمِش_رَںٛگ
कुंटिल्लें: دٔگِتھ_ماز کُفتہٕ
कुंभकर्णी: کُمبکَرنہٕ_سٕںٛز
कुकर्मी: بَدنٲمی_دار شَرَمناک رُسواکُن
कुकुलें: لۄکُٹ_مۄکُٹ _مۄکُٹ پِنٛتہٕ_کَلہٕ_ پینٛتہٕ_کَلہٕ_ _پِتہٕ_کَلہٕ پِشُل _پِشول _آبہٕ_تَھپھ _نَرٕم_پَھمٛب _مُلٲیِم ژھوٚٹ لۄکُٹ پیونٛت
कुचकामी: لاچار بےبَس
कुचकुचीत: گوٚن
कुच्छित्री: بَدتٔمیٖز _بَدسٔلوٗک _بےٚطور
कुटिल्लें: پیٖسِتھ
कुटील: بےٚ_ایمان_ _بےٚ_بروسہٕ سخ _مُشکِل
कुटुंबवितुश्टी: فسٲدۍ
कुटुंबहीण: بےٚکَس
कुटुंबीक: گریلوٗ موروٗسی _وَراسٔتی گَرٕ_بار_وول_ شُرۍ_بٲژ_وول
कुडके_जाल्लें: چوٗر_چوٗر
कुडीचें: جِسمٲنی
कुडीचो: جِسمہٕ_دار
कुड्डो: اوٚن
कुड्डो_विश्वासी: تۄہمَت_پَرَست
कुड्डो_विस्वासू: کَٹَر فِرسوٗدٕ_ دٔقیانوٗسی
कुतां_काडपी: تَنٛقیٖدی
कुतां_काडिनासपी: سیوٚد
कुपथ्य: مُضِر مُضِر_ _مُضرِ_صحت
कुपां_नाशिल्लें: صاف
कुपां_बगरचें: صاف
कुपां_विरयत: صاف
कुपांवीण: صاف
कुपात्र: فٕضوٗل
कुपाळ: اوٚبُرآلوٗدٕ
कुपोशीत: کمزور
कुप्रसिद्द: بَدنام
कुमारिका: اَنۂرِش_ پاک_دامن __خانٛدرٕ_روٚس_ _نیتھرٕر_وٚس
कुमारी: اَنۂرِش_ پاک_دامن __خانٛدرٕ_روٚس_ _نیتھرٕر_وٚس
कुरूप: بَدشکٕلبَدصوٗرَت
कुलिखीत: ٹُنٛڈٕ_خاو خَراب_لِکھاوَٹ
कुळपरंपरा: خانٛدٲنۍ
कुळवंत: خانٛدٲنۍ
कुळाची_परंपरा: خانٛدٲنۍ
कुळीन: خانٛدٲنۍ
कुविख्यात: بَدنام
कुवेटी: کُویتُک
कुशळ: مٲہِر _قٲبِل _پَکہٕ قٲبِلہُنر_منٛدمٲہِِر
कुशिल्ले: سَڑیومُت
कुशिल्लें: کیٚمۍ_لدکیٚمۍدار خراب_ _سڈیومُت_ _ہوٚتمُت_ _دۄدریو_مُت
कुशीक_काडिल्लें: ہَٹوومُت ڈولمُت
कुशीकचें: قریٖبی _نَزدیٖکی
कुशीचें: نَزدیٖکُک
कुसकें: خراب_ _سڈیومُت_ _ہوٚتمُت_ _دۄدریو_مُت
कुसयिल्लें: خٔمیٖر_بنیومُت خُم_کھولمُت
कूट: پیچیٖدٕمُشکِلسَخ
कूडहीण: جِسمہٕ_روٚژھ_ _جِسمہٕ_بَغٲر
कूपाळू: رحم_دِلاِنصٲفی
कूळहीण: کَم_ذات وےٚ_روٚس گَرٕ_روٚس عَیالہٕ_روٚس
कृतघ्न: نا_شُکران_ _ناشِناس
कृतज्ञ: احسان_منٛد _شُکُرگُزار
कृतार्थ: احسان_مَنٛد _شُکُرگُزار
कृत्रीम: بناوٹی _نَقلی
कृपापात्र: ہَمدَرٕد
कृशोदरी: زٲویُل_کَمَر_واجیٚنۍ
कॅटेलनी: کیٚٹِلین
कॅथोलीक: کیٹھلِک
कॅनेडीयन: کیٚنیڑاہُک کیٚنٔڑِیَن
केंद्रशासीत: مَرکٔزی_حٕکوٗمَتہٕ_وول
केंद्रीत: مرکزی
केंद्रीय: مرکٔزی
केंसाळ: زَتَھل جٔژ_وول
केनियायी: کیٖنیاہُک
केर्रेक: پاگَل دٮ۪وانہٕ موٚت ڈوٚلمُت
केल्लें: کٔرمٕژ _سَپٕزمٕژ
केशरी: کۄنٛگہٕ_دار زعفران_دار
केसरी: کۄنٛگہٕ_رنٛگہٕ سِنٛدرِ_رَنٛگُک
केसाळ: ییٛرٕدار
केस्तांवी: لَڑایہِ_گٔرۍ_ دَنٛگہٕ_باز
केस्ताळ: لَڑایہِ_گوٚر
कैदी: قۭدۍ جیلُکھ _بَنٛد
कोंकणी: کونٛکنی کونٛکنی_ کونٛکنُک کونٛکنُک_ _کونٛکنی
कोंगरे: وٲنٛکۍ_دار_ گوٗنٛگَر_دار_ کٔرلی
कोंड्याचें: بٲنسوٗ بٲنٛسوٗ
कोंत्रायिल्ले: کَںٛدٕ_کٲری
कोंबरेल्लें: پٔھلۍمٕتۍ
कोटाचें: قلعہٕ_کِس قِلعُک
कोटिवें: کرورُہِم
कोट्याधीश: کرور_پٔتی_ _کرور_پٔتۍ
कोडू: ژوٚک ٹیوٚٹھ ٹیوٚٹھ_ _ٹیچَھر
कोडू_काजरो: واریاہ_ٹیوٚٹھ واریاہ_ٹیوٚٹھ
कोडू_वीख: واریاہ_ٹیوٚٹھ
कोडूभाशी: ٹیٚچھہِ_زَبانہِ_وول _ترٛۄشہِ_زَبانہِ_وول
कोणूच: کانٛہہ_تہِ
कोनश्यांचें: کوٗنہٕ_دار
कोनी: کوٗنہٕ_دار
कोनीय: کوٗنہٕ_دار
कोप्रकार: وۄزُم_دِنہٕ_وول قرٕض_دِنہٕ_وول
कोमल: نَرٕم _مُلٲیِم نوزُک ٲویُل پِشُل _پِشول _آبہٕ_تَھپھ _نَرٕم_پَھمٛب _مُلٲیِم
कोमलांगिनी: نَرٕم_اَنٛگ_واجینۍ _نَرِم_تان_واجینۍ
कोमेल्ले: پھوٚٹمُت
कोमोरोजी: کیمیروزی
कोयराचें: رَبہِ_دار_ _لَژھِ_بوٗرُت
कोरांतिल्ले: کَںٛدٕ_کٲری
कोरियन: کورِیَن کورِیٲیی
कोरियी: کورِیَن کورِیٲیی
कोरी: نوٚو لاگنَے کورٕ
कोरें: کورٕ_ خٲلی_ _سادٕ
कोलंबियी: کولَمبِیاہُک کولَمبِیَن
कोलकाती: کَلکٔتۍ
कोलवाचें: گاسوٗ
कोल्हापुरी: کولاپوٗرُک کولاپوٗرۍ
कोसळिल्लें: کھستہٕ_ پیوٚمُت
कौमार्ययुक्त: پاک_دامَن
क्युबी: کیوٗباہُک کیوٗبٲیۍ کیوٗبَن
क्रमहीण: بےٚ_تَرتیٖب
क्रमा_बगरचें: بےٚ_تَرتیٖب
क्रमान: لَگاتار_ _مُسَلسَل
क्रियाशीळ: مصروٗف
क्रियाहीण: بےٚ_کار بِہِتھ
क्रिये_बगरचें: بےٚ_کار بِہِتھ
क्रिस्ती: کیٹھلِک
क्रुर: بےٚرحمظٲلِمبےٚ_آر
क्रूर: ظٲلِم _اِزَہ_کھور
क्रॅऑली: کرِٛیولۍ
क्रोएशियन: کرٛوایشِیاہُک کرٛوایشِیٲیۍ_کرٛوایشِیَن کرٛوایشِیٲیۍ
क्षणजिवी: فٲنی
क्षणभंगूर: فٲنی
क्षणीक: _عارضی_ کیٚنٛہہ_کالُک _کیٚنٛژھَس_کالَس
क्षत्रीय: شٔترِٛیا شٔترٛیاہُک
क्षमा: ماف
क्षमायाचक: معٲفی_منگن_وول_ _معٲفی_ہیٚنہٕ_وول
क्षमायोग्य: معٲفی_لایق
क्षमावान: معاف_کَرَن_وول _معٲفی_دِنہٕ_وول
क्षमाशीळ: معاف_کَرَن_وول _معٲفی_دِنہٕ_وول
क्षम्य: معٲفی_لایق
क्षय_रोगी: ٹی_بی_لَد
क्षीण: أڑِجوٗ ہوٚکھمُت _زٲوِیُٛل_ _نِیُٛک_ _کمزور
क्षुद्र: کَم_ذات
क्षुद्र_कुळाचें: ؤسِتھ_قٔبیٖلُک
क्षेत्रीय: علاقٲی
क्षेपक: لگاونٕکۍ
क्षेपणक: لگاونٕکۍ
क्षेम: رُت نیک اِصٕل جان
खंडक: پُھٹراون_وول_ _ختم_کَرن_وول
खंडणीय: پھٕٹَن_وول ژَٹنَس_لایَق
खंडाचें: جٔزیٖرٕ_نُماہُک
खंडी: بَرِ_اعظمُک
खंडीत: مَنٛسوٗخ_ _رَد پُھٹمُت
खंडीय: جٔزیٖرٕ_نُماہُک
खंतदिणी: دُکھی _غَمہٕ_ہوٚت
खंती: مایوٗس نا_اُمیٖد_ دِل_مَعلوٗل صدمہٕ_وول
खंतीची: دُکھی _غَمہٕ_ہوٚت دۄکھہٕ_دار
खंबीर: قٲیِماَٹَل _بَرقَرار جُکنہٕ_بَغٲر _نَمنہٕ_روٚستُے
खंयचेंय_एक: اکھ_زٕ
खगोली: فَلکِیٲتی
खटखटीत: دوٚر_ _سخت
खटारी: کھٹارٕ
खडकाळ: کَنِیوٗ
खडतर: سَکھ_ _مُشکِل
खडपाळ: کَنِیوٗ
खडबडीत: ہیوٚر_بۄن پُھہَر
खड्डो: ٹِنہِ_کَلہٕ_ _ٹَکلہٕ ٹِنہِ_کَلہٕ
खणखणीत: مِہیٖن ٲوِج
खणपी: کَھنَن_وول
खणिल्लें: کٔھنِتھ کٔھنِمٕتِس
खतखतीत: توٚت_توٚت_ _گَرٕم_گَرٕم_ _گَرما_گَرٕم پویہٕ_مُت
खताळ: داغہٕ_دار_ دَبہٕ_دار
खतेवल्लें: دٲغی_ _داغ_دار
खदूळ: گُرُٹ دالَو
खनीज: کٔھنِج
खबर_आशिल्लें: وٲقِف
खबर_नाशिल्लें: بےٚزٲنۍ _اَنجان
खबरेपत्र: دۄہدِشُکھ
खर: بےٚ_لَگام تیز خوفناک_ _دَہشَتناک مظبوٗطپایدارپۄختہٕ ٹیوٚٹھ_ سخت جوشہٕ_ہوٚت_ _جوشہٕ_دار جوشہٕ_وول_ سَرگَرٕم تیز بُلَنٛد سٔنگیٖن_ خراب_ خوف_ناکھ کھوٚژٕوُن خۄد_غرض_ بَد_لیحاظٕ__ احسان_فراموش مِہیٖن ٲوِج
खर_बुद्दीचें: تیز_دٮ۪ماغہٕ_دار
खरकटें: ژھیوٹ _اِستعمال_کَرنہٕ__آمُت
खरखरीत: خۄشِک_ _ہوٚکھ
खरसाणीचे: زورٕدار
खरी: صاف صٔحی_ اَصلی_
खरें: پوٚزصحیح صحیح_ _ٹھیٖک_ _دُرست حٔقیٖقی
खरो: ایمانٛداررُت
खर्चीक: فضوٗل_خرچ
खर्व: خَرَب
खळबळीत: حٲرت_اَنٛگیز حٲران_کُن
खळान_भरिल्लें: مایہِدار
खांदये_बगरचें: لَنٛجو_روٚس
खांदये_विरयत: لَنٛجو_روٚس
खांदी_नाशिल्लें: لَنٛجو_روٚس
खांदो: لَنٛجِدار شاخہٕ_دار
खांपें: مٲہِر _قٲبِل _پَکہٕ
खांपो: مٲہِر
खाकी: خٲکۍ گُرِٹھۍ
खाजगी: ذٲتی _پَنُن ذٲتی _پَنُن غٲر_سرکٲری
खाजराचें: کٔھزٕرَن_ہُںٛد کٔھزٕرہیوٗ
खाडकीचें: ہۄنٛگنہِ_ہُںٛد
खाडयो: ریشَل ریشہٕ_دار
खाणा_बगरचें: نِراَہار
खातेदार: کھاتہٕ_وٲلۍ
खादाड: یٔڑل _بَتہٕ_جِن
खाद्य: کھٮ۪نس_لایق
खानदानी: موروٗسی _وَراسٔتی
खापो: بَہادُر دِلاوَر دِلیر ہوٚس_ہیوٗ
खायलें: آنجٲرۍ_مانٛجٲرۍ_ ناچیٖز ماتحَت بونہ بٔنیُم تٔلیُم
खायलो: بۄن_ _بوٚنِیُٛم_ _پَس_ _سروٚن
खायल्या_कुळाचें: کَم_ذات ؤسِتھ_قٔبیٖلُک
खारट: نُنہٕ_دار _نَمکیٖن الکالٲیِن_الکلِک
खारें: نُنہٕ_دار _نَمکیٖن
खालचें: بوٚنِٛیُٛم_ _کَم_ _لۄکُٹ
खालते_मानेचें: بُتھ_لٔدِتھ
खाला_दिल्लें: بۄنہٕ_کَنہِ_دِتھ
खाली: ژھوٚرُے خٲلی کَم_کارٕ_وول کَم_کامہِ_وول کَم_کامہِ_کارٕ_وول خٲلی فرٛی
खाल्लें: ہَضٕم
खावंक_नाशिल्लें: شوٗژ _صاف_ پاک_ _ژھیوٚٹ_نہٕ
खावगें: یٔڑل _بَتہٕ_جِن
खावपाचें: کھٮ۪نس_لایق
खावपी: کھور کھٮ۪نہٕ_وول
खाशेलें: خاص
खाश्या: اَکے_ڈَمبہِ پَنُن
खाश्श्या: ذٲتی پَنُن پَنُن
खास: خاص خاص خاص مَخصوٗص
खिणयाळें: _عارضی_ کیٚنٛہہ_کالُک _کیٚنٛژھَس_کالَس
खिसेकापो: چَنٛدٕ_ژوٗر_ چَنٛدَن_پَھرَن_وول
खीणयाळें: فٲنی
खुटें: پٔرٛتہٕ_وٲنۍ_ _بےٚ_مَزٕ
खुनी: قٲتِل_ _خوٗنی
खुळो: پاگَل باورٕ
खूब: واریاہ _بِسِیار واریاہ _کٲفی پوٗرِ_پوٗر_ _بَر_پوٗر بٔرِتھ_ _ٹیپہِ_ __بَرپوٗر سروٚن
खूब_कोडू: واریاہ_ٹیوٚٹھ
खूब_चड: واریاہ _سٮ۪ٹھاہ
खूब_व्हड: واریاہ_کُشادٕ
खेंचर: وُڈٕوُن
खेदहीण: بےٚ_شوق
खेरीज: مُختٔلِف_ بر_عکس
खेळाचें: گِنٛدنَس_لایَِق کھیلَن_مُتعلِق
खेळीमेळीचें: رَلوُن
खोजो: نامَرٕد
खोटे: کھوٚٹ_ _نَقلی_ جٲلی_ فَرضی
खोटें: اَپٕزۍیور اَپُزغلط بےٚ_بُنِیاد _غَلَط ہانٛژھہٕ_دار
खोटो: بَدنِیت _کھوٚٹ_نِیَت _کھٔٹ_نِیَت مکار _اَپٕزیور
खोडपी: پُھٹراون_وول_ _ختم_کَرن_وول
खोडाचें: لٔکرِیو لٔکرِ_ہُنٛد ہَچوٗ ہَچہٕ_ہُنٛد
खोडून_काडपी: پُھٹراون_وول_ _ختم_کَرن_وول
खोदूळ: گُرُٹ دالَو
खोल: سرٛوٚن سرٛوٚن
खोशये_बगरचें: غٲر_مُتمعین
खोशी: خۄش خۄش_حالخۄش_مِزازخۄش_باش دِل_رنٛزنوومُت_ _مَن_رنٛزنوومُت
खोस_दिना_अशें: غٲر_مُتمعین
खोस_दिवपी: پُر_مُتمعین
खोसदिणें: مََزٕ_دار _پُر_مَسرَت خۄشوُن_ خۄش_گَوار_ اَصٕل لوٗب_وُن پُر_مُتمعین
खोसयाळें: پُر_لُطُف _پُر_سٔکوٗن
ख्यास्तपात्र: سَزایافت _سَزہَس_لایق سَزایافت _سَزہَس_لایق
ख्यास्ती_बगरचें: سزا_روس
ख्यास्ती_विणें: سزا_روس
गंगेचें: گَنٛگاہُک
गंदकी: گَنٛدکہِ_رَںٛگُک
गंदीत: مٕشکاونہٕ_آمُت _مُشکاونہٕ_آمُت
गंधहीण: مشکہٕ_روٚس
गंधीत: مُشکہٕ_دار _خۄشبو_دار
गंवां_कोराचें: کٕنٕکہٕ_رَںٛگ گُندمی
गंवाळ: کٕنٕکہٕ_رَںٛگ گُندمی
गच्च: گوٚن
गच्च_वाडिल्लें: ژانٛڈٕ_دار
गटखळ: سَخ _مُشکِل
गडखळ: سَخ _مُشکِل
गडगडपी: پھۄلمُت پھانٛپھلیومُت
गडद: شوکھ تیز بوٚرُت
गडबडें: جلدباز
गडबडो: رٔزیٖلہٕشَرارتی
गणतंत्री: جمہوٗری
गणनीय: گٔنٛزرَنَس_لایق
गण्य: گٔنٛزرَنَس_لایق
गतिशील: تیز
गतिहीण: رُکِتھ
गतीचें: پَکوُن _چَلوُن
गतीशील: پَکوُن _چَلوُن
गतीहीण: ٹھٕہرِِتھ_ _رُکِتھ_ _بنٛد
गद्यात्मक: نَژی
गरगरीत_वाडिल्लें: ژانٛڈٕ_دار
गरजू: ضروٗرت_منٛد_ _حاجت_بنٛد مۄحتاج
गरजे_भायर: غٲر_ضَروٗری
गरजेचें: ضروٗری _لٲزِمی لٲزِمی _ضروٗری
गरजेवंत: ضروٗرت_منٛد_ _حاجت_بنٛد مۄحتاج
गरम: توٚتگرٕموٕشُن ییرُو وٕشنیردار توٚت _گَرٕم
गरमागरम: توٚت_توٚت_ _گَرٕم_گَرٕم_ _گَرما_گَرٕم
गराचें: گوجہِ_دار
गरीब: غریبمِسکیٖنسَفید_پوش
गर्भस्थ: دَرشٕکَم_ شٕکَم_دَر
गर्भीत: چُھوپِتھ_ کٔٹِتھ دَرشٕکَم_ شٕکَم_دَر
गर्भेस्त: بے_زُو_ _گۄبہِ_کھۄرٕ
गर्वहीण: نرٕم ِعِزتہٕ_بَغٲر _شانہٕ_بَغٲر _عِزتہٕ_روٚس
गर्विश्ट: غٲرَت_منٛد خۄد_پسنٛد
गवत_खावपी: گاسہٕ_کھٮ۪نہٕ_وول
गवताचें: گاسوٗ
गवय्यो: گَٮ۪وَن_وول
गवाय: چٔشمہٕ_دیٖد
गांजपी: گوٗنٛجِتھ
गांठयारें: کھُرۍ_دارکھُرۍ_لد
गांधर्व: گَنٛدَرٕو_سُںٛد نیٖم_دیوتا_سُںٛد
गांधीवादी: گانٛدی_وادی گانٛدی_وادی
गांबियायी: گیمبیاہُک_ _گیمبیٲے
गांवगिरी: گامٕچ گٲمی_ _گامٕکۍ_ _دیہٲتی_ _گروٗس
गांवगिरे: گامٕکۍ_ _گٲمی_ _دہٲتی_ _گروٗس
गांवगिरो: گامُک
गांवटी: گر_کُلی
गांवठी: گامُک
गाठींचें: کھُرۍ_دارکھُرۍ_لد
गाड: بوٚرُت مَژِ_ _سرٛوٚن_ _گوٚب
गाढ: موٚٹ
गादयेचें: گٔدِ _پَھمبُک_گَدیلہٕ
गाबणी: بیٚیہِ_زوٗ گوٚبِہ_کھۄر
गाबायी: گاباہُک گابٲے
गायक: گَٮ۪وَن_وول
गायब: نظر_نہٕ_یِنہٕ_وول
गायेपसूनचें: گاوِِ_نِش_نیرَن_وول گاوِ_نِش_حٲصِل_سَپدَن_وول گاوِ_ہُںٛد
गार्फ: قَلمی
गाळाचें: سٲلٲبی_میٚژ سیوٚمب
गावपी: گَٮ۪وَن_وول
गिड्डो: ٹھٕنٛگنہٕ_ لۄکُٹ_ گُٹھکہٕ
गिन्यानान_भरिल्लें: عٔلمہِ_واجین
गिन्यानी: عٲلِم وٲقٕف_ _آگاہ_ زٲنۍکار_ _زٲنۍیاب
गिमाळ्याचो: گَرم_ _گریشٕمہ_کال_ _رٮ۪تہٕ_کالہِ
गिरबोवपा_सारकें: زٔدۍ_کَرنَس_لایَق
गिरायक: رَٹَن_وول
गिरेस्त: وٲفِر أمیٖررۄپیہِ_وولسَرمایہِ_دار
गिळिल्लें: ژوپمُت _نیٚنٛگلیومُت _گیرٕ_کوٚرمُت احاطہٕ_کوٚرمُت
गिळूंक_नाशिल्लें: نیٚنٛگلاونَے
गुंडयाळें: کَنیوٗ
गुंथवणूकदार: پونٛسہٕ_لاگَن_وول
गुंथिल्लें: لٔگِتھ
गुजराती: گُجراتُک گُجرٲتۍ گُجرٲتۍ_ _گُجرٲتی
गुजराथी: گُجرٲتۍ گُجرٲتۍ_ _گُجرٲتی
गुठल्यांचें: گَٔنٛدۍ_دار
गुडहीण: رازٕ_بَغٲر
गुणकारक: کارگَر_ _اثر_دار
गुणग्राहक: قدردان
गुणग्राही: قدردان
गुणयुक्त: اَصٕل
गुणरहीत: بَد_صِفت_ _عٲب_دار
गुणवंत: صِفَت_دار
गुणवत्तायुक्त: اَصٕل
गुणवत्ताहीण: گۄنو_روٚس
गुणी: صِفَت_دار صِفتہٕ_وول وَصفہٕ_وول
गुणेस्त: خوٗن_ہان_ _ہوٗن_ہار
गुन्यांवकार: گۄناہ_گارقصوٗروارجُرُم_وارخطہہ_وارمُجرِم
गुन्यांवकारी: جُرُم_یافتہٕ جُرم_یافتہٕ گۄناہ_گار_ _خطاوار خَطاکار اِلزام_یافتہٕ
गुन्यांवी: جُرم_یافتہٕ خَطاکار اِلزام_یافتہٕ
गुन्यावंकार: گۄناہ_گار _قٕصوٗروار
गुपीत: سِر سِر _کٔھٹِتھ راز رازدار پُر_اَثرار چُھوپِتھ_ کٔٹِتھ ژوٗرِ_تھوٚومُت _کٔھٹِتھ_تھوٚومُت
गुप्त: سِر سِر _کٔھٹِتھ راز ژوٗرِ_تھوٚومُت _کٔھٹِتھ_تھوٚومُت
गुप्तहेरी: جاسوٗسی
गुबगुबीत: لوو
गुयानी: گیاناہُک گُیاناہُک گُیانیٖز گیانیٖز
गुरवार: بے_زُو_ _گۄبہِ_کھۄرٕ
गुरुकूलवासी: گُروٗکُلُک گُرکُل_وٲسی گُروکُلُک_روزَن_وول
गुरू_नाशिल्लें: بےٚ_وۄستاد وۄستادَو_بَغٲر وۄستادَو_رۄستُے
गुरूहीण: بےٚ_وۄستاد وۄستادَو_بَغٲر وۄستادَو_رۄستُے
गुलाबाचें: گۄلابَن_ہُںٛد گۄلٲبۍ
गुलाबी: گۄلٲبۍ
गुलाम: چَمچہٕ_ خۄش_آمٔدۍ_ چاپلوٗس گٔنٛڈِتھ
गुल्ल: مشغوٗل لٔگِتھ آوُر_ _مصروٗف
गुळगुळीत: ہموار_ __سوٚم_ _پِِشُل
गूढ: سِر سِر _کٔھٹِتھ راز پیچیٖدٕمُشکِلسَخ رازدار پُر_اَثرار چُھوپِتھ_ کٔٹِتھ
गृहस्ताश्रमी: گَرکُلی خانٛدار گَرٕ_وول
गृहोपयोगी: گریلوٗ
गॅसीय: گیسُک
गेय: گٮ۪ونَس_لایَق
गेल्लें: زَبٕد_ کُرِکۍ_کٔرِتھ سوٗزمُت_ _روانہٕ_کوٚرمُت
गैरहजर: غٲر_حٲضِر _غٲر_موجوٗد _نابوٗد
गॉटेमालाचें: گاٹٕمالاہُک گاٹٕمالٲیۍ گاٹٕمالَن
गॉटेमालायी: گاٹٕمالاہُک گاٹٕمالٲیۍ گاٹٕمالَن
गोंदळिल्लो: پریشان _اوٗرنہِ_یوٗرۍ
गोचर: ٹاکارٕ نوٚن
गोठिल्लें: لٔگِتھ
गोड: موٚدُر_ _میوٗٹھ_ _سُریٖلہٕ_ _موٚدُر_حلقہٕ موٚدُر میٖٹھ موٚدُر خۄشوُن
गोड_उलोवपी: کھۄلکی
गोडभाशी: کھۄلکی
गोड्यामुताचें: ڈیابِٹِک کھںٛڈٕ_بٮ۪مٲرۍ_وول
गोथिक: گوتھِک
गोथीक: گوتھِک
गोबरें: سوٗرۍ
गोरखपंथाचें: گورَکھ_ناتھَس_مانَن_وول گورَکھ_ناتھ_سُںٛد_مُریٖد
गोरखपंथी: گورَکھ_ناتھَس_مانَن_وول گورَکھ_ناتھ_سُںٛد_مُریٖد
गोरो: پرٛوٚن
गोरो-गुलाबी: نُنہٕ_کاژُر
गोरो_धवो: پرٛوٚن
गोल: گول گول
गौण: فضوٗل
गौरवपूर्ण: با_وَقار_ _شان_دار
गौरवशीळ: با_وَقار_ _شان_دار
ग्रंथिकी: کتٲبی
ग्रस्त: زَد دۄکھٕ_لَد _غَمزدٕ_ ژٮ۪لہٕ_لَد
ग्रिनलॅण्डी: گریٖنلینٛڑُک گریٖنلینٛڑَر گریٖنلینڑِک گریٖنلینٛڑٲیۍ
ग्रीक: یوٗنانُک یوٗنٲنۍ گریٖٖک
घट: قریٖبی قٲیِماَٹَل _بَرقَرار دِلہیر _جِگرٕ_دوٚر _بہادُر ٹھوس تیزوٕلٹہٕ مظبوٗطپایدارپۄختہٕ بَد_حَواس مُصیٖبَت_زَد _صَدمہٕ_لَد_ دَم_پھٕٹۍ دوٚر_ _سخت ٹھیٖک اَصٕل واریاہ_دوٚر واریاہ_مَظبوٗط
घट_काळजाचें: سَنٛگ_دِل بےٚ_آر
घट_काळजाचो: سنٛگ_دِل_ بےٚ_انصاف _بےٚ_رحم _بےٚعار کٔنیوٗ _سنٛگدِل_ _بےٚرحَم
घटमूट: اوٚر_تہٕ_دوٚر_ ویوٚٹھ_پوٗٹھ
घडपाचें: سَپدَن_واجٮ۪ن گَژھَن_واجٮ۪ن
घडपी: سَپدَن_واجٮ۪ن گَژھَن_واجٮ۪ن
घडयिल्लें: تَصَوُری _خَیٲلی بنیومُت
घडिल्लें: ُگُزریومُت
घडूंक_नाशिल्लें: نہ_گَژھہٕ_وٕنۍ
घणघणीत: مِہیٖن ٲوِج
घन: ٹھوس
घमेंडखोर: گُمنٛڈی_ _مغروٗر
घमेंडी: غٲرَت_منٛد خۄد_پسنٛد اَکڑی
घरगुती: گریلوٗ گر_کُلی گریلوٗ
घरभेदी: فسٲدۍ
घरमोडें: فسٲدۍ
घरहीण: گَرٕ_روٚژھ_ _گَرٕ_بَغٲر
घरावें: گریلوٗ گر_کُلی
घसरड: کھٕرِدار رِکٕنۍوول رِس_دار
घसरिल्लें: سَستہٕ_ _کم
घांसमारें: ژۄپَل
घाई_करपी: جلدباز
घाडी: جودگوٚر سِہَرگوٚر
घाणयारें: مٲلہٕموٚکُرگَنٛدٕناصافناپاکھ مل_دار
घाणीचें: گَنٛدٕ _موٚکُر
घातक: سَخٕت_ شٔدیٖد
घातकी: ظٲلِم لا_خٲر_ _گدار _بے_وفا خطرناک_ دوکھہٕ_باز_ فَرٲبۍ_ جال_ساز _چالاک ہوشیار
घातमारें: دوکھہٕ_باز_ فَرٲبۍ_ جال_ساز _چالاک ہوشیار
घातिल्लें: کھولمُت _عٲیِد_کوٚرمُت _لوگمُت
घानायी: گاناہُک
घामाचें: عٲرقہٕ_سۭتۍ_وۄتَھن_وول عٲرقہٕ_سۭتۍ_پٲدٕ_گَژھَن__وول عٲرَق_اَنَن__وول عٲرَق_یِنہٕ_وول
घामान_भिजिल्ली: عٲرقہٕ_ہوٚت_ _عٲرقہٕ__اوٚدُر
घामेल्ली: عٲرقہٕ_ہوٚت_ _عٲرقہٕ__اوٚدُر
घामेल्लें: تاپہٕ_ژٔٹۍ تاپَن_ژٔٹمٕتۍ
घायाळ: زَخمی چھۄکہٕ_لَد زَخمی
घारशें: بِیُل بِلۍ
घारसो: بیُل
घार्मिक: مَزۂبی
घालप: ترٲوِتھ_ _رَلٲوِتھ
घालपा_सारकें: لاگُن_لایق_ _قٲبلہِ_استعمال
घालोवपी: ژٔلراوَن_وول دوٗر_کرَن_وول
घाळ: لاپَرواہ
घुमटाचें: قُبہٕ_دار قُبہٕ_وول پرٛنگ_دار_پرٛنگ_وول
घुमपी: گوٗنٛجِتھ
घुमें: ژھۄپَل_ دَمَل
घुरी_घालपी: فِدٲیی
घुवळी_वखदां: أفیٖمہِ
घुवळीचें: شودٕ_ _شرٲبی_ _چرسی
घुसपटिल्लें: کُھرۍ_دار
घुसपलिल्लो: پھسیومُت _بَنٛد_گوٚمُت
घुसपल्लें: کُھرۍ_دار
घुसपागोंदळ: پیٖچیٖدٕ مُشکِل سَخ وٕلٹہٕ
घुसळिल्लें: مَنٛدومُت چھونٛپ_دِتھ دیون_دِتھ
घुस्पागोंदळाचें: پیچیٖدٕ _مُشکِل کُھرۍ_لَد
घुस्पूंक_नाशिल्लें: سُلجیومُت
घृणास्पद: ناشٲیستہٕ
घृणीत: ناشٲیستہٕ
घेरिल्लो: ؤلِتھ
घेवपी: رَٹَن_وول
घोग्यांचो: روٗدٕ_شرٛانہ
घोडदळ: گُرۍ_سوار
घोड्या_बगरचें: پٲدِل
घोनें: بیوقوٗفچوراَحمَکباورٕ
घोर: سٔنگیٖن_ خراب_ خوف_ناکھ کھوٚژٕوُن
घोळटी: پِکوُن_ چَلوُٕن_ جٲری
घोळटें: خانہٕ_بَدوش_ _ٹھِکانہٕ_روٚس_ _دَر_بہٕ_دَر_پھیرَن_وول
घोळपी: گَلَن_وٲلۍ _پِگلَن_وٲلۍ
घोळोवप: ترٲوِتھ_ _رَلٲوِتھ
घोशीत: درٛامُت_ عیلان_کوٚرمُت ووٚنمُت
घोस्ताचें: ٹوٹھ _دِلَس_مُوٲفیٖق _مَن_پَسَنٛد
चंचळ: ڈوٚلمُت رٔزیٖلہٕشَرارتی بےٚقرار ڈٔٹِتھ_نہ_روزَن_وول بےٚ_مغٕز_ _گوٚش
चंदनाचें: ژنٛدنُک
चंदनी: ژنٛدنُک
चंदेरी: زوٗن _زوٗنہٕ_گاش
चंद्रवंशी: چَنٛدَروَنٛشی چَنٛدَروَشیہِ چَنٛدرِوَنٛشُک
चकचकपी: چَمکیٖلہٕ _چَمَکوُن _زٕژٕدار پرٛزَلوُن چَمَکوُن نَپہٕ_نَپہٕ_کَروُن
चकचकीत: گاشدار صاف_ _شَفاف چَمَکدارچَمکیٖلہٕزٕژٕدار
चक्रम: بیوقوٗفچوراَحمَکباورٕ پاگَل دٮ۪وانہٕ موٚت ڈوٚلمُت پاگَل باورٕ
चक्रवर्ती: شَہنشاہ
चक्राचें: ہَگَردار پٔہیہٕ_دار ویٖلہٕ_دار
चक्राचो: چَکَرٕ
चक्री: چَکَرٕ
चक्रीय: چَکَرٕ
चड: واریاہ _بِسِیار واریاہ _کٲفی خطرناکھ سروٚن
चड_काळाचें: پوشوُن
चड_कोडो: واریاہ_ٹیوٚٹھ
चड_गरजेचें: اَشد_ضروٗری
चड_रागीश्ट: شَرارتہٕ_ہوٚت
चडपा_सारक्या: کَھسوٕنِس
चडपी: کَھسَن_وول
चडशे: زیادٕ_سَے_زیادٕ
चडांत_चड: زیٛادٕ_کھۄتہٕ_زیٛادٕ زیادٕ_سَے_زیادٕ
चडाक्षरी: وارِیاہ_اَچھرٕ_وول
चडिल्लें: کھوٚتمُت
चतुर्भुजी: ژُکوٗنٛجَل
चतूर: چالاک تیز ہُشار رِنٛدٕ زِنٛدٕ_دِل چالاک_ _عٲقٕل__ _ذہیٖن_ __شٲطِر _تُرٛک_ _گاٹُل
चपळ: چالاک_ _عٲقٕل__ _ذہیٖن_ __شٲطِر _تُرٛک_ _گاٹُل
चमचो: چَمچہٕ_ خۄش_آمٔدۍ_ چاپلوٗس
चमत्कारी: چَمَتکٲری_ _معجِزٲتی چَمَتکٲری_ کَرامٔتی_ کٔرِشمٲتی
चरबी_आशिल्लें: چَربہٕ_دار چَربی_دار
चरबी_नाशिल्लें: چَربہٕ_روٚس چَربہِٕ_ورٲے
चरबीहीण: چَربہٕ_روٚس چَربہِٕ_ورٲے
चरबेचें: چَربہٕ_دار چَربی_دار
चरम: اعلٰی سِخٕت شَدیٖد حد_درجٕہ انتہا عروٗجَس_پٮ۪ٹھ
चरमपंथी: اِنتِہا_پَسنٛد
चरित्रवान: رُت رٕژِسیٖرَت_وول
चरित्रहीण: بَد_کِردار_ _بَدذات بَد_کِردار_ آوارٕ_ _بَدماش_ بَد_چَلَن_ _بے_عزت بَدمٲش_ _بَدکِردار_ _بَد_ذات
चर्चीत: نامور_ _مشہوٗر
चलणुकेंत_नाशिल्लो: فرسوٗدٕ _نالَگہار
चलणुकेची: پِکوُن_ چَلوُٕن_ جٲری
चलपाचें: بٔٹھۍ_
चलपी: پَکوُن پَیدل کٲم_کَرنَس_لایَق پکوُن
चलयिल्लें: چَلوُن
चळवळें: بٲغی
चवताळिल्लें: پاگَل_ مست
चवतिसावो: ژۄیہِ_ترٕٛہِیُٛم
चवतीस: ژۄے_ترٕٛہ
चवथें: ژوٗرِیُٛم_
चवदा: ژۄدٲہِم
चवद्यांयशीं: ژُشیٖتھ
चवद्यांयश्यांवें: ژُ_شیٖتمس
चवद्याण्णव: ژُنَمَتھ
चवद्याण्णवावें: ژُ_نمتِم
चवद्यात्तर: ژُسَتَتھ
चवद्यात्तरावें: ژُ_ستتھِم
चवपन: ژُوَنٛزاہ ژُوَنٛزَہ
चवपनावें: ژُونزٔہِِم _ژُوَنٛزٔہیُم
चवसठ: ژُہٲٹھ
चवसठावें: ژُہٲٹھِم
चवेचाळिसावें: ژۄےتٲجی
चवेचाळीस: ژۄیتٲجی
चांदीचें: رۄپہٕ_رَنٛگُک رۄپہٕ_سُںٛد
चांद्र: قَمری
चाकाचें: ہَگَردار پٔہیہٕ_دار ویٖلہٕ_دار
चाकी: ہَگَردار پٔہیہٕ_دار ویٖلہٕ_دار
चाडी: چٲڑی
चान्नी: زوٗن _زوٗنہٕ_گاش
चाफाच्या_रंगाचें: چَمپا_رَنٛگُک
चाफ्याकोराचें: چَمپا_رَنٛگُک
चाबपी: ژۄپَل
चामटो: کوٚنٛڑ کٔنٛجوٗس کٔنٛجوٗسکوٚنٛڑ
चामड्याचें: دالوٗ دالُک چَمرِیوٗ
चामाराचें: واتُل_سُنٛد سِرٲجی
चायनीस: چیٖنی
चार: ژور ۴
चार_खावपी: گاسہٕ_کھٮ۪نہٕ_وول
चार_रंगी: ژُرَنٛگہٕ_دار
चारचाकी: ژور_ٹٲر_وول ژۄن_ٹٲرَن_ہُںٛد ژور_پٔہیہِ_وول ژۄن_پٔہیَن_ہُںٛد
चारतर्फी: ژُطَرفہٕ
चारपट: ژۄگنہٕ_ _ژوٚگُن_ _ژور_گنہٕ
चारशेंवीस: دونٛکھہٕ_باز _تِگڑَم_باز بے_ایٖمان
चारित्र्यवान: رُت رٕژِسیٖرَت_وول
चारेक: لَگ_بَگ_ژور
चालंत: پَکوُن _چَلوُن
चालक: کَنٛڑَکٹَر
चालाक: چالاک_ _عٲقٕل__ _ذہیٖن_ __شٲطِر _تُرٛک_ _گاٹُل تِگڑَم_باز
चालू: پَکوُن _چَلوُن پَکوُن کامہِ_کار _کار_کُن جٲری چالوٗ ٲڑروومُت شُروٗعٲتی اِبتِدٲیی
चाळपाचें: مَنٛدنَس_لایَق چھٲپِس_لایَق مَتھنَس_لایَق
चाळिल्लें: مَنٛدومُت چھونٛپ_دِتھ دیون_دِتھ
चाळिशेक: لَگ_بَگ_ژَتجیہ ژَتجیہَن_تام
चाळिसावें: ژَتجِیہُم
चाळीस: ژَتجِہہ
चावपी: ژۄپَل
चाहतें: طٲلِب _یَژَھن_وول _کانٛچَھن_وول
चिंतनशील: فِکِر_منٛد غورٕ_کوٚرمُت
चिंतपाचें: سونٛچنس_لایق سرنَس_لایق
चिंताजनक: پریشان_کَرٕوُن_ _دۄکھ_واتناوَن_وول_ _فِکِر_منٛد_کَرَن_وول
चिंताहीण: فضوٗل
चिंतेबगरची: مَشوَر_بَغٲر
चिंतेस्त: فِکِر_مَنٛد
चिकचिकीत: مایہٕ_دار
चिकट: مایہٕ_دار
चिकलाचें: رَبہِ_دار
चिकित्सा: طِبیٲتی _طِبی
चिकू: کوٚنٛڑ کٔنٛجوٗس
चिकू_मारवाडी: کٔنٛجوٗسکوٚنٛڑ
चिकें: کم _کینٛہہ
चिखलाचें: رَبہِ_دار_ _لَژھِ_بوٗرُت
चिखलामेकळें: صاف
चिडचिडो: نَسہٕ_نٲس_ ترٛوٚش_مِزان_ تُن_مِزاز_ موٗڈی
चिडिल्लें: مَظلوٗم_ _سِتَم_زَد برٛکوَنہٕ_آمُت مَتھنہٕ_آمُت برٛس_گٔمٕژ برٛیٚے_گٔمٕژ برٛیٚشیومُت
चिड्डयिल्लें: دَم_کٔرِتھ
चितारिल्लें: نقٲشی_کٔرِتھ بناوِتھۍ
चित्रांकीत: چھِٹَل
चित्रायिल्लें: چھِٹَل نقٲشی_کٔرِتھ بناوِتھۍ
चित्रीत: چھِٹَل لیبٕلہِ_دار _لیبلہِ_وول بَیان_کٔرنہٕ_آمُت زِکر_کَرنہ_آمُت نقٲشی_کٔرِتھ بناوِتھۍ نَقٲشی_کٔرِتھ
चिनी: چیٖنی چیٖنی
चिन्हीत: لیبٕلہِ_دار _لیبلہِ_وول
चिपचिपीत: آبہٕ_سٔرۍ _آبہٕ_بُزۍ
चिप्प_भिजील्लेंप: سٔرۍبٔرِتھ
चिरंजिवी: نہ_بَدَلُوُن غٲر_مبدِل
चिरंजीव: لافٲنی پایدار_ _مَضبوٗط
चिरिल्लें: ژھیوٚنمُت
चिलखता_वीण: بے_زرہ_بکتر بے_ہَتھیار ہَتھیار_روس
चिली: چِلیَن چِلی_مُلکُک
चिवट: دوٚر سَخٕت مَضبوٗط
चीनी: چیٖنُک
चुंबकाचें: کٔششی
चुंबकी: کٔششی
चुकिल्लें: خَراب پَھش_پھِرِتھ
चुकीची: غلط
चुकीचें: غلط
चुट्टे_कोराचें: چھوٚت_سَبٕز
चुरगळिल्ल्या: ژَمٹیومُت
चुलत: پِتُر پِتُر
चेंचिल्लें: مَظلوٗم_ _سِتَم_زَد
चेंचिल्लो: پوشہٕ_روٚس پوٚشہٕ_ورٲے دانٛدٕ_ماز
चेंपिल्लें: مَظلوٗم_ _سِتَم_زَد
चेक: چَک
चेडी: بَد_کِردار_ _بَدذات
चेतन: زِنٛدٕجانٛدارزُودار
चेतनायुक्त: خَبَردار_ _باخَبَر وٲقِف_ آگاہ
चेपटें: چَپٹہٕ بِہِتھ
चैत्री: چیتی
चोंचरें: اَڈٕ_کوٚل
चोंपिल्लें: مار_پیوٚمُت مار_کھیوٚمُت
चोंयवटेनचें: ژُطَرفہٕ
चोकपा_सारकें: چوٗسنَس_لایَق
चोपनावें: ژُونزٔہِِم _ژُوَنٛزٔہیُم
चोरपाचें: تَھپھ_دِنَس_لایَق تھپھِ_نِنَس_لایَق
चोरपी: دونٛکھٕ_باز دَغاباز تارَن_گوٚر
चोरिल्लें: ژوٗرِ_نِنَس_لایَق لوٗٹنَس_لایَق لوٗٹِتھ ژوٗرِ_نِمُت ژوٗرِ_نِنہٕ_آمُت ژوٗر_کَرنہٕ_آمُت لوٗٹمُت تَھپہِ_نیومُت
चोवपन: ژُوَنٛزاہ ژُوَنٛزَہ
चोविसावें: ژوٚوُہِیُٛم
चोवीस: ژوٚوُہ
चौकोनी: ژُکوٗنٛجَل
चौदा: ژۄداہ
चौपट: ژۄگنہٕ_ _ژوٚگُن_ _ژور_گنہٕ
चौरंगी: ژُرَنٛگہٕ_دار
छंदबद्द: ہَم_قٲفیہ
छंदबद्ध: پابَنٛد_ گنٛڈِتھ
छंदाचें: شوقیا
छंदी: موٚکُر کٔمیٖنہٕ _ذٔلیٖل شوقیا
छत्तिसावें: شیٚۍترٕٛہِیُٛم
छत्तीस: شیٚۍترٕٛہ
छत्रपती: چٔھترِدار چٔھترِوول
छापिल्लें: چھٲپِتھ
छापो_मारपी: چھاپہٕ_ترٛاوَن_وول
छाप्पन: شُوَنٛزاہ
छाप्पनावें: شُونٛزٔہِِم _شُوَنٛزٔہیُم
जंगम: پَکوٕنۍ اورٕیور_پَکناوُن_لایَق _پِھرُن_لایَق
जंगली: جنٛگلی ٹرٛک جَنٛگلی_ وَنُک
जंतूनाशक: کیٚمۍمارنُک
जखमी: زَخمی چھۄکہٕ_لَد زَخمی
जखमे_विरयतचें: زَخمہٕ_روٚس چھۄکھہٕ_روٚس
जगजयी: دُنِیاہ_زینَن_وول
जगजाहीर: مانٛنہِ_آمُت زانٛنہٕ_آمُت
जड: گوٚبوَزَندار وَزَن_دار وَزنی
जड_जाल्लें: بار_وول وَزَن_دار
जडयिल्लें: جٔرِتھ
जपानाचो: جاپٲنۍ_ جاپانٕکۍ
जपानी: جاپٲنۍ_ جاپانٕکۍ جاپٲنۍ جاپٲنۍ
जपूंक_जायनाशिल्लें: اجپا
जप्त: زَبٕد_ کُرِکۍ_کٔرِتھ
जप्त_केल्लें: ضبط_کوٚرمُت روٚٹمُت سیٖز
जबरदस्त: واریاہ_بوٚڑ بوٚڑ_بارٕ
जबाबदार: جَواب_دِہ _ذِمہٕ_دار
जमनींतलें: زمیٖن_تَلُک_ _زمیٖنہٕ_تَلہٕ_کَنِیُٛک
जमा_करपी: جَمع_کَرَن_وول بَرَن_وول
जमातीचें: قٔبیٖلُک
जमानती_बगरचें: زمانتہٕ_روٚس
जमैकी: جَمیکاہُک جَمیکٲیۍ جَمیکَن
जयी: کامیاب_ _کامران
जरतारी: زَربافُک زَرباپھُک
जर्जर: مَرنہٕ_سَر
जर्मन: جَرمٔنۍ_ _جَمنُک جَرمٔنۍ
जलचर: آبی
जलचलीत: آبَس_پٮ۪ٹھ_پَکَن_وول آبَس_پٮ۪ٹھ_چَلَن_وول
जलस्थलचर: زٔمیٖنَس_تہٕ_آبَس_منٛز_روزَن_وول
जलहीण: ہوٚکھ خۄشٕک _آبہٕ_وَرٲے
जल्म_घेतिल्लें: پٲدٕ_گوٚمُت _زامُت _دُنیاہَس_مَنٛز_آمُت
जल्म_घेवंकना_असो: زیٚنَے یُس_نہٕ_کٲنٛسہِ_زامُت_آسہِ
जल्मजात: پیدٲیِشی
जल्मल्लें: پٲدٕ_گوٚمُت _زامُت _دُنیاہَس_مَنٛز_آمُت
जल्मसिद्ध: پٲدٲیشی
जल्मा_उपरांतचें: غٲر_پٲدٲیشی
जल्मा_सावन: پیدٲیِشی
जल्मांध: آماہ _اوٚن
जल्माक_आयिल्लें: پٲدٕ_گوٚمُت _زامُت _دُنیاہَس_مَنٛز_آمُت
जल्मीत: پٲدٕ_گوٚمُت _زامُت _دُنیاہَس_مَنٛز_آمُت
जल्मूक_नाशिल्लो: زیٚنَے یُس_نہٕ_کٲنٛسہِ_زامُت_آسہِ
जळारहीण: مٔہیو_ر_وٚستٕے
जळारां_बगरचें: مٔہیو_ر_وٚستٕے
जळिल्लें: دوٚدمُت
जळोवपी: دزن_وول
जस्ताचें: زسدُک
जांतव: حیٲتیاتی
जांबळें: وانٛگٕنۍ لاجوٲرۍ
जांबियायी: زَمبِیاہُک زَمبیٲیۍ زَمبِیَن
जागरूक: ہوشار _چوکَس آگاہ_ _ہُشار_ گاٹُل_ زانَن_وول
जागृत: ہوشار _چوکَس
जागे: آگاہ_ _ہُشار_ گاٹُل_ زانَن_وول
जागें: ہوشار _چوکَس
जाड: موٚٹ ویوٚٹھ
जाणकार: تجرُبہٕ_کار _مٲہِر عٲلِم زانَن_وول وٲقٕف_ _آگاہ_ زٲنۍکار_ _زٲنۍیاب
जाणटी: بٕڑٕ _بُزَرٕگ
जाणटें: بُزَرٕگ _بٕڑٕ _مُعزَز
जाणपी: قابلِ_فہم
जाणा_आशिल्लें: وٲقِف
जाणा_जाल्लें: وٲقٕف_ _آگاہ_ زٲنۍکار_ _زٲنۍیاب
जाणाजाल्लें: وٲقِف
जातहीण: زٲژ_روٚس
जातिभायरें: اَزٲژ زٲژِ_نٮ۪بَر زاتہِ_نٮ۪بَر
जाती_बगरचो: زٲژ_روٚس
जाती_भायलें: وۄپَر_ژۭٲژِ_ہُںٛد اَزۭٲژ
जाती_भितरलें: زٲژ
जाती_विशींचें: قومی
जातीचें: قومی
जाप_दिवपी: جواب_دِنہٕ_وول
जापसालदार: جَواب_دِہ _ذِمہٕ_دار ذِمہٕ_دار_ قٲبلہِ_اعتِماد
जापे_बगर: جَوابہٕ_روٚس
जाफरानी: کۄنٛگہٕ_دار زعفران_دار
जाफराबादी: زافرابادُک زافرابٲدۍ
जाबाबदार: ذِمہٕ_دار_ قٲبلہِ_اعتِماد
जाम: ہٮ۪متہٕ_روٚس
जाम_जाल्लें: تھوٚکمُت
जायत_सावन: پیدٲیِشی
जायत्यो: واریاہ _بِسِیار
जार्डनी: جاڑنُک
जाल्लें: کٔرمٕژ _سَپٕزمٕژ ُگُزریومُت
जाळयेचें: جالہِ_دار جال_دار گٔدۍ_دار
जाळीदार: جالہِ_دار جال_دار گٔدۍ_دار
जावन_गेल्लें: ُگُزریومُت
जावायी: جاوٲیۍ
जासुसी: جاسوٗسی
जाहीर: عام یہِ_نہٕ_سِر_آسہِ اِظہار_ _ظٲہِر _ونُن _بولُن
जिक्के: یوٗتاہ
जिखिल्लें: زیننَس_لایق زیوٗنمُت_ فتح_کٔرمٕتۍ
जिखिल्लो: زینَن_وول_ _کایماب_گَژھن_وول
जिज्ञासु: خٲہِش_مَنٛد
जितके: یوٗتاہ
जितले: یوٗتاہ
जितेंजागतें: جان_دار_ _پُر_جوش_ _پُر_لطف_ حشاش_بَشاش
जितेंद्री: پرہیزگار
जितो: زِنٛدٕجانٛدارزُودار خَبَردار_ _باخَبَر وٲقِف_ آگاہ
जिद्दी: ۂٹی _اَکڑی
जिल्ल्याचें: ضِلہٕ
जिवंत: زِنٛدٕجانٛدارزُودار جان_دار_ _پُر_جوش_ _پُر_لطف_ حشاش_بَشاش
जिवघेणें: جان_لیوا_ _فٲنی
जिवनदान: زِنٛدٕگی_دِنہٕ_وول زِنٛدٕ_تھاوَن_وول
जिवीत: زِنٛدٕجانٛدارزُودار
जिवें: جان_دار_ _پُر_جوش_ _پُر_لطف_ حشاش_بَشاش
जिवो: زِنٛدٕجانٛدارزُودار خَبَردار_ _باخَبَر وٲقِف_ آگاہ
जीण_वाडोवपी: رٔنِتھ_ _روٚنمُت
जीर्ण: خَستہٕ_حال_ _پُھٹمُت
जुंव्याचें: جزیٖرُک
जुगारी: زٲرۍ
जुनी: کھٹارٕ
जुनें: خستہٕ_گوٚمُت _مۄقلیومُت
जुल्मी: ظٲلِم _اِزَہ_کھور
जुळें: دُکہِ
जुवळीं: دُکہِ
जुवळें: دُکہِ
जुवान: جوان
जेझू_विशीं: عیسٲیی
जेवणा_बगरचें: نِراَہار
जेवपाचें: کھٮ۪نس_لایق
जेवपी: کھٮ۪نہٕ_وول
जेश्ठ: زُیٹھ_ بوٚڈ زُیٹھ_ بوٚڈ
जैतवंत: زیننَس_لایق کامیاب_ _کامران
जैतीवंत: زینَن_وول_ _کایماب_گَژھن_وول
जैवीक: حَیاتِیٲتی
जॉर्जियायी: جرجِیٲی جارجِیاہُک
जोखप: زخمی
जोखिल्लें: میٛوٗنمُت توٗلِتھ _میٖنِتھ
जोडपी: زینہٕ_وُن
जोडपें: اِزدِوٲجی
जोडिल्लें: اِلحاق واجب_الوَصوٗل واجب_الوَصوٗل مُلحقات زیٖوٗنمُت _کَموومُت
जोडूंक_नाशिल्लें: الگ_ _بیوٚن
जोतपा_सारकें: کاشتَس_لایق قٲبلہِ_کاشت
जोर_काडपी: تَپھ_دوٗر_کَرَن_وول
जोरनाशक: تَپھ_دوٗر_کَرَن_وول
ज्ञात: زٲنۍ_یاب
ज्ञानपूर्ण: عٔلمہِ_واجین
ज्ञानमय: عٔلمہِ_واجین
ज्ञानहीण: جٲہِل_ _ناوٲقِف_ بےٚخَبَر
ज्ञेय: قابلِ_فہم
ज्वलनशील: دَزنَس_لایق_ _دَزنَس_قٲبِل
ज्वालामुखी: آتَش_فِشٲنی
झगझगीत: گاشدار چَمکیٖلہٕ
झगडपी: لَڑایہِ_گٔرِنۍ
झगडाळ: لَڑایہِ_گٔرِنۍ لَڑایہِ_گوٚر
झगडाळू: لَڑایہِ_گٔرۍ_ دَنٛگہٕ_باز
झगडूल: لَڑایہِ_گٔرِنۍ
झगड्डाळ: بۄغضی _حَسدی
झगड्याचें: کُھرۍلَد _خۄشکیٚتہِ_لَد
झडिल्लें: روٗدٕ روٗدٕ_دار
झणझणीत: سَخٕت
झांकपी: فٕضوٗل_کَتھہٕ_کَرَن_وول_ _دٮ۪ماغ_کھٮ۪نہٕ_وول
झिंबाबेयी: زیمبِیٲے_ _زیمبِیاہُک
झिपरे: زَتَھل
झिपरें: زَتَھل جٔژ_وول
झिरझिरिल्ली: خستہٕ_گوٚمُت _مۄقلیومُت
झिरझिरीत: توٚن پَتلہٕ توٚن_آب_ہیٛو
झिरमिरीत: توٚن
झिळींचें: ژانٛڈٕ_دار
झुजपी: ڈٔٹِتھ_روزَن_وول
झुजा_इत्सुक: جَنٛگُک_شوق_تھاوَن_وول
झुजाचें: جنٛگی_حکمت فوجی
झुजारी: بَہادُر_ دِلیر
झेंपें: بیوقوٗفچوراَحمَکباورٕ
झेताचो: اَکڑی
झेमें: بیوقوٗفچوراَحمَکباورٕ
झेमेड्डो: نِنٛدٕرِ_ہوٚت
झेलाचें: شیٖنوٗ_ _شیٖنہٕ_دار
झोंपांचें: ژانٛڈٕ_دار
झोडिल्लें: مار_پیوٚمُت مار_کھیوٚمُت
टकटक: ٲچھ_ٹٕٹرارے_بَغٲر
टकलू: ٹِنہِ_کَلہٕ
टकलो: ٹِنہِ_کَلہٕ_ _ٹَکلہٕ
टणक: مظبوٗطپایدارپۄختہٕ
टवटवीत: تازٕ تازٕ نوٚو تازٕ تازٕتٔریٖن
टायप_केल्लें: ٹایِپ_کٔرِتھ
टाळपी: پرہیزگار
टाळूं_येना: اَٹَل
टिकाकार: کٕٹھ_کَڈَن_وول_ ٹیٖپ_ژَٹَن_وول
टिकात्मक: طنٛزِیٲیی
टिकेसयतचें: تَفسیٖردار
टिपक्यांचें: ٹٮ۪چہٕ_دار
टेंबुरणी: آبنوٗسُک آبنوٗسۍ آبنوٗسَس_ہیوٗ آبنوٗسۍ_ہیوٗ
टोगोली: ٹوگوہُک ٹوگولیٖز ٹوگولیٖس
ट्युनिशियायी: ٹِیوٗنِشِیاہُک ٹِیوٗنِشیٲیۍ ٹِیوٗنِشِیَن
ट्युनीशी: ٹُنیشِیاہُک_ _ٹُنیشِیٲۍ
ठगो: بَدماشلَفَنٛگہٕذٔلیٖلکٔمیٖنہٕکھوٚر
ठिपक्यांचें: ٹٮ۪چہٕ_دار ٹیٚچہِدار
डच: ڈَچ ڈَچ
डळमळीत: دُلمُل غٲر_یٔقیٖنی
डाळंबा_कोराचें: دٲنہٕ_رَںٛگ
डेनमार्की: ڈٮ۪نمارکُک ڈینِش ڈیٚنِش
डोमिनिकाचें: ڈومَنِکاہُک ڈومنِکٲیۍ ڈومِنِکَن
डोमिनिकी: ڈومَنِکاہُک ڈومنِکٲیۍ ڈومِنِکَن
डोलत: گیٖران _نزان
ढळमळीत: دُلمُل غٲر_یٔقیٖنی
ढोंक: ژوٚک_آتَش
ढोंगी: دۄنٛکھہٕ_باز
णव: نَو ۹
णवपट: نَو_گوٚنہٕ_ _نَوِ_لَٹِہ
णवलाखांचें: نَوَن_لَچَھن_ہُںٛد
णवलाखी: نَوَن_لَچَھن_ہُںٛد
णववें: نٔیِم
णवेक: لَگ_بَگ_نَو نَوَن_تام
णव्याण्णव: نَمہٕ_نَمَتھ
णव्याण्णवावें: نمنمتِم
णव्वद: نَمَتھ
णव्वदावें: کُنشیٖتِم نمتِم
तंजानियायी: تنزیٖنِیٲے_ _تنزیٖنِیاہُک
तंतूमय: ریشہٕ_دار
तंत्रांविशींचें: تَکنیٖکی_ ٹٮ۪کنیٖکی
तंत्राबगरचें: بےٚ_تَکنیٖکی_ _بےٚ_ٹٮ۪کنیٖکی
तंत्रीक: تَکنیٖکی_ ٹٮ۪کنیٖکی
तंदुरी: توٚنٛدرٕ _توٚنٛدوٗری _توٚنٛدوٗرۍ
तकले_बगरचें: کَلہٕ_ژوٚٹ کَلہٕ_روٚس
तकलेंतलें: خیٲلی _اَپُز
तकलेचें: دٮ۪ماغُک _کَلُک
तकारांती: ت_اَچَھر_وول
तटवासी: بٔٹھِس_پٮ۪ٹھ_روزَن_وٲلۍ
तटस्थ: بےٚ_پَرواے _غٲر_جٲنِب_دارانہٕ
तडी_वयलें: بٔٹھِس_پٮ۪ٹھ_واقعہ _بٔٹھِس_پٮ۪ٹھ_آباد
तड्डकी: اَپٕزۍیور
तण_खावपी: گاسہٕ_کھٮ۪نہٕ_وول
तत्कालीक: تَمی_دَمہٕ_ _فوٗری
तत्काळीन: تیٚلہِ
तत्पर: تَیار
तत्पुरते: عٲرضی
तथाकथीत: ناوٕ_کِنۍ _وَننہٕ_یِنہٕ_وول
तथ्यपूर्ण: پوٚز _صٔحیح
तननशील: خَم_پٔزیٖر
तपा_बगरचें: اُتپی
तपाशिल्लें: پَرکھَنہٕ_آمُت جانٛچ_کٔرِتھ پَرکھٲوِتھ وٕچھِتھ_دٲنٛچھِتھ _ٹٮ۪سٹہٕ_کٔرِتھ
तपासणी: طِبیٲتی _طِبی
तपासणे_बगरचें: پرکھاونَے پَرکَھنَے پَرکھونہٕ_روٚس
तपासूंक_नाशिल्लें: پرکھاونَے پَرکَھنَے پَرکھونہٕ_روٚس
तमीळ: تٔمِل تٔمِل_ _تامِل تٔمِل_ _تامِل
तयवानी: تَیوٲنۍ _تَیوانُک
तयार: تَیار تَیار رٮ۪ڑی_میٛڑ
तयार_करूंक_नाशिल्लें: نہ_بَنٲوۍ_مٕتۍ
तयार_केल्लें: بنیومُت
तयार_जाल्लें: وۄپدیومُت _کھوٚتمُت
तरंगपी: ییٖروُن
तरणें: جوان
तरबेज: تربِیت_یافتہٕ
तरातरांचें: مُختٔلِف _قٕسٕم_وار
तरेकवार: مُختٔلِف _قٕسٕم_وار
तरेकवार_रंगांचें: رَنٛگہٕ_بہٕ_رٔنٛگی
तर्क_नाशिल्लें: مٔنعی_بَغٲر مٔنعی_روٚس
तर्कपुर्ण: معقوٗل _مُنٲسِب _دانِشمنٛدانہٕ _ _مضبوط_بُنیاد_وول_۔_مُنطقی
तर्कहीण: مٔنعی_بَغٲر مٔنعی_روٚس نا_قٲبلہٕ_بَحَث
तर्का_बगरचें: نا_قٲبلہٕ_بَحَث
तर्काबगरचें: مٔنعی_بَغٲر مٔنعی_روٚس
तर्र: چیتھ
तलवारधारी: تَروار_بٔٔٔٔردار تَلوار_بَردار
तळा_बगरचें: ژَکہِ_روستٕے_بانہٕ
तळाचें: ژوٚکیُک بوٚنیُم
तळ्यांत_जावपी: تالُک تَلہا
तळ्यांतलें: تالُک تَلہا
तळ्याचें: تَلاوُک ترٛاگُک زۄڈیٚک
तशाक_तशें: ہوٗبہوٗ ہِیوٗ
तांकिवंत: بَہادُر_ قَداوار
तांकीवंत: طاقتور _زوراور _زوردار
तांतया_आकाराचो: ٹھوٗل_ہیو
तांतयाळ: ٹُھلہٕ ٹھوٗلہٕ_دار ٹھوٗلہٕ_واجٕنٛۍ
तांत्रीक: جودگوٚر سِہَرگوٚر
तांबडो: وۄزُل _سۄرَخ نُنہٕ_کاژُر
तांबशें: وۄشلیومُت سۄرُخ
तांबसो: ہَلکہٕ_وۄزُل چھوٚت_وۄزُل
तांबूस: ہَلکہٕ_وۄزُل چھوٚت_وۄزُل وۄشلیومُت سۄرُخ وۄزُل_نار رَتھ_ہیوٗ سۄرَخ
तांब्याचें: سَرتَلِو سَرتَلہِ_ہُنٛد ترٛامہٕ_رَںٛگ
ताकतिकेन: تیز
ताकतीक_करपी: جلدباز
ताचे_खेरीज: علاوٕہُرٮ۪مانہٕ
ताचे_बगर: علاوٕہُرٮ۪مانہٕ
ताचे_भायर: علاوٕہُرٮ۪مانہٕ
ताचे_शिवाय: علاوٕہُرٮ۪مانہٕ
ताजिकिस्तानी: تاجکِستٲنۍ تاجکِستانُک
ताजें: تازٕ_نوٚو تازٕ سَبٕز نوٚو تازٕ تازٕتٔریٖن
ताजें_टवटवीत: تازٕ
ताजो: تازٕ
ताठ: جُکنہٕ_بَغٲر _نَمنہٕ_روٚستُے
तातारी: تاتارُک تاتٲرۍ
तात्काळीचें: تیز جَلدی فوری
तानेल्लें: ترٛیشہٕ_ہوٚت
ताप_काडपी: تَپھ_دوٗر_کَرَن_وول
तापट: شرارتی _تیز _تُنٛد گَرَم_مِزاز
तापनाशक: تَپھ_دوٗر_کَرَن_وول
तापिल्लें: پویہٕ_مُت توٚت _گَرٕم
ताबूस: ترٛامہٕ_رَںٛگ
ताब्यांत: ماتحَت
तामसी: شرارتہٕ_ہوٚت ژَکہِ_ہوٚت تیشَل
तामसीक: شرارتہٕ_ہوٚت ژَکہِ_ہوٚت تیشَل
तामीळ: تٔمِل تٔمِل_ _تامِل تٔمِل_ _تامِل
तारखीत: تٲریٖخ_دیُتمُت _ڈیٹ_دیُتمُت
तारणहार: رَچھَن_وول_ ہَرِ_ژَھٹھ_ہٮ۪نہٕ_وول _رٲچھۍ_راوَٹ_کَرَن_وول
तारपी: رَچھَن_وول_ ہَرِ_ژَھٹھ_ہٮ۪نہٕ_وول _رٲچھۍ_راوَٹ_کَرَن_وول
तारवटी: جہٲزی جہازُک
तारहीण: تارِ_روٚستُے _تارِ_بَغٲر
तारीख_सोंपिल्लें: سَڑیومُت
तारे_बगरचें: تارِ_روٚستُے _تارِ_بَغٲر
तार्कीक: منطقی منٛطقی بحث_گٔمٕتۍ_مسلہٕ
तार्‍याविणें: تارکو_روٚس
तालव्य: تالِرۍ تالس_مُتعلِق
ताळतंत्राबगरचें: غٲر_مٔعیٲری
ताळो: لَنٛجِدار شاخہٕ_دار
तिकतीकपी: چَمکیٖلہٕ _چَمَکوُن _زٕژٕدار
तिकळें: ترٛیَو_لٔڑکَو_پَتہٕ_زامُت ترٛیَو__لٔڑکو_پَتہٕ_زامٕژ
तिकळो: ترٛٮَ۪و_کورٮَ۪و_پَتہٕ
तिकोनी: تِکوٗنہٕ_ ترٛےٚ_کوٗنہٕ_دار
तिक्कें: تیوٗتاہ
तिक्ष्ण: تیز
तिखट: تیز مَسالہٕ_دار_ تٔلِتھ_بٕزِتھ _ترٛوٚش ٹیوٚٹھ_ٹیوٚٹھ
तिख्याचें: شیٚشتٕروٗ فَولٲدۍ شیٚشتٕرٕچ شیٚشتٕروٗ فولٲدۍ
तिगपी: پایہٕ_دار
तिगाय: تریٚشؤے_ تریٚنؤے
तितकें: تیوٗتاہ
तितलें: تیوٗتاہ
तितारी: ترٛے_تارٕ_وول
तिनचाकी: ترٛٮ۪ن_ٹٲرَن_ہُںٛد ترٛٮ۪ن_پٔہیَن_ہُںٛد ترٛے_ٹٲر_وول ترٛے_پٔہیہِ_وول
तिनेक: لَگ_بَگ_ترٛے ترٛے_تام
तिप्पट: ترٛۄگنہٕ
तिबक्यांचें: ٹٮ۪چہٕ_دار
तिबेटी: تِبتی تِبتی تِبتی
तिमाही: سہ_ماہی
तिरंगी: تُرٛرٔنٛگۍ تُرٛرٔنٛگی _ترٛےٚرَنٛگہٕ_دار
तिरकटी: مٔکٕر_زَبان گَنٛدٕ_زَبان
तिरसट: ٹیوٚٹھ_ _ٹیچَھر
तिरसुवादीक: مٔکٕر_زَبان گَنٛدٕ_زَبان
तिरायत: غٲر
तिरायताचें: وۄپَر غیر
तिव्र: تیز تیز بُلَنٛد
तिसरें: ترٛٮ۪یِم
तिसावें: ترٕٛہیُِٛم
तीख: تیز مَسالہٕ_دار_ تٔلِتھ_بٕزِتھ _ترٛوٚش ٹیوٚٹھ_ٹیوٚٹھ ٹیوٚٹھ_ _ٹیچَھر مِہیٖن ٲوِج
तीग: تریٚشؤے_ تریٚنؤے
तीगजाण: تریٚشؤے_ تریٚنؤے
तीन: ترےٚ
तीन_कोनशांचे: تُرپۄہَر
तीन_कोनांचे: تُرپۄہَر
तीन_तारी: ترٛے_تارٕ_وول
तीन_दिसांचें_शेळें: پھیوٗرمُتسڑیومُتخراب_گومُت
तीन_पडींचें: کٔھزٕر
तीन_फावटीचें: ترٛییٚہِ_لَٹہِ_کاشت_کوٚرمُت
तीनतर्फी: ترُطَرفہٕ ترٮ۪ن_طرفَن_ہُںٛد ترٮ۪ن_دَرٮ۪ن_ہُںٛد
तीनपडी: کٔھزٕر
तीनपायी: تُرٛ_زَنٛگَل
तीनमाही: سہ_ماہی
तीनरंगी: تُرٛرٔنٛگۍ تُرٛرٔنٛگی _ترٛےٚرَنٛگہٕ_دار
तीस: ترٕٛہ
तुंबिल्लें: رُکِتھ _ٹٔھہرِتھ
तुंबिल्लो: بنٛد
तुकुतुकू: ٲچھ_ٹٕٹرارے_بَغٲر
तुजें: چون
तुटकें: پُھٹمُت
तुटकें-फुटकें: پُھٹمُت
तुमचें: تُہُنٛد
तुमचें.: چون
तुर्कमेनिस्तानी: تُرکٕمٔنِستٲنۍ تُرکٕمٔنِستانُک
तुर्कस्थानी: تُرٛکی
तुर्की: تُرکی تُرٛکی تُرکی
तुलनात्मक: تَقابُلی
तुल्य: مُقابَل
तुळात्मक: تَقابُلی
तुळे_भायरें: اتوٗل_تہٕ_بے_توٗل _حَدٕ_روٚس _گَنٛڑٕ_روٚس
तुश्ट: شُکُر_گُزار_ _شاکِر
तुस्ततोखणायेचें: عِزَت_دار قٲبلہِ_تعریٖف
तुस्तेचें: سَلٲمی_دِنَس_لایَق
तृणजिवी: سَبٕز_کھور سَبزی_کھور
तृतीय: ترٛٮ۪یِم
तृप्त: مُطمٔیٖن
तेंगशेचें: تھوٚد
तेखातीरचें: عٲرضی
तेजपूर्ण: پرٛزلوُن
तेजस्वी: پرٛزلوُن تابن_وول چمکدار
तेजहीण: بِگریومُت بےٚ_رونَق رونقہٕ_روٚس رونقہٕ_بَغٲر
तेजाबी: تیزآب_دار
तेत्तिसावो: تیٚتۍترٕٛہِیُٛم
तेत्तीस: تٔییٕہ_ترٕٛہ
तेमकाचें: تھوٚد
तेरा: تُرٛواہ
तेरावें: تُرٛوٲہِمِ
तेलकट: تیٖلہٕ_دار_ _تیٖلٕے_یوت_ _مایہِ_دار_ _تیٖلہٕ_وول تیٖلہٕ_دار_ _تیٖلٕے_یوت_ _تیٖلہٕ_وول تیٖلہٕ_دار_ _مایہِ_دار_ _تیٖلٕے_یوت_ _تیٖلہٕ_وول
तेलगू: تیٚلِگوٗ تیٚلہِگوٗہُک تیٚلِگوٗہُک
तेलाचें: تیٖلہٕ_دار_ _مایہِ_دار_ _تیٖلٕے_یوت_ _تیٖلہٕ_وول
तेलुगू: تیٚلِگوٗ تیٚلہِگوٗہُک تیٚلِگوٗہُک
तेविसावें: ترٛوٚوُہِیُٛم
तेवीस: تَرٛوٚوُہ
तेवेचाळिसावें: تیٚتٲجِیُٛم
तेवेचाळीस: تٔیتٲجی
तैवानी: تَیوٲنۍ _تَیوانُک
तोंकाचें: تھوٚد پیٚتۍ_دار
तोंकाळ: تُرٛسۍ_دار _تُرٛس_دِنہٕ_وول پیٚتۍ_دار
तोंडपाठ: زَبٲنۍ_دَگہِ
तोंडा_वयलें: نَزدیٖک
तोंडाचें: بُتھیُک
तोंडी: زَبٲنی
तोंप्पी: تُرٛسۍ_دار _تُرٛس_دِنہٕ_وول
तोखणायेचे: تٲریٖفَن_لایَق
तोखणायेचें: سَلٲمی_دِنَس_لایَق عِزَت_دار قٲبلہِ_تعریٖف
तोडीचो: مُقابلہٕ_کَرُن
तोतरें: اَڈٕ_کوٚل
तोलाचें: وَزَن_دار وَزنی
तोलूंक_नाशिल्लें: تول_نے
त्या_काळा_वयलें: تیٚلہِ
त्यागिल्लें: ترٛٲومٕژ
त्यागी: قۄربٲنی_دِنہٕ_وول
त्याज्य: ترٛاونَس_لایَق_ مٔشراونَس_لایَق
त्रस्त: مَزلوٗم پریشان_کوٚرمُت دۄکھٕ_لَد _غَمزدٕ_ ژٮ۪لہٕ_لَد
त्रासदिणी: دُکھی _غَمہٕ_ہوٚت
त्रासदिणें: اِزاہ_خور _تکلیف_دیٖہہ_ شدیٖد_عذاب _دۄکھ
त्रासाची: دۄکھہٕ_دار
त्रासिल्लो: مَزلوٗم
त्रासीक: دِل_مَلوٗل_ _دُکھی_ _رٔنٛجیٖدٕ
त्रिआयामी: ترٛے_حُجُم_وول ترٛے_رۄقبہٕ_وول
त्रिकोणाकार: تِکوٗنَل_ _تُرٛکوٗنٛجَل
त्रिकोणी: تِکوٗنَل_ _تُرٛکوٗنٛجَل تِکوٗنہٕ_ ترٛےٚ_کوٗنہٕ_دار
त्रिकोनी: تُرپۄہَر تِکوٗنہٕ_ ترٛےٚ_کوٗنہٕ_دار
त्रिनिदादी: ترٛنِدادُک ترٛنِدادِیَن
त्रिपद: تُرٛ_زَنٛگَل
त्रिबुनालीन: اَدالتی
त्रिशूळधारी: تُرشوٗل_وول
त्रेप्पन: تُرٛوَنٛزاہ تُرٛوَنٛزَہ _۵۳
त्रेप्पनावें: تُرٛوَنٛزٕہمِ _تُرٛوَنٛزٔہیُم
त्रेसठ: تُرٛہٲٹھ_ؤرِش
त्रेसठावो: تُرہٲٹھِم
त्र्यांयशीं: تُرٛشیٖتھ
त्र्यांयश्यावें: تُر_شیٖتِم
त्र्याण्णव: تُرٛنَمَتھ
त्र्याण्णवावें: تُر_نمتِم
त्र्यात्तर: تُرٛسَتَتھ
त्र्यात्तरावें: تُر_ستھِم
त्वचेचो: مٕسلُک_ ژَمہِ_ہُنٛد
थंड: نَرٕم_مِزازُک _نَرٕم تٔمیٖزدار _سٔلیٖقہٕ_مَنٛد بوٚرُد_باراوٚب_گوٚب سَرٕد_ _تُرُن_ ہُنٛدُر تُرُن_سَرٕد تُرُن_ ہُنٛدُر_ سَرٕد سَرٕد نَرٕم_ شانَت حٔلیٖم ٹَھنٛڑٕ اَمُن_دار بَد_حَواس ہُنٛدُر شُہُل
थकपाचें: تھکاوَن_وول
थकारांती: تھ_اَچَھر_وول
थकिल्लें: تھوٚکمُت
थकूंक_नाशिल्लें: تھکنہٕ_بَغٲر
थपकटें: ہموار چَپٹہٕ بِہِتھ
थपथपिल्लें: بٔرِتھ_ _بوٚڈمُت__ _اوٚدُر_ _آب_ہِیوٗ__ _لِتھ_وِتھ__ لَت_پَت سٔرۍبٔرِتھ
थपथपीत: آبہٕ_سٔرۍ _آبہٕ_بُزۍ
थपथपीतप: سٔرۍبٔرِتھ
थरथरपी: واریاہ_بٕڈٕ
थरांचें: تہَدار
थरावीक: محدوٗد
थरिल्ली: فٲصلہٕ_کٔرِتھ
थळावीक: مُقٲمی
थळावें: مُقٲمی دیسی مُقٲمی
थळीय: زٔمیٖنی
थांबिल्ली: بِہِت_گٔمٕژ _رُکِتھ
थांबिल्लें: ٹھٕہرِِتھ_ _رُکِتھ_ _بنٛد
थाटामाटाचें: شانٛدار عٔظیٖم_وشان شان_و_شوکَت_وول ٹھاٹھ_باٹھ_واجِنٛۍ
थायां_पडपी: نوٚن
थायी: تھای تھایِچ_ _تھای تھایُک_ _تھای_ _تھیلیٚنٛڑُک
थारनासतना: لَگاتار
थारायिल्लें: مُقرَر صحیح _ٹھیٖک مُقَرَر
थारायिल्ल्या: حَدٕ_بَنٛد_ حَدٕدار
थारावीक: پَکہٕ
थिकाळ: داغہٕ_دار_ دَبہٕ_دار
थिरप्रतीज्ञ: ہَڑدَرٕم
थीर: مُستَحکَم_ _مَضبوٗط بوٚرُد_باراوٚب_گوٚب قٲیِماَٹَل _بَرقَرار جُکنہٕ_بَغٲر _نَمنہٕ_روٚستُے غٲرمنٛکولہ اَلہٕ_اَلہٕ_دار_ تَھرٕ_تَھرٕ_دار
थीर_चित्ताचो: پُرسَکوٗن_ خاموش_ شانت
थीर_मताचें: اٹل_روزُن_ _ڈٔٹِتھ_روزُن
थीरनिश्चयी: پکہٕ_اِرادٕ_وٲلۍ
थेट: سیوٚد
थोक: تھوک
थोटें: لوٚنگ لوٚنٛگ
थोटो: موزوٗر
थोडे_भितर: مۄختَصَر
थोडें: کم _کینٛہہ کیٚنٛہہ
थोडें_उलोवपी: کَم_کَتھہٕ_کَرَن_وول_ کَم_سُخَن_ کَم_رَلوُن
थोडोसो: کَم_ _کَمٕے_ _قٔلیٖل
दंग: آوُر_ _مصروٗف
दंगलखोर: فاس_تراون_وول _فَسٲدۍ
दंगेखोर: فاس_تراون_وول _فَسٲدۍ
दंडीत: سَزا_یافتہٕ
दकारांती: د_اَچَھر_وول
दक्षिणी: جنوٗبی
दक्षिणे_वटेन: دٔچھِنۍ
दक्षीण_अफ्रिकी: جنوٗبی_افریٖکاہُک
दक्षीण_अमेरिकी: جَنوٗبی_امریٖکاہُک
दक्षीण_कोरियायी: جنوٗبی_کوریاہُک جنوٗبی_کوریٲی
दणकट: کٔسِتھ چٲرِتھ
दणकेबाज: زوردار
दत्तक: مَنٛگتہٕ
दनपारचें: دُپہارُک
दबदबीत: کٔسِتھ
दयाळू: رحم_دِلاِنصٲفی
दयावान: وُسی_دِل _دِل_دار
दयेस्त: رحم_دِلاِنصٲفی چَلاون_وٲلۍ_ _خدمت_گار_ _تیٖماردار
दर: پرٛٮ۪تھ_کانٛہہ پَرٛٮ۪تھ_اکھ
दर_एक: پرٛٮ۪تھ_کانٛہہ پَرٛٮ۪تھ_اکھ
दरबारी: دربٲرۍ
दर्याचें: سَمنٛدری
दर्यायी: سَمَنٛدٔری سَمَنٛدَرُک
दर्शनशास्त्रीय: فَلسفی_ _فَلسفُک
दर्शनीय: وٕچُھن_لایق_ قٲبلہِ_دیٖدار_ _دیٖدارَس_لایق _قٲبلہِ_دیٖد نا_قٲبلہِ_دیٖد_ _نا_قٲبلہِ_دیٖدار _وٕچھنس_لایق_نہٕ
दलीत: مظلوٗم_ _سِتَم_زَد غمزَد
दळडिरें: لاچار بٮ۪کَس غٔریٖب
दळडिरो: غریبمِسکیٖنسَفید_پوش غمزَد
दळभद्री: لاچار بٮ۪کَس غٔریٖب
दळिद्री: لاچار بٮ۪کَس غٔریٖب
दळिद्रो: غریبمِسکیٖنسَفید_پوش
दस्तावेजी: دَستاویزی
दांडगट: کٔسِتھ چٲرِتھ
दांत_नाशिल्लो: دَندٕ_بَغٲر
दांतयाळी: دَنٛدانہٕ
दांतयें: دٔنٛدۍ
दांतहीण: دَنٛدٕ_روٚس
दांतोळी: دَنٛدانہٕ
दांतोळें: دٔنٛدۍ
दांपत्य: اِزدِوٲجی
दाग_आशिल्लें: دٲغی_ _داغ_دار مُسِرلَد
दागा_विरयत: داغٕ_روس _بےٚ_داغ _داغہٕ_وَرٲے
दागाचें: مُسِرلَد
दागाळ: داغہٕ_دار_ دَبہٕ_دار
दागिल्लें: دٲغی_ _داغ_دار
दाट: گوٚن گٔنۍ موٚٹ آبہٕ_روٚس_گنہٕ_رس موٚٹ ویوٚٹھ
दाडयेकार: ریشَل ریشہٕ_دار
दाडयेवालो: ریشَل ریشہٕ_دار
दाण्यांचें: دانہٕ_دار
दातयाळें: دَنٛدٕدار
दातरांचें: دَنٛدٕدار
दादलेपणाचें: مَردانہٕ مَردانہٕ
दादलो: نَر
दादल्यां_संबंदीं: مَردانہٕ
दान_करी_सारकें: خٲرات_کَرنَس_لایَق خٲراتَس_لایَق صدقَس_لایَق
दान_दिवपा_सारकें: خٲرات_کَرنَس_لایَق خٲراتَس_لایَق صدقَس_لایَق
दान_दीय_सारकें: خٲرات_کَرنَس_لایَق خٲراتَس_لایَق صدقَس_لایَق
दानवी: شیطٲنی
दानवीर: خٲرات_دِنہٕ_وول
दानशूर: خٲرٲتۍ خٲرات_دِنہٕ_وول
दानाचें: خٲرات_کَرنَس_لایَق
दानित्सू: خٲرات_کرَن_وول خٲرات_دِنہٕ_وول
दानित्सूक: خٲرات_کرَن_وول خٲرات_دِنہٕ_وول
दानी: خٲرٲتۍ خٲرات_دِنہٕ_وول
दाबखीळदार: کمانہِ_دار سِپرِنٛگ_دار
दार्शनीक: فَلسفی_ _فَلسفُک
दावकें: کھوٚش
दावखुरें: کھوٚش
दावें: کھووُر
दास: گٔنٛڈِتھ
दिकाहीण: وتہِ_ڈٔلۍ_متۍ
दिक्षे_बगरचें: خٲرات_دِنہٕ_روٚس
दिखावटी: بَناؤٹی ظٲہِری
दिखावू: یاوٕ
दिग्गज: بَہادُر دِلاوَر دِلیر ہوٚس_ہیوٗ بَہادُر دِلاوَر دِلیر ہوٚس_ہیوٗ عٲلِم_ _ٚفٲضِل
दिनवाशी: احسان_منٛد _شُکُرگُزار
दिल्लें: مۄیثر موہِیا _دٔستِیاب دُیتمُت تقسیٖم_کَرنہٕ_آمُت بٲگرَنہٕ_آمُت بٲگراونہٕ_آمُت باگنَے_کَرنہٕ_آمُت وَقٕف_کَرنہٕ_آمُت نَزٕر_کَرنہٕ_آمُت
दिवंक_नाशिल्ले: دِنہٕ_نہَ_آمُت
दिवंक_नाशिल्लें: واپَس_نہٕ_دِنہٕ__آمُت
दिवंगत: موٗدمُتمۄردٕمرحوٗم
दिवाणी: دیٖوٲنی
दिवाळखोर: پھٔنٛگۍ_گومُت
दिव्य: بیاکھ_دُنِیاہ جنتُک_ _جنتی جان
दिशाहीण: وتہِ_ڈٔلۍ_متۍ
दिश्टी_पडपी: نوٚن
दिसपी: نوٚن
दिसांधळें: دُۄہ_اوٚن دُہُل_اوٚن
दिसाळें: دۄہدِشُکھ
दीन: خستہٕ_حال_ _تکلیٖف_دہ_ خراب
दीनदयाळू: رَحَم_دِل
दीनपालक: غٔریٖبَن_رَچَھن_وول غٔریٖبَن_پالَن_وول
दीर्घ_काळाचें: پوشوُن
दीर्घकालीन: واریاہ_کال_ _زیادٕ_وقت
दुंदर_पानांचें: خوٗبصوٗرَت_ؤتھٕر_وول
दुकळग्रस्त: خۄشِک_سٲلی_ _قہط_سٲلی
दुकळपिडीत: خۄشِک_سٲلی_ _قہط_سٲلی
दुकां_बगरचें: ہوچھ_مٕژن_أچھن
दुकाळिल्लो: اوٚش_بوٚڈمُت_ _اوٚش_پھوٚٹمُت _اوٚش_بٔرِتھ
दुकुमेती: دَستاویزی
दुखदिणें: اِزاہ_خور _تکلیف_دیٖہہ_ شدیٖد_عذاب _دۄکھ
दुखापती_बगरचे: زَخمہٕ_روٚژھ_ _زَخمہٕ_بَغٲر
दुखावल्लें: زَخمی
दुख्खदिणी: دُکھی _غَمہٕ_ہوٚت
दुख्खहीण: بےٚ_شوق
दुख्खांती: غَمگیٖن موٚیوٗس_کُن
दुख्खाची: دُکھی _غَمہٕ_ہوٚت دۄکھہٕ_دار
दुख्खी: حٲران دِل_مَلوٗل_ _دُکھی_ _رٔنٛجیٖدٕ مُصیٖبت_زَد_ _پریشان صدمہٕ_وول
दुचाकी: دۄن_ٹٲرَن_ہُںٛد دۄن_پٔہیَن_ہُںٛد زٕ_ٹٲر_وول زٕ_پٔہیہِ_وول
दुडवांकार: أمیٖررۄپیہِ_وولسَرمایہِ_دار
दुतर्फी: مٔنٛزِم دُطرفہٕ
दुतोंडी: زٕ_بٕتھۍ_دار زٕ_بٕتھہِ_وول دُرٔخۍ دونٛکھہٕ_باز دُپَن_دَلاز
दुदाचें: دۄدںدار دۄدٕ
दुदाचो: شیٖر_خار
दुदारू: دۄد_دِنہٕ_واجِنۍ
दुदाळ: دۄدںدار دۄدٕ دۄدٕ_رَںٛگُک دۄدٕ وارِیاہ_دۄد_دِنہٕ_واجیٚنۍ
दुदाहारी: صرِف_دۄد_چٮ۪نہٕ_وول
दुधारी: دُدَنٛدَل دُشرٛاکَل دُنوکَل
दुपटें: دۄگنہٕ
दुबळी: کَم_پایہِ__ بِچٲرۍ
दुबळें: کمزور ہوٚکھمُت _زٲوِیُٛل_ _نِیُٛک_ _کمزور
दुबळो: ہٮ۪متہٕ_روٚس
दुबावा_बगरचो: بروسہٕ_منٛد
दुबावा_विरयत: بروسہٕ_منٛد صاف دُلمُلہٕ_روٚس بے_مَنٛدَچھ_ مَنٛدچھٕ_بَغٲر بِلا_شَکھ
दुबावी: شٔکی ؤہملد_ برٮ۪ملد
दुबावीत: وۄمیدوار _آشہِ_ہوٚت ؤلِتھ _دُلمُل شکاوَر شٔکی شَک_آوَر
दुभती: دۄد_دِنہٕ_واجِنۍ
दुयेंती: بٮ۪مارمٔریٖضدٲدۍ_لَد
दुरंगी: زٕ_رَنٛگہٕ_دار
दुरदर्शिकायहीण: عٲقِبت_نا_اَنٛدیش
दुरदर्शी: دوٗر_اَنٛدیش_نظر_کَرَن_وول
दुरीग_आशिल्लें: دٮ۪واروول دیوردار
दुरुस्त: ٹھیٖک_ _دُرست_ _صحیح_ _ٹھیٖک_ٹھیٖک ٹھیٖک صحیٖح مُنٲسِب
दुर्गाचें: دٮ۪واروول دیوردار
दुर्गूण: عٲبہٕ_لَد_ بَد_صِفَت
दुर्जन: بَدکٔمیٖنہٕظٲلِم
दुर्दशाग्रस्त: خستہٕ_حال_ _بَد_حال
दुर्बोध: مُشکِل
दुर्भागी: بَدقٕسمَت
दुर्मीळ: سَکھ_ _مُشکِل نایاب_ خاص
दुर्वेव्हारी: بَد_سَلوٗک_ بَد_تٔمیٖز
दुशीत: خراب_ _نۄقصی_ خٲمی_ _قُصوٗروار
दुश्काळग्रस्त: خۄشِک_سٲلی_ _قہط_سٲلی
दुश्ट: بَدکٔمیٖنہٕظٲلِم بَد_زات بَد_معاش خٔبیٖث دُشٹھ
दुसरे_जातीचें: پَرذٲژ
दुसरें: دوٚیُم_ دوٚیِم
दुसर्‍या_लग्नाचें: وۄرُد دٔیِم_خانٛدَر_کَرَن_وول
दुसर्‍यांचेर_आदारून: مۄحتاج
दुसर्‍याचें: وۄپَر غیر
दुस्मानकेचो: دُشمندٲری _زِدٕدٲری
दुस्मानहीण: دُشمَنَو_روٚستُے
दुस्मानी: دُشمَنَو_ہوٚت
दुस्वाशी: نفرت_کرن_وول بَدکٔمیٖنہٕظٲلِم
दुस्वासी: لاپرواہ_ بےٚپرواہ عداوتی _زِدٕوول
दूझ: باہ ۱۲
दूद_आटिल्लें: دۄدٕ_روٚستُے_وَچھ_واجیٚنۍ
दूद_पियेवपी: شیٖر_خار
दूर: دوٗر
दूरचें: پَتھ_کھورِ واریاہ_دوٗر
दृढ: قٲیِماَٹَل _بَرقَرار
दृश्टियुक्त: گاشہٕ_دار
दृश्टिहीण: اوٚن
देंवणेचें: وٕٕترایدار
देंवतें: سَستہٕ_ _کم وٕٕترایدار چَڑٲے_دار چَڑایہِ_دار چَڑٲےوول چَڑایہِ_وول
देंवयिल्लें: برخاست
देखघेणे: مِثٲلی _معیٲری _بہتٔریٖن شانٛدار _مُنفَرِد عینی
देखणें: خوٗبصوٗرتمٲرۍ_موٚنٛد خوٗبصوٗرَت حٔسیٖن مٲرۍ_موٚنٛد
देगणाचें: چَڑٲے_دار چَڑایہِ_دار چَڑٲےوول چَڑایہِ_وول
देगे_वयलें: بٔٹھِس_پٮ۪ٹھ_واقعہ _بٔٹھِس_پٮ۪ٹھ_آباد
देगेचें: قریٖبی _نَزدیٖکی تِلہٕ_دار
देड: ڈۄڈ
देड_पटीचें: ڑۄڑ_گۄنہٕ
देडीचें: ڑۄڑ_گۄنہٕ
देण्याचें: دِنہٕ_وول
देवनिंदक: کٲفِر_ ناستِک
देवा_भशेनचें: دیوتاہَن_ہُںٛد دیوتاہَن_بَرابَر
देवाचें: مُقدَس الوٗہی خدٲیی
देवादेणें: خۄدٲیی_دِیُت
देवासूर: دیواسوٗر
देश_सोडिल्लो: ہِجرَت_کَرَن_وول
देशत्यागी: ہِجرَت_کَرَن_وول
देशद्रोही: گَدار_ _قومی_گَدار
देशभक्त: دیشبَگٕت
देशी: قومی دیٖسی مُقٲمی دیسی مُقٲمی
देशी.: قومی
दैववादी: قٕسمَت_مانَن_وول
दैवी: خدٲیی دیوی مُقدَس الوٗہی خدٲیی خۄدٲیی دیوتاہَن_ہُنٛد دیوتاہَن_ہُںٛد_دِیُت دیوتاہن_ہٕںٛزِوَتہِ_مَنٛز_دِنہٕ_آمُت
दोंगराकार: پَہٲڑی
दोंगराळ: پہٲڑۍ پَہٲڑی پہٲڑۍ
दोंगरी: پَہٲڑی
दोगूय: دۄشوَے دونوَے
दोट्टी: دۄگنہٕ دُلوٚر
दोट्टें: دۄگنہٕ
दोतर्फी: مٔنٛزِم دُطرفہٕ
दोताचें: داجُک
दोन: زٕ
दोन_कुडक्यांचें: زٕ_چھلہٕزٕ_حِصہٕ
दोन_तोंडांचें: زٕ_بٕتھۍ_دار زٕ_بٕتھہِ_وول دُرٔخۍ دونٛکھہٕ_باز دُپَن_دَلاز
दोन_दाबांचें: دُکھانٛٹٮ۪ل
दोन_पटी: دۄگنہٕ
दोन_पांयांचें: زٕ_پایہٕ_ دُ_زَنٛگل
दोन_माळ्यांचें: دُپُہَر
दोन_हाताचें: زِ_اَتھٕ_دار
दोनखणी: دُ_خانَل دُ_بانوٗ زٕ_بانہٕ_وول دُ_بانَل
दोनदाबी: دُکھانٛٹٮ۪ل
दोननाळी: زٕ_نالہِ_دار
दोनपांयी: زٕ_پایہٕ_ دُ_زَنٛگل
दोनभागी: دُ_خانَل دُ_بانوٗ زٕ_بانہٕ_وول دُ_بانَل
दोनभुजी: زٕ_نَرِ_وول دُنَرٮ۪ل
दोनमाळी: دُپُہَر
दोनरंगी: زٕ_رَنٛگہٕ_دار
दोनवर्सुकी: دُوُہُر
दोनांय_वटांतलें: دُوطرفہٕ _دُطرفانہٕ
दोनूय: دۄشوَے دونوَے
दोळ्याचें: أچھ_ہُنٛد
दोशमुक्त: رِہا
दोशी: گۄناہ_گارقصوٗروارجُرُم_وارخطہہ_وارمُجرِم بُرٕ بَد
द्रव: پانیُل_چیٖز
द्रवचलीत: ٲبی _آبہٕ_پٮ۪ٹھ_حٲصِل_گَژھوُن
द्रवीत: ویٚگلیومُت _کُملیومُت پِگلیومُت
द्राक्षा_भशेन: دَچھِ_ہیوٗ شرٲبی
द्राक्षांचें: دَچھوٗ
द्राक्षाच्या_रंगाचें: دَچھِ_ہیوٗ شرٲبی
द्राक्षाळ: دَچھِ_ہیوٗ شرٲبی
द्विवर्शी: دُوُہُر
धंदेकार: رُت_خۄلقہٕ_وول
धंद्याचें: تِجٲرتی
धडधाकट: کٔسِتھ چٲرِتھ اوٚر_تہٕ_دوٚر_ ویوٚٹھ_پوٗٹھ
धडपडो: بَدماش_ لَڑایہٕ_گٔرۍ_ دَنٛگہٕ_باز
धडाकेबाज: زوردار
धनलाबाचें: سَکھاو
धनलोभी: لالچی
धनवान: وٲفِر
धनसुवार्थी: لالچی
धनी: وٲفِر أمیٖررۄپیہِ_وولسَرمایہِ_دار
धन्य: احسان_مَنٛد _شُکُرگُزار
धन्यवादी: احسان_منٛد _شُکُرگُزار
धरतरे_बगरचें: زٔمیٖنہِ_پٮ۪ٹھ_نَہ_کھسَن_وول زٔمیٖنہِ_پٮ۪ٹھ_نَہ_وۄپدَن_وول
धरपी: ہیٚۍ_ہیٚۍ
धर्म_मानपी: مَزۂبی
धर्मगिन्यानी: مٲہرِ_دیٖنٛیات
धर्मच्यूत: بےدیٖن_ _لا_دیٖن
धर्मज्ञानी: مٲہرِ_دیٖنٛیات
धर्मनिरपेक्ष: لادیٖنی_ غٲر_مَزۂبی
धर्मनिश्ट: مَزۂبی
धर्मभ्रश्ट: بےدیٖن_ _لا_دیٖن
धर्मवीद: مٲہرِ_دیٖنٛیات
धर्मशास्त्री: مٲہرِ_دیٖنٛیات
धर्मार्थ: مَزۂبی
धर्मालंबी: مَزۂبی
धर्मावलंबी: مَزۂبی
धर्मिक: مَزۂبی
धर्मिश्ठ: مَزۂبی
धर्मीक: مَزۂبی مَزۂبی
धवली: سَفید پروٚن
धवें: صاف _چٔھلِتھ
धवो: پرٛوٚن
धा: دہ_
धा_आनी_आठ: اَردٲہِم
धा_आनी_चार: ژۄدٲہِم
धा_आनी_पांच: پَنٛدٲہِم
धा_पट: داہ_گۄنہٕ
धा_लाख: داہ_لَچھ دَہ_لَچھ
धा_हजार: داہ_ساس
धांपिल्लें: کھٔٹِتھ چُھپِتھ
धांपिल्लो: ؤلِتھ
धांवडायिल्लें: برخاست کٔڑنہٕ_آمُت نٮ۪بَر_کَڑنہٕ_آمُت
धांवडायिल्लो: کوٚڈمُت کَڈنہٕ_آمُت گرِ_کوٚڈمُت
धांवपी: ژَلوُن
धाएक: لَگ_بَگ_داہ داہ_تام
धाकटुलें: پِنٛتہٕ_کَلہٕ_ پینٛتہٕ_کَلہٕ_ _پِتہٕ_کَلہٕ
धाकटो: کوٗنس لَکُٹ
धाकलो: کوٗنس_ لۄکُٹ
धाडशी: صَبریصٲبِرصَبٕر_کَرَن_وول دِل_ہیر _بہادُر سَرفروش_ _جان_نِثار
धाडसाचें: مُہم_باز
धाडसी: مُہم_باز
धाडिल्लें: سوٗزمُت سوٗزمُت_ _روانہٕ_کوٚرمُت
धातूचें: دھاتُک
धात्वीय: دھاتُک
धादोशी: شُکُر_گُزار_ _شاکِر
धादोस: مُطمٔیٖن
धार_आशिल्लें: تیز
धार_गेल्लें: موٚنٛڑ
धार_पडिल्लें: موٚنٛڑ
धारण_करपी: ہیٚۍ_ہیٚۍ
धारदार: تیز تیز_
धारावाहीक: قٕسطٕ_وار
धारी: ہیٚۍ_ہیٚۍ
धारीचें: رِکھہٕ_دار لٲنہٕ_دار
धारेचें: تیز تیز_
धार्मीक: مَزۂبی
धावें: دٔہِیُٛم
धिमें: وارٕوارٕ_ _ژھۄکیومُت
धिरिश्ट: صَبریصٲبِرصَبٕر_کَرَن_وول سَرفروش_ _جان_نِثار
धीट: صَبریصٲبِرصَبٕر_کَرَن_وول دِل_ہیر _بہادُر
धील: ڈیوٚل ڈیوٚل
धुंवरट: گوٚٹ اَنہِ_گوٚٹ دُہہ_دار
धुंवराळ: گوٚٹ گوٚم
धुंवरें: گوٚٹ اَنہِ_گوٚٹ دُہہ_دار
धुंवसर: گوٚٹ اَنہِ_گوٚٹ دُہہ_دار
धुक्याचें: گوٚٹ گوٚم
धुगधुगीत: وُشُن_ _سۄکھٕ_بوٚل_ _شیٖر_گرٕم
धुपयिल्लें: مُشکہٕ_دار خۄش_بۄےدار
धुयलेलें: چھوٚلمُت
धुयिल्लें: چھوٚلمُت
धुल्लाचें: گَردِدار گَردِہوٚت _گَردِ_بوٚرُتھ
धुल्लें: چھوٚلمُت
धुळकट: گَردِ_ہوٚت گَردِدار گَردِہوٚت _گَردِ_بوٚرُتھ
धुवंक_नाशिल्लें: چَھلنَے
धैर्यहीण: بےٚ_تاب _صَبرٕٕ_روٚس
धोंतर_न्हेशिल्लो: دوٗتۍ_لٲگِتھ
धोंतरकार: دوٗتۍ_لٲگِتھ
धोंपरां_मेरेनचें: کوٚتھِس_تام کۄٹھیٚن_تام
धोणुकार: کَمان_چالہِ کَمانَس_ہیوٗ
धोणूधारी: کَمان_وول کَمان_تھاوَن_وول
धोदेल: ویوٚٹھہُنیومُت
धोनयो: یٔڑل _بَتہٕ_جِن
धोलत: گیٖران _نزان
धोलपी: نامَنٛظوٗر
ध्यानमग्न: مَس مَستہِ_مولا
ध्यानहीन: دھیان_نَہ_دِنہٕ_وول _روومُت
ध्यानी: مُتفکٕر سونٛچَن_وول فِکرِوول مَس مَستہِ_مولا
ध्यानेस्त: مَس مَستہِ_مولا
ध्रुवाचें: قُطبی
ध्रुवीय: قُطبی
न_फेडी_सारकें: ناواجِبہِ_ادا
नकल_करपी: نَقلہٕ_گوٚر نَقلہٕ_گوٚر لاگَن_گوٚر
नकली: بناوٹی _نَقلی یاوٕ نَقلہٕ_گوٚر نَقلی نَقٕل
नकसूद: نوزُک ٲویُل
नकारांती: ن_اَچَھر_وول
नकारात्मक: مَنفی
नकारार्थी: نیگیٹِو
नक्षत्रहीण: تارکو_روٚس
नक्षत्रांविणें: تارکو_روٚس
नक्षत्राचें: تارَک_دار تارکو_سۭتۍ_بٔرِتھ
नक्षत्राळ: تارَک_دار تارکو_سۭتۍ_بٔرِتھ
नक्षत्री: تارَک_دار تارکو_سۭتۍ_بٔرِتھ
नक्षिदार: نقٕش_دار
नक्षीकाम_केल्लें: نقٲشی_دار
नखरेबाज: نٔکھرٕ_دار_ وَرٕدار
नखेत्रांनी_भरिल्लें: تارک_دار
नगरवासी: شہرُک
नगरी: شہرُک
नगरेंतले: شہرُک
नग्न: ننگہٕنٮ۪تھہٕ_نوٚن
नजरबंद: نظر_بند
नटयिल्लें: سجٲوِتھ_پٲرٲوِتھ
नटिल्लो: بَناو_سٕنٛگار_کٔرِتھ_ سَجٲوِتھ _شیٖرِتھ_پوٗرِتھ
नटोवणी: سجاوٹی
नडणी: کَچھ
नतमस्तक: کَلہٕ_نوٚمرِتھ_ نٔمِتھ _جُکِتھ
नदर: سونٛچنَس_لایَق غورکَرنَس_لایَق غورطَلب
नदर_आशिल्लो: گاشہٕ_دار
नदरबंद: نظر_بند
नदरेक_पडपी: نوٚن
नपियेवपा_सारकें: نہ_چَنَس_لایَق
नपुसक: نامَرٕد
नमस्कार_करि_सारकें: نَمنَس_لایق عزتَس_لایَق
नमस्कार_करी_सारकें: عزتَس_لایَق احترامَس_لایَق جُکھنَس_لایَق
नम्र: نرمی_ نرم_مزازٕ_ _نرم_طبیعت _حلیٖم_ _نرم_ ندامت نَرٕم_ شانَت حٔلیٖم ٹَھنٛڑٕ
नर: نَر
नरकाचें: جہنمی
नरभक्षक: آدَم_خور اِنسان_کھاو انسان_کھٮ۪نہٕ_وول
नरभक्षी: آدَم_خور اِنسان_کھاو
नरम: نَرٕم_مِزازُک _نَرٕم نَرٕم نَرٕم _مُلٲیِم نوزُک ٲویُل
नळ्यांचें: ٹٲلہٕ_دار
नवनिर्मीत: نَوینہ نٔو_ نوٚو
नवलकाणयेचें: ناولہِ_ہٕںٛدۍ ناولہِ_مُطٲبِق
नवलकाणीक: ناولہِ_مَںٛز_شُمار_کَرنَس_لایَق ناولِ_مَںٛز_بَیان_کَرنَس_لایَق
नवलिकेचें: ناولہِ_ہٕںٛدۍ ناولہِ_مُطٲبِق
नवशिकें: نوٚو_ہٮیٚچھمُت
नवशिक्षीत: نوٚو_ہٮیٚچھمُت
नविनीकरणी: دُبارٕ_بناونہٕ_یِنہٕ_وول_ _پھِرۍ_پھِرۍ_پٲدٕ_کَرنہٕ_یِنہٕ_وول _دُبارٕ_پٲدٕ_کرنہٕ_یِنہٕ_وول
नवी: نَوینہ نٔو_ نوٚو
नवीन: نوٚوحالُک نوٚو تازٕ تازٕتٔریٖن
नवे: نوٚوحالُک
नवें: غٲر_تصوُر_ _خیالہٕ_نٮ۪بَر
नवेंच_शिकिल्लें: نوٚو_ہٮیٚچھمُت
नवो: أزیُک _اَزکَلُک وٕنٛکٮ۪نُک
नशिलें: شَرٲبی مے_بوٚرُت
नशीबवान: خۄش_قسمت
नशेचें: شودٕ_ _شرٲبی_ _چرسی شَرٲبی مے_بوٚرُت
नशेबाज: نَشہٕ_خور_ _نَشہٕ_باز
नश्ट: تباہ _فان وٲران_ _چَھلہٕ_چھانٛگٕر
नश्टो: نفرت_کرن_وول بَد_زات بَد_معاش خٔبیٖث دُشٹھ حٲسِد _حسدی بۄغضی _حَسدی
नश्वर: فٲنی
नसाय_करपी: حٲسِد _حسدی
नसायहीण: زِدِ_بَغٲر حسدٕ_بَغٲر بۄگزٕ_بَغٲر
नसायें: حٲسِد _حسدی لاپرواہ_ بےٚپرواہ
नस्तार: مَنفی
नांगरणे_विरयत: واینے _کھننَے
नांगरिल्लें: کاشت_کوٚرمُت
नांगरूंक_नाशिल्लें: واینے _کھننَے
नांगेचें: کٔنٛڈۍدار
नांमाबगरचें: ناوٕ_روٚس_ گُم_نام
नांवा_पुरतें: ناوٕ_کِنۍ _وَننہٕ_یِنہٕ_وول
नांवाचें: نامدارنامہٕ_وَر ناوٕ_کِنۍ _وَننہٕ_یِنہٕ_وول
नांवाजतो: مَشہوٗرنامہٕ_وَر
नांवादीक: مَشہوٗرنامہٕ_وَر
नाउमेदी: بِلا_تحقیقات
नाककात्रें: نَستہِ_ژوٚٹ نَستہِ_روٚس
नाककापें: نَستہِ_ژوٚٹ نَستہِ_روٚس
नाकयें: نٔسۍ نٔسۍ
नाकहीण: نَستہِ_روٚس
नाका_जावपाचें: تھکاوَن_وول
नाका_बगरचें: نَستہِ_روٚس
नाकाजाल्लें: غٲر_ضَروٗری فَضوٗل بے_معنی
नाखटा_बगरचें: پنجو_روٚستُے
नाखटां_खायरें: دَںٛدَو_سۭتۍ_نَم_ژَٹَن_وول دَنٛدَو_سۭتۍ_نَم_تُرٛکَن_وول
नाखटां_खावपी: دَںٛدَو_سۭتۍ_نَم_ژَٹَن_وول دَنٛدَو_سۭتۍ_نَم_تُرٛکَن_وول
नाखूश: مایوٗس _ناخۄش
नाखोशयेचें: غٲر_مُتمعین
नागडो: ننگہٕنٮ۪تھہٕ_نوٚن
नागशेपडेचो: ناگ_دُمی
नागोवणेचें: لوٗٹمُت تَھپہِ_نیومُت
नागोवणो: بَدماشلَفَنٛگہٕذٔلیٖلکٔمیٖنہٕکھوٚر ژوٗر تھَپَل
नाचपी: نَژَن_وول رَقٕص_کَرَن_وول
नाजूक: نوزُک نوزُک نَرٕم ٲویُل پِشُل _پِشول _آبہٕ_تَھپھ _نَرٕم_پَھمٛب _مُلٲیِم نوزُک ٲویُل
नाटकी: بناوٹی _نَقلی ظٲہِری ڈرامٲی ڈرامٲی
नाड: تِگڑَم_باز
नात्या_बगरचें: لاتعلُق
नादीरशाही: نٲدِرشٲہی نٲدِر_شاہ_سُںٛد
नापसंतीचें: کَھروُن
नापास: فیل _ناکام
नापीक: بَنٛجَر ناکٲبلِ_کاشت
नाबाद: ناٹ_اَوُٹ
नामंजुर: نامَنٛظوٗر
नामंजूर: نامنٛظوٗر نامَنٛظوٗر_ _خٲرِج
नामक: نامدارنامہٕ_وَر
नामनेचे: مشہوٗر ناووَر نامچیٖن
नामनेचो: مَشہوٗرنامہٕ_وَر
नामर्द: نامَرٕد
नामांकीत: ناوزَد
नामिबियायी: نٔمیٖبِیاہُک نٔمیٖبِیٲے
नामी: نامدارنامہٕ_وَر
नायजिरियायी: نیجیرِیاہُک
नायट्रीक: نایٹروجنِکۍ
नारंगी: سَنٛگتَر_رَنٛگ
नारकी: جہنمی
नारदाचें: ناردٕ_سُنٛد ناردی
नारदी: ناردٕ_سُنٛد ناردی
नालायक: ناقٲبِل _نالایَق بےٚکار نابہٕ_کار_ نالایَق
नावडटें: نا_پَسنٛد
नावडीचें: کَھروُن
नावाडगें: شَرارتی ووٚٹ شیطان زہمَت
नावाडगो: بَدنام
नावेश: نابوٗد _غٲب
नाशक: ناش_کَرَن_وول کیٚمٮ۪ن_مارَن_وول تَباہ_کَرَن_وول اَثَر_کَم_کَرَن_وول تباہ_کَرن_وول
नाशवंत: فٲنی
नाशिवंत: تباہ_کَرن_وول تَباہ_کُن
नासीक: نٔسۍ
नास्तीक: لامَزہب_ بےٚ_دیٖن
निंदक: کٕٹھ_کَڈَن_وول_ ٹیٖپ_ژَٹَن_وول
निंदा_करपी: کٕٹھ_کَڈَن_وول_ ٹیٖپ_ژَٹَن_وول
निंदात्मक: ہانٛژَل
निंदे_बगरचें: مخالفتہٕ_روٚس
निंदे_विरयत: مخالفتہٕ_روٚس
निंदेस्त: بُرٕ بَد
निकारगुवायी: نِکارگُواہُک نِکارگُوَن
निखर्व: داہ_کَھرَب ۱٠٠٠٠٠٠٠٠٠٠٠٠٠ٹیٚن_ٹرٛلِیَن
निखळपी: اَلگ_گژھَن_وول یَلہٕ_گََژھَن_وول
निग्रही: کم_گُفتار_ _دَم_دار_ __نٔزلی بےٚ_شَرَم بےٚ__حَیا بدتٔمیٖز
निजामी: نِظٲمۍ
नितळ: صاف صاف _واضح صافشوٚدپاکھ شَفاف _خٲلِص
नितीक: قانوٗنی تیز_مزازِ_ _تیز
नितीकतायपूर्ण: اِخلٲقی
नितीपूर्ण: اِخلٲقی
निद्रागत: شوٚنٛگمُت
निद्राहीण: نیٚنٛدرِ_روٚس
निनावी: ناوٕ_روٚس_ گُم_نام
निपक्ष: بےٚ_پَرواے _غٲر_جٲنِب_دارانہٕ
निपुत्रीक: شُرۍ_روٚژھ نیٚچوٗ_روٚس گَبَر_روٚس نیٚچوٗ_روٚس گَبَر_روٚس بےاولاد
निपूण: مٲہِر _قٲبِل _پَکہٕ قٲبِلہُنر_منٛدمٲہِِر
निबर: بےٚرحمظٲلِمبےٚ_آر دِلہیر _جِگرٕ_دوٚر _بہادُر سَنٛگ_دِل بےٚ_آر تیزوٕلٹہٕ سخت_ _روب_داب سنٛگ_دِل_ بےٚ_انصاف _بےٚ_رحم _بےٚعار مظبوٗطپایدارپۄختہٕ دوٚر_ _سخت خۄد_غرض_ بَد_لیحاظٕ__ احسان_فراموش کٔنیوٗ _سنٛگدِل_ _بےٚرحَم
निमंत्रक: دعوت_دِنہٕ_وول
निमंत्रण: دعوتی دعوت_دِنہٕ_آمُت
निमणें: عبوٗری
निमतां_करपी: بَہانہٕ_باز
निमताळो: بَہانہٕ_باز
निमसरकारी: نیٖم_سرکٲری
निमाणें: سِخٕت شَدیٖد حد_درجٕہ انتہا عروٗجَس_پٮ۪ٹھ عبوٗری
निमाणो: کوٗنس لَکُٹ
निमाण्या: ٲخری _پٔتیُم
नियंत्रक: ضٲبط_بنٛد_کرُن_وول رَگُلَیٹَر سَینسَر
नियंत्रीत: حدٕ_اِختیار
नियमीत: قٲیدٕ_بَنٛد
नियाळात्मक: ملامَت
नियाळिल्लें: پَرکھَنہٕ_آمُت
नियुक्तीत: مُقرَر
नियोजीत: مُقَرَر
निरंकारी: یَژھِ_تہٕ_پَژھِ_وول
निरंकूश: مجاز _مۄختار
निरंहकारी: نرٕم
निरक्षर: اَنپَڑ
निरपराध: بے_قصوٗر _بےٚ_گۄناہ _موصوٗم
निरपराधी: بےٚگۄناہ موسوٗم
निरपेक्ष: ماوضہٕ_روٚس _اَجرٕ_روٚس
निरपेक्षी: لاطمع
निरभिमानी: نرٕم
निरर्थक: بَکوٲسۍ فٕضوٗل
निरशेल्लें: پریشانِ_حال_ _پریشان
निरस: خۄشٕک_انسان جٲہِل بدتٔمیٖز
निराकार: شَکلہِ_صوٗرتہِ_روٚس _جِسمہٕ_روٚس روٗحٲنی
निरादार: بےٚ_بُنِیاد اڈنٛجہِ
निराधार: بےٚسہارٕ _بےٚکَس بےٚ_بُنِیاد _غَلَط ہُتٮ۪تھ _ہُتھ_جایہِ ڈکھہٕ_روٚس
निरावासीत: وٕجارٕ _غیر_آباد
निराश: نا_اُمیٖد_ دِل_مَعلوٗل
निराशादायी: وۄمید_روٚس_ _بےٚ_وۄمیٖد _مایوس_کُن
निराशावादी: نا_اُمیٖد
निराशेवणेचें: وۄمید_روٚس_ _بےٚ_وۄمیٖد _مایوس_کُن
निराश्रीत: بےٚگَر
निराहार: بۄچِھٕ_ہوٚت_ فاقٕے نِراَہار
निरीच्छ: لاتَماہ _بےٚشوکھ _شوکھہٕ_روٚس
निरीश्वरवादी: لامَزہب_ بےٚ_دیٖن
निरुत्तर: لاجواب_ _بےزُبان_ زٮ۪وِ_روٚس_زبٲنۍ_روٚس_ _زبان_بنٛد
निरुत्साही: بِلا_تحقیقات
निरुपद्रवी: شریٖف
निरुपायी: حلہٕ_روٚس وَتہِ_روٚس ترکیٖبہِ_روٚس حَلہٕ_روٚس _وَتہِ_روٚس
निरुपेगी: فضوٗل
निरूपयोगी: لاچار بےبَس
निरोगी: صحت_منٛد
निर्जन: خلوَخ ویٖران _سُنسان
निर्जल: آب_نہ_چینُک
निर्जळ: ہوٚکھ خۄشٕک _آبہٕ_وَرٲے
निर्जाप: لاجواب_ _بےزُبان_ زٮ۪وِ_روٚس_زبٲنۍ_روٚس_ _زبان_بنٛد جَوابہٕ_روٚس
निर्जीव: زُوٕ_روٚستُے _بےجان زُوٕ_روٚژھ حَرکَتہِ_روٚس تَھرٕ_تَھرِ_روٚس
निर्णय_जाल्ली: فٲصلہٕ_کٔرِتھ
निर्णया_बगरचें: غٲر_طے_شُدٕ
निर्णायक: فٲصلہٕ_کُن
निर्णीत: فٲصلہٕ_کٔرِتھ
निर्दयी: بےٚرحمظٲلِمبےٚ_آر کٔنیوٗ _سنٛگدِل_ _بےٚرحَم
निर्दोश: بےٚگۄناہ موسوٗم بےٚعٲب بےٚگۄناہ_ پاکھ
निर्बंध: پابَنٛد
निर्बळ: ہٮ۪متہٕ_روٚس کمزور
निर्बळा: کَم_پایہِ__ بِچٲرۍ
निर्भय: دِلہیر _جِگرٕ_دوٚر _بہادُر سَرفروش_ _جان_نِثار
निर्भेळ: صافشوٚد صافشوٚدپاکھ
निर्मळ: صافشوٚدپاکھ
निर्माण_केल्लें: بنیومُت
निर्माणकर्तो: بَناوَن_وول
निर्मातो: بَناوَن_وول
निर्मिल्लें: بنیومُت
निर्मीत: بنیومُت
निर्यात: بَرآمد_ _بَرآمدی_تجارت
निर्यात_करपी: برامدی_تجارت_کَرَن_وول
निर्याती: برامدی_تجارت_کَرَن_وول
निर्लज्ज: بےٚشرمبےٚ_حَیَح _بےٚ_مَنٛدَچھ پٲزارَن_ہُنٛد بےٚ_جِجَک_ _بِلا_جِجَک_ _نِہ_ڑَر_ _بےٚ_مَنٛدَچھ
निर्लोभी: لالچہٕ_روٚس_ لالچہٕ_بَغٲر
निर्वासीत: پَناہ_گُزیٖں_ مَہاجِر رَفوٗجی جُلاے_وَطَن کٔڑنہٕ_آمٕتۍ
निर्विवाद: نہَ_ژھٮ۪نَن_وول اِختِلاف_روٚس_ اِختِلاف_بَغٲر
निर्वीख: زہرٕ_روٚس ویٚہہٕ_روٚس
निर्वीर: بہادُرو_روٚس ہٮ۪متہِ_والٮ۪و_روٚستُے دِلیرو_روٚستُے
निर्शेल्लें: غمگیٖن _دِل_مٔلوٗل _اُداس
निर्शेवप: مایوٗس
निलंबीत: برخاست
निळसार: نیوٗل
निळें: نیوٗل
निळ्या_दोळ्यांचो: بیُل
निवडक: ژارنَس_لایق
निवडपा_सारकें: ژارنَس_لایق
निवडिल्ली: مُقرَر
निवडिल्लें: چھونٛٹمُت ژٲرِتھ چُنمُت
निवलकाणयेचें: ناولہِ_ہٕںٛدۍ ناولہِ_مُطٲبِق
निवळ: صافشوٚدپاکھ صاف_ _شَفاف شَفاف _خٲلِص
निवळावपी: ژٔلراوَن_وول
निवारक: اَحتِیٲطی ژٔلراوَن_وول
निवृत्त: آزاد یَلہٕ
निवेदीत: دَرخواست_کٔرمٕژ اِلتجا_کوٚرمُت_ عرض_کوٚرمُت
निव्वळ: صاف _واضح
निशस्त्र: سامانہٕ_روٚژھ ۂتھِیارٕ_روٚس
निशाचर: روتٕلۍ _رٲژ_ہُنٛد
निशाणी__केल्ली: دَستہٕ_خت_کٔرِتھ
निशाणे_बगर: دَستہٕ_خت_روٚستُے
निशाणे_विरयत: دَستہٕ_خت_روٚستُے
निशाद: صرِف_راتَس_کھٮ۪نہٕ_وول
निशिद्ध: حرام_ _منع_کَرنہٕ_آمُت_ _رُکاونہٕ_آمُت
निशुल्क: مُفت
निश्कपट: صافشوٚدپاکھ
निश्कपटी: ایمانٛداررُت روٗپ_نہٕ_بَدلاوَن_وول
निश्कलंक: بےٚعٲب بےٚگۄناہ_ پاکھ
निश्काम: بےٚ_غرض _بےٚ_نفس
निश्कामी: مَطلَب_روٚس
निश्क्रीय: _بےٚحٮ۪س_ _سُست_ _بےٚ_حرکت _گُپتھ
निश्चींत: بےٚفِکِر _فِکرِروٚس
निश्चीत: اَٹَل مُقرَر صحیح _ٹھیٖک پَکہٕ
निश्टूर: بےٚرحمظٲلِمبےٚ_آر
निश्ठावान: اعتِقادپَژھیقیٖن وَفادار
निश्ठाहीण: غد_دار _بےٚ_وَفا
निश्पर्णी: پَنہٕ_روٚس
निश्पाप: صافشوٚدپاکھ بےٚگۄناہ بےٚگۄناہ موسوٗم
निश्प्राण: زُوٕ_روٚستُے _بےجان
निश्फळ: ناکام_ _ناکامیاب بےٚ_غرض _بےٚ_نفس
निसंकोच: بِلا_شَکھ
निसंकोची: بےٚ_جِجَک_ _بِلا_جِجَک_ _نِہ_ڑَر_ _بےٚ_مَنٛدَچھ
निसरटी_(निसट्टी): کھٕرِدار رِکٕنۍوول رِس_دار
निसुवार्थ: مَطلَب_بَغٲر_ مطلَب_روٚس
निस्तेज: بِگریومُت
निस्वार्थी: مَطلَب_روٚس
निहंगी: نِہَنٛگ_مَسلَکَس_مانَن_وول نِہَنٛگ_فِرقُک
नीच: موٚکُر _فٕضوٗل کٔمیٖنہٕ _گَنٛدٕ گِریومُت
नीच_कुळाचें: ؤسِتھ_قٔبیٖلُک
नुतनीकरणी: دُبارٕ_بناونہٕ_یِنہٕ_وول_ _پھِرۍ_پھِرۍ_پٲدٕ_کَرنہٕ_یِنہٕ_وول _دُبارٕ_پٲدٕ_کرنہٕ_یِنہٕ_وول
नेटाचें: زورٕدار طوٗفانُک
नेटाचो: اَکڑی
नेटान: تیز
नेणटें: نا_بالینٛغ
नेणार: اَنٲڑۍ _ناقٲبِل ناسَمَجھ معصوٗم بےٚ_خَبَر انزٲنۍ
नेत्याबगरचें: نُمایَنٛدٕ_روٚستُے
नेपाळी: نٮ۪پٲلۍ_ نٮ۪پالُک نیپٲلۍ نیٚپٲلۍ
नेम_पाळपी: أصوٗل_پَرَستہٕ _أصوٗل_پَسَنٛد
नेमणूक_केल्लें: مانٛنہٕ_آمُت تَسلیٖم_شُداہ
नेमा_प्रमाणें: مُنٲسِب _جان
नेमान: قٲیدٕ_بَنٛد
नेमाळें: دۄہدِشُکھ
नेमिल्लें: مانٛنہٕ_آمُت تَسلیٖم_شُداہ موٚزوٗرۍ اہلِقار
नेमी: أصوٗل_پَرَستہٕ _أصوٗل_پَسَنٛد با_قٲیدٕ لَگاتار ترتیٖب_وار با_ضٲبطہٕ
नेमीत: مُنٲسِب _جان
नैसर्गीक: قدرٔتی خدٲیی
नॉर्वेयी: نارویہُک نارویٖجَن نارویٖجَن
नोंदणी: درٕج
नोंदीत: درٕج دٲیِر_کَرنہٕ_آمُت
न्याय_करपी: دیانَتدار_ عٲدِل
न्यायकरतो: دیانَتدار_ عٲدِل
न्यायालयीन: اَدالتی
न्यायी: دیانَتدار_ عٲدِل
न्युझीलॅण्डी: نیوزِلینٛڑُک نیِوزِلینٛڑَر
न्हयकार: مَنفی
न्हयकारपी: اِنکار_کَرَن_وول نا_مَنظوٗر_کَرَن_وول رَد_کَرَن_وول
न्हयकारी: مَنفی نیگیٹِو
न्हाण_घेतिल्लो: سرٛان_کٔرِتھ
न्हाल्लो: سرٛان_کٔرِتھ
न्हावंक_नाशिल्लें: سرٛانہٕ_روٚس سرٛان_کَرنَے_غۄسلہٕ_روٚس غۄسُل_کَرنَے
न्हावपा_सारकें: سرٛان_کَرنَس_لایَق غۄسٕل_کَرنَس_لایَق
न्हावपाचें: سرٛان_کَرنَس_لایَق غۄسٕل_کَرنَس_لایَق
न्हाविल्लो: سرٛان_کٔرِتھ
न्हिदखुरें: سُست کٲہِل
न्हिदखुरो: نِنٛدرِ_ہوٚت نِنٛدٕرِ_ہوٚت
न्हिदनाशिल्लो: نیٚنٛدرِ_روٚس
न्हिदसुरें: سُست کٲہِل
न्हिदिल्लें: شوٚنٛگمُت
न्हिदेचें: نیٚنٛدرِ_ہُنٛد_ _نیٚنٛدرِ
न्हिदेस्त: نِنٛدرِ_ہوٚت نِنٛدٕرِ_ہوٚت
न्हिद्राळू: نِنٛدرِ_ہوٚت
न्हिद्रो: نِنٛدٕرِ_ہوٚت
न्हीदमग्न: شوٚنٛگمُت
न्हेसनाशिल्लें: لاگنے
न्हेसपा_सारकें: لاگُن_لایق_ _قٲبلہِ_استعمال
न्हेसपाचें: لاگنَس_لایَق نٲلۍ_ترٛاونَس_لایَق
पंचकोनी: پانٛژٕ_کوٗنَل_ _پاںٛژھ_کوٗنٛجَل
पंचखणी: پانٛژ_خانَل پانٛژ_بانَل
पंचतारंकीत: فَیِو_سِٹار پانٛژ_تارَک_دار
पंचभुतांचें: جِسمٲنی
पंचमासीक: پانٛژِِ_رٮ۪تہٕ_گَژھَن_وول پَںٛچمٲیی پانٛژِ_ریتہٕ_سَپدَن_وول
पंचमुखी: پانٛژ_بُتھ_وول پانٛژ_روے_وول
पंचरंगी: پانٛژٕ_رَنٛگہٕ_وول پانٛژ_رَنٛگ_وول پانٛژ_رَںٛگ_وول پانٛژٕ_رَںٛگ
पंचवार्शीक: پَنٛج_سالہٕ
पंचवाहक: پانٛژ_گُرِوول
पंचविसावें: پٕنٛژٕہِیُٛم
पंचविसेक: لَگ_بَگ_پُٕںٛژٕ
पंचवीस: پٕنٛژٕہ
पंचात्तरेक: پاںٛژٕسَتَتھ
पंचायती: پَنچایتُک پَنٛچٲیتی
पंचायतीचें: پَنچایتُک پَنٛچٲیتی
पंचावन: پانٛژٕوَنزاہ
पंचावनावें: پنٛژونزٕہِم _پانٛژوَنٛزٔہیُم
पंचावनेक: لَگ_بَگ_پانٛژٕوَنزاہ پانژٕوَنٛزَن_تام
पंचेचाळिसावें: پانٛژتٲجِہِم
पंचेचाळिसेक: لَگ_بَگ_پانٛژتٲجی
पंचेचाळीस: پانٛژتٲجی
पंच्यांयश्यावें: پانژ_شیٖتِم
पंच्याण्णव: پَنٛژٕنَمَتھ
पंच्याण्णवावें: پانژ_نمتِم
पंच्यात्तर: پانٛژٕسَتَتھ
पंच्यात्तरावें: پنژ_ستتھِم
पंच्यायशीं: پَنٛژٕ_شیٖتھ
पंजाबी: پَنٛجابُک پَنٛجٲبۍ پنٛجٲبۍ پنٛجٲبۍ_ _پنٛجابُک پَنجابُک پَنجٲبۍ
पंडीत: عقل_مَنٛدسَمَجھداردٮ۪ماغدارذٔہیٖندٲنِش_منٛد عٲلِم
पंथ: فِرقَہ_وارانہٕ
पंथीय: فِرقَہ_وارانہ
पंदरा: پَنٛداہ پَنٛدٲہِم
पंन्नासेक: لَگ_بَگ_پَنژاہ پَنژاہَن_تام
पकदस्त: گوٚبوَزَندار شاہانہٕ دَمدار
पकारांती: پ_اَچَھر_وول
पक्कें: پَکہٕ
पक्को: شِٹھہٕ کَٹَر
पक्षपाती: طرفدار _ہٮ۪مٲیتی تعصبی_ راے_تراے_دار_ فرق_دار
पक्षबदलू: دوٚر_بَدلاوَن_وول
पगारी: تَنٛخہ_دار
पचकळ: فٕضوٗل_کَتھہٕ_کَرَن_وول_ _دٮ۪ماغ_کھٮ۪نہٕ_وول
पचनाशिल्लें: گلیٖز_ _گوٚب
पचपचीत: مایہٕ_دار
पचपी: ہَلکہٕ ہَضَم_گَژَھن_وول_ شرٛۄپَن_وول
पचिल्लें: شرٛۄپیومُت
पच्छतापी: پَچھتاوَن_وول _پَشتاوَن_وول
पच्छातापी: پَچھتاوَن_وول اَفسوٗس_کَرَن_وول
पटेकार: تھیٚکَن_وول
पठाणी: پَٹھٲنۍ
पठारी: بالٲیی _پہٲڑی مٲدٲنۍ
पडकें: کھستہٕ_ پیوٚمُت
पडमूर: نا_شُکران_ _ناشِناس
पडवळाकार: اَلہِ_ہیوٗ
पडिंग: لاگنَے
पडिल्लें: کھستہٕ_ پیوٚمُت غمگیٖن _دِل_مٔلوٗل _اُداس سَستہٕ_ _کم روٗدٕ روٗدٕ_دار
पड्डो: جالہِ_دار
पड्डो_नाशिल्लें: پَردٕ_روٚستُے پَردٕ_روٚژھ پَردٕ_روٚس بےٚ_پَردٕ نَنٛگَے
पड्ड्या_बगरचें: پَردٕ_روٚستُے پَردٕ_روٚژھ پَردٕ_روٚس بےٚ_پَردٕ نَنٛگَے
पड्ड्यांचें: پَردٕدار
पड्ड्याचें: پَردٕ_وول_پَردٕ_دار باپَردٕ
पणसाचें: پانس
पतिव्रता: وَفادار_زَنانہٕ
पथी: پَرہیزگار
पदचारी: پَیدل
पदव्युत्तर: پوسٹہٕ_گرٮ۪جویٹ
पदव्युत्तरी: گرٛیجویٹ
पनवतीचो: گِریومُت
पनिराचें: ژامنہِ_دار ژامنہِ_ہُںٛد
पन्नास: پَنٛژاہ
पन्नासावें: پنٛژٲہِیُٛم
पयलींचें: خستہٕ_گوٚمُت _مۄقلیومُت
पयलींचो: پٔتِم_ برونٛٹھ_کالُک پٕرون
पयलें: گۄڈنیُک گۄڈٕ_زامُت
पयशेकार: أمیٖررۄپیہِ_وولسَرمایہِ_دار
पयश्यांची: مَعٲشی
पयस: دوٗر محروٗم_ _نۄقصان_دیٚہہ_ _مفادَس_خلاف اَسور یَتھ_نہٕ_اَتھٕ_آسہِ_لوٚگمُت
पयस_करपी: ژٔلراوَن_وول دوٗر_کرَن_وول
पयसचें: پَتھ_کھورِ واریاہ_دوٗر
पयसचो: دوٗرِ_پٮ۪ٹھُک
पयसावपी: ژٔلراوَن_وول دوٗر_کرَن_وول
पयसुल्लें: پَتھ_کھورِ واریاہ_دوٗر
पयसुल्लो: دوٗرِ_پٮ۪ٹھُک
परकें: غٲر
परक्याचें: وۄپَر غیر
परगोत्री: وۄپَر_خانٛدانُک پَر_زٲژ_ہُنٛد وۄپَر_زٲژ_ہُنٛد وۄپَرخوٗنُک
परजळपी: چَمکیٖلہٕ _چَمَکوُن _زٕژٕدار
परजळीत: گاشدار
परजातीचें: پَرذٲژ
परजिवी: پَر_کھاو
परत-परत_येवपी: بار-_بار_یِِنہٕ_وول پھِر_پھِر_یِنہِ_وول
परत_घेतिल्लो: بہال
परत_दिल्लो: بہال
परतिल्लें: بَدلوومُت
परतुपाचें: واپسی _یِنٕچ
परतूंक_नाशिल्लें: واپَس_نہٕ_دِنہٕ__آمُت
परतें: پھِرِتھ_ _اُلٹہٕ مُخٲلِف_ _اُلٹہٕ_ _اَدلہٕ_بَدل_ _مُخٲلِف پِھرِتھ دُبہٕ _پھِرِتھ _اُلٹہٕ
परतेचें: واپسی _یِنٕچ
परदेशी: غیر_مُلکی نیٚبرِم_ پَر_مٕلکُک
परपंरावादी: رٮ۪واج_دار
परम: اعلٰی سِخٕت شَدیٖد حد_درجٕہ انتہا عروٗجَس_پٮ۪ٹھ
परमळहीण: مشکہٕ_روٚس
परमळीत: خُۄشبودار _مٕشک_دار_ خۄش_گُوار مُشکہٕ_دار _خۄشبو_دار مٕشکاونہٕ_آمُت _مُشکاونہٕ_آمُت
परमाणू: ایٚٹمی
परलोकी: بیاکھ_دُنِیاہ
परलोकीक: بیاکھ_دُنِیاہ
परवानगे_बगरचें: مَنَع_کٔرمٕژ پابَنٛد
परवानगे_भायरें: اجازتہٕ_روستٕے
परसुवादीन: مۄحتاج _غلام
पराक्रमी: سَرفروش_ _جان_نِثار جانٛباز
पराग्वेयी: پرٛاگوییَن
पराजीत: ہورمُت
पराधीन: غۄلام
परावर्तीत: پھیٖرِتھ _پَلٹٮ۪ومُت
परावलंबी: محتاج محتاج
परिचीत: وٲقِف زٲنۍ_یاب
परिणामकारक: کارگَر_ _اثر_دار
परित्यागी: ترٛاونَس_لایَق_ مٔشراونَس_لایَق
परिपक्व: تجرُبہٕ_کار _مٲہِر پوٚپ پۄختہٕ
परिपूर्ण: بوٚرُتھ _بَرپوٗر
परिभाशीत: واضح_کوٚرمُت
परिवर्तन: بدلیومُت_ _تبدیٖل_گوٚمُت
परिवर्तनशील: بَدلوُن
परिवर्तीत: بوٚڑ_ _بَڑُن
परिवारांतलें: گریلوٗ
परिवारीक: گَرٕ_بار_وول_ شُرۍ_بٲژ_وول
परिसिमीत: حَدٕ_بَنٛد_ حَدٕدار
परोपकारहीण: فضوٗل _بے_کار
परोपकारा_बगरचें: فضوٗل _بے_کار
परोपकारा_भायरें: فضوٗل _بے_کار
परोपकारी: فٲیدٕ_منٛد _نَفع_بَخش
पर्यायहीण: لاچار بےبَس
पर्यायी: اِختِیارٲتی ہیٛو_مٔعنی_دار
पर्यावरणी: ماحولیاتُک عِلمہِ_ماحولیاتُک
पर्वताकार: پَہٲڑی
पर्शियन: ایرٲنۍ ایرٲنۍ
पळपी: کھوژٕ_بٕڑ _بُزدِل
पळपुटो: کھوژٕ_بٕڑ _بُزدِل
पळयिल्लें: پَرکھَنہٕ_آمُت اَگوا_کَرنَس_لایَق وُچھمُت وُچھنہٕ_آمُت
पळून_गेल्लो: پسپٲیی_کَرَن_وول
पळोवंक_नाशिल्लें: نظراَنٛداز
पळोवपा_सारकें: وٕچُھن_لایق_ قٲبلہِ_دیٖدار_ _دیٖدارَس_لایق _قٲبلہِ_دیٖد نا_قٲبلہِ_دیٖد_ _نا_قٲبلہِ_دیٖدار _وٕچھنس_لایق_نہٕ
पवित्र: پاکھ _مُقَدَس
पसंतीचें: ٹٲٹھعزیز
पसरायिल्लें: چٔھکروومُت _پٔھہلوومُت _وَہروومُت
पसरिल्लें: دُوٗنٛژھرٲوۍ_مٕتۍ چھٔکرِتھ _پھٲلِتھ
पसून: پٲدٕ_گَژھن_واجٮِنۍ _گَژَھن_واجِنۍ
पस्तिशेक: لَگ_بَگ_پانٛژ_ترٕہ
पस्तिसावें: پانٛژٕترٕٛہِیُٛم
पस्तीस: پانٛژترٕٛہ
पांखयाळें: پَردار
पांखां_आशिल्लें: پَردار
पांखां_बगरचें: پَکھو_روٚس_ _پَکھٕ_ژٔٹ
पांखांकात्रें: تیٖرَٕو_روٚس تیٖرٕ_ژوٚٹ
पांगळो: موزوٗر
पांच: پانٛژ
पांच_पटीचें: پانٛژ_گۄنہٕ
पांचकोनी: پانٛژٕ_کوٗنَل_ _پاںٛژھ_کوٗنٛجَل
पांचखणी: پانٛژ_خانَل پانٛژ_بانَل
पांचपट: پانٛژ_گۄنہٕ
पांचमाही: پانٛژِِ_رٮ۪تہٕ_گَژھَن_وول پَںٛچمٲیی پانٛژِ_ریتہٕ_سَپدَن_وول
पांचरंगी: پانٛژٕ_رَنٛگہٕ_وول پانٛژ_رَنٛگ_وول پانٛژ_رَںٛگ_وول پانٛژٕ_رَںٛگ
पांचवर्सुकी: پَنٛج_سالہٕ
पांचवें: پوٗنٛژِم
पांचेक: لَگ_بَگ_پانٛژ
पांय_ओडपी: بےٚعزتی_کَرن_وول
पांयां_पड_सारकें: عزتَس_لایَق احترامَس_لایَق جُکھنَس_لایَق
पांसठ: پانٛژٕہٲٹھ
पांसठावें: پیٛژہٲٹھِم
पाकिस्तानी: پاکِستٲنۍ_ پاکِستانُک
पाखंडी: دۄنٛکھہٕ_باز
पाखाट्यांविरयत: پَکھو_روٚس_ _پَکھٕ_ژٔٹ
पाचक: ہَلکہٕ
पाचवें: سَبٕز_ _سبزار کوٚچ_اَمبہِ_رَںٛگٕچ خام_سَبٕز سَبٕز
पाचवेंचार: سَر_سَبٕز سَرسَبٕز
पाचारिल्लें: مُخٲتِب
पाझरप: اثَر_گوٚمُت
पाठ्य: پَرنَس_لایق
पाड: مٲلہٕموٚکُرگَنٛدٕناصافناپاکھ فلٲنی_ _ہُہ بتر _بَدتَر بِگڑیمٕژ
पाड_जाल्लें: خراب_ _سڈیومُت_ _ہوٚتمُت_ _دۄدریو_مُت
पाडिल्लें: پَتھر_پیوٚمُت
पाडे_बुद्धीचो: بَد_زات بَد_معاش خٔبیٖث دُشٹھ
पाडें: مٲلہٕموٚکُرگَنٛدٕناصافناپاکھ
पाडो: نفرت_کرن_وول بَد_زات بَد_معاش خٔبیٖث دُشٹھ
पाण: ٲبی
पाणाविल्लो: اوٚش_بوٚڈمُت_ _اوٚش_پھوٚٹمُت _اوٚش_بٔرِتھ
पाणिनी: پانِنی
पाणिनीचें: پانِنی
पातयेवणें: بروسہٕ_منٛ _ایٖماندار
पातळ: توٚن آبہٕ_دار توٚن_ آب_ہیو پانیُل_چیٖز توٚن توٚن
पातळिल्लें: چھٔکرِتھ _پھٲلِتھ پھۄلیمٕتۍ
पातशायी: بادشٲہی_ _سُلطٲنی
पात्र: لایقہِ_کار قٲبِل_ _لایق
पादिसेर: لاچار بٮ۪کَس غٔریٖب
पानबुडो: سرٛانٛٹھ_وایَن_وول
पानाळ: پَن_ؤتھرٕ_دار
पापनाशक: گۄناہ_خَتَم_کَرَن_وول
पापशुन्य: گۄنہَن_نِش_پاک پاک
पापहीण: بےٚگۄناہ گۄنہَن_نِش_پاک پاک
पापाबगरचें: گۄنہَن_نِش_پاک پاک
पापी: گۄناہ_گار بَد_زات بَد_معاش خٔبیٖث دُشٹھ
पापूय_नाशिल्लो: مٲلۍ_یٔتیٖم یٔتیٖم
पारखणे_बगरचें: پرکھاونَے پَرکَھنَے پَرکھونہٕ_روٚس
पारखुपी: دوٗر_اَنٛدیش_نظر_کَرَن_وول
पारखूंक_नाशिल्लें: پرکھاونَے پَرکَھنَے پَرکھونہٕ_روٚس
पारदर्शक: شِفاف
पारदर्शी: شِفاف
पारपांरीक: رٮ۪وٲتی
पारस्पारीक: زٲتی
पार्थीव: زمیٖنی_ _میٚژِ_ہُنٛد
पालक: رَچھَن_وول_ ہَرِ_ژَھٹھ_ہٮ۪نہٕ_وول _رٲچھۍ_راوَٹ_کَرَن_وول
पालविल्लें: تُرُن_ ہُنٛدُر_ سَرٕد
पालेल्लें: پٔھلۍمٕتۍ
पाळपी: رَچھَن_وول_ ہَرِ_ژَھٹھ_ہٮ۪نہٕ_وول _رٲچھۍ_راوَٹ_کَرَن_وول
पाळिल्लें: گر_کُلی
पाव: پاوُین_ پاو
पावयिल्लें: چُکوومُت _نَکھہٕ_وولمُت واتناونہٕ_آمُت
पावली_घालपी: پکوُن
पावली_मारपी: پکوُن
पावसा_विणें: نَہ_پیٚوُن نَہ_وَسہٕ_وُن
पावसा_विरयत: نَہ_پیٚوُن نَہ_وَسہٕ_وُن
पावसाळी: وَہراتُک_ روٗدٕ_موسمُک
पावसाळो: پٮ۪وٕوُن
पाशाणी: سَنٛگ_دِل بےٚ_آر کنٮ۪و سَنٛگمَرمَری
पाश्चात्य: مَغرِبی
पाश्च्यात्य: مَغرِِبی
पास: کامیاب _پاس مَنٛظوٗر_کَرنہٕ_آمٕژ پاس_کَرنہٕ_آمٕژ
पासठेक: لَگ_بَگ_پانٛژٕ_ہٲٹھ
पिंजकें: ژٔھیٚنِمٕتۍ
पिंजिल्लें: ژھوٚنمُت_پرٛون_ رُنیومُت_ ژٔھیٚنِمٕتۍ
पिकसावं: فِکِر_مَنٛد
पिकांचें: فَصلی
पिकाळ: آباد_ زَرخیز
पिकिल्लें: پوٚپ سفید چھیٚتیومُت
पिकें: پوٚپ
पिचो: پاگَل باورٕ
पिडिल्लें: پریشان_کوٚرمُت
पिडिल्लो: مَزلوٗم
पिडीत: زَد
पिडेस्त: بٮ۪مارمٔریٖضدٲدۍ_لَد دِل_مَلوٗل_ _دُکھی_ _رٔنٛجیٖدٕ دۄکھٕ_لَد _غَمزدٕ_ ژٮ۪لہٕ_لَد
पितळीचें: سَرتَلیوٗ سَرتَلہِ_ہُںٛد
पितळेचें: سَرتَلوٗ سَرتَلیُو سَرتَلہِ_ہُنٛد
पितारिल्लें: نقٲشی_کٔرِتھ بناوِتھۍ
पितारीत: نقٲشی_کٔرِتھ بناوِتھۍ
पितूळचें: سَرتَلیوٗ سَرتَلہِ_ہُںٛد سَرتَلوٗ سَرتَلیُو سَرتَلہِ_ہُنٛد
पितृघाती: مٲلۍ_سُںٛد_قَتٕل_کَرَن_وول
पितृहीण: مٲلۍ_یٔتیٖم یٔتیٖم
पित्ताचें: تِلہٕ_پیٚتِکہِ_رَسُک
पिनिल्लें: ژٔھیٚنِمٕتۍ
पियेनासपाचें: نہ_چَنَس_لایَق نہ_چَنَس_لایَق
पिरामिडी: اہرامُک
पिळिल्लें: چوٗرمُت شُرٛکرِِتھ
पिशें: پاگَل دیوانہٕ ڈوٚلمُت بَدحَواس_ بےٚ_حَواس
पिसांट: بیوقوٗفچوراَحمَکباورٕ
पिसाट: پاگَل باورٕ
पिसावल्लें: پاگَل_ مست
पिसो: پاگَل دٮ۪وانہٕ موٚت ڈوٚلمُت
पिस्त्या_कोराचें: پِستہٕ_رَنٛگُک
पुंवाळ: گوٚدوٗد_دار
पुजक: عِبادَت_کَرَن_وول پوٗزا_کَرَن_وول
पुजनीय: معزز
पुजपा_सारकी: معزز
पुजा_केल्लें: معزز
पुजारी: عِبادَت_کَرَن_وول پوٗزا_کَرَن_وول
पुजाहीण: پوٗزا_نہٕ_کَرَن_وول
पुजिल्ली: پوٗزنہِٕ_آمُت پوٗزنہٕ_آمٕژ
पुजिल्लें: معزز
पुजूंक_नाशिल्लें: پوٗزنہٕ_بَغٲر عِبادتہٕ_بَغٲر عَبادتہٕ_روٚس پوٗزنہٕ_روٚس
पुजे_बगरचें: پوٗزنہٕ_بَغٲر عِبادتہٕ_بَغٲر عَبادتہٕ_روٚس پوٗزنہٕ_روٚس
पुज्य: معزز عبادتَس_لایقبَنٛدٕگی_لایق عزتہٕ_وول احترام_وول با_احترام
पुण्य: رُت نیک اِصٕل جان
पुण्यवान: نیکرُتسواب_گار
पुण्यात्मो: نیکرُتسواب_گار
पुत्र_इच्छीत: نیٚچوٗ_سٕںٛز_خٲیِش_تھاوَن_وول نیٚچوٗ_زٮ۪نُک_خٲیِشمَںٛد
पुत्रभिलाशी: نیٚچوٗ_سٕںٛز_خٲیِش_تھاوَن__وول نیٚچوٗ_زاے_سٕںٛز_وۄمید_تھاوَن_وول
पुत्रवती: گَبَر_واجٕنۍ
पुत्रवान: گَبَر_وول
पुनरावृत्तीचें: پَتھ_کُن_تھوٚومُت _بَچٲوِتھ
पुनर्नियुक्ती: بہال
पुनर्वसणुकीत: نَوِ_صَرٕ_بَسومُت_ نَوٕ_صَرٕ_آباد_کوٚرمُت
पुनर्वासीत: نَوِ_صَرٕ_بَسومُت_ نَوٕ_صَرٕ_آباد_کوٚرمُت
पुरक: پوٗرٕ_کَرَن_وول_ بَرابَر_کَرَن_وول مُکَمل_کَرَن_وول
पुरस्कार_मेळिल्लो: نَوٲزنہٕ_آمٕتۍ
पुरस्कृत: نَوٲزنہٕ_آمٕتۍ
पुराणीक: پورانچ _پُورانُک
पुरातात्वीक: آثارِ_قدیٖمی
पुराय: پَکہٕ _سَراسَر _پوٗرٕ پوٗرٕ سروٗنٛٹُے_ _سورُے_ _پوٗرِ_پوٗر_ _ثوبوٗت سورُے سٲری سٲلِم پوٗرِ_پوٗر_ _بَر_پوٗر مُکَمَل پوٗرٕٕ
पुरुशी: مَردانہٕ مَردانہٕ
पुरूश: نَر
पुरो: سٮ۪ٹھاہ_ _کٲفی
पुरो_जाल्लें: تھوٚکمُت
पुरो_जावपाचें: تھکاوَن_وول
पुर्तगाली: پُرتکالٕکۍ پُرتکٲلۍ
पुर्तुगेझ: پُرتگٲلۍ
पुर्वापार: موروٗسی _وَراسٔتی
पुर्विल्लें: برٛۄنٛہہ_کال پرٛونبرٛو٘نٛہہ_کالُک
पुर्विल्लो: پٔتِم_ برونٛٹھ_کالُک پٕرون
पुश्ट: طاقتی
पुश्टीक: صحَت_بَخٕش صحَت_منٛد
पुसट: غٲر_واضح گوٚٹ گوٚم
पुस्तकाकार: کتابہِ_ہیُوکتابہِ_شکلہِ
पुस्तकी: کتٲبی
पूत_आशिल्लो: گَبَر_وول
पूर्ण: پوٗرٕ سروٗنٛٹُے_ _سورُے_ _پوٗرِ_پوٗر_ _ثوبوٗت سورُے سٲری سٲلِم مُکَمَل پوٗرٕٕ
पूर्णप्रभावीत: مُتٲثِر اَثَر_زَد
पूर्वकथित: برٛۄنٛہٕے_وَننہٕ_آمُت
पूर्वी: مَشرِقی
पृश्ठ: پٔتیُم
पृश्ठांकीत: خطٲوِتھ
पेंवपी: ژھرٛانٛٹھ
पेज: فٕضوٗل_کَتھہٕ_کَرَن_وول_ _دٮ۪ماغ_کھٮ۪نہٕ_وول
पेज_पडिल्लें: بار_وول وَزَن_دار
पेजाद: واریاہ_دوٚر واریاہ_مَظبوٗط
पेझाद: طاقتور _زوراور _زوردار واریاہ_بوٚڑ بوٚڑ_بارٕ
पेटयिल्लें: دَزٕوُن
पेटिल्लें: مار_پیوٚمُت مار_کھیوٚمُت
पेटोवपी: دزن_وول
पेय: چَنَس_لایَق
पेयहीण: نہ_چَنَس_لایَق
पेरणेचें: وَونَس_لایق
पेरपी: بیول_وَوَن_وول_ لاگَن_وول_ باغوان
पेरिल्लें: ووٚومُت لاگنہٕ_آمُت
पेरूंक_नाशिल्लें: وونے_دانۍ
पेशीपुंजुल्याचें: خِلہٕ_دار
पॉझिट्रॉन: مُثبَت_ _پُلَس
पॉलिशा_बगरचें: گَرنَے
पोंग: کوٚب_دار
पोंदलें: بٔنیُم تٔلیُم
पोकळ: کھۄکُھر
पोको: کھۄکُھر
पोजडें: موٚکُر_ گَنٛدٕ
पोजडो: بَد_زَبان زَباندَراز
पोटचें_गेल्लें: مۄردٕ _موٗدمُت_بَچہِ
पोटभर: یَڑ_بٔرِتھ
पोटयो: یٔڑل _بَتہٕ_جِن
पोटसरें: کٕھکھرِ_پَکَن_وول
पोटाचें: شِکمُک یٔڑۍ_ہُںٛد
पोर: حرام_زادٕ حرٲمۍ ناجٲیِز حرام_زادٕ حرٲمۍ
पोरणें: خستہٕ_گوٚمُت _مۄقلیومُت برٛۄنٛہہ_کال پرٛونبرٛو٘نٛہہ_کالُک پرٛون _برٛۄنٛہہ_کالیُک
पोल: کھۄکُھر
पोलिशी: پولینڑُک پولِش پولِش
पोलो: کھۄکُھر
पोशिल्लें: گر_کُلی
पोशेगवाली: پَلَو_لٲگِتھ
पोसकें: مَنٛگتہٕ
पोसपी: رَچھَن_وول_ ہَرِ_ژَھٹھ_ہٮ۪نہٕ_وول _رٲچھۍ_راوَٹ_کَرَن_وول
पौरव: دیومالٲیی اوٚسطوٗری
प्रकाशी: پَرزَلوٕنۍ
प्रकाशीत: چھٲپِتھ روشَن_ _گاش_دار
प्रकाशीत_जावपाचीं: اَثَر_دار
प्रखर: تیز
प्रगट: اِظہار_ _ظٲہِر _ونُن _بولُن واضح _صاف
प्रगतिशील: تَرقی_یافتہٕ
प्रगती_केल्लो: ترقی_یافت
प्रगतीकर्तो: تَرقی_کَرَن_وول
प्रचलीत: پَکوُن پِکوُن_ چَلوُٕن_ جٲری
प्रचारक: پَرچٲرۍ
प्रचारीत: تَقریٖر_کَرنہٕ_آمُت تبلیغ_کَرنہٕ_آُمُت خِطاب_کَرنہٕ_آمُت
प्रजातंत्री: جمہوٗری
प्रजातंत्रीक: جمہوٗرِی_ _عوٲمی_حکوٗمت
प्रतिकारी: بدلہٕ_ہٮ۪نہٕ_وول
प्रतिगामी: پھِرِتھ_کٲم_کَرَن_وول _پھِرِتھ_پَکَن_وول
प्रतिद्वंद्वी: حِصہٕ_نِنہٕ_وول
प्रतिध्वनीत: گزیمٕژ_آواز
प्रतिपादीत: وَٮ۪ژھناونَس_لایَق واش_کَڑنَس_لایَق تَشکیٖل_دِتھ بَنٲوِتھ
प्रतिभावान: ہۄنر_منٛد
प्रतिभाशाली: ہۄنر_منٛد
प्रतिरुपी: ہِشے _ہیوٗ _ہِوُے
प्रतिश्ठीत: مَشہوٗر _نام_دار _عِزَت_دار رۄتبہٕ_دار رۄتبہٕ_وول عظمَت_دار_ عزتہٕ_وول
प्रतिस्पर्धक: حِصہٕ_نِنہٕ_وول
प्रतीसर्तक: حِصہٕ_نِنہٕ_وول
प्रत्यक्ष: قٲبلہِ_اِدراک قٲبلہِ_یقیٖن_ _ٹاکارٕ_ _چشم_دیٖد
प्रत्येक: پرٛٮ۪تھ_کانٛہہ پَرٛٮ۪تھ_اکھ
प्रथम: گۄڈنیُک
प्रदर्शनी: وٕچَھس_لایق
प्रदर्शीत: گِنٛدنہٕ_آمُت نُمٲیشہٕ_دار نُمٲیِش_دار
प्रदुशीत: آلوٗدٕ خراب_ _نۄقصی_ خٲمی_ _قُصوٗروار
प्रदेशीक: صُوبٲیی
प्रधान: اَہَم_کُلاز
प्रभावशाली: حٲکم_ آمِرانہ حاکمانہ
प्रभावशुन्य: بےٚ_اثر ناقٲبِل
प्रभावहीण: بےٚ_اثر ناقٲبِل بےٚ_اثر
प्रभावी: حٲکم_ آمِرانہ حاکمانہ کارگَر_ _اثر_دار
प्रभावीत: اَثَر_پٔزیٖر
प्रमाणीत: تسدیق_کٔرِتھ مُظٲہِرٕ_کٔرِتھ ثٲبٕت
प्रमाणें: مُطٲبِق _پَسَنٛد بَرابَرہِویہم_رۄتبہٕہم_پَلہٕ مُطٲبِق
प्रयत्नशील: کوٗششہِ_وول
प्रयोजनार्थी: غَرِض_مَنٛد
प्रवासी: مُہٲجِر مُہٲجِر
प्रवाहीत: لَگاتار_ مُسَلسَل
प्रवेशाचें: اَژنُک
प्रवेशीत: آمُت
प्रशंसक: مانَن_وول
प्रशस्त: شانٛدار_ _عظیٖم_ _عٲلی_شان
प्रशासनीक: اِنتظٲمی_ _سیٲسی
प्रशिक्षणार्थी: زیرٕ_تٔعلیٖم
प्रशिक्षीत: تربِیت_یافتہٕ
प्रसन्न: خۄش
प्रसन्नचित्त: خۄش_حالخۄش_مِزازخۄش_باش
प्रसन्नमूख: خۄش_وُن
प्रसारीत: نشٕرکرنہٕ_آمُت
प्रसिद्ध: مَشہوٗرنامہٕ_وَر مشہوٗر ناووَر نامچیٖن
प्रस्तावीत: تجویٖز_کوٚرمُت _تجویز_کَرنہٕ_آمُت
प्रस्तुतीकरणाचें: سِٹیجَس_لایَکھ
प्रस्न_विचारपी: سوال_کَرن_وول سوال_پرٛژھن_وول
प्रहारक: حَملاوَر
प्रांतीय: صُوبٲیی
प्राकृतीक: قدرٔتی خدٲیی
प्राचीन: برٛۄنٛہہ_کال
प्राज्ञी: تعلیم_یافتہٕ_ _پَڑا_لِکھا
प्राणघातक: جان_لیوا_ _فٲنی
प्राणी_चिकित्सक: وٮ۪ٹہَ_نٔری
प्राथमीक: اِبتِدٲیی _شروعٲتی
प्रादेशीक: صُوبٲیی
प्राधिकृत: اِختِیٲری
प्राप्त: حٲصِل
प्राप्त_करपी: حٲصِل_کَرَن_وول_ _لَبَن_وول
प्राप्त_केल्लें: مۄیثر موہِیا _دٔستِیاب
प्राप्य: قٲبلہِ_حٔصوٗل
प्रामाणीक: بروسہٕ_منٛ _ایٖماندار پوٚز _صٔحیح ایمانٛداررُت نیک نیک_نِیَژوول جان _رُت
प्रायोगीक: تَجرُبٲتی
प्रायोजीत: پیشکش
प्रारब्दवादी: قٕسمَت_مانَن_وول
प्रासंगीक: عِبٲرٔتی عِبارِتُک سِیٲقی سَیاقُک
प्रीयभाशी: کھۄلکی
प्रेत_खायरें: مۄردٕ_کھاو
प्रेमपूर्ण: حدٕ_روٚس بےٚ_شُمار
प्रेममय: حدٕ_روٚس بےٚ_شُمار
प्रेमासक्त: دیوانہٕ_ _فِدٲے
प्रेमी: عاشِق
प्रेरक: مُتٲثِر_کَرَن_وول
प्रेरणा_दिवपी: اَثردار
प्रेरणादायक: اَثردار
प्रेरणास्पद: اَثردار
प्रेरीत: آمادٕ_ _رٲغِب
प्रेशीत: سوٗزمُت
प्रोत्साहक: ہٮ۪مت_دِنہٕ_وول
प्रोत्साहीत: حوصلہٕ_وول
प्रौढ: پۄختہٕ
प्रौद्योगीक: تَکنیٖکی
फकत: صرف_ _محض_ _فقط
फकांडीं: مَسکَھرٕ ٹَھٹھہٕ_باز ٹَھٹھہٕ_گوٚر
फकारंती: پھ_اَچَھر_وول
फकिरी: لاچار بٮ۪کَس غٔریٖب فٔقیٖرہیوٗ فٔقیٖرَس_ہیوٗ مُسافِر_ہیوٗ
फटकळ: زَبان_دَراز بَد_زَبان بٕتھۍ_پُھیر
फटकिरें: اَپٕزۍیور اَپُزغلط
फटकिरो: مکار _اَپٕزیور
फटकीरपणाचें: اَپُزغلط
फटाश्यो_मारपी: تھیٚکَن_وول
फटिंग: ہانٛژھہٕ_دار
फटींग: اَپٕزۍیور بےٚ_بُنِیاد _غَلَط دونٛکھہٕ_باز _تِگڑَم_باز بے_ایٖمان جٲہِل_ _بدتمیٖز بَدماشلَفَنٛگہٕذٔلیٖلکٔمیٖنہٕکھوٚر مکار _اَپٕزیور بےٚ_ایٖمان دوکھہٕ_باز_ فَرٲبۍ_ جال_ساز _چالاک ہوشیار
फटीचें: اَپُزغلط تَصَوُری _خَیٲلی ژھوٚرُے
फटोवणेचें: لوٗٹمُت تَھپہِ_نیومُت
फडफडीत: تازٕ تازٕ نوٚو تازٕ تازٕتٔریٖن
फरारी: فرار_ _ژوٚلمُت_ _غٲب
फळआहार: مٮ۪وٕدار
फळदिणें: پَھل_دار_ _میوٕ_دار_ _نفع_دار
फळपी-फुलपी: پھۄلمُت پھانٛپھلیومُت
फळां_दिवपी: مٮ۪وٕ_دار_ پَھلہٕ_دار
फळां_नाशिल्ले: مٮ۪وٕ_روٚس
फळां_लागपी: مٮ۪وٕ_دار_ پَھلہٕ_دار
फळां_लागिल्लें: مٮ۪وٕ_دار_ پَھل_دار
फळांचें: مٮ۪وٕ_دار_ پَھل_دار
फळादीक: کامیاب_ _کامران
फळादीक.: رَتھہِ_کھَسنَس_لایَق
फळार: مٮ۪وٕدار
फांकिल्लें: چھٔکرِتھ _پھٲلِتھ
फांटो: لَنٛجِدار شاخہٕ_دار
फांफार्रांव: بَد_لِحاظ _بَد_تٔمیٖز _بَدسٔلوٗک
फाकिवंत: مَشہوٗرنامہٕ_وَر
फाटलें: پٔتیُم پٔتِیُٛم_ _أنٛدِیُٛم_ ٲخری مُتبٲدِل
फाटलो: پٔتِم_ برونٛٹھ_کالُک پٕرون
फाटल्या: پرٛون _برٛۄنٛہہ_کالیُک
फाटल्यान: پھِرِتھ ؤلِتھ بِلا_واسط
फाटल्यान_चडिल्लें: پَتھ_کَنہِ_بِہَن_وول
फाटल्यान_बशिल्लो: پَتہٕ_کَنِیُٛک
फाटल्यान_लागपी: پَتہٕ_لاروُن
फाटल्यान_सरकिल्लें: پَتھ_کُن_گوٚمت
फाटल्यानचें: پٔتۍ_کِنۍ_وَننہٕ_آمُت
फाटी_उरिल्लें: پَس_پایہِ
फाटी_पडिल्लें: پَس_پایہِ
फाटीं_उरिल्लो: پَتھ_روٗدٕمُت کٲہِل سُست
फाटीकणो_मोडिल्लें: پُھٹمُت_کَمرٕ_وول پُھٹمُت_کَمبرٕ_وول
फाटीचें: کھوٚٹ_ _نَقلی_ جٲلی_ فَرضی
फातरा_काळजाचो: سنٛگ_دِل_ بےٚ_انصاف _بےٚ_رحم _بےٚعار
फातरांचो: کَنیُو کَنیوٗ کَنہِ_دار کَنٮ۪ن_ہُنٛد
फातराळ: کَنِیوٗ کَنیوٗ
फातराळो: کَنیُو کَنیوٗ کَنہِ_دار کَنٮ۪ن_ہُنٛد
फाफडिल्लें: چٔھکروومُت _پٔھہلوومُت _وَہروومُت
फाफशिल्लें: چھٔکرِتھ _پھٲلِتھ
फाम: اَفواہ_واجِنۍ
फामाद: مَشہوٗرنامہٕ_وَر مَشوٗر مشہوٗر ناووَر نامچیٖن
फायदो_खावपी: نَفاہ_کھٮ۪نہِٕ_وول نَفاہ_خور
फायद्याचें: مُفید فٲیدٕمَنٛد
फायस्टार: فَیِو_سِٹار پانٛژ_تارَک_دار
फारायल्लें: ژوٗرِ_نِنہٕ_آمُت ژوٗر_کَرنہٕ_آمُت
फारायिल्लें: اَگوا_کَرنَس_لایَق
फारावपी: دونٛکھٕ_باز دَغاباز تارَن_گوٚر ژوٗر تھَپَل
फाराविल्लो: پھسیومُت _بَنٛد_گوٚمُت
फारीक_करिनासपा_सारकें: ناواجِبہِ_ادا
फारीक_करूंक_नाशिल्लें: اَدا_کَرنٔے دِنٔے بۄکہٕ
फारीक_करून_घेतिल्लें: اَدا_کوٚرمُت دِنہٕ_آمُت
फारीक_केल्लें: چُکوومُت _نَکھہٕ_وولمُت
फारीक_ना_करी_सारकें: ناواجِبہِ_ادا
फालतू: بَکوٲسۍ فضوٗل موٚکُر _فٕضوٗل کٔمیٖنہٕ _گَنٛدٕ غٲر_ضَروٗری فٕضوٗل فَضوٗل بے_معنی
फाल्गुनी: پَھگنُک پَھگنی
फाल्याचें: پَگہُک
फाळदीक: پوٗرٕ
फाळीक_लागिल्लो: مَرنہٕ_سَر
फावोशी: بہتٔریٖن_ اَفضَل_تٔریٖن
फावोशें: مُطٲبِق _پَسَنٛد مُنٲسِبمعقوٗل ٹھیٖک_ صٔحی_ مُنٲسِب_ مُفیٖد قٲبِل_ _لایق خۄشگَوار مُنٲسِب ٹھیٖک اِنسانَس_خٲطرٕ_مُفیٖد
फिकें: رَنٛگہٕ_روٚستُے بےٚ_رَنٛگ_ بَد_رَنٛگ چھوٚت_ _ہلکہٕ
फिटफिटें: نوزُک نَرٕم ٲویُل
फिटीचें: مرگی_لَد مرگی_وول
फिन: عقل_مَنٛدسَمَجھداردٮ۪ماغدارذٔہیٖندٲنِش_منٛد
फिनलॅण्डी: فِنلینٛڑُک فِنِش فِنِش
फिरकेचें: پیچہٕ_وول_ _پیچ_دار
फिरोजी: فیروزی
फिलिपीनी: فِلپیٖٖٖنی فِلپیٖنۍ
फिल्मी: فِلمی
फिशाल: قٲبِلہُنر_منٛدمٲہِِر عقل_مَنٛدسَمَجھداردٮ۪ماغدارذٔہیٖندٲنِش_منٛد
फिशाळ: وٲقٕف_ _آگاہ_ زٲنۍکار_ _زٲنۍیاب
फीट: تَنٛگ_ لۄکٕٹ ٹھیٖک صحیٖح مُنٲسِب
फुकट: مُفت
फुक्याचें: فضوٗل بےٚکار زایہِ
फुक्याचें_खावपी: مُفتُک_کھٮ۪نہٕ_وول مُفت_کھور
फुटकें: پُھٹمُت
फुटिल्लें: پھوٚٹمُت
फुटीर: بیوٚن_بیوٚن _چھٔکرِتھ _اَلَگ_اَلَگ _جُدا_جُدا پھوٗٹل
फुटें: پٔرٛتہٕ_وٲنۍ_ _بےٚ_مَزٕ
फुडलें: دوٚیِم
फुडलो: برٛوٗنٛٹھیُم برٛوٚنٛہہ_پَکَن_وول
फुडल्या: یِنہٕ_وول
फुडाराचें: یِنہٕ_وول _برٛۄنٛہہ_کُن_سَپدَن_وول
फुडारी_नाशिल्लें: نُمایَنٛدٕ_روٚستُے
फुडारीहीण: نُمایَنٛدٕ_روٚستُے
फुमेरी: خٔمیٖر_ہُںٛد
फुलां_बगरचें: پوشہٕ_روٚژھ
फुलांचें: پوش_کُلۍ پوش_دار پوش_دار کامہِ_دار
फुलांनी_भरिल्लें: پوشہٕ_دار
फुलिल्लें: پھۄلیومُت پھوٚلمُت_ پھوٚٹمُت پوش_دار
फुलूंक_नाशिल्लें: اَڑٕ_پھوٚل
फुश्यारी_मारपी: تھیٚکَن_وول
फॅल: فیل _ناکام
फेडिनासपा_सारकें: ناواجِبہِ_ادا
फेसाळ: پوٚس_دار
फॉरेन: نیٚبرِم_ پَر_مٕلکُک
फोराचें: جِلدٕ_کٔرِتھ
फोर्त: مظبوٗطپایدارپۄختہٕ ٹھیٖک اَصٕل
फोलगी: فضوٗل_خرچ
फोल्गी: فضوٗل_خرچ عَیاش_ _شوقیٖن_
फौजदारी: فوجدٲری
फौजी: فوٗجی
फ्राक: کمزور
फ्रान्स_गुवानी: فرٲنٛسی_گُواناہُک فرٲنٛسی__گُوَن
फ्रान्सी: فرٲنٛسی
फ्रेंच: فرانٛسُک فرٲنٛسی فریٚنچھ فرٲنٛسی
फ्रेन्च: فرانٛسُک فرٲنٛسی فریٚنچھ فرٲنٛسی
बंगळुरी: بنٛگلورُک
बंगाली: بَنٛگٲلۍ بنٛگٲلۍ بنٛگٲلۍ
बंजारा: خانہٕ_بَدوش_ _ٹھِکانہٕ_روٚس_ _دَر_بہٕ_دَر_پھیرَن_وول
बंडखोर: بٲغی
बंद: بنٛد بَنٛد
बंद_केल्लें: ٹھٕہرِِتھ_ _رُکِتھ_ _بنٛد
बंदखणीचे: ہوالٲتی
बंदनमुक्त: نَہ_رُکہٕ_وُن رُکاوٹہٕ_بَغٲر رُکاوٹہٕ_وَرٲے
बंदनहीण: نَہ_رُکہٕ_وُن رُکاوٹہٕ_بَغٲر رُکاوٹہٕ_وَرٲے
बंदना_बगरचो: نَہ_رُکہٕ_وُن رُکاوٹہٕ_بَغٲر رُکاوٹہٕ_وَرٲے
बंदिस्त: یرگمٲلۍ
बंदो: چَمچہٕ_ خۄش_آمٔدۍ_ چاپلوٗس
बकारांती: ب_اَچَھر_وول
बकासूर: یٔڑل _بَتہٕ_جِن
बकें: زٲویُلنیُک أڑِجوٗ
बचत_केल्लें: سوٚمبروومُت _جَمع_کوٚرمُت _أتھۍ_تھوٚومُت
बडबडे: کَتھَل _بَکوٲسۍ
बडबडें: بَکوٲسۍ کَتھَن_ہُںٛد_مَزٕ_تُلَن_وول
बडबडेचें: بَکوٲسۍ
बडबडो: فٕضوٗل_کَتھہٕ_کَرَن_وول_ _دٮ۪ماغ_کھٮ۪نہٕ_وول چاپلوٗس
बडयिल्लें: مار_پیوٚمُت مار_کھیوٚمُت
बडाय_मारपी: تھیٚکَن_وول
बडीची: موروٗسی _وَراسٔتی
बडीचें: خانٛدٲنی
बत्तिसावें: دۄیہِ_ترٕٛہِیُٛم_ _۳۲
बत्तीस: دۄیہٕ_ترٕٛہ
बत्तीस_दांतांचो: کرِہٕنٛۍ_زِٮ۪وِ_وول
बदनामिकारक: ہانٛژَل
बदल: بدلیومُت_ _تبدیٖل_گوٚمُت
बदलनासपी: نہ_بَدلن_وول _اَٹَل
बदलपी: بَدلوُن
बदली_केल्लो: تَبادلہٕ_کوٚرمُت تَبادلہٕ_وول
बदामी: بادٲمی بادامی بادَم_رَنٛگُک بادَم_رَنٛگٕچ
बदिस्त: پابَنٛد_ گنٛڈِتھ
बद्‍दल: مُطَلِق
बनारसी: بنارَسُک کٲشی_ہُںٛد
बनावट: بَناؤٹی بناوٹی _نَقلی تَصَوُری _خَیٲلی
बरबडोसी: بَربڑوسی بَربڑوٗسۍ
बरमुडायी: بَرمُڑٲی بَرمُڑاہُک
बरयल्लें: کاغزی
बरयल्लो: لیٚکھِت
बरयिल्लें: لیٖکھِتھ _لیوٚکھمُت
बरी: اَصٕل _جان _رُت _بِہتٔریٖن _لایقہِ_کار بٔڑ_بارٕ
बरुंडी: بُروٗنٛڑی_یُک
बरे_वळखीचो: زٲنۍ_یاب
बरें: رُت _اَصٕل_ جان بِلا_اعتِراض اعلاج_دار مَزٕ_دار_ لٔزیٖز_ میوٗٹھ جان خوٗن_ہان_ _ہوٗن_ہار
बरें_जायना__अशें: لااعلاج
बरें_मागपी: خٲرخواہ
बरो: رُت _اَصٕل _شٔریف بہتَر_ _ٹھیٖک_ _مُنٲسِب ٹھیٖک اَصٕل
बरोबर: ٹھیٖک_ صٔحی_ مُنٲسِب_ مُفیٖد صحیح_ _ٹھیٖک_ _دُرست
बरोवन_दवरपा_सारकें: قٲبلہِ_تحریٖر
बर्फा_भशेनचें: شیٖن_ہِیوٗ
बर्फाळ: شیٖنوٗ_ _شیٖنہٕ_دار شیٖنہٕ_ؤلِتھ شیٖنٕے_یوت شیٖنہٕ_بٔرِتھ شیٖنہ_ؤلِتھ _شیٖنہٕ_بٔرِتھ
बर्मी: بٔرمی_ _بَرمی بٔرمَنُک بٔرمی_ _بَرمی
बर्‍या_कुळाचें: خانٛدٲنۍ
बर्‍या_घराण्यांतलें: خانٛدٲنۍ
बलदंड: طاقَتور_نَرِ_وول
बलात्कारी: عَصمَت_دٔری_کَرَن_وول
बल्गेरी: بلغیرِیا
बल्ल: ویوٚٹھہُنیومُت
बळकट: کٔسِتھ چٲرِتھ
बळजबरी_करपी: عَصمَت_دٔری_کَرَن_وول
बळजबरी_जाल्लें: عصمت_دری_کَرنہٕ_آمٕژ
बळवर्धक: طاقتی
बळादीक: طاقتور _زوراور _زوردار
बळिश्ट: طاقتور _زوراور _زوردار مظبوٗطپایدارپۄختہٕ کٔسِتھ چٲرِتھ بَہادُر_ قَداوار
बशिल्लें: بِہِتھ _قَرار_کٔرِتھ _قَیام_کٔرِتھ سوار
बसयिल्लें: جٔرِتھ
बहरेनी: بیٚہریٖنی
बहामयी: بَہاماہُک بہامٲیۍ
बहिर्दृश्टी: ٹاس_پَٹٲسۍ
बहिर्मूख: ٹاس_پَٹٲسۍ
बहिश्कृत: کٔڑنہٕ_آمُت نٮ۪بَر_کَڑنہٕ_آمُت پَرٕژھیوٚن_کَرنہٕ_آمُت
बहुचर्चीत: ناموَر مَشوٗر
बहुभूज: وارِیاہ_اَنٛدٕ_وول وارِیاہ_طَرف_وول وارِیاہ_پاسہٕ_وول
बांगलादेशी: بنٛگلا_دیٖشی بنٛگلادیشی بنٛگلا_دیشُک
बांदिल्लें: بنیومُت
बाकी: بَقایہہ
बाकीचें: ہُریومُت_ بَچومُت_ ژَڈیومُت باقٕے_ بَقایہ
बागवल्लें: جُکِتھ _نٔمِتھ _رٲغِب ہوٚل
बागविल्लें: بروٚنٛکُن_جُکِتھ
बाजारांतलें: بازٕرۍ
बाजाराचें: بازٕرۍ
बाजारी: بازٕرۍ
बाजिराव: نَواب
बात्तर: دُسَتَتھ
बाद: بےٚکار فلٲنی_ _ہُہ
बादीत: مِسمار_کٔرِتھ
बाधक: رُکاوَٹ_دار_ _تھوٚر_دار
बापायचें: مٲلۍ_وَتہِ_
बापोल: پِتُر
बापोलयो: پِتُر
बाबरी: بابری
बायजणपणाचें: زَنانہٕ_ہیو_ زَنانَن_ہٕنٛدۍ_پٲٹھۍ
बायलांचें: زنانہ
बायलाडें: زَنانہٕ_ہیو_ زَنانَن_ہٕنٛدۍ_پٲٹھۍ
बायलेचे: زَنانہٕ
बारबॅडोसी: باربیڑوٗسُک باربیڑوسۍ
बारा: باہ ۱۲
बारामाही: صدابہار بَہہ_موس_ _بَہَن_رٮ۪تَن_ہُنٛد
बारावें: بٔہِم
बारीक: زٲویُلنیُک أڑِجوٗ زٲوِیُٛل_ نِیُٛک_ _توٚن زٲوِیُٛل_ _توٚن_ _نِچ_ _مِہینہٕ ہوٚکھمُت _زٲوِیُٛل_ _نِیُٛک_ _کمزور ژھوٚٹ لۄکُٹ پیونٛت لۄکُٹ
बारीक-बारीक: لۄکُٹ_لۄکُٹ
बारीक-सारीक: لۄکٕٹۍ_مۄکٕٹۍ _ہَلکہٕ_پُھلکہٕ _کینٛہہ_کینٛہہ _تھوڑا_بُہوٚت
बारीक_सारीक: لۄکُٹ_مۄکُٹ معموٗلی عام
बारीकसाणीचें: بۄدٕ_دار _ذٔہیٖن
बारीकसाणेचो.: کوٚنٛڑ کٔنٛجوٗس
बालपण: بٔجگانہٕ_ _شُرۍ_گی
बालोपयोगी: کورٮ۪ن_ہٕنٛدۍ_خٲطرٕ_کارآمَد کورٮ۪ن_ہٕںٛدۍ_خٲطرٕ_مُفیٖد
बाळंटेर: پرٛسَن_واجِنۍ
बाळक: زا _زاے _شیٖر_خوار
बावगल्लें: بروٚنٛکُن_جُکِتھ
बावटो_घेतिल्लें: جَنٛڈٕ_وول
बावट्याकार: جَنٛڈٕ_وول
बावट्याचें: جَھنٛڑٕوول بینَر_دار بینَر_وول
बावन: دُوَنٛزَہ
बावनावें: دُونزٔہِم _دُوَنٛزہیُم
बाविल्लें: بِگریومُت بےٚ_رونَق رونقہٕ_روٚس رونقہٕ_بَغٲر بِگریومُت غمگیٖن _دِل_مٔلوٗل _اُداس زَۄزریمُت_ _زَردیومُت ہوٚکُھمُت_ _سوس_نیومُت
बावीस: زٕتووُہہ
बावीसावें: زٕتوٚوُہٕم
बाशें: بی
बाश्पशील: وٕہٕوُن_ _غٲب
बाश्पीत: کشیٖدٕ
बासठ: دُہٲٹھۍ
बासठावें: دُہٲٹھِم
बाह्य: نیٛبرِم
बिंदुंकीत: نۄقطہٕ_دار ٹیٚکۍ_دار
बिंधास्त: مست
बिकट: خٕلاف مُشکِل_ _دُشوار
बिगरनिवासी: غٲر_ریاستی _غٲر_مٕلکی
बिगरसरकारी: غٲر_سرکٲری
बिनकांटयारें: کَنٛڑٮ۪و_روٚستُے _کَنٛڑٮ۪و_بَغٲر
बिनचूक: اَٹَل_ بِلکُل_صحیح
बिनपांयाचो: پَکھٕ_روٚس
बिनपावशी: نَہ_پیٚوُن نَہ_وَسہٕ_وُن
बिनराखीव: اَنرٕزٔروِڑ غٲر_مَحفوٗظ_شُدہ
बिनविरोध: بِلا_اِختِلاف
बियां_बगर: بیٛالہِ_روٚس بیٛالہِ_ورٲے بیٛالہِ_روٚژھ
बियां_विरयत: بیٛالہِ_روٚس بیٛالہِ_ورٲے بیٛالہِ_روٚژھ
बियांचें: بیٛالہِ_دار
बियाळ: بیٛالہِ_دار
बियेचें: بیٛالہِ_مَںٛزُک
बिहारी: بِہٲرۍ_ بَہارُک
बी: وغٲرٕ_وغٲرٕ
बीन: وغٲرٕ_وغٲرٕ
बीन_विखारी: زَہرٕ_روٚس_ زَہرٕ_بَغٲر
बीनज्वाळाग्राही: نہ_دزن_وول
बीनतारी: تارِ_روٚستُے _تارِ_بَغٲر
बीनपगारी: تَنخاہ_روٚس _نَنخاہ_بَغٲر
बीनविखारी: زہرٕ_روٚس ویٚہہٕ_روٚس
बीनविरोध: مُخالفَت_روٚس
बुडकुलो: ژھوٚٹ_تہٕ_موٚٹ گول_مَٹول
बुडा_विरयत: ژَکہِ_روستٕے_بانہٕ
बुडिल्लें: پھوٚٹمُت
बुडिल्लो: لوٗسمُت
बुदवंत: عقل_منٛد عقل_مَنٛدسَمَجھداردٮ۪ماغدارذٔہیٖندٲنِش_منٛد عٲلِم
बुद्दिजिवी: عقل_منٛد
बुद्दीक: دٮ۪مٲغی دٮ۪ماغُک ذہنی
बुद्दीहीण: بےٚعَقل _بددٮ۪ماغ
बुद्धिवादी: عقلِیت_پَسَنٛد
बुन्यादीक: مُلہٕ_ بُنیٲدی
बुरकाचें: گٔددار
बुरखोधारी: باپَردٕ پردٕ_وول بےٚپَردٕ نَنٛگہٕ
बुरशें: مٲلہٕموٚکُرگَنٛدٕناصافناپاکھ موٚکُر_ گَنٛدٕ مل_دار
बुराक_नाशिल्लें: گَدِ_روٚس
बुराकाची: گٔدۍدار
बुलेट_प्रूफ: بُلیٚٹ_پروٗف
बे: زٕ
बेकायदेशीर: غٲر_قونوٗنی
बेकार: کٲہِل بےٚکار خٲلی_ یَلہٕ بےٚ_روزگار کَم_کارٕ_وول کَم_کامہِ_وول کَم_کامہِ_کارٕ_وول بےٚکار
बेकारलवडी: بےٚکار
बेगडी: بَناؤٹی بناوٹی _نَقلی یاوٕ ظٲہِری
बेगमी: بیگمہِ_ہُںٛد
बेगीन: تیز
बेघर: گَربارٕ_وول گَرٕ_روٚژھ_ _گَرٕ_بَغٲر
बेचाळिसावें: دۄیتٲجِیُٛم
बेचाळीस: دۄیہٕ_تٲجی
बेचैन: بےٚتاب
बेजार: مایوٗس _ناخۄش مایوٗس نا_اُمیٖد_ دِل_مَعلوٗل
बेजारदिणें: مایوٗس_کُن مایوٗس_کرَن_وول دِل_تَںٛگ__کَرَن_وول دِل_شِکشتہٕ_کَرَن_وول شکَستہٕ_کُن
बेजारिल्लें: تنگ_آمُت_ _تنگ_گوٚمُت_ _بیزار_ _پریشان_ _جیرٕ_آمُت
बेजोड: واٹہٕ_روس
बेताल: بےٚتال تالہِ_روٚستُے تالہِ_ورٲے لَیہِ_روٚس
बेदखल: أزِل_گٔمٕتۍپرٮ۪تکھ_دِتمُتبے_دخل
बेदाग: داغٕ_روس _بےٚ_داغ _داغہٕ_وَرٲے
बेधडक: بےٚ_جِجَک_ _بِلا_جِجَک_ _نِہ_ڑَر_ _بےٚ_مَنٛدَچھ
बेनाळ: زٕ_نالہِ_دار
बेनिनी: بینِنی_ _بینِنِز
बेनुल्ल: پَر_کھاو
बेपरवा: نَظراَنٛدازَس_لایَق تَگوفُلَس_لایَق
बेपरवाय: لاپَروا_ بےٚ_پَروا_ مَستہٕ_ بےٚ_فِکٕر
बेफिकीर: مست
बेबदड: شرٲبۍ چیتھ
बेबदो: نَشہٕ_خور_ _نَشہٕ_باز شرٲبۍ شرٲبۍ چیتھ
बेमुदत: میعادٕ_بِغٲر
बेयमान: نا_شُکران_ _ناشِناس بےٚ_ایٖمان
बेरंग: بےٚ_رَنٛگ_ بَد_رَنٛگ
बेलगाम: لانٛکمہِ_روٚس
बेलरसी: بیٚلَروٗسُک بیٚلروٗسۍ بیٚلَریشِیَن بیٚلروٗسی بیٚلروٗسۍ
बेलिजी: بیٚلیٖزُک بیٚلیٖزۍ بیٚلیٖزِیَن
बेल्जियन: بیٚلجَمُک بیٚجٔمۍ بیٚلجِیَن
बेल्जियमी: بیٚلجَمُک بیٚجٔمۍ بیٚلجِیَن بیٚلجِمی بیٚجٔمۍ
बेवारशी: ییٚتیٖم _سٔگیٖر _بےٚکَس آوارٕ_ لاوٲرِث لاوٲرِس
बेशुद्द: بےٚحٮ۪س بےٚ_ہوش
बेशुद्ध: بےٚہوش _بےٚ_حٮ۪ص بَد_حَواس
बेसनाचें: بیٛسنہِ_ہُںٛد
बेसावध: لاپَرواہ
बेसूर: بٮ۪گُر _طرزٕ_روٚس بےٚتال تالہِ_روٚستُے تالہِ_ورٲے لَیہِ_روٚس
बोंडें: بیوقوٗفچوراَحمَکباورٕ
बोंब_उडोवपी: بمبٲری_کرن_وٲلۍ
बोंब_घालपी: بمبٲری_کرن_وٲلۍ
बोटी_वयलें: جہٲزی جہازُک
बोडकीं: پَنہٕ_روٚس
बोडकें: نَنٛگہٕ
बोडको: پِنہٕ_ؤتھرو_روٚس چھوٚن نَنٛگہٕ زِنۍموٚنٛڑ موٚنٛڑ کُنٛدٕ مۄنٛڑُر موٚنٛٹُھن
बोत्सवानी: بوتسوانٲے
बोधक: خبری خبردِنہٕ_وول شیٚچھ_وَنن_وول شیٚچھ_دِنہٕ_وول
बोधपूर्ण: عٔلمہِ_واجین
बोधहीण: حٲران_کُن
बोध्य: سہل _آسان
बोलकें: گرٛزُن مٔدٕرِ_زَبانِہِ_وول _میٖٹھ_زَبانہِ_وول
बोलिवियाचें: بوٚلِوِیاہُک بوٚلِوِیَن
बोलिवियायी: بوٚلِوِیاہُک بوٚلِوِیَن
बौद्ध: بُدھ
बौद्ध_धर्मावलंबी: بُدھ_مَزہَبُک_پیروکار بُدھ_مَزہَبُک_حٲمی
बौद्धीक: دٮ۪مٲغی دٮ۪ماغُک ذہنی
ब्यांयशीं: دُشیٖتھ
ब्यांयश्यांवें: دُ_شیٖتِم
ब्याणव: دُ_نَمَتُھ
ब्याण्णवावें: دُ_نمتِم
ब्यात्तरावें: دُستتھِم
ब्रह्मज्ञानी: روٗحٲنی
ब्रह्मांडांतलें: کایناتُک
ब्राजीली: برٛازیٖلُک برٛازِلِیَن
ब्रिटीश: _برطانَوِی_ برٛٹِش بَرتانوی_ _بَرتانِیُٛک
भंगीत: پُھٹمُت
भंगुर: ٲوُیل
भंयकर: خوٗن_خارخطر_ناکھکھوژٕوُن خطرناکھ
भंयभीत: خوف_زَدٕ_ _کھوٗژمُت
भक्त: عِبادَت_کَرَن_وول پوٗزا_کَرَن_وول
भक्तिपूर्ण: بَگتی_سان
भक्तीहीण: پَژھِ_روٚس عٔقیٖدٕ_روٚس
भक्षक: کھور
भक्ष्य: کھٮ۪نس_لایق
भगभगीत: کَشُن_اَنَن_وول
भगवें: گۄسٲنۍ
भगवो: کۄنٛگہٕ_رنٛگہٕ
भटकें: پھیروُن نَژوُن
भटा_बगरचें: یُس_نہٕ_برٛہمَنَن_کَرنَس_لایَق_آسہِ
भडक: اِشتعٲلی چَمکیٖلہٕ شوکھ تیز
भड्डें: ؤسِتھ کَم_پایہِ ؤسۍ_پایہِ
भड्डो: ویوٚٹھ
भयभीत: خوف_زَد
भयरो: زوٚر
भयांकृत: بےٚرحمظٲلِمبےٚ_آر خوٗن_خارخطر_ناکھکھوژٕوُن
भयानक: حَملہٕ_دار_ حَملہٕ_واجین خوٗن_خارخطر_ناکھکھوژٕوُن
भरड: ویوٚٹھ
भरतकाम: کامہٕ_دار
भरदस्त: گوٚبوَزَندار
भरपूर: واریاہ _سٮ۪ٹھاہ واریاہ _کٲفی پوٗرِ_پوٗر_ _بَر_پوٗر بٔرِتھ_ _ٹیپہِ_ __بَرپوٗر
भरवण: کٔھٹِتھ _چُھپِِتھ
भरशिल्लें: مِلمِش _رَلٲوِتھ _مِلٲوِتھ
भरिल्लें: بوٚرُتھ _بَرپوٗر چُکوومُت _نَکھہٕ_وولمُت مِلمِش _رَلٲوِتھ _مِلٲوِتھ بٔرِتھ_ _بٔریٖتھ_ _تالہِ_تام_ _لبریز بٔرِتھ_ _بوٚڈمُت__ _اوٚدُر_ _آب_ہِیوٗ__ _لِتھ_وِتھ__ لَت_پَت بٔرِتھ بٔرِتھ لٔدِتھ
भलायकी_वाडोवपी: صحتمَںٛدانہٕ صحتمَںٛد
भलायकेक_बरें: صَیحَت_بَِخٕش
भलायकेवंत: صحت_منٛد
भलें: رُت _اَصٕل_ جان
भव्य: وۄتھوُن _ڑۭس بوٚڈ_ عٔظیٖم واریاہ_کُشادٕ شانٛدار_ _عظیٖم_ _عٲلی_شان بوٚڈ
भशेन: بَرابَرہِویہم_رۄتبہٕہم_پَلہٕ ہیو یُتھ_ یُتھٕے
भश्टी_जायनाशिल्ली: نابالیغ
भश्टें: ماہ_وٲری_گَژھَن_واجٕنۍ
भांगरा_पसून_तयार_केल्ली: سۄنہٕ_سُنٛد
भांगराची: سۄنہٕ_سُنٛد
भांगराळें: سۄنہٕ_ۂری سۄنٛہری
भाकरी_खावपी: ژوٚٹ_کھیٚنہٕ_وول
भागपी: تقسیمی
भागलपुरी: بَگَلپوریُک بَگَلپوٗرۍ
भाग्यशाली: خۄش_قسمت
भाजिल्लें: رٔنِتھ_ _روٚنمُت دوٚدمُت
भाज्य: لایقہِ_تقسیم
भाट: مانَن_وول
भाटकारवादी: جٲگیٖردارانہٕ جٲگیٖردار
भाटकारशायी: جٲگیٖردارانہٕ
भाटकारी: جٲگِیٖردارانہٕ
भाटाबेंसाचे: جٲگیٖرُک_ دۄلَتُک
भाड्याच्यो: ادا_کوٚرمُت پونٛسہٕ_دِتۍ_مٕتۍ
भानगडींचें: کھۄشکٮ۪ت_دار وَرٕ_دار تَفریٖق_دار
भायर_आशिल्लें: ماہ_وٲری_گَژھَن_واجٕنۍ نٮ۪برِم نٮ۪بَر
भायर_जाल्लें: ماہ_وٲری_گَژھَن_واجٕنۍ
भायर_धाडिल्लें: بَرآمد_ _بَرآمدی_تجارت
भायर_सरिल्लें: نٮ۪بَر_درٛامُت نوٚن_درٛامُت
भायराविल्लें: کٔڑنہٕ_آمُت نٮ۪بَر_کَڑنہٕ_آمُت
भायरी: جۄلابہٕ
भायरें: پَرٕژھیوٚن_کَرنہٕ_آمُت
भायरो: بےٚ_دخٕل
भायलें: نیٛبرِم نیٚبرِم_ پَر_مٕلکُک غٲر نٔیبٕرۍ نٮ۪برِم نٮ۪بَر
भायलो: غیر_مُلکی
भायल्याचें: وۄپَر غیر
भारतीय: ہِنٛدُستٲنۍ _ہِنٛدُستانُک
भारी: وَزَن_دار وَزنی
भाळावपी: دلفریب
भावनाहीण: جذباتو_روٚس
भावपूर्ण: جَزبٲتۍ
भावहीण: جذباتو_روٚس
भाविल्लें: ٹٲٹھعزیز
भावी: یِنہٕ_وول
भावीक: بَگتی_سان عِبادَت_کَرَن_وول پوٗزا_کَرَن_وول
भावूक: جذبٲتۍ
भाशांतरकार: تَرجُمہٕ_کار
भाशांतरीत: تَرجَمہٕ
भाशातंर_करपी: تَرجُمہٕ_کار
भाशीक: زبٲنۍ_ہُنٛد
भाशेचें: زبٲنۍ_ہُنٛد
भिकाड्डो: کوٚنٛڑ کٔنٛجوٗس
भिकुड्डो: بُزدِلڈَرپوکؤہمیکمزور
भिकुणांचें: ژَرٕ_وول ژَر_دار
भिजिल्लें: سَگنوومُت_ _سَگ_دِیُٛتمُت_ _سَگُومُت
भिजूड: بُزدِلڈَرپوکؤہمیکمزور
भिडेस्त: حیح_منٛد حیح_مَنٛد
भितर_पावूंक_नाशिल्लो: غٲر_رُکُن
भितरले: أنٛدروٗنی _أنٛدرِم
भितरलें: أنٛدرِم
भित्रो: بُزدِلڈَرپوکؤہمیکمزور
भिन्नरुपी: غیر_نُمایَنٛدٕ
भियेल्लो: کھوٗزمُت_ _خوف_زَد_ _دَہشَت_زَد
भिरांकूळ: خوف_زَد حَملہٕ_دار_ حَملہٕ_واجین خوٗن_خارخطر_ناکھکھوژٕوُن
भिल्ली: بِھِل_سُںٛد
भिवकुरो: بُزدِلڈَرپوکؤہمیکمزور
भिसाचें: زَتَھل
भुंयगत: مَنٛز_روزَن_وول زمینس_تَل_ _زمیٖن_تَلُک
भुंयचर: زٔمیٖنَس_پٮ۪ٹھ_روزَن_وول
भुंये_बगरचें: غٲر_زٔمیٖنی زٔمیٖنہِ_پٮ۪ٹھ_نَہ_کھسَن_وول زٔمیٖنہِ_پٮ۪ٹھ_نَہ_وۄپدَن_وول
भुंयेंतलें: زمیٖن_تَلُک_ _زمیٖنہٕ_تَلہٕ_کَنِیُٛک
भुकेल्लो: بۄچھِ_ہوٚت
भुकेस्त: بۄچھِ_ہوٚت یٔڈَل_ بیٚچھ
भुगोलीक: جُغرِِفِیٲتی
भुतकाळ: پرٛون _برٛۄنٛہہ_کالیُک
भुतकाळीन: پرٛانہِ_وَقتُک_ _پَتھ_کالُک
भुताचें: کھوژُن
भुताटकेचें: کھوژُن
भुतानी: بوٗٹانُک_ بوٗٹٲنۍ بوٗٹٲنۍ بوٗٹٲنۍ
भुमितीक: جییومیٹری_ہُںٛد
भुमीगत: زمینس_تَل_ _زمیٖن_تَلُک
भुरगें: نا_بالینٛغ
भुरगें_खायरी: پوٚترٕٕ_دَگ_واجٕنۍ
भुरगेंकारीण: بَچہِ_واجٕنۍ لۄکٕٹۍ_بَچہِ_واجٕنۍ شُرۍ_واجٕنۍ
भुरगेंपणाचें: شُرِل_ بَچہٕ_کانہٕ_حَرکَت
भुरगेकान्न: بَچہِ_واجٕنۍ لۄکٕٹۍ_بَچہِ_واجٕنۍ شُرۍ_واجٕنۍ
भुरगेपण: بٔجگانہٕ_ _شُرۍ_گی
भुरग्यांचें: بٔجگانہٕ اَولاد
भुरग्याकारीण: بَچہِ_واجٕنۍ لۄکٕٹۍ_بَچہِ_واجٕنۍ شُرۍ_واجٕنۍ
भुरळ_घालपी: دلفریب
भुलयणें: جٲددار میٛچھہٕ مٔدرِ دِل_نِنہٕ_وول_ دِل_نِو_وُن _دِلچسپ_
भुलोवपी: دِل_نِنہٕ_وول_ دِل_نِو_وُن _دِلچسپ_ دلفریب
भुसभुशीत: پُھٹمُت
भूंय: زٔمیٖنی زٔمیٖنہِ_ہُںٛد
भूंयमंडळी: عالمگیٖری
भूंयहीण: غٲر_زٔمیٖنی
भूक_वाडोवपी: مزدار _لطافت_دار بۄچھِ_بَڑاوَن_وول بۄچھِ_بٔڑراوَن_وول
भेड्डो: زوٚر
भेदनीय: غٲر_محفوٗظ
भेदभावपूर्ण: تعصبی_ راے_تراے_دار_ فرق_دار
भेद्य: غٲر_محفوٗظ
भेरो: زوٚر
भेळशेल्लें: بی
भेसळीचें: مِلاوَٹہِ_دار _ؤسِتھ
भैरवी: بیروی
भोंवपी: پھیروُن نَژوُن
भोगशिनासपी: معٲفی_نَہ_دِنہٕ_وول معاف_نَہ_کَرَن_وول نَہ_بَخشَن_وول
भोगसणी: ماف
भोगसणी_मागपी: معٲفی_منگن_وول_ _معٲفی_ہیٚنہٕ_وول
भोगिल्लो: ژالَن_وول
भोगी: کامہِ_کار _کار_کُن
भोळें: جَلٕد_پَژھ_کَرَن_وول آسٲنی_سان_پَژھ_کَرَن_وول
भोळो: نَرٕم_مِزازُک _نَرٕم شریفسیوٚد_سادٕسیوٚد
भोवअर्थी: بِسِیار_جٔہژَل
भोवगुणी: قٲبِلہُنر_منٛدمٲہِِر
भोवधंधी: وارِیاہ_کامہِ_کَرَن_وول وارِیاہ_کار_کَرَن_وول
भोवधर्मीक: مُختٔلِف_مَزہَبہٕ_وول
भोवमान_करूंक_नाशिल्लो: سلٲمی خٲر_آمدیٖد نَطرِ_مَںٛز_اَننُن
भोवमानीत: مہمان_نواز عزت_دارناماور_لُکھ قٲبِلسمجھ_دار
भोवमानेस्त: عَزتہٕ_وول مُحتَرَم عزتہٕ_وول_ احترامہٕ_وول
भोवरंगी: رَنٛگہٕ_بہٕ_رٔنٛگی
भोववर्शी: زیٖٹھ_وُمرِ_وول
भोववेवसायी: وارِیاہ_کامہِ_کَرَن_وول وارِیاہ_کار_کَرَن_وول
भोवसंख्य: واریاہ_ذیادٕ
भोवसंख्या: زیادٕ_ _بٔیسیارٕ_ گُتُل
भौशीक: ضِلعی ضِلعُک
भ्रमिश्ट: پاگَل دیوانہٕ ڈوٚلمُت پَریشان
भ्रमीत: پَریشان
भ्रश्ट: گُمراہ
भ्रश्टाचारी: بٔد_کٲری
मंगल: رُت نیک اِصٕل جان
मंगलकारी: فٲیدٕ_مَنٛد
मंगळीक: مَنٛگلی
मंगोलियन: منٛگولِیٲے منٛگولِیاہٕکۍ منٛگولیٲے منٛگولیاہُک
मंगोलियायी: منٛگولیٲے منٛگولیاہُک
मंगोली: منٛگولِیٲے منٛگولِیاہٕکۍ
मंचनीय: سِٹیجَس_لایَکھ
मंचीत: گِنٛدنہٕ_آمُت
मंजूर: مَنٛظوٗرشُدٕ _مَنٛظوٗر_گوٚمُت
मंत्र_मारिल्लें.: پٔرِتھ
मंत्रीत: پٔرِتھ
मंद: کملوٚتوارٕ_وارٕ کَمزور_ _ناتوان لوٚت وارٕوارٕ_ _ژھۄکیومُت ہُنٛدُر
मंदबुद्दी: عقلہِ_موٚنٛڑ_ _موتُھن
मंदमती: عقلہِ_موٚنٛڑ_ _موتُھن
मकदुनियायी: میٚکڑونِیاہُک میٚکڑونِیٲیۍ میٚکڑونِیَن میٚکڑونِیَن
मकारांती: م_اَچَھر_وول
मखमली: مَخمٔلۍ مَخمَلُک مَخمَلوٗ مَخمَلُک
मगधी: مَگٲہی مَگاہی مَگاہُک
मग्न: لٔگِتھ آوُر_ _مصروٗف
मचमचीत: مَزٕ_دار_ لٔزیٖز_ میوٗٹھ مَسالہٕ_دار ترٛوٚش
मजत_घेवपी: اِمدٲدۍ
मजती: مَدتی
मजबूत: مظبوٗطپایدارپۄختہٕ
मजेशीर: مَزٕدار_ دِلچَسٕپ مَسکَھرٕ ٹَھٹھہٕ_باز ٹَھٹھہٕ_گوٚر
मडगास्करी: مَدَگاسکَرُک
मडील्लें: کٔھنِتھ
मडें_खायरें: مۄردٕ_کھاو
मढयिल्लें: جٔرِتھ
मढोवंक_नाशिल्लें: تَراشنہٕ_روٚژھ
मणिपुरी: مٔنی_پوٗرُک مٔنی_پوٗری
मणिपूरी: منی_پوٗری
मताधिकारी: قٲبِلہِ_ووٹ
मतींतलें: خیٲلی _اَپُز
मथुरेचें: مَتھوٗراہُک
मदलो: مٔنٛزیُم
मदल्या_आकाराचें: دٔرمِیٲنی
मदल्याकाळांतलें: منٛز_کالُک
मदांद: چِیٚتھ پاگَل_ مست
मदेवर्ती: مٔنٛزِم عارضی
मद्यम_पिरायेचें: دَرمِیان
मद्रासी: مَدرٲسۍ مَدراسُک
मधलें: دَرمِیٲنی
मधूर: پِشُل _پِشول _آبہٕ_تَھپھ _نَرٕم_پَھمٛب _مُلٲیِم
मध्यकाळांतलें: منٛز_کالُک
मध्यकाळीन: منٛز_کالُک مَنٛزٕ_کالُک
मध्यम: دَرمِیٲنی
मध्यम_आकाराचें: دٔرمِیٲنی
मध्यमवर्गी: درمِیٲنی_طبقُک
मध्ययुगीन: منٛز_کالُک
मध्यवर्ती: مٔنٛزِم
मध्यस्ते_भायरें: مداخلتی
मन_भुलोवपी: لوٗبوُن
मननशील: فِکِر_منٛد
मनभुलयणी: لُطف_اَنٛدوز
मनभुलयणें: خۄشوُن_ خۄش_گَوار_ اَصٕل لوٗب_وُن لوٗبوُن خوٗبصوٗرَت حٔسیٖن مٲرۍ_موٚنٛد
मनमानी: دِلَس_مُوٲفِق_ دِلَس_وٮ۪ژَن_واجٮ۪ن
मनरिजवणेचें: دِلچَسٕپ
मनशाक_सोबता: اِنسانَس_خٲطرٕ_مُفیٖد
मनसीक: دٮ۪مٲغی دٮ۪ماغُک ذہنی
मनाक_भुरळ_घालपी: لوٗبوُن
मनायेचें: ٹھاکھ _مَنَہہ
मनीस_निर्मीत: اِنسان_دٔسۍ_بَنٲوِتھ _اِنسان_دٔسۍ_بَناونہٕ_آمُت
मनीसचलीत: اِنسانہٕ_دٔسۍ_چَلَن_وول
मनीसपण: رُت _اَصٕل_ جان
मनीसपणाचें: اِنسٲنِیتٕچ
मनोगत: دِلٕکۍ
मनोविज्ञानीक: نفسِیٲتی
मरगळिल्लें: کَمزور نیُک زٲوِیُل
मरणा_उपरांत: موٗدمُت
मरणा_धडेर_आशिल्लो: مَرنہٕ_سَر
मरणाक_तेंकिल्लो: مَرنہٕ_سَر
मरणादीक: زِنٛدٕگی_اَنٛد_واتناوَن_وول _زِنٛدٕگی_خَتٕم_کَرَن_وول
मरणाभिलाशी: مرنٕچ_خٲہِش_کَرَن_وول
मरणासन्न: مرن_وول
मरणेत्शी: مرنٕچ_خٲہِش_کَرَن_وول
मरतकच: موٗدمُت
मराठी: مَرٲٹھۍ_ _مَہراشٹڑٛی مَرٲٹھۍ مَرٲٹھۍ مَرٲٹھۍ مہراشٹُرٛک
मरूंक_पाविल्लें: کَمزور نیُک زٲوِیُل
मर्दानी: مَردانہٕ
मर्यादीत: کِفایت_شعار محدوٗد حَدٕ_بَنٛد_ حَدٕدار حَدَن_منٛز_روزَن_وول
मलेशियायी: مَلیشیاہُک مَلیشِیٲی مَلیشِیٲیۍ مَلیشِیَن
मल्लुक्याचें: مرگی_لَد مرگی_وول
मल्ल्याळम: مَلیٲلۍ مٔلیٲلۍ مٔلیٲلۍ
मल्ल्याळी: مَلیٲلۍ مٔلیٲلۍ مٔلیٲلۍ
मळकें: مٲلہٕموٚکُرگَنٛدٕناصافناپاکھ مَل_خۄر
मळबस्पर्शी: واریاہ_تھوٚد
मळबा_कोराचें: آسمٲنۍ
मळबांतलें: آسمٲنۍ آسمانُک
मळबाक_तेंकपी: واریاہ_تھوٚد
मळाचें: مٲدٲنۍ
मळ्यांचीं: واریاہ_پور_وول
मवशे: ماستُر
मशागत: بٔڑرومُت _روٚچھمُت
मसजिदेचें: مٔشیٖدِ_ہُںٛد مَسجِد_ہُںٛد
मसालेदार: مَسالہٕ_دار
मसाल्याचें: مَسالہٕ_دار ترٛوٚش
मस्तिल्लें: مَظلوٗم_ _سِتَم_زَد برٛکوَنہٕ_آمُت مَتھنہٕ_آمُت برٛس_گٔمٕژ برٛیٚے_گٔمٕژ برٛیٚشیومُت
मस्तें: شَرارتی ووٚٹ شیطان زہمَت
महतिवान: بَجَروول تَھزَر_وول عزتہٕ_وول
महत्वाकांक्षी: تَمَہہ_دار
महान: عظیٖماَصٕلجان
महाराष्ट्री: مَرٲٹھۍ_ _مَہراشٹڑٛی
महाराष्ट्रीयन: مَرٲٹھۍ_ _مَہراشٹڑٛی
महाविद्यालयीम: کالجَن_ہُنٛد
महिमावान: بَجَروول تَھزَر_وول عزتہٕ_وول
मांगलीक: مَنٛگلی
मांडिल्लें: وَٮ۪ژھناونَس_لایَق واش_کَڑنَس_لایَق
माखिल्लें: بٔرِتھ_ _بوٚڈمُت__ _اوٚدُر_ _آب_ہِیوٗ__ _لِتھ_وِتھ__ لَت_پَت
मागणें_केल्लें: فَرمٲیِشی
मागणेचें: أپیٖلہِ_دار
मागनासपी: خۄددار _غٲرَت_مَنٛد
मागलें: پٔتیُم
मागलो: پٔتِم_ برونٛٹھ_کالُک پٕرون
मागारिल्लें: پَس_پایہِ
मागिल्लें: فَرمٲیِشی موٚنٛگمُت مَںٛگنہٕ_آمُت درخواست_کَرنہٕ_آمُت اِلتِجا_کَرنہٕ_آمُت اِلتِماس_کَرنہٕ_آمُت
मागीरचें: پٔتِیُٛم_ _أنٛدِیُٛم_ ٲخری
माचयेबगरचें: نہ_گِنٛدنَس_لایَق
माजी: سٲبِق
माडिल्लें: برٛکوَنہٕ_آمُت مَتھنہٕ_آمُت برٛس_گٔمٕژ برٛیٚے_گٔمٕژ برٛیٚشیومُت
माड्डिल्लें: مَظلوٗم_ _سِتَم_زَد
माणकुलें: لۄکُٹ_مۄکُٹ _مۄکُٹ پِشُل _پِشول _آبہٕ_تَھپھ _نَرٕم_پَھمٛب _مُلٲیِم ژھوٚٹ لۄکُٹ پیونٛت
मातयेकोराचो: خٲکۍ گُرِٹھۍ
मातयेभरवण: تباہ _فان زٔمیٖن_بوس وٲران_ _چَھلہٕ_چھانٛگٕر
मातसो: کَم _رَژھ
मातिल्लें: ژانٛڈٕ_دار
मातृहीण: ماجہِ_یٔتیٖم یٔتیٖم
मातेराचें: گوٚدوٗد_دار
मादक: شودٕ_ _شرٲبی_ _چرسی شَرٲبی مے_بوٚرُت
मादी: مادٕ
माध्यमीक: درمیٲنی_ _مٔنٛزِیُٛم
माननीय: عٔزتہٕ_واجٔینۍ
मानपी: پٲرَوکار_ _حمایتی_ _پٔلوٕ_ _مُرید
मानवल्लें: ٹٲٹھعزیز
मानवी: اِنسٲنِیتٕچ
मानसीक: ذہنی
मानादीक: عٔزتہٕ_واجٔینۍ عَزتہٕ_وول عزت_بنٛد_ _یَزتہٕ_وول داوعت_دنہِٕ_امُت مُحتَرَم عزتہٕ_وول_ احترامہٕ_وول
मानिल्लें: پابَنٛدی_بَغٲر_ _حَدٕ_بِغٲر
मानिल्लो: زَبانہِ_سۭتۍ_ووٚنٛمُت
मानेस्त: عزت_بنٛد_ _یَزتہٕ_وول
मान्य: پابَنٛدی_بَغٲر_ _حَدٕ_بِغٲر منٛظوٗر مَنٛظوٗر_کَرنہٕ_آمٕژ پاس_کَرنہٕ_آمٕژ رٲضی
मान्य_केल्ली: منٛظوٗر
मान्य_नाशिल्लें: ناقٲبلہِ_قَبوٗل
मापनीय: میننَس_لایَق مینَن_لایَق
मापिल्लें: میٛوٗنمُت توٗلِتھ _میٖنِتھ
मापूंक_नाशिल्लें: میننہٕ_روٚستُے
माफ: ماف
माफ_करी_सारकी: معٲفی_لایق
माफी-बगरचो: ناقٲبِلہِ_معٲفی
मामे: مامتٕر مامتُر
माया_नाशिल्लो: کٔنیوٗ _سنٛگدِل_ _بےٚرحَم
मायेस्त: مایہِ_بوٚرُتھ _لولہٕ_بوٚرُتھ _محبتی _شَفکٔتی
मार_खाल्लेलें: مار_پیوٚمُت مار_کھیوٚمُت
मारक: اَثَر_کَم_کَرَن_وول قٲتِل وٮ۪ہہ_بوٚرُتھ
मारकें: ٹھۄل_دِنہٕ_وول ٹھۄل_کَڑَن_وول
मारपाक_योग्य: قَتٕلَس_لایَق _مارنَس_لایَق
मारपी: قٲتِل حَملاوَر
मारवाडी: مارواڑُک ماروٲڑۍ ماروٲڑۍ ماروٲڑۍ
मारिल्लें: مار_پیوٚمُت مار_کھیوٚمُت درٛامُت
मारी_सारकें: قَتٕلَس_لایَق _مارنَس_لایَق
मार्गदर्शक: اشارٕ اِشارٕ_دِوٕوُن
मालकीचे: ملیقیٲتی _وَراستی
मालकीचें: اختیارٕچ _حَقٕچ
मालक्रियाद: شَرارتی ووٚٹ شیطان زہمَت
मालदिवी: مال_دیٖوی مالدیٖوُک مالڑیٖوۍ مالڑیٖٖوی مالڑیٖوِیَن
मालीश_कारपा_सारकें: مٲلِش_نَہ_کَرُن_لایَق
माल्टायी: مالٹاہُک مالٹٲیۍ
माल्टी: مالٹاہُک مالٹٲیۍ
माळी: واریاہ_پور_وول
माळेचें: قٕسطٕ_وار
मावळिल्लो: لوٗسمُت
मावशे: ماستُر
मावस: ماستُر ماستُر
मासहीण: ہوٚکھمُت _زٲوِیُٛل_ _نِیُٛک_ _کمزور
मासाळ: لوو مازٕ_دار
मासाहारी: مازخور_ ماز_کھاو
मासीक: رٮ۪تُک_ ماہانہٕ_ ماہوار
मिजो: میٖزورٔمۍ میٖزورَمُک
मिजोरमाचें: میٖزورٔمۍ میٖزورَمُک
मिटना__अशें: نَہ_مِٹَن_وول
मिठाचें: الکالٲیِن_الکلِک
मित्रत्व: رَلوُن
मिथ्या: ژھوٚرُے
मिरयांचें: چوٗرِدار
मिरयो_आशिल्लें: چوٗرِدار
मिरीमिरी: نِیُک_نِیُک_روٗد سوٚت_سوٚت_روٗد
मिळमीळीत: ڈٔٹِتھ_نہ_روزَن_وول
मिशयाळो: گونٛژھَل گونٛژھہٕ_دار
मिशयेकार: گونٛژھَل گونٛژھہٕ_دار
मिश्कील: اَسوُنمَزاکِیہٹھَٹھہٕ_گوٚرمَسکھَر مَسکَھرٕ ٹَھٹھہٕ_باز ٹَھٹھہٕ_گوٚر
मिश्र: رَلہٕ_مِلہٕ
मिश्रीत: رَلاونَس_لایق مِلاونَس_لایق رَلاونَس_قٲبِل
मिस्तुराद: مِلاوَٹہِ_دار _ؤسِتھ رَلہٕ_مِلہٕ
मिस्री: مِصرُک اِ_جِپٹُک
मीर्गाचें: وَہراتُک_ روٗدٕ_موسمُک
मुंबयकार: بَمبیہِ_ہُنٛد
मुंबयचें: بَمبیہِ_ہُنٛد_ _مَمبیہِ_ہُنٛد
मुक्कामाचें: مٔنٛزِل
मुक्त: آزاد آزادیَلہٕ آزاد
मुक्तछंद: غٲر_قافیہ
मुखार_आयिल्लें: برۄنٛہہ_کُن_آمُت برۄنٛہہ_کُن_اَننہِٕ_آمُت
मुखार_आशिल्लें: برۄنٛہہ_کُن_آمُت برۄنٛہہ_کُن_اَننہِٕ_آمُت
मुखार_येवपी: یِنہٕ_وول
मुखार_रावपी: نَکھہٕ_روزَن_وول نَزدیٖق_روزَن_وول
मुखार_सरिल्लें: ترقی_یافتہٕ
मुखारचो: برٛوٗنٛٹھیُم
मुखावयलो: برٛوٗنٛٹھیُم برٛوٚنٛہہ_پَکَن_وول
मुखेल: اہم_ _بُنیٲدی اہم _مَخصوٗص اہم اَہَم_کُلاز
मुखेली: اہم
मुख्य: اہم _مَخصوٗص اَہَم_کُلاز
मुख्यः2: اہم_ _بُنیٲدی
मुगलायी: مُغلَن_ہُںٛد مُغلٲیی
मुगा_कोराचें: مۄنٛگہٕ_رَںٛگ
मुगाच्या_कोराचें: مۄنٛگہٕ_رَںٛگ
मुदयाळे: وٲنٛکۍ_دار_ گوٗنٛگَر_دار_ کٔرلی
मुदलांतलें: مُقٲمی
मुदी_घातिल्लें: نِشٲنۍ_وول نِشٲنۍ_واجیٚنۍ
मुद्रांकीत: مُہَر_ترٛٲوِتھ
मुद्रीत: مُہَر_ترٛٲوِتھ چھٲپِتھ
मुनेल्लें: موٚنٛڑ
मुमुर्खें: ژھوٚپ
मुर्ती: موٗرَژِ_ہٕںٛدِ_شَکلہِ_مَںٛز
मुलतानी: مُلتٲنۍ مُلتانُک
मुल्यवान: بیش_قٕمتی
मुळां_नाशिल्लें: موٗلہٕ_بَغٲر موٗلہٕ_روٚستُے موٗلہٕ_روٚس موٗلہٕ_روٚژھ
मुळां_बगरचें: موٗلہٕ_بَغٲر موٗلہٕ_روٚستُے موٗلہٕ_روٚس موٗلہٕ_روٚژھ
मुळाचें: موٗلہٕ_دار
मुळावें: اِبتِدٲیی _شروعٲتی
मुळाव्यो: مُلہٕ_ بُنیٲدی
मुसलमानी: مَسلمانَن_ہُںٛد مُسلِم
मुसळधार: روٗدٕ_شرٛانہ
मुस्तिल्लें: مَظلوٗم_ _سِتَم_زَد
मूठ_आशिल्लें: تَھپہِ_دار
मूर्ख: بیوقوٗفچوراَحمَکباورٕ
मूर्त: جِسمٲنی_ _اِجتِمٲیی
मूळ: پَنٕنۍ مُقٲمی
मृत: موٗدمُتمۄردٕمرحوٗم
मृदुभाशी: مَٲدٕر_زَبان میوٗٹھ_وَنَن_وول زَبر_وَنَن_وول
मृदू: نَرٕم _مُلٲیِم نوزُک ٲویُل
मृद्गंध: میٚژِ_مُشٕک
मॅचींग: رَلوُن میچِنٛگ
मेंगें: وارٕوارٕ_ _ژھۄکیومُت
मेकळी: آزاد
मेकळें: نوٚن آزاد ژھوٚرُے خٲلی خٲلی_ یَلہٕ لوٚت یَلہٕ ؤسیع
मेकळो: آزادیَلہٕ
मेकळ्या_हाताचें: ؤسۍ_دِل_ بوڈ_دِلوؤل _دِل_وؤل
मेक्सिकन: میٚکسِِکَن
मेघहीण: صاف
मेजकेंच: حَدَن_منٛز_روزَن_وول
मेजपा_योग्य: گٔنٛزرَنَس_لایق
मेजपा_सारकें: گَنٛزراونَس_لایَق
मेजिनाशिल्लें: اَتوٗل_تہٕ_بے_توٗل
मेजिल्लें: گٔنٛزرِتھ
मेजी_सारक्यो: گٔنٛزرَنَس_لایق
मेजूंक_नाशिल्लें: حِسابہٕ_روٚس _گٔنٛزراونہٕ_روٚس
मेणा_सारकें: موم_ہیٛو
मेणाचें: موموٗ
मेणाभशेनचें: موم_ہیٛو
मेले_उपरांत: موٗدمُت
मेल्लें: مۄردٕ_ _نا_لایَق نَنٛگہٕ ہوٚکھمُت_ ہوٚکھ مٲرِتھ
मेल्लो: موٗدمُتمۄردٕمرحوٗم
मेळनाशिल्लें: نایاب نابوٗد _نَہ_میلوُن مُشکِل_ _ژھیٚپھ_کھیٚنہٕ_وول
मेळयल्लें: قٲبلہِ_حٔصوٗل
मेळयिल्लें: زیٖوٗنمُت _کَموومُت اَدا_کوٚرمُت دِنہٕ_آمُت
मेळविरयत: ہِشرِ_وَرٲے
मेळिल्लें: حٲصِل مِلمِش _رَلٲوِتھ _مِلٲوِتھ بَرامَد
मेळोवन_दिल्लें: مۄیثر موہِیا _دٔستِیاب
मेळोवप: ترٲوِتھ_ _رَلٲوِتھ
मेळोवपी: حٲصِل_کَرَن_وول_ _لَبَن_وول
मैत्री: دوستانہٕ
मैथिली: میتھلی
मैदानी: بالٲیی _پہٲڑی مٲدٲنۍ
मॉरिटानियायी: مورِٹانِیاہُک مورِٹانِیَن
मॉरेशीयी: موریشَسُک
मोखप: زخمی
मोगभरीत: حدٕ_روٚس بےٚ_شُمار
मोगाचें: خانہٕ_مول لولہٕ_بوٚرُتھ
मोगाळ: مایہِ_بوٚرُتھ _لولہٕ_بوٚرُتھ _محبتی _شَفکٔتی
मोगासक्त: دیوانہٕ_ _فِدٲے
मोगी: عاشِق
मोटे: بوٚڈ
मोटें: زُیٹھ_ بوٚڈ زُیٹھ_ بوٚڈ ویوٚٹھ ویٚوٹھ_پوٗٹھ بوٚڑ
मोटो: ویوٚٹھہُنیومُت
मोड: طوٗفان
मोडकी: کھٹارٕ
मोडकें: پُھٹمُت خَستہٕ_حال_ _پُھٹمُت
मोडको: ٹھٕنٛگنہٕ_ لۄکُٹ_ گُٹھکہٕ
मोडण: ۂج _ہوٚل_ _ہوٚل_کوٚل
मोडणाचें: موڈ_دار_ _ہوٚل_ _وَردار موڑٕ_دار
मोडपा_सारकें: مُخالفتس_لایق
मोडवो: ٹھٕنٛگنہٕ_ لۄکُٹ_ گُٹھکہٕ
मोडिल्लें: کھستہٕ_ پیوٚمُت پُھٹمُت خَستہٕ_حال_ _پُھٹمُت
मोडूं_येत_अशें: ٲوِلۍ
मोतयाकोराचें: مۄختہٕ_ہیو_ _صاف_شفاف
मोनें: اَڑٕ_پھوٚل خاموٗش روٗزِتھ
मोनो: خاموش _ژھوٚپ_ _زیوِ_روٚس_زبٲنۍ_روٚس کوٚل
मोफत: مُفت
मोर: مورٕ_سُنٛد
मोरा_भशेनचें: مورَس_ہیوٗ مورچالہِ
मोरा_सारकें: مورَس_ہیوٗ مورچالہِ
मोराचें: مورٕ_سُنٛد مورَن_مُتعلَق
मोरेक्की: موراکوہُک
मोलादीक: بیش_قٕمتی بےٚ_مۄل
मोल्डोवायी: مولدوواہُک مولدووٲیی مولدووٲیۍ مولدووٲیی مولدووٲیۍ
मोव: نَرٕم_مِزازُک _نَرٕم نَرٕم نَرٕم _مُلٲیِم نوزُک ٲویُل نوزُک نَرٕم ٲویُل
मोव_काळजाचें: نرم_دِل _انصٲفی_ _عٲری
मोसमाभायरो: بےٚ_وَقتُک _کۄوَقتُک غٲر_معقوٗل
मोसमी: موسمہٕ_مُطٲبِق
मोहक: جٲددار میٛچھہٕ مٔدرِ خۄشوُن_ خۄش_گَوار_ اَصٕل لوٗب_وُن خۄشوٕنۍ
मोहीत: کٔشِش _رٲغِب بَد_حال_ جَزبٲتۍ
मौखीक: تَلَفُظ_کٔرمُت ہَجیہ_کورمُت
मौनव्रती: خاموشی_اِختِیار_کَرَن_وول مونی
म्यानमारी: بٔرمَنُک بٔرمی_ _بَرمی
म्हगेलो.: میونپَنُن
म्हजो: میونپَنُن
म्हत्व_नाशिल्लें: اَہمِیَت_بَغٲر_ _اَہمِیَت_روٚس
म्हत्वकांक्षा_नाशिल्लें: فَضوٗل
म्हत्वपूर्ण: اَہمِیَت_وول_ _اَہمِیَت_دار
म्हत्वहीण: اَہمِیَت_بَغٲر_ _اَہمِیَت_روٚس
म्हत्वाचें: اَہمِیَت_وول_ _اَہمِیَت_دار
म्हयनाळें: رٮ۪تُک_ ماہانہٕ_ ماہوار مَہانہ رٮ۪تہٕ_پَتہٕ_رٮ۪تہٕ_گژھَن_وول
म्हयन्याचें: ماہ_وٲری_گَژھَن_واجٕنۍ رٮ۪تُک اَکہِ_رٮ۪تُک
म्हयमावान: عظیٖم بوٚڈ ناموَر
म्हा: عٲلِم_ _ٚفٲضِل
म्हातारी: بٕڑٕ _بُزَرٕگ
म्हातारें: بُزَرٕگ _بٕڑٕ _مُعزَز
म्हान: عظیٖماَصٕلجان عٲلِم_ _ٚفٲضِل
म्हानगरीय: شہری
म्हापद्म: پَدٕم اَکھ_کاڑرِلِیَن۱٠٠٠٠٠٠٠٠٠٠٠٠٠٠٠
म्हापातकी: گوٚناہِ_کٔبیٖر_کَرَن_وول
म्हापापी: گۄناہگار گوٚناہِ_کٔبیٖر_کَرَن_وول گوٚناہِ_کٔبیٖر_کَرَن_وول
म्हाप्राण: بےٚ_پھور
म्हाबळादीक: بَہادُر_ قَداوار
म्हामुर्ख: بےٚعَقٕل_ _خَر _گوٗٹھ ناسَمَج
म्हारग: بیش_قٕمتی درٛوٚگ درٛوٚگ _قۭمتی
म्हालम्हातारी: بٕڑٕ _بُزَرٕگ
म्हालम्हातारें: بُزَرٕگ _بٕڑٕ _مُعزَز
म्हालवाहक: بور_سارَن_وول
म्हावराक: مازخور_ ماز_کھاو
म्हाविद्यालयीन: کالجَن_ہُنٛد
म्हावीर: بہودُر
म्हेळें: ناصاف _خَراب _گَنٛدٕ مٲلہٕموٚکُرگَنٛدٕناصافناپاکھ مل_دار
म्होंवाळ: موٚدُر_ _میوٗٹھ_ _سُریٖلہٕ_ _موٚدُر_حلقہٕ موٚدُر میٖٹھ موٚدُر خۄشوُن
म्होंवाळ_उलोवपी: کھۄلکی
म्होवल्याचें: گوجہِ_دار
यंत्रचलीत: میٚکینِکَل _مِشیٖنی
यजुर्वेदी: یَجُرویدُک
यजुर्वेदीक: یَجُرویدُک یَجُرویدِک
यज्ञाचें: یَگُک
यत्नशील: کوٗششہِ_وول
यमकाचें: ہَم_قٲفیہ
यमनी: یَمنُک یَمنی
यशस्वी: زینَن_وول_ _کایماب_گَژھن_وول
यहुदी: یٔہوٗدۍ_ _ہِبرٛوٗ
याचक: فٔریٲدۍ عَرض_کَرَن_وول دَرخَواست_دَنہٕ_وول
याद__नाशिल्लें: مٔشٕد_گومُت
याद_उरपा_सारकी: یادگار
यानहीण: گاڈِ_بَغٲر
यानाचेर_चडिल्लें: سَوار
यानारूड: سَوار
युगांडी: یُگینٛڑہُک_ _یُگینٛڑٲے
युगोस्लावियन: یوٗگوسٕلاوِیاہُک یوٗگوسُلٲوۍ یوٗگوسٕلاو
युनानी: یوٗنانُک یوٗنٲنۍ گریٖٖک
युरेशियायी: یوٗرایشِیاہُک پوٗرایشِیٲیۍ
येतें_वतें: دُوطرفہٕ _دُطرفانہٕ
येवंक_नाशिल्लो: نَہ_آمُت
येवंनजशा: نہ_واتن_والٮ۪ن
येवजिल्लें: منہٕ_مُطٲبِق
येवपी: یِنہٕ_وول _برٛۄنٛہہ_کُن_سَپدَن_وول
येशस्वी: کامیاب_ _کامران مشہوٗر ناو_وول_ قٲبلِ_تَوَجَہ قٲبلِ_ذِکر
योगीक: یوگاہُک
योग्य: قٲبِلہُنر_منٛدمٲہِِر مُطٲبِق _پَسَنٛد مُقرَر صحیح _ٹھیٖک لایقہِ_کار مُنٲسِبمعقوٗل قانوٗنی بہتٔریٖن_ اَفضَل_تٔریٖن ٹھیٖک_ صٔحی_ مُنٲسِب_ مُفیٖد صحیح_ _ٹھیٖک_ _دُرست صحیح خۄشگَوار مُنٲسِب ٹھیٖک اِنسانَس_خٲطرٕ_مُفیٖد معموٗل
योग्य_वेळार: وَقتاًفَوَقتاً
योजक: واٹُت
योजिल्लें: مَنٛصوٗبہٕ_دار
योजीत: مَنٛصوٗبہٕ_دار
योद्धो: بَہادُر_ دِلیر
यौगीक: مُرکب مِلہٕ_مِش
रंगकुड्डेपण: کَلَر_بٕلایِنٛڑ
रंगयाळें: رَنٛگہٕ_بہٕ_رٔنٛگی
रंगयिल्लें: روٚنٛگمُت رَنٛگ_کٔرِتھ پینٛٹ_کٔرِتھ
रंगहीण: رَنٛگہٕ_روٚستُے بےٚ_رَنٛگ_ بَد_رَنٛگ
रंगांचो: رَنٛگہٕ رَنٛگہٕ_وول رَنٛگ_بہِ_رٔنٛگی
रंगी: رَنٛگ_بِرنٛگی
रंगीत: مُختٔلِف رٔنٛگیٖن رَنٛگدار روٚنٛگمُت
रकाद_दिवपी: شیٚچھ_گوٚر قٲصِد
रकिल्लें: روٗدٕ روٗدٕ_دار
रक्तपिपासू: خوٗن_خار
रक्तबंबाळ: خوٗنہٕ_سٔرۍ _خوٗنہٕ_سٕتۍ_بٔرِتھ _خوٗنہٕ_مَہرازٕ
रक्तरंजीत: خوٗنہٕ_سٔرۍ _خوٗنہٕ_سٕتۍ_بٔرِتھ _خوٗنہٕ_مَہرازٕ
रक्तवर्णी: سۄرَکھ
रक्तहीण: خوٗنہٕ_روٚژھ
रक्ताचें: خوٗنہٕ_دار
रक्षक: رٲچھۍ_در _باڑی_گاڑ
रक्षकहीण: رٲچھدَر_بَغٲر
रगत_नाशिल्लें: خوٗنہٕ_روٚژھ
रगत_पियेवपी: خوٗن_خار
रचणार: بَناوَن_وول
रचनात्मक: تَخلیٖقی
रचिल्लें: خیٲلی _اَپُز بنیومُت
रचूंक_नाशिल्लें: نہ_بَنٲوۍ_مٕتۍ
रडकुरें: وَدٕوُن وَدوُن بومَل
रडपी: وَدوُن
रडयें: وَدوُن بومَل
रडवें: وَدٕوُن
रणवीर: بَہادُر_ دِلیر
रणशूर: بَہادُر_ دِلیر
रथहीण: رَتھہٕ_روٚس رَتھٕ_وَرٲے
रथारूढ: رَتھَس_پٮ۪ٹھ_کھوٚتمُت
रद्द: مَنٛسوٗخ_ _رَد
रबरबीत: نَرَم نَرٕم برٛسیمٕژ
रमणी: خوٗبصوٗرت حٔسیٖن
रमणीय: لُطف_اَنٛدوز
रम्य: لُطف_اَنٛدوز خوٗبصوٗرتمٲرۍ_موٚنٛد
रवथाचें: درامٕنۍ_کرن_وول
रवांडायी: رُونٛدٲیی رُونٛدٲیۍ رُونٛدَن
रवांडी: رَوَنٛڑاہُک رَوَنٛڑٲے
रवो: ویوٚٹھ
रशियन: روٗسُک_ روٗسی
रशीयन: روٗسُک
रसहीण: خۄشٕک _رَسہٕ_روٚستُے
रसात्मक: شٲعرانہٕ_ _مَنظوٗم
रसाळ: رَسدار _رَس_بوٚرُتھ
रसीक: ہۄنر_پسنٛد_ _فَن_پسنٛد رٔنٛگیٖن_مِزاز_ شوقیٖن مَستہٕ
रस्ताद: آوارٕ_ لاوٲرِث
रस्त्याचें: سَڑکہِ_ہُںٛد وَتھِ_ہُںٛد
रहस्य: رازدار پُر_اَثرار
रहस्यहीण: رازٕ_بَغٲر
रांड: مۄنٛڈ _بیوا
रांदनी_वयलें: دانس_کھولمُت
राकेसी: جِنہٕ دیٚوَن_ہٕںٛز جَنٛنَن_ہٕنٛز
राक्षसी: جِنہٕ دیٚوَن_ہٕںٛز جَنٛنَن_ہٕنٛز شیطٲنی
राखण_नाशिल्लें: رٲچھ_روٚس
राखणहीण: رٲچھدَر_بَغٲر
राखणे_बगरचें: رٲچھدَر_بَغٲر
राखीव: مَحفوٗظ_ _مَخصوٗص پَتھ_کُن_تھاونہٕ_آمُت تُلِتھ_تھاونہٕ_آمُت أتۍ_تھاونہٕ_آمُت
राखीवतेबगरचें: اَنرٕزٔروِڑ غٲر_مَحفوٗظ_شُدہ
राखूंक_नाशिल्लें: رٲچھ_روٚس
रागिश्ट: شرارتی _تیز _تُنٛد گَرَم_مِزاز روشَن_وول
राजकारणाचे: سیاسٔتی
राजकारणी: سیاسٔتی سَیٲسی
राजकी: شٲہی_ شاہانہٕ شٲہی_اَنٛدازُک
राजद्रोही: حکومتی_بٲغی
राजनितीक: سیاسٔتی
राजपूत: راج_پوٗتۍ
राजसी: شاہانہٕ بادشاہی شاہانہٕ
राजसुयी: رازسوٗے رازسوٗیِک
राजस्थानी: راجَستٲنۍ راجَستانُک
राजाहीण: لا_حکوٗمتی_ _بَد_نظٲمی
राज्य_पांवड्या_वयलें: صُوبٲیی
राज्यस्तरीय: صُوبٲیی
राज्या_विशींचें: شٲہی_ شاہانہٕ شٲہی_اَنٛدازُک
राणटी: جَنٛگلی_ وَنُک
रातकुड्डें: روت_اوٚن_دار
रातचर: روتٕلۍ _رٲژ_ہُنٛد
रातांधळें: روت_اوٚن_دار
रानटी: جنٛگلی جنگلی_ _وحشی_ _یٲگی ٹرٛک
रानवटी: جنٛگلی جنگلی_ _وحشی_ _یٲگی ٹرٛک جَنٛگلی_ وَنُک
रानवासी: بَنوٲسۍ
राबित्याचें: بٔسِتھ آباد گُلزار نَوآبٲدی کالونی_ہُنٛد
राबित्याच्यो: گَریلوٗ
रामनामी: رام_ناوُک رام_نٲمی
रामबाण: اَثَر_دار اَثَر_کَرَن_وول کار_آمَد _کار_گَر
रावपी: بٔسِتھ آباد گُلزار
राष्ट्रताये_संबंदी: قومِیَت
राष्ट्रद्रोही: گَدار_ _قومی_گَدار
राष्ट्रभक्त: دیشبَگٕت
राष्ट्रीय: قومی اَنٛدروٗنی دٲخلی قومی مُلکی
रासायनीक: کیمِیٲیی
रिकामी: ژھوٚرُے خٲلی خٲلی فرٛی
रिकामें: خٲلی_ یَلہٕ کورٕ_ خٲلی_ _سادٕ
रिकॉर्डर: رِکاڑَر
रिटायर्ड: رِٹایر
रिणा_बगरचो: خۄد_کٔفیٖل
रिणाविरयत: خۄد_کٔفیٖل
रितसर: باقٲعدٕ مُنَظم
रीण_दिवपी: وۄزُم_دِنہٕ_وول قرٕض_دِنہٕ_وول
रीणकार: قَرٕض_دار
रीतसर: شیرۍ_مٕتۍ
रुंद: کھوٚل
रुखार_रावपी: کُلِس_پٮ۪ٹھ_روزَن_وول
रुखाळ: گوٚن وارِیاہ_کُلۍ_وول
रुखावळीचें: گوٚن وارِیاہ_کُلۍ_وول
रुचीक: مَزٕدار
रुचीचें: مَزٕدار لٔزیٖز_ _مَزٕدات
रुजवणेक_घातिल्लें: لاگنہٕ_آمُت
रुजवणेचें: وَونَس_لایق
रुढ: رٮ۪وٲیتی رَسمی
रुढिवादी: دٔکِیانوٗسی _پرٛانہِ_خیالاتُک
रुपवती: خوٗبصوٗرت_ _حسیٖن
रुपांतरीत: تَبدیل_گوٚمُت
रुपेरी: رۄپہٕ_رَنٛگُک رۄپہٕ_سُںٛد
रुप्याचें: رۄپہٕ_رَنٛگُک رۄپہٕ_سُںٛد
रुसी: روٗسُک روٗسُک_ روٗسی
रूक्ष: خۄشٕکہوٚکھ مایِہ_روٚس _محبتہٕ_روٚس
रूच_नाशिल्लें: خبَر_کیُتھ _مَزٕ_بَغٲر
रूचीक: مَزٕ_دار_ لٔزیٖز_ میوٗٹھ
रूप_नाशिल्लें: بَدشکٕلبَدصوٗرَت
रॅकॉर्डर: رِکاڑَر
रेंवटाळ: سٮ۪کیُل_ سٮ۪کہِ_دار ریگِستٲنۍ_ _ریگِستانُک
रेबट: دَل_دَل_وول
रेब्याचें: رَبہِ_دار
रेशमी: ریٖشمی ریٖشمی
रेशांचें: رِکھہٕ_دار لٲنہٕ_دار
रोगाणू_जीव: بٮ۪مٲرۍ_پٲدٕ_کَرَن_وول
रोगाणूनाशक: بٮ۪مٲرۍ_دوٗر_کَرن_وول بٮ۪مٲرۍ_ژٔلراوَن_وول
रोगी: بٮ۪مارمٔریٖضدٲدۍ_لَد
रोमांचक: جوشیٖلہٕ_ _حٲرت_انٛگیز
रोमांचकारी: جوشیٖلہٕ_ _حٲرت_انٛگیز
रोमांचीत: حٲران_کُن_ _عجیٖب_وغریٖب جوشیٖلہٕ
रोयिल्लें: کاشت_کوٚرمُت
रोवूंक_नाशिल्लें: وونے_دانۍ لاگنَے
रोसाळ: رَسہٕ_دار
रोहक: کَھسَن_وول
र्निमुकूट: تاجہٕ_روٚس
लंगडें: لوٚنگ لوٚنٛگ
लंगडो: زَنٛگہِ_ژوٚٹ _نوتٕوان _لوٚنٛگ موزوٗر
लंबवत: عموٗری
लकलकीत: گاشدار صاف_ _شَفاف
लकारांती: ل_اَچَھر_وول
लक्ष: سونٛچنَس_لایَق غورکَرنَس_لایَق غورطَلب
लक्षवेदी: مَقصَد_حٲصِل_کَرَن_وول
लक्षा_वसून_पयस: وَتہِ_ڈٔلمٕتۍ وَتھ_رٲومٕژ_دار
लक्समबर्गाचें: لَکسَمبرٛگُک
लक्समबर्गी: لَکسَمبرٛگُک لَکسمبرٛگٲیۍ لَکسِمابرٛگٲیۍ
लखपती: لَکھ_پٔتۍ
लखलखपी: چَمک_دَمَک_وول چَمک_دَمَک_واجٕنۍ
लखलखीचें: چَمک_دَمَک_وول چَمک_دَمَک_واجٕنۍ
लखलखीत: چَمک_دَمَک_وول چَمک_دَمَک_واجٕنۍ
लग्न_जाल्लें: خانٛدرٕ_وول
लग्न_थरिल्लें: نِشٲنۍ_وول نِشٲنۍ_واجیٚنۍ
लग्नाचें: خانٛدَر خانٛدرَس_لایَق وٲژمٕژ نیتھرَس_لایَق
लज_नाशिल्लो: بےٚشرمبےٚ_حَیَح _بےٚ_مَنٛدَچھ
लजेची: شَرَم_ناک
लजेस्त: حیح_منٛد مَںٛدچھِٕ_ہوٚت حیح_مَنٛد
लज्जीत: مَنٛدچھومُت
लटकें: اَپُزغلط بےٚ_بُنِیاد _غَلَط بَناؤٹی ژھوٚرُے
लटको: بَدماشلَفَنٛگہٕذٔلیٖلکٔمیٖنہٕکھوٚر مکار _اَپٕزیور
लठ्ठ: ویوٚٹھ ویٚوٹھ_پوٗٹھ
लडकें: کھوٚٹ_ _نَقلی_ جٲلی_ فَرضی
लडायेचीं: جَنٛگی
लडावू: جَنٛگی
लढाऊ: بَہادُر_ دِلیر
लफड्याचें: کھۄشکٮ۪ت_دار وَرٕ_دار تَفریٖق_دار
लवचीक: نَرٕم
लश्करी: فوجُک
लस्करी: فوجُک
लांकडाचें: لٔکرِیو لٔکرِ_ہُنٛد ہَچوٗ ہَچہٕ_ہُنٛد
लांचखोर: رِشوَت_کھۄر
लांडें: لٔٹۍژوٚٹ لٔچھِِ_روٚس پَکھو_روٚس_ _پَکھٕ_ژٔٹ
लांब: زیٖٹھ زیوٗٹھ_ بوٚڈ
लांब-रुंद: زیٖٹھ
लांब_काळाचें: پوشوُن
लांबोडी: تھوٚد تَھدِ_قَدُکھ
लाओ: لااوزَبانہِ_ہُنٛد لااووُک
लाओशियन: لااووُک
लाख: لَچھ
लाखांनीं: لَچہٕ_وادٕ
लाखाचें: لَچھ_رۄپیَن_ہُںٛد اَکہِ_لَچھِچۍ
लाखाधीश: لَکھ_پٔتۍ
लाखावें: لٔچھِم
लागचें: قریٖبی _نَزدیٖکی
लागपी: مِہیٖن ٲوِج
लागवडीचें: وۄپداو
लागशिल्लें: نَزدیٖکُک
लागिल्लें: لٲگِتھ لاگنہٕ_آمُت
लागीं_आयिल्लें: نَکھہٕ_آمُت نَکھہٕ نَزدیٖق_آمُت
लागीं_वचपी: نَذدیٖق_پَکَن_وول برۄنٛہہ_پَکَن_وول
लागींचे: نَزدیٖک
लागींचें: قریٖبی _نَزدیٖکی نَزدیٖکی
लागू: لاگوٗ عٲیِد
लाचार: لاچار بےبَس بےٚ_بَس_ مَجبوٗر_ _لاچار
लाजरें: حیح_منٛد
लाडाचें: خانہٕ_مول
लातवियायी: لیٹوِیاہُک لیٹوِیٲیۍ لیٹوِیَن لیٚٹوِیَن لیٹوِیٲیۍ
लाथाळ: لَتَل لَتھ_کَڑَن_وول
लाब_कमवपी: نَفاہ_کھٮ۪نہِٕ_وول نَفاہ_خور
लाब_खावपी: نَفاہ_کھٮ۪نہِٕ_وول نَفاہ_خور
लाबदिणें: مُفید فٲیدٕمَنٛد پَھل_دار_ _میوٕ_دار_ _نفع_دار
लाभहीण: نَفہ_روٚژھ_ _فٲیدٕ_روٚژھ
लाभार्थी: مُستٔفید
लायक: قٲبِل_ _لایق
लायिल्लें: لاگوٗ عٲیِد لٲگِتھ لاگنہٕ_آمُت
लाल: وۄزُل _سۄرَخ
लावण्यवती: خوٗبصوٗرت حٔسیٖن
लाशिल्लें: دوٚدمُت
लाशें_आशिल्लें: دٲغی_ _داغ_دار
लाशें_पडिल्लो: داغہٕ_دار_ دَبہٕ_دار
लाशेल्लें: دٲغی_ _داغ_دار
लाशेल्लो: داغہٕ_دار_ دَبہٕ_دار
लिंगीक: جِنسی
लिकलिकपी: پرٛزَلوُن چَمَکوُن نَپہٕ_نَپہٕ_کَروُن
लिकलिकीत: چَمَکدارچَمکیٖلہٕزٕژٕدار
लिकलीकपी: چَمکیٖلہٕ _چَمَکوُن _زٕژٕدار
लिखीत: لیٚکھِت لیٖکھِتھ _لیوٚکھمُت کاغزی
लिथुनियायी: لِتھوٗنِیاہُک لِتھوٗنِیَن لِتھوٗنیٲیۍ لِتھوۭٲنۍ لِتھوینِیَن
लिपयिल्लें: ژوٗرِ_تھوٚومُت _کٔھٹِتھ_تھوٚومُت کھٔٹِتھ چُھپِتھ
लिबियायी: لِبیاہُک_ _لِبیٲی
लिबेरियायी: لِبٔرِیاہُک_ _لِبرٔریٲے
लुकसाणदिणें: مُزِر نۄقصان_دِہ
लुकसाणाचें: مِسمار_کٔرِتھ
लुकसाणीचें: مُزِر نۄقصان_دِہ
लुकसाणीचो: نَفہ_روٚژھ_ _فٲیدٕ_روٚژھ
लुटिल्लें: لوٗٹِتھ ژوٗرِ_نِمُت لوٗٹمُت تَھپہِ_نیومُت
लुडबें: اَڈٕ_کوٚل
लुप्त: نابوٗد _غٲب
लुळो: ہوٚل_کوٚل _اتھٕ_ژوٚت_ نَرِ_ژوٚٹ
लुळोपांगळो: نوتوان _موزوٗر _اَڑلیوٚک
लेंवाळ: ییٛرٕدار
लेथोसी: لِسوتھوہُک لِسوتھی لِسوتھۍ لِسوتھوہَس_مُتعلِق
लेबनानी: لیبنانُک لیٚبنٲنۍ
लेबनीज: لیبنانُک لیٚبنٲنۍ
लेबनीस: لیبنانُک لیٚبنٲنۍ
लेबलाचें: لیبلہِ_وول نِشان_وول
लेबली: لیبلہِ_وول نِشان_وول
लेव: چھوٚت_ _ہلکہٕ
लेव_हळडुवें: لیٚدُرزرٕد
लैंगीक: جِنسی
लोक: ضِلعی ضِلعُک
लोककल्याणकारी: اِنسان_دوست بَشَر_دوست
लोकचर्चीत: ناموَر مَشوٗر
लोकतंत्रीक: جمہوٗرِی_ _عوٲمی_حکوٗمت
लोकप्रीय: لُکَن_ہُنٛد_پَسَنٛدیٖدٕ
लोकमान्य: لُکَن_ہُنٛد_پَسَنٛدیٖدٕ
लोकरी: ییرُو
लोकशायी: جمہوٗرِی_ _عوٲمی_حکوٗمت
लोकशायेचें: جمہوٗری
लोकांचें: ضِلعی ضِلعُک
लोकांमुखी: بوزنہٕ_آمٕژ
लोकांमोगाळ: لُکَن_ہُنٛد_پَسَنٛدیٖدٕ
लोकांमौखीक: بوزنہٕ_آمٕژ
लोकाचें: وۄپَر غیر
लोकोपयोगी: اِنسان_دوس
लोकोपेगी: اِنسان_دوس
लोखंडाचें: شیٚشتٕروٗ
लोखंडी: شیٚشتٕروٗ
लोणयाचें: تھَنہِ_دار
लोभी: خۄدغرَض_ غَرَض_اوٚن مطلٔبی یٔڈَل
लोळकें: مٲلہٕموٚکُرگَنٛدٕناصافناپاکھ مَل_خۄر
लोळिल्लें: مٲلہٕموٚکُرگَنٛدٕناصافناپاکھ
ल्हव: لوٚتہلکہٕ
ल्हव_ल्हव: کملوٚتوارٕ_وارٕ
ल्हवपीक: لوٚت
ल्हान: کم_پایہِ_ _ؤسۍ_پایہِ کوٗنس_ لۄکُٹ معصوٗم کوٗنس لَکُٹ ژھوٚٹ لۄکُٹ پیونٛت لۄکُٹ
ल्हान-सान: لۄکٕٹۍ_مۄکٕٹۍ _ہَلکہٕ_پُھلکہٕ _کینٛہہ_کینٛہہ _تھوڑا_بُہوٚت
ल्हान_ल्हान: لۄکُٹ_لۄکُٹ
ल्हान_व्हड: لۄکُٹ_مۄکُٹ معموٗلی عام
ल्हानशें: پِنٛتہٕ_کَلہٕ_ پینٛتہٕ_کَلہٕ_ _پِتہٕ_کَلہٕ
ल्हारांचो: لہرِدار
वंगाळ: ژھوٚٹ_تہٕ_موٚٹ
वंचीत: محروٗم_ _نۄقصان_دیٚہہ_ _مفادَس_خلاف
वंदनीय: نَمنَس_لایق عزتَس_لایَق
वंशावळीचें: خانٛدٲنی
वक्र: بےٚ_ڈول
वखदी: دوا
वचनबद्ध: قسم_بد
वजन_काडिल्लें: میٛوٗنمُت
वजन_केल्लें: میٛوٗنمُت
वजनदार: گوٚبوَزَندار
वजनी: وَزَن_دار وَزنی
वट्ट: سروٗنٛٹُے_ _سورُے_ _پوٗرِ_پوٗر_ _ثوبوٗت سورُے سٲری سٲلِم
वणखल्लें: لر_ترٲوِتھ
वनवासी: بَنوٲسۍ
वनस्पतीहीण: کُلۍ_کَٹٮ۪و_روٚستُے
वयर_आयिल्लो: کھوٚتمُت
वयर_दिल्लो: پٮ۪ٹھ_کَنِہ_دِنہٕ_آمُت _پٮ۪ٹھ_کَنِہ_ذِکٔر_کَرنہٕ__آمُت
वयरचो: پیٚٹھیُم ہیٚریُم
वयरसकयल: ہیوٚر_بۄن
वयले: اَصٕل _تھوٚد
वयलें: تھوٚد نٔیبٕرۍ
वयलो: پٮ۪ٹھ_کَنِہ_دِنہٕ_آمُت _پٮ۪ٹھ_کَنِہ_ذِکٔر_کَرنہٕ__آمُت پیٚٹھیُم ہیٚریُم
वयलो_सूर: باردار
वयल्या_कुळांतलें: خاندانۍ
वयल्या_कुळांतलो: تھَدِ_قٔبیٖلُک
वयल्याचाराचें: مایِہ_روٚس _محبتہٕ_روٚس
वयल्यावयलें: بَناؤٹی
वयस्क: بالیغ _جوان
वयार_आयिल्लें: بالغ جَوان
वरिश्ठ: بُزَرٕگ _بٕڑٕ _مُعزَز زُیٹھ
वरी: ہیو یُتھ_ یُتھٕے
वर्ग: پانَس_بَرابَر
वर्गाकार: ژُکوٗنٛجَل
वर्गी: طبقُک درجُک زۭٲژ_ہُںٛد
वर्जिल्लें: ترٛٲومٕژ
वर्जीत: ٹھاکھ _مَنَہہ
वर्ज्य: ٹھاکھ _مَنَہہ
वर्णना_बगरचें: وَننَے
वर्णनीय: تفصیلَس_لایق _تَٚصیٖلی
वर्णी: رَنٛگ_بِرنٛگی
वर्णीत: بَیان_کٔرنہٕ_آمُت زِکر_کَرنہ_آمُت
वर्तमान: موجوٗدٕ_وَقت اَزکال _موجوٗد_زَمانہٕ
वर्तमान_काळ: موجوٗدٕ _حالٕے
वर्तमानपत्राचें: اَخبٲرۍ
वर्तमानपत्री: اَخبٲرۍ
वर्सभराच्यो: صدابہار
वर्साचें: ؤرِش وٕہُر
वर्सुकी: اَکہِ_ؤرِیُک
वर्सुकें: سالانہٕ
वलें: اوٚدُر
वळखीचें: وٲقِف زٲنۍ_یاب
वळखीचो: زٲنۍ_کار
वळखुपा_सारकें: پِرزٕناونَس_لایَق
वळणाचें: موڈ_دار_ _ہوٚل_ _وَردار موڑٕ_دار
वळेरीत: لِسٹُک فہرستُک
वळेरेंत: لَگاتار_ _مُسَلسَل
वश_केला_असो: قوبوٗوَس_منٛز
वशिल्लें: بٔسِتھ آباد گُلزار
वशीकरण: پانَس_کُن_کَرَن_وول
वशीकृत: قوبوٗ_کَرنہٕ_آمُت کاژِ_رَٹنہٕ_آمُت اِختیارَس_مَںٛز_اَنٛنہٕ_آمُت
वसंत_काळाचें: بہارُک _رٮ۪تہٕ_کالیُک
वसंतकाळीन: بہارُک _رٮ۪تہٕ_کالیُک
वसणुकेचें: نَوآبٲدی کالونی_ہُنٛد رِہٲیشی
वसतीघरवासी: ہوسٹَلَس_منٛز_زوزَن_وول
वसाड: وٕجارٕ _غیر_آباد بَنٛجَر ناکٲبلِ_کاشت وٲراگ وٲٔران ویٖران
वसुलेचें: ؤصوٗل_کوٚرمُت
वस्तुनिश्ठ: مٲدی _خٲرجی
वांकडें: ۂج ٹیوٚٹھ_ _ٹیچَھر ہوٚل
वांकडो: ۂج _ہوٚل_ _ہوٚل_کوٚل
वांकडो-तिकडो: ۂج _ہوٚل_ _ہوٚل_کوٚل
वांकिल्लें: ہوٚل
वांगडी_आशिल्लो: رٔسوٗک_وول
वांगडें: بےٚ_ڈول
वांझ: ہانٛٹھ
वांटील्लें: تقسیٖم_کَرنہٕ_آمُت بٲگرَنہٕ_آمُت بٲگراونہٕ_آمُت باگنَے_کَرنہٕ_آمُت
वांटेकार: شٲمل
वांयगण: اَگہَنُک
वांयग्या_कोराचें: وانٛگٕنۍ لاجوٲرۍ
वाकडें: جُکِتھ _نٔمِتھ _رٲغِب کوٚب_دار _بَٹھٕدار
वाकड्या_नाकाचें: ۂجۍ_نَس_وول ۂجۍ_نَستہِ_وول
वाकिल्लें: بروٚنٛکُن_جُکِتھ
वाक्चतूर: مٔدٕرِ_زَبانِہِ_وول _میٖٹھ_زَبانہِ_وول
वाक्प्रचारांनी_भरिल्लें: محاورٕ_دار محارٕوول
वाचक: خبری خبردِنہٕ_وول شیٚچھ_وَنن_وول شیٚچھ_دِنہٕ_وول
वाचपा_योग्य: وۄتُھن_ _پَرنَس_لایق_ قٲبلہِ_فہم
वाचपा_सारकें: وۄتُھن_ _پَرنَس_لایق_ قٲبلہِ_فہم
वाचपायोग्य: پَرنَس_لایق
वाचयिल्लें: سوٚمبروومُت _جَمع_کوٚرمُت _أتھۍ_تھوٚومُت
वाचाळ: کَتھَل _بَکوٲسۍ کَتھَن_ہُںٛد_مَزٕ_تُلَن_وول
वाचिल्लें: پوٚرمُت
वाचिल्लो: پوٚرمُت
वाचीक: پَرنَس_لایق
वाच्यनीय: وۄتُھن_ _پَرنَس_لایق_ قٲبلہِ_فہم
वाट_पळोवपी: پرٛارَن_وول اِنتِظار_کَرَن_وول مُنٛتَظِر
वाटकुळें: گول گول
वाटाण्यांचें: مَٹَروول مَٹردار
वाटायिल्लें: سوٚمبروومُت _جَمع_کوٚرمُت _أتھۍ_تھوٚومُت
वाठारी: علاقٲی
वाड_जावपी: بَڑوُن کھسہٕ_وُن
वाडपी: بَڑوُن کھسہٕ_وُن
वाडयिल्ली: بڑوومُت_ _بوٚڑ
वाडयिल्लें: وٮ۪ژھنے_کٔرمٕژ
वाडिल्लें: بالغ جَوان درۄجر
वाडोवपी: بَڑاوَن_وول_ حِمایَت_کَرَن_وول
वातड: دوٚر_ _سخت دوٚر سَخٕت مَضبوٗط خۄشِک_ _ہوٚکھ
वातानुकुलक: ایر_کَنڑِشنَر
वातानुकुलीत: اَیرکٔنٛڈِشنٕڑ
वातावरणाचें: موسمی
वातावरणी: موسمی
वादग्रस्त: کُھرۍلَد _خۄشکیٚتہِ_لَد تَناز_دار
वादळ: سَخٕت شدید _تیز
वादा_बगर: اِختِلاف_روٚس_ اِختِلاف_بَغٲر
वादाचें: کُھرۍلَد _خۄشکیٚتہِ_لَد تَناز_دار
वादास्पद: کُھرۍلَد _خۄشکیٚتہِ_لَد
वानप्रस्थाश्रमी: خَلوَت_نِشیٖن تَنہا تنہا_پسَںٛد
वानप्रस्थी: خَلوَت_نِشیٖن تَنہا تنہا_پسَںٛد
वानरी: وانٛدٕر
वानस्पतीक: نباتٲتی
वान्शे_विरयत: ماوضہٕ_روٚس _اَجرٕ_روٚس
वापराचें: فٲیدٕ_مَنٛد کامہِ_کار عَملی
वापरिल्लें: اِستعمال_کوٚرمُت
वाफेचें: کشیٖدٕ
वायट: بَدنِیت _کھوٚٹ_نِیَت _کھٔٹ_نِیَت مٲلہٕموٚکُرگَنٛدٕناصافناپاکھ موٚکُر _فٕضوٗل کٔمیٖنہٕ _گَنٛدٕ گِریومُت خٕلاف خَراب غَلَط_ بُرٕ دوکھہٕ_باز_ فَرٲبۍ_ جال_ساز _چالاک ہوشیار بتر _بَدتَر بِگڑیمٕژ موٚکُر گَنٛدٕ نٔجیٖس ناپاکھ
वायट_उलोवपी: ٹیٚچھہِ_زَبانہِ_وول _ترٛۄشہِ_زَبانہِ_وول
वायट_करपी: بَد بُرٕ
वायट_गूण: عٲبہٕ_لَد_ بَد_صِفَت
वायट_चिंतपी: بد_نیت_ _بَد
वायट_मार्गान_मेळयिल्लें: ہَضٕم
वायट_वेव्हारी: بَد_سَلوٗک_ بَد_تٔمیٖز
वायट_वेसनी: موٚکُر کٔمیٖنہٕ _ذٔلیٖل
वायट_सभावाचो: بَدتٔمیٖز _بَدسٔلوٗک _بےٚطور
वायटकार: بٮ۪مارمٔریٖضدٲدۍ_لَد
वायूगतिकी: طیٖرِنِیاتُک
वायेचें: بٲدی بٲدی ہوٲیی فِضٲیی
वारें_घोळपी: ہَوادار
वार्‍याचें: ہوٲیی فِضٲیی
वावटळ: سَخٕت شدید _تیز
वावडी: اَفواہ_واجِنۍ
वासनाहीण: پاک
वासाचें: خُۄشبودار _مٕشک_دار_ خۄش_گُوار
वास्तवीक: صٔحی_ اَصلی_
वास्तुशिल्पीय: تٔعمیٖرٲتی
वाहक: رَگِدار سارَن_وول سارَن_وول کَنٛڑَکٹَر
वाहनाचें: گاڑِ_ہُںٛد
विंगडविंगड: مُختٔلِف _قٕسٕم_وار
विकत_हाडिल्लें: ہیوٚتمُت
विकतें_घेतिल्लें: ہیوٚتمُت
विकपाच्यो: کٕننہٕ_خٲطرٕ _کٕنَس_لایق_ _کٕنُن_کِیُتھ
विकल्पी: اِختِیارٲتی
विकसीत: ترقی_یافت تَرقی_یافتہٕ
विकासकर्तो: تَرقی_کَرَن_وول
विकासशील: تَرقی_پَسَنٛد
विकिल्लें: کُنمُت ہیوٚتمُت
विकृत: _خراب بِگڑیومُت_ _اَبتَر
विक्रमी: بہادُر ہٮ۪متہٕ_وول بَہرَن_وول بہَروُن دِلیر دِلاوَر
विक्राळ: خوٗن_خارخطر_ناکھکھوژٕوُن
विक्रेच्यो: کٕننہٕ_خٲطرٕ _کٕنَس_لایق_ _کٕنُن_کِیُتھ
विखंडी: زٕ_حِصہٕ_کَرَن_وول
विखा_बगर: زَہرٕ_روٚس_ زَہرٕ_بَغٲر
विखाचें: زہریٖلہٕ_ زَہرٕ_دار
विखारी: زہریٖلہٕ_ زَہرٕ_دار زہریٖلہ زہردار زہربوٚرُتھ زَہریٖلہٕ
विखाळ: زہریٖلہٕ_ زَہرٕ_دار زہریٖلہ زہردار زہربوٚرُتھ زَہریٖلہٕ
विख्यात: مشہوٗر ناووَر نامچیٖن
विचलीत: بےٚقرار
विचार_करपाचें: سونٛچنس_لایق سرنَس_لایق
विचार_केल्लें: سوٗنٛچِتھ_سَمجتھ _غوروفِکِر_کٔرِتھ
विचार_जाल्लें: سوٗنٛچِتھ_سَمجتھ _غوروفِکِر_کٔرِتھ
विचारवंत: سونٛچَن_سَمَج__وول_ سٔنٛجیٖدٕ
विचारशील: سونٛچَن_سَمَج__وول_ سٔنٛجیٖدٕ غورٕ_کوٚرمُت
विचारशुन्य: مَشوَر_کَرنے_ _مَشوَر_روٚس
विचारहीण: مَشوَر_کَرنے_ _مَشوَر_روٚس
विचारी: سونٛچنس_لایق سرنَس_لایق
विचारीक: خَیالہٕ_بوٚرُتھ خَیالَتَو_سۭتۍ_بٔرِتھ سونٛچَن_سَمَج__وول_ سٔنٛجیٖدٕ خیٲلی_ _خیالُک_ _خیالن_ہُنٛد_ _خیالن_مُتلِق
विचित्र: بَدلٕے _بَناوٹی _نَقلی عٔجیٖب غٲر_مٔعموٗلی
विजयी: کامیاب_ _کامران
विजातीय: پَرذٲژ
विजेचें: برقی اِلیٚکٹرانِک
विजेवरी: چَمک_وُن
विज्ञानीक: ساینَسی
विटिल्लें: تنگ_آمُت_ _تنگ_گوٚمُت_ _بیزار_ _پریشان_ _جیرٕ_آمُت
वितरायिल्लें: نشٕرکرنہٕ_آمُت
विदुशी: ٹھوٚر_اَنَن_وول رُکاوَٹ_اَنَن_وول رُکاوَٹھ_اَنَن_وول خَلَل_ترٛاوَن_وول تھۄتھ_اَنن_وول پریشان_کَرن_وول
विदेशी: غیر_مُلکی نیٚبرِم_ پَر_مٕلکُک
विद्यालयीन: مَدرَسُکھ _مَدرَسُک
विद्रूप: بَدشکٕلبَدصوٗرَت _خراب بِگڑیومُت_ _اَبتَر
विद्वत्तापूर्ण: عٲلمانہٕ
विद्वाटें: پاگل
विद्वान: عٲلِم
विधवा: مۄنٛڈ _بیوا
विधानीक: قانوٗن_سٲزی
विधिचें: قانوٗنی
विधीलिखीत: قٕسمَتہٕ_مُطٲبِق
विध्वंशी: تباہ_کَرن_وول
विनम्र: نرمی_ نرم_مزازٕ_ _نرم_طبیعت _حلیٖم_ _نرم_ ندامت شریٖف_ _نرم_ _حلیٖم
विनयशील: تیز_مزازِ_ _تیز
विनयी: ایمانٛداررُت
विनवणेचें: أپیٖلہِ_دار
विनाकारण: بِلا_وَجَہہ
विनाशक: ناش_کَرَن_وول کیٚمٮ۪ن_مارَن_وول تَباہ_کَرَن_وول
विनाशी: ناش_کَرَن_وول کیٚمٮ۪ن_مارَن_وول تَباہ_کَرَن_وول
विनिमयीत: اَدلہٕ_بَدلی مُبٲدلٲتی
विनोदी: اَسوُنمَزاکِیہٹھَٹھہٕ_گوٚرمَسکھَر مَزاقِیہ_ مَزاق_دار اَسَن_دار
विपक्षी: مُخٲلِف
विपक्षीय: مُخٲلِف
विभागणी: بٲگرِتھ
विभागी: علاقٲی مَحکمُک
विभाजक: تقسیمی
विभुशीत: عِزَت_یافتہٕ _خٕطاب_یافتہٕ پٲرٲوِتھ _سَجٲوِتھ
विमूख: وَتہِ_ڈٔلمٕتۍ وَتھ_رٲومٕژ_دار
विमोकर्तो: بیٖمہٕ_کَرَن_وول
वियेतनामी: وِیَتنامُک وِیتنٲمۍ وِیَتنٲمۍ وِیَتنٲمی ویَتنٲمیٖز وِیَتنٲمیٖس
वियोगी: ژھیٚنہٕ_گوٚمُت جُدا_گوٚمُت روومُت ویٚروٚس
विरक्त: فَنافی_اللہ_ _سٔنۍیٲس_ خۄدا_دوس
विरगळपी: گَلَن_وٲلۍ _پِگلَن_وٲلۍ
विरनाशें: ثوبوٗت _نَہ_حَل_گَژَھن_وٲلۍ
विरनासपी: ثوبوٗت _نَہ_حَل_گَژَھن_وٲلۍ
विरपी: گَلَن_وول
विरळ: توٚن کانٛہہ_کانٛہہ_ اَکھ_زٕ
विरहिणी: اَلگ_گٔمٕژ
विरही: ژھیٚنہٕ_گوٚمُت جُدا_گوٚمُت روومُت ویٚروٚس
विरहीण: بہادُرو_روٚس ہٮ۪متہِ_والٮ۪و_روٚستُے دِلیرو_روٚستُے
विरुद्ध: پھِرِتھ_ _اُلٹہٕ مُخٲلِف_ _اُلٹہٕ_ _اَدلہٕ_بَدل_ _مُخٲلِف
विरुध्दार्थी: ضد
विरूपाक्ष: خوٚناکھ_أچھۍ_وول
विरोधा_बगरचें: مُخالفَت_روٚس
विरोधा_बवगरचें: بِلا_اِختِلاف
विरोधा_विणें: بِلا_اِختِلاف
विरोधी: مُخٲلِفانہٕ تضادٕ_وول مُخٲلِف مُقٲبٕلۍ
विरोधी_अर्थी: ضد
विरोधी_पक्ष: مُخٲلِف
विरोधीत: مُخٲلفت_کَرنہٕ_آمُت
विलक्षण: عٔجیٖب غٲر_مٔعموٗلی
विलासी: کامہِ_کار _کار_کُن عَیاش_ _شوقیٖن_
विलीन: کٔھٹِتھ _چُھپِِتھ
विवरणात्मक: بَیٲنی وَضاحٔتی
विवश: بےٚ_بَس_ مَجبوٗر_ _لاچار
विवादास्पद: کُھرۍلَد _خۄشکیٚتہِ_لَد
विवाहीत: خانٛدرٕ_وول
विवीध: واریاہ _بِسِیار
विवेकी: دانہہ
विशम: طاق
विशयाच्यो: مَضموٗنَس_مُتعلِق
विशाचें: زہریٖلہٕ_ زَہرٕ_دار
विशाणूंचें: وَایِرَل
विशारी: زہریٖلہٕ_ زَہرٕ_دار زہریٖلہ زہردار زہربوٚرُتھ زَہریٖلہٕ
विशाळ: بوٚڈ_ عٔظیٖم واریاہ_کُشادٕ شانٛدار_ _عظیٖم_ _عٲلی_شان بوٚڈ
विशाळकाय: وۄتھوُن _ڑۭس
विशीं: مُطَلِق
विशुववृत्ती: خطِ_استواہُک
विशेक: لَگ_بَگ_وُہ
विशेश: خاص خاص مَخصوٗص
विशेशज्ञ: مٲہِر
विश्वविजेतो: دُنِیاہ_زینَن_وول
विश्वव्यापी: عالمی
विश्वासघातकी: لا_خٲر_ _گدار _بے_وفا
विश्वासी: بَروسہٕ_کرن_وول _پَژھ_کَرَن_وول
विश्वीक: کُلِ_دُنیاہُک_ _کُلِ_جہانُک_ _کُلِ_کایناتُک
विसंगत: غلط
विसरपी: مَشرَفہٕ_وول
विसरभोळें: مَشرَفہٕ_وول
विसराळू: مَشرَفہٕ_وول
विसरिल्लें: مٔشٕد_گومُت
विसवदिणी: آرام_دِہ سۄکھ_واتناوَن_وول
विसावो: _وُہِیُٛم
विस्कळ: توٚن
विस्कळीत: وٲران دُوٗنٛژھرٲوۍ_مٕتۍ بےٚ_تَرتیٖب _تَرتیٖبہِ_روٚس
विस्तारीत: وَٮ۪ژھنٲوِتھ وَضاحَت_کٔرتھ ؤسعی زیوٗٹھ بوٚڈ وٮ۪ژھنے_کٔرمٕژ
विस्तीर्ण: پھۄلٲوِتھ
विस्थापीत: دُوٗنٛژھرٲوۍ_مٕتۍ
विस्फारीत: ؤژھمٕژو
विस्वासघातकी: دوکھہٕ_باز_ فَرٲبۍ_ جال_ساز _چالاک ہوشیار
विस्वासू: بروسہٕ_منٛ _ایٖماندار
विहीत: با_قٲیدٕ
वीख_काडिल्लें: زہرِ_روٚس زَہرٕ_بَغٲر زہرٕ_وَرٲے زہرٕ_روٚستٕے
वीख_ना_केल्लें: زہرِ_روٚس زَہرٕ_بَغٲر زہرٕ_وَرٲے زہرٕ_روٚستٕے
वीर: بہادُر_ حوصلہٕ_منٛد_ _دِلیر_ _ہمتہِ_وول سَرفروش_ _جان_نِثار جانٛباز
वीरतायेचें: جُرَت_مَنٛد
वीस: وُہہ_ ۲٠
वेंचणूक: چُنٲوی
वेंचपा_सारकें: ژارنَس_لایق
वेंचिल्ली: مُقرَر
वेंचिल्लें: چھونٛٹمُت ژٲرِتھ چُنمُت منتخب
वेंचून_काडिल्लें: منتخب
वेगळी: بَدلٕے _بَناوٹی _نَقلی اَسور یَتھ_نہٕ_اَتھٕ_آسہِ_لوٚگمُت
वेगळे: مُختٔلِف_ بر_عکس
वेगळें: پھِرِتھ_ _اُلٹہٕ الگ_ _بیوٚن
वेगळेंवेगळें: مُختٔلِف _قٕسٕم_وار
वेगवान: تیز
वेगवेगळें: مُختٔلِف _قٕسٕم_وار
वेगहीण: بِہِت_گٔمٕژ _رُکِتھ
वेगाचे: زورٕدار
वेगाचें: پَکوُن _چَلوُن طوٗفانُک تیز فوری دٔستی
वेगान: تیز
वेतना_विणें: تَنخاہ_روٚس _نَنخاہ_بَغٲر
वेदज्ञ: مٲہرِ_ویدا
वेदतज्ञ: مٲہرِ_ویدا
वेदपंडीत: مٲہرِ_ویدا
वेदशास्त्री: مٲہرِ_ویدا
वेदांचें: وید
वेदीक: وید
वेदीचें: سِٹیجُک
वेधप: زخمی
वेनिजुएला: ویٚنِزِیوٗلاہُک ویٚنِزِیوٗلَن
वेपाराचें: تِجٲرتی
वेपारीक: تِجٲرتی
वेर्थ: ناکام_ _ناکامیاب
वेलापवर्ती: سوٚدرُک
वेळ_पाळपी: وَقتُک_پابَنٛد
वेळ_पाळिनासपी: لیٹ_لٔطیف
वेळार: وَقتاًفَوَقتاً
वेवसायाचें: تِجٲرتی
वेवसायीक: تِجٲرتی
वेवस्थीत: شیرۍ_مٕتۍ باقٲعدٕ مُنَظم قٲیدٕ_بَنٛد صحیح محفوٗظ
वेव्हारी: رُت_خۄلقہٕ_وول سخت_ _روب_داب کامہِ_کار عَملی
वेश्टिल्लो: ؤلِتھ
वेश्यागामी: عَیاش
वेसनी: موٚکُر کٔمیٖنہٕ _ذٔلیٖل
वैचारीक: خَیالہٕ_بوٚرُتھ خَیالَتَو_سۭتۍ_بٔرِتھ سونٛچَن_سَمَج__وول_ سٔنٛجیٖدٕ خیٲلی_ _خیالُک_ _خیالن_ہُنٛد_ _خیالن_مُتلِق
वैतनीक: تَنٛخہ_دار
वैभवशाली: أمیٖررۄپیہِ_وولسَرمایہِ_دار
वैयक्तीक: ذٲتی _پَنُن
वैरपणाचो: دُشمندٲری _زِدٕدٲری
वैरी: دُشمَنَو_ہوٚت
वैश्वीक: کُلِ_دُنیاہُک_ _کُلِ_جہانُک_ _کُلِ_کایناتُک
वोल्ताचें: موڈ_دار_ _ہوٚل_ _وَردار
व्यंगात्मक: طنٛزِیٲیی
व्यंगीक: طنٛزِیٲیی
व्यक्त: اِظہار_ _ظٲہِر _ونُن _بولُن واضح _صاف
व्यक्तीगत: ذٲتی _پَنُن
व्यभिचारी: بَد_چَلَن_ _بَد_کِردار_ بَد_ذات_ کٔمیٖنہٕ بَد_کِردار_ _بَدذات
व्यर्थ: ناکام_ _ناکامیاب فضوٗل بےٚکار زایہِ
व्यस्त: آوُر_ _مصروٗف
व्याकरणाचें: گرامرٕچ _نحوی
व्याकरणीक: گرامرٕچ _نحوی
व्याकूळ: بےٚ_قَرار_ بےٚ_چین_ _بےٚ_تاب
व्याख्या_केल्ल्यो: واضح_کوٚرمُت
व्यापक: پھۄلٲوِتھ
व्याप्त: پھۄلیمٕتۍ
व्यायामी: وَرزِشی وَرزِشی کَسرٔتۍ
व्युत्पन्न: درامُتنیرُن
व्रतगामी: وَرتھَس_مَںٛزجِنسی_تعلُقات_تھاوَن_وول
व्हगडायिल्लें: ضایہِ_ _برباد_ _فضوٗل
व्हड: عظیٖماَصٕلجان بوٚڈ_ عٔظیٖم زیٖٹھ زُیٹھ_ بوٚڈ زُیٹھ_ بوٚڈ شانٛدار_ _عظیٖم_ _عٲلی_شان بوٚڈ بوٚڑ
व्हड-मनाचो: ؤسعی_دِل_ فَراخ_دِل
व्हड_आंकडो: زیادٕ_ _بٔیسیارٕ_ گُتُل
व्हड_कानाचें: بوٚڑ_کَنہٕ_وول زیٖٹھ_کَن_وول
व्हड_काळजाचो: ؤسعی_دِل_ فَراخ_دِل
व्हड_नाकाचें: بوٚڑ_نَستہِ_وول نَستہِ_بوٚڑ
व्हडली: بٔڑ_بارٕ
व्हडलें: زُیٹھ_ بوٚڈ زُیٹھ_ بوٚڈ بوٚڈ
व्हड्या_वयलें: ناوٕ_مَںٛز_سٲر_کَرن_وول ناوِ_سَوار
व्हरपी: سارَن_وول
व्हांवतें: ژلوُن _وَسوُن لَگاتار_ مُسَلسَل
व्हांवपी: ژلوُن _وَسوُن
शंकू: شَنکھ ہَتھ_کاڑرِلِیَن ۱٠٠٠٠٠٠٠٠٠٠٠٠٠٠٠٠٠
शंखाचो: پوگَن_ہُںٛد
शंख्वाकार: کوٗنَل تِکوٗنَل
शंग्रह_करी_सारक्यो: سوٚمبراونَس_لایَق جَمع_کَرنَس_لایَق ترتیٖب_دِنَس_لایَق
शंढ: نامَرٕد
शंबर: ہَتھ_ ۱٠٠
शंबरावें: ۂتیُم
शंबरेक: لَگ_بَگ_ہَتھ ہَتھَس_تام
शक्तीवर्धक: طاقتی
शक्तीहीण: کمزور
शक्य: مُمکِن
शटकोनी: شےٚ_کوٗنَل
शडश्व: شیٚھ_گُرِ_وول
शडानन: شےٚ_بُتھ_وول شےٚ_بُتھَل
शतायुशी: مٔردیادم
शतायू: ہَتھٕ_وُہَر مٔردیادم
शत्रुजीत: دُشمَنَس_مات_دِنہٕ_وول دُشمَنَس_ہارناوَن_وول
शत्रुहीण: دُشمَنَو_روٚستُے
शब्दाचें: لَفظی
शब्दाडंबराचें: اَثَردارالفاظ
शरण_आयिल्लो: پَناہ_گیٖر
शरणागत: پَناہ_گیٖر
शरणार्थी: پَناہ_گُزیٖں_ مَہاجِر رَفوٗجی
शरदाचें: ہَردُک
शरबताचें: شَربَتُک
शरीरहीण: جِسمہٕ_روٚژھ_ _جِسمہٕ_بَغٲر
शर्मेची: شَرَم_ناک
शस्त्रधारी: ۂتھِیار_بَنٛد ۂتھیاربَنٛد ہَتھیار_بَردار
शस्त्रहीन: سامانہٕ_روٚژھ
शांत: نَرٕم_مِزازُک _نَرٕم تٔمیٖزدار _سٔلیٖقہٕ_مَنٛد بوٚرُد_باراوٚب_گوٚب پُر_سٕکوٗن پُرسَکوٗن_ خاموش_ شانت شَرارتہٕ_روٚس نَرٕم_ شانَت حٔلیٖم ٹَھنٛڑٕ پُر_سٕکوٗن
शांती_आवडपी: اَمُن_پَسَنٛد
शांतीपूर्ण: اَمُن_دار
शांतीप्रीय: اَمُن_پَسَنٛد
शांयशीं: شُشیٖتھ
शांयश्यावें: شُہ_شیٖتِم
शाकभक्ष्यी: سَبزی_خور
शाकाहारी: سَبزی_خور
शाक्त: شاکت
शाखा: لَنٛجِدار شاخہٕ_دار
शाणो: دوٗر_اَنٛدیش_نظر_کَرَن_وول
शाण्णव: شُنَمَتھ
शाण्णवावें: شُنمتم
शात्तर: شُسَتَتھ
शात्तरावें: شُہ_ستتِھم
शापीत: آہہِ_سَر_میٛلیومُت _شرٛاپَل
शापोती: بَد_لِحاظ _بَد_تٔمیٖز _بَدسٔلوٗک
शाब्दीक: لَفظی
शारांतले: شہرُک
शारिकरणाचें: شہر_بَناونہٕ_آمٕتۍ
शारिरीक: جِسمہٕ_دار جِسمٲنی
शारी: شہرُک شہرُک شہری
शारीकरणी: شہر_بَناونہٕ_آمٕتۍ
शाळचें: مَدرَسُکھ _مَدرَسُک
शाश्वत: لافٲنی روزوُن _پوشوُن
शासकी: ایٚکزِ_کیوٗٹِو سَرکٲرۍ اِنتظٲمی_ _سیٲسی
शास्त्रविरूद्ध: مَزہَبَس_خِلاف
शास्त्रीय: معیٲری _کٕلاسِکَل کَلاسِکَل_ _شاسترِیِہ
शास्वत: نَہ_مِٹَن_وول
शाही: شٲہی
शिंगां_नाशिल्लें: ہٮ۪نٛگو_روٚس
शिंगाबगरचें: ہٮ۪نٛگو_روٚس
शिंदुरी: کۄنٛگہٕ_رنٛگہٕ
शिंपडिल्लें: چھٔکرِتھ _پھٲلِتھ چٔھکروومُت _پٔھہلوومُت _وَہروومُت
शिंपणेली: سَگ_دِنہٕ_وول
शिंपिल्लें: سَگنوومُت_ _سَگ_دِیُٛتمُت_ _سَگُومُت
शिंप्पी: سَگ_دِنہٕ_وول
शिंयाळें: وَنٛدُک
शिंविल्लें: سُوِتھ
शिकपी: پرن_وٲلۍ
शिकयिल्लें: پٔرۍ_مٕتۍ_لیٚکھۍ_مٕتۍ
शिकारी: شِکٲرۍ شِکٲرۍ شِکار_کَرَن_وول
शिकिल्लें: پوٚرمُت_لیوٚکھمُت اَصٕل_تَربِیَت__دار_ اَصِٕل_تَربِیَت_وول
शिक्षणीक: تٔعلیٖمی
शिक्षीत: پوٚرمُت_لیوٚکھمُت
शिजपी: گَلَن_وول
शिटूक: دوٗر_اَنٛدیش_نظر_کَرَن_وول چالاک تیز ہُشار رِنٛدٕ زِنٛدٕ_دِل حٲضِر_جواب زٔہیٖن قٲبِل دیٚماغ_دار
शिटूक.: چالاک_ _عٲقٕل__ _ذہیٖن_ __شٲطِر _تُرٛک_ _گاٹُل
शिडशिडीत: زٲویُلنیُک
शितळ: سَرٕد_ _تُرُن_ ہُنٛدُر تُرُن_سَرٕد نَرٕم_ شانَت حٔلیٖم ٹَھنٛڑٕ اَمُن_دار شُہُل
शिपायाचें: فوٗجی سِپاہ_ہیوٗ فوجی_ہیوٗ
शिफारशीत: سُفٲرِشہٕ_وول _تَجویٖز_کوٚرمُت
शिमा_रक्षक: سَرحَد_رٲچھۍ
शिमांकीत: سَرحَد_گٔنٛڈِتھ_ _سَرحَد_دار
शिमीत: گٔنٛڈِتھ محدوٗد حَدَن_منٛز_روزَن_وول
शिरंगार: سجاوٹی
शिरापीत: آہہِ_سَر_میٛلیومُت _شرٛاپَل
शिल्लक: بَقایہہ ہُریومُت_ بَچومُت_ ژَڈیومُت باقٕے_ بَقایہ
शिवनामी: شِونٲمۍ
शिवराक: مازٕ_بَغٲر سَبزی_خور
शिश्ट: تٔمیزداراَصٕلجان
शिश्टाचारी: مُہَزِب
शिस्त_नाशिल्लो: بے_اعتِدال
शिस्तवार: قٲیدٕ_قونوٗنہٕ_وول
शिस्तीची: ضَبٕطٕ_دار
शिस्तीचें: تہزیٖبی قٲیدٕ_قونوٗنہٕ_وول
शींगां_आशिल्लें: ہٮ۪نٛگَل
शीत: سَرٕد شُہُل
शीत_जेवपी: بَتہٕ_کھٮ۪نہٕ_وول
शीम_रक्षक: سَرحَد_رٲچھۍ
शीलवान: باکِردار
शुद्ध: صافشوٚد صافشوٚدپاکھ صاف شَفاف _خٲلِص
शुभ_चिंतक.: خٲرخواہ
शुल्लक: لۄکٕٹۍ_مۄکٕٹۍ _ہَلکہٕ_پُھلکہٕ _کینٛہہ_کینٛہہ _تھوڑا_بُہوٚت
शूभ: رُت نیک اِصٕل جان
शूर: بہادُر_ حوصلہٕ_منٛد_ _دِلیر_ _ہمتہِ_وول جانٛباز
शेंकड्यांनी: ہَتہٕ_بٔدۍ
शेंदुरी: سِنٛدرِ_رَنٛگُک
शेंपडेकार: لٔٹۍدار
शेंपडेचें: لٔٹۍدار
शेकरें: کَنیوٗ
शेचाळीस: شیٚیہٕ_تٲجی
शेजारचें: نَزدیٖکُک
शेण_मेळयिल्लें: گُہہ_دار
शेणलेलो: روومُت
शेणाचें: گُہہ_دار گُہۍ_دار
शेणिल्लें: لاپَتہ_ رومُت
शेणिल्लो: روومُت
शेतकी: وۄپداو
शेपडायिल्लें: مار_پیوٚمُت مار_کھیوٚمُت
शेपडी_आशिल्लें: لَچہٕ_دار
शेपडेचें: لٔٹۍدار لَچہٕ_دار
शेळें: بی
शेश्टीहीण: کَلہٕ_ژوٚٹ کَلہٕ_روٚس
शेष: بَقایہہ
शोकहीण: بےٚ_شوق
शोकांती: غَمگیٖن موٚیوٗس_کُن
शोकी: شوقیٖن
शोकीन: شوقیٖن
शोधक: مُکبِر
शोधीत: تحقیٖق_کَرنہٕ_آمُت
शौकीन: عَیاش_ _شوقیٖن_
श्रद्धापात्र: ٰعِبادتَس_لایق
श्रद्धाळू: عقیٖدت_منٛد
श्रवणीय: قٲبلہِ_سماعت_ _بوزنس_لایق ناقٲبلہِ_سماعت _بوزنس_لایق_نہٕ
श्रीमंत: أمیٖررۄپیہِ_وولسَرمایہِ_دار
श्रुंगारीत: پوٗرِتھ
श्रेणीय: طبقُک درجُک زۭٲژ_ہُںٛد
श्रेयदिणें: ترجی_وؤل
श्रेयस्कर: ترجی_وؤل
श्रेष्ठ: عظیٖماَصٕلجان
श्लेश: مُبہَم
स: شَےٚ_ _شَیٚہ_ _شیٚیُٛم
स_पटींनी: شٚے_گۄنہٕ
स_पायांचें: شےٚکھۄرَل شےٚ_کھۄرو
स_बोटांकार: شُہ_اوٚنگُل شےٚ_اوٚنٛگجہِ_وول
स_भुजांचो: شُکوٗنَل
संकटग्रस्त: مُصیٖبت_زَد_ پریشان_ِ_حال مُصیٖبَت_زَد مُصیٖبَت_لَد
संकटनाशक: آرام_دیہہ _مُشکِل_کُشا
संकटनाशी: آرام_دیہہ _مُشکِل_کُشا
संकटमय: مُشکِل_ _دُشوٲری _پریشٲنی
संकटाचें: مُشکِل_ _دُشوٲری _پریشٲنی
संकरीत: ہاٮ۪ی_بِرڈ
संकलीत: رٔژھرِتھ
संकल्पीत: اِرادٕ_کوٚرمُت
संकुचीत: تنٛگ_ _کُنٛد
संकोची: حیح_مَنٛد
संगणकाचें: کَمپیوٹرُک
संगणकी: کَمپیوٹرُک
संगणकीकरणी: کَمپِیوٗٹَرٛیزٕڑ کَمپِیوٗٹٕرَیزٕڑ
संगमरवरी: سَنٛگمَرمَری
संगिताचें: موسقی_دار _موسیٖقی_بٔرِتھ _موسیٖقی_وول موٗسیقی_ہُنٛد
संगितात्मक: موسقی_دار _موسیٖقی_بٔرِتھ _موسیٖقی_وول
संगीतमय: موسقی_دار _موسیٖقی_بٔرِتھ _موسیٖقی_وول
संग्रहणीय: سوٚمبراونَس_لایَق جَمع_کَرنَس_لایَق ترتیٖب_دِنَس_لایَق
संग्रहीत: رٔژھرِتھ
संग्रामाचें: جنٛگی_حکمت فوجی
संघटनेचें: دِفاقی
संघटीत: یَکجاہ_ یَکجوٚت
संघर्शशीळ: جَدوجَہد_دار کوٗششہٕ_وول وۄٹھہٕ_ژھرٛانٛٹھہِ_دار
संघर्शी: جَدوجَہد_دار کوٗششہٕ_وول وۄٹھہٕ_ژھرٛانٛٹھہِ_دار
संघर्शीत: کوٗشِش_کَرَن_وول جَدوجَہَد_کَرَن_وول
संघीय: دِفاقی
संचारीत: ۔۔۔۔۔۔۔ نَشٕر_کَرنہٕ_آمُت
संचालीत: چَلوُن
संत: خاموش ٹٕھہرتھ ممنِتھ رُکِتھ
संतती: اَولاد
संतुळीत: توٗلِتھ_تہٕ_میٖنِتھ
संतुश्ट: شُکُر_گُزار_ _شاکِر
संतुश्टी: مُطمَعِن_کَرَن_وول سَنٛتوش_کَرَن_وول
संथ: رُکِتھ _ٹٕھہرِتھ
संदिसादू: موقعہٕ_پَرَست
संदीसादू: موقعہٕ_پَرَست
संदेश_दिवपी: شیٚچھ_گوٚر قٲصِد
संदेशवाहक: شیٚچھ_گوٚر قٲصِد
संन्याशी: سٔنیٲسۍ
संप_करपी: حَرتٲلۍ حَرتال_کَرَن_وول
संपत्ती_भायरें: أزِل_گٔمٕتۍپرٮ۪تکھ_دِتمُتبے_دخل
संपत्तीक: جٲگیٖرُک_ دۄلَتُک
संपादकीय: اِداریِہ
संपादनीय: شیٛرنس_لایَق _ٹھیٖک_کرُن_لایق
संपादीत: تَرتیٖب_دِتھ
संप्रदाय: فِرقَہ_وارانہٕ
संप्रदायीक: فِرقَہ_وارانہ
संबंद_दवरिनासपी: رِشتہٕ_روٚس رِشتہٕ__وَرٲے
संबंदहीण: لاتعلُق
संबंदा_बगरचें: لاتعلُق
संबंदीं: مُطَلِق
संबंदीत: وابَسطہٕ
संबोधक: خطاب_کَرَن_وول
संभव: مُمکِن
संभोग_घेवपी: ہَم_جِنسی_کَرَن_وول ہَم_بستری_کَرن_وول
संभोगी: ہَم_جِنسی_کَرَن_وول ہَم_بستری_کَرن_وول
संमोहीत: ہِپنوٹایِزڈ مٲترٲوِتھ_ مٲتراونہٕ_آمُت
संयमी: پَرہیزگار پرہیزگار اصول_پابند کم_گُفتار_ _دَم_دار_ __نٔزلی
संयमीत: رٕژَر_ _صبٕر_ _نرمی صٲبِر_ _نرم
संयुक्त: جوٗڑِتھ
संयोगी: واٹُت
संयोजक: واٹُت
संरचनात्मक: بناوَٹی ساختی
संवगडी_आशिल्लो: رٔسوٗک_وول
संवसार_जिखपी: دُنِیاہ_زینَن_وول
संवसारी: گَرکُلی خانٛدار گَرٕ_وول
संवसारीक: دُنیٲوی عالمی
संविधानीक: آیینی
संवेदनशीळ: نوزُک نَرم_دٕل حَساس
संशयी: شکاوَر شٔکی ؤہملد_ برٮ۪ملد
संशोदक: تحقیٖق_کَرَن_وول
संशोधक: ایجاد_کَرَن_وول
संसर्गजन्य: لاگ_دار
संसर्गीक: لاگ_دار لاگزَد اِنفٮ۪کشَن_لَد وٮ۪د
संस्कारी: شٲیستہٕ تٔہزیٖب_دار تٔمیٖز_دار مُہزِب
संस्कृत: سَنٛسکرٛت
संस्कृतीक.: ثَقافتی تَمَدُنی_ تہزیٖبی
संस्थेचें: تَنظیٖمہِ_ہُںٛد اِدارُک
सकयल_दिल्लें: بۄنہٕ_کَنہِ_دِتھ
सकयलें: بوٚنِٛیُٛم_ _کَم_ _لۄکُٹ بٔنیُم تٔلیُم
सकयलो: بۄن_ _بوٚنِیُٛم_ _پَس_ _سروٚن
सकयल्ल्या__कुळाचें: ؤسِتھ_قٔبیٖلُک
सकर्मक: تٔرۍ
सकलें: آنجٲرۍ_مانٛجٲرۍ_ ناچیٖز بونہ
सकारात्मक: اِقرٲری
सक्तीचें: لٲزِمی _ضروٗری
सक्रीय: مصروٗف
सक्षम: ہٮ۪متہِ_وول
सख्खें: اَکے_ڈَمبہِ پَنُن
सख्खो: ذٲتی پَنُن
सगली: سورُے سٲری سٲلِم
सगलें: پوٗرٕ
सगलें_खावपी: ہَم_خور
सगल्या_गुणांनी_भरिल्लो: ہَرفَن_مولا
सगल्यांक_खबर_आशिल्लें: مانٛنہِ_آمُت زانٛنہٕ_آمُت
सच्चरित्री: باکِردار
सजयिल्लें: سجٲوِتھ_پٲرٲوِتھ سَجٲوٹی
सजावट: سجاوٹی
सजिल्लें: پوٗرِتھ
सजिल्लो: بَناو_سٕنٛگار_کٔرِتھ_ سَجٲوِتھ _شیٖرِتھ_پوٗرِتھ
सजीव: جان_دار_ _پُر_جوش_ _پُر_لطف_ حشاش_بَشاش
सज्ज: بٔرِتھ
सज्जन: رُت _اَصٕل _شٔریف
सटीक: صحیح
सडसडीत: صحت_منٛد
सडीक: صحیح
सडेतोड: صافواضح
सणसणीत: سَخٕت
सत: پوٚزصحیح
सत_उलोवपी: پٔزۍزیورایمان_دار
सतत: لَگاتار
सतरंगी: سَتھ_رَنٛگہٕ_وول سَتھ_رَنٛگ_دار
सतरा: سَدَہ ۱۷ سَدٲہِم
सतर्क: چالاک تیز ہُشار رِنٛدٕ زِنٛدٕ_دِل آگاہ_ _ہُشار_ گاٹُل_ زانَن_وول
सतर्क.???????????: خبردارہوشارچوکَس
सतायिल्लें: پریشان_کوٚرمُت
सत्कर्मी: ثَوابہٕ_گار
सत्तर: سَتَتھ
सत्तरावें: ستتھِم _سَتتھیُم
सत्तरेक: لَگ_بَگ_سَتَتھ سَتتَھَن_تام
सत्ताधारी: منتخب _اِنٛتِخاب_کَرنہٕ_آمُت _ژورمُت
सत्तावन: ستوَںٛزاہ
सत्तावनावें: ستوَنٛزٕٔہِِم _سَتوَنٛزٔہیُم
सत्ताविसावें: سَتووُہِیُٛم
सत्तावीस: سَتووُہ
सत्ते_खाला: ماتحَت
सत्ते_तळा: ماتحَت
सत्तेचाळिसावें: سَتٲجِیُٛم
सत्तेचाळीस: سَتتٲجی
सत्त्याण्णवावें: ست_نمتن ستہٕ_نمتِم
सत्त्यात्तरावें: ستھ_ستتھِم
सत्यनिश्ठ: پٔززیور پوٚززِیٲر پوٚز_وَنَن_واجیٚنۍ
सत्यभाशी: پٔزۍزیورایمان_دار
सत्यवादिनी: پٔززیور
सत्यवादी: پٔزۍزیورایمان_دار پٔززیور پوٚززِیٲر پوٚز_وَنَن_واجیٚنۍ
सत्यांयश्यावें: ستہٕ_شیٖتِم
सत्याग्रही: سٔتِیاگرٛہی
सत्रे_भशेनचें: چھترِ_دار
सत्वगुणी: اِخلٲقۍ
सदळ: ڈیوٚل کھوٚل ڈیوٚل یَلَے نَرٕم ڈیوٚل
सदळ_हाताचें: ؤسۍ_دِل_ بوڈ_دِلوؤل _دِل_وؤل
सदां__खातीरचें: نَہ_مِٹَن_وول
सदाचरणी: باکِردار
सदाचारी: نیک نیک_نِیَژوول
सदापर्णपाती: سَدابہار
सदापर्णी: سَدابہار
सदाहरीत: سَدابہار
सद्चरित्री: باکِردار
सधवा_भशेनचें: پِِرٕ فقیٖرٕ درویشہٕ
सनसनाटी: حٲرت_اَنٛگیز حٲران_کُن
सनातन: روزوُن _پوشوُن لافٲنی_ _ابدی
सनाथ: رٲچھ_راوَٹھ_کَرن_وول مُحٲفِط
सपांयी: شےٚکھۄرَل شےٚ_کھۄرو
सपाट: ہموار سوٚم صاف
सप्तकाचें: ہَفتہٕ_وار
सप्तरंगी: سَتھ_رَنٛگہٕ_وول سَتھ_رَنٛگ_دار
सफळ: پوٗرٕ
सभावीक: فطرٔتی
सभ्य: تٔمیزداراَصٕلجان
सम: بَرابَرہِویہم_رۄتبہٕہم_پَلہٕ ہیو یُتھ_ یُتھٕے
समकालीन: وَقتاًفَوَقتاً اَکے_وَقتُک
समगुणी: ہِوی_صِفتہٕ_وٲلۍ ہیوٗ_مِزازٕ_وٲلۍ
समजिकायचें: رَلوٕنۍ_میلوٕنۍ
समजूंक_नाशिल्लें: سمجھ_نے
समजूतदार: دانہہ
समजूतदारपणाचें: رَلوٕنۍ_میلوٕنۍ
समतापी: گَرَم_خوٗن_وول
समदर्शी: یَکسان_نَظَر
समन्वयीत: رلہٕ_مِلہٕ _گٔنٛڑِتھ _رٲبطہٕ_دار
समरुपी: ہِشے _ہیوٗ _ہِوُے
समर्थीत: حِمایَت_کَرنہٕ_آمُت
समर्पीत: وَقٕف
समवयस्क: ہَم_عُمَر
समा: ٹھیٖک_ صٔحی_ مُنٲسِب_ مُفیٖد
समांतर: ہموار بَرابَر
समाजवादी: سمٲجی_ _سماج_پرست
समाजीक: سَمٲجی
समाधान: خوش
समाधानी: أنٛزرومُت _اَنٛدیومُت حَلہٕ_دار مالامال کٲیِل
समान: ہیو یُتھ_ یُتھٕے ہموار بَرابَر ہَم_معنی نَقلی نَقٕل
समान_गूण_आशिल्लो: ہِوی_صِفتہٕ_وٲلۍ ہیوٗ_مِزازٕ_وٲلۍ
समान_पिरायेचे: ہَم_عُمَر
समानार्थी: ہیٛو_مٔعنی_دار
समाप्त: سَپدیومُت _مۄکلیومُت
समाही: شٮ۪شماہی_ شےٚ_ریوٚت
समिक्षणात्मक: ملامَت
समुखी: شےٚ_بُتھ_وول شےٚ_بُتھَل
समुद्री: سَمَنٛدٔری سَمَنٛدَرُک سَمَنٛدٔری بحری سَمنٛدری
समृद्ध: أمیٖٖر زَرخیز
समृद्धिदिणें: عیش_تہٕ_عشرَت_دِنہٕ_وول
समेटाचें: مُہادٕ_وول
समेस्त: سورُے سٲری سٲلِم
सम्मानीत: اَحتِرام
सम्राट: شَہنشاہ
सय__केल्ली: دَستہٕ_خت_کٔرِتھ
सयल: ڈیوٚل
सरकटें: کٕھکھرِ_پَکَن_وول
सरकारमान्य: اِختِیٲری
सरकारी: ایٚکزِ_کیوٗٹِو سَرکٲرۍ اِنتظٲمی_ _سیٲسی
सरपटें: کٕھکھرِ_پَکَن_وول
सरपळेचें: زٔنٛجیٖردار زٔنٛجیٖرٕ_وول ہانٛکلہِ_دار ہانٛکلہِ_وول
सरबरायेचें: مہمان__نَواز
सरबियन: سَربِیٲیی سَربِیٲیۍ
सरळ: سُلجیومُت سٕہلآسان قدرتی سہل _آسان شریفسیوٚد_سادٕسیوٚد سَہَل_ _سُہوٗلیَت_دار_ _سُہوٗلَت_وول سیوٚد قٲبلہِ_حَصوٗل نٔنۍ_ صاف_ پِشُلنرم_پھمب_ہیُوپوٹھ سیوٚد
सरळमार्गी: سیوٚدُے_پَکَن_وول
सरसादारण: عام_ _معموٗلی _عام_پٲٹھۍ _عام_طور_ _عموٗمی_ _عموٗمن
सरसामान्य: عموٗمی _عام__طور_ _عموٗمن عام_ _معموٗلی _عام_پٲٹھۍ _عام_طور_ _عموٗمی_ _عموٗمن
सरस्वतीचें: سَرَسؤتی_ہُںٛد
सरींचें: قریٖبی _نَزدیٖکی
सरोजमुखी: پَمپوش_روے_وول پَمپوش_بُتھ_وول
सर्गींचें: جنتُک_ _جنتی
सर्गेस्त: موٗدمُتمۄردٕمرحوٗم
सर्जनशीळ: تَخلیٖقی
सर्पील: آرٕ_کرِتھ
सर्वकालीक: دٲیمی اَبدی
सर्वकालीन: دٲیمی اَبدی
सर्वगुणी: ہَرفَن_مولا
सर्वगूणसंपन्न: ہَرفَن_مولا
सर्वज्ञ: زانَن_وول
सर्वज्ञानी: زانَن_وول
सर्वभक्षी: ہَم_خور
सर्वमान्य: ہم_خیال _ہم_راے _اِتِفٲقی
सर्वव्यापी: حٲضِر_تہٕ_نٲظرِ ہَرکُنہِ_جایہِ__حٲضِر حٲٛضِر_و_نٲضِر
सर्वशक्तीमान: طاقَت_وَر _زوراوَر
सर्वशक्तीशाली: طاقَت_وَر _زوراوَر
सर्वश्रेश्ट: اَصٕل _جان _رُت _بِہتٔریٖن _لایقہِ_کار
सर्वसादारण: عام_ _معموٗلی _عام_پٲٹھۍ _عام_طور_ _عموٗمی_ _عموٗمن
सर्वसामान्य: عموٗمی _عام__طور_ _عموٗمن عام_ _معموٗلی _عام_پٲٹھۍ _عام_طور_ _عموٗمی_ _عموٗمن
सर्वांगीण: جِسمُک
सर्वाहारी: ہَمہٕ_خۄر
सर्वेस्पर: تعالیٖ کٔریٖم
सर्वोच्च: تٔھدِس_ _ہیٚرِیُٛم_ _پیٚٹھِیُٛم بوٚڑ تھوٚر عظیٖم
सर्वोत्कृश्ठ: جان_ _زَبَر_ _رُت
सर्वोत्तम: جان_ _زَبَر_ _رُت
सर्वोपरी: بوٚڑ تھوٚر عظیٖم
सल्तनती: بادشٲہی_ _سُلطٲنی
सळसळीत: توٚت_توٚت_ _گَرٕم_گَرٕم_ _گَرما_گَرٕم
सवकाश: کملوٚتوارٕ_وارٕ
सवकास: کملوٚتوارٕ_وارٕ
सवती: وۄرٕ سۄنہٕ_تون
सवाय: سَستہٕسرٛوٚگ سۄاد سَستہٕ_ _سرٛوٚگ
सवायशीण: کھانٛدرٕ_واجیٚنۍ
सवार: سوار
सविसावें: شَتوُہِیُٛم
सवें: شٔیِم
सव्वा: سۄاد
सव्वीस: شَتٕوُہ
सशस्त्र: ۂتھِیار_بَنٛد
सस्तन: بَچہٕ_دِنہٕ_وٲلۍ پیٛاوَل
सहकारी: کاپریٹِو
सहज: سٕہلآسان قدرتی سَہَل_ _سُہوٗلیَت_دار_ _سُہوٗلَت_وول
सहन_करपी: بَرداش_کَرَن_وول
सहप्रवासी: ہَم_سَفَر ہم_راہ سٲتھی
सहमत: رٲضی
सहयात्री: ہَم_سَفَر ہم_راہ سٲتھی
सहयोगी: مَدتی
सांकेतीक: اِشارٕ_دار
सांगपा_सारकी: وَننَس_لایق
सांगि_सारकी: وَننَس_لایق
सांगितीक: موٗسیقی_ہُنٛد
सांगिल्लें: دَرخواست_کٔرمٕژ اِلتجا_کوٚرمُت_ عرض_کوٚرمُت وَننہٕ_آمُت_ _وَننہٕ_پٲٹھۍ وَٮ۪ژھناونَس_لایَق واش_کَڑنَس_لایَق
सांगिल्ल्या: وَنِمَژٕ
सांगिल्ल्यो: تَقریٖر_کَرنہٕ_آمُت تبلیغ_کَرنہٕ_آُمُت خِطاب_کَرنہٕ_آمُت
सांगूंक_नाशिल्लें: ونہٕ_نیہ_کَتھ
सांचिल्लें: رُکِتھ _ٹٔھہرِتھ
सांच्यांत_घातिल्लें: سانٛچہٕ_دار
सांठयिल्लें: سوٚمبروومُت _جَمع_کوٚرمُت _أتھۍ_تھوٚومُت
सांठिल्लें: رُکِتھ _ٹٔھہرِتھ
सांठोवपी: جَمع_کَرَن_والٮ۪ن
सांठ्याचें: پَتھ_کُن_تھاونہٕ_آمُت بچٲیِتھ_تھاونہٕ_آمُت تُلِتھ_تھاونہٕ_آمُت
सांबाळपी: رَچھَن_وول_ ہَرِ_ژَھٹھ_ہٮ۪نہٕ_وول _رٲچھۍ_راوَٹ_کَرَن_وول
सांमंतकाळीन: مَںٛز_کال
सांसठ: شُہٲٹھ
सांसठावें: شُہ_ہٲٹھم
साकरीचें: کھَنٛڑدار
साक्षर: پوٚرمُت_لیوٚکھمُت
साक्षात: جِسمٲنی_ _اِجتِمٲیی قٲبلہِ_یقیٖن_ _ٹاکارٕ_ _چشم_دیٖد
साक्षिदार: چٔشمہٕ_دیٖد
साखळेचें: زٔنٛجیٖردار زٔنٛجیٖرٕ_وول ہانٛکلہِ_دار ہانٛکلہِ_وول
सागरी: سَمَنٛدٔری سَمَنٛدَرُک
साचिवी: سیٚکٹِریٹُک
साठ: شیٹھ
साठयिल्लें: پَتھ_کُن_تھاونہٕ_آمُت بچٲیِتھ_تھاونہٕ_آمُت تُلِتھ_تھاونہٕ_آمُت
साठावें: شیٖٹھِم _شیٖٹھیُم
साठेक: لَگ_بَگ_شیٹھ شیٹَھَن_تام
साडे: ساڑٕ
साडे_तीन: ساڑٕٕ_ترٛے
सात.: ستھ
सातपडी: سَتھ_لَرٕ_وول
सातरंगी: سَتھ_رَنٛگہٕ_وول سَتھ_رَنٛگ_دار
सातलाखांचें: سَتَن_لَچھَن_ہُںٛد
सातलाखी: سَتَن_لَچھَن_ہُںٛد
सातवें: سٔتِم
सातसठ: ستہ_ہٲٹھ
सातसठावें: ستہٕ_ہٲٹھِم
सातेक: لَگ_بَگ_سَتھ
सातोळें: سَتہٕ_ریٚتُک سَتہٕ_ریوٚت سَتَن__ریٚتَن_ہُنٛد
सातोळ्याचें: ہَفتہٕ_وار
सात्तिसावें: سَتہٕ_ترٕٛہِیُٛم
सात्तीस: سَتہٕ_ترٕٛہ
सात्वीक: اِخلٲقۍ
सादरीकरणाचें: سِٹیجَس_لایَکھ
सादरीत: گِنٛدنہٕ_آمُت
सादारण: آنجٲرۍ_مانٛجٲرۍ_ ناچیٖز عام_ _معموٗلی_ سادٕ بِلا_اعتِراز عموٗمی _عام__طور_ _عموٗمن سادٕ_ _شریٖف_ نرم لۄکٕٹۍ_مۄکٕٹۍ _ہَلکہٕ_پُھلکہٕ _کینٛہہ_کینٛہہ _تھوڑا_بُہوٚت
सादूर: خبردارہوشارچوکَس
सादें: آنجٲرۍ_مانٛجٲرۍ_ ناچیٖز سَہَل_ _سُہوٗلیَت_دار_ _سُہوٗلَت_وول کورٕ_ خٲلی_ _سادٕ سادٕ_ _شریٖف_ نرم سادٕ _سَفید
सादें.: سیوٚد
सादो: شریفسیوٚد_سادٕسیوٚد
साधनयुक्त: وَسٲیِل_دار
साधनसंपन्न: وَسٲیِل_دار
साधनहीण: ؤسیٖلہٕ_روٚژھ
साधनां_नाशिल्लें: ؤسیٖلہٕ_روٚژھ
साधवी: باکِردار
साध्य: اعلاج_دار
सान: معصوٗم ژھوٚٹ لۄکُٹ پیونٛت
सानुलें: لۄکُٹ_مۄکُٹ _مۄکُٹ پِنٛتہٕ_کَلہٕ_ پینٛتہٕ_کَلہٕ_ _پِتہٕ_کَلہٕ ژھوٚٹ لۄکُٹ پیونٛت
साफ: صاف _واضح شَفاف _خٲلِص
सामकें_गरजेचें: اَشد_ضروٗری
सामकें_पुर्विल्लें: سارِوٕے_کھۄتہٕ_پرون
सामको: پَکہٕ _سَراسَر _پوٗرٕ
सामको_उणो: کَم _رَژھ
सामवेदी: سامویدِک سامویدِ
सामान्य: عام_ _معموٗلی_ سادٕ مُشتَرکہٕ بِلا_اعتِراز سادٕ_ _شریٖف_ نرم
सामुहीक: مُشتَرکہٕ
साम्यवादी: اِتحاد_پسنٛد سماجی_مساوات اشتراکی
सायबेरियायी: سَیِبٔریاہُک
सारकें: بَرابَرہِویہم_رۄتبہٕہم_پَلہٕ ہِویکُنی باقٲعدٕ مُنَظم ہموار بَرابَر ٹھیٖک_ صٔحی_ مُنٲسِب_ مُفیٖد صحیح_ _ٹھیٖک_ _دُرست
सारको: پَکہٕ _سَراسَر _پوٗرٕ ہیو یُتھ_ یُتھٕے ٹھیٖک اَصٕل
सारहीण: فَضوٗل مۄلہٕ_روٚس بےٚ_مۄلہٕ مۄلہٕ_بَغٲر فَضوٗل بٮ۪کار
सार्थ: بےٚمعنے_ _بےٚ_مانے
सार्थक: پوٗرٕ
सार्वभौमीक: عالَمگیٖر
साव: تٔمیزداراَصٕلجان ایمانٛداررُت جان _رُت
सावत्र: وۄرٕ سۄنہٕ_تون
सावध: خبردارہوشارچوکَس
सावधी: فِکسٕڑ مِیٲدی
सावळें: گیٚشوم گُںٛدَمی
सावळेचें: شُہلہٕ_دار
सावळो: کرٛہُن
सासणा_खातीरचें: نَہ_مِٹَن_وول
साहसी: مُہم_باز
साहित्यप्रेमी: اَدَب_پَسنٛد
साहित्यमोगी: اَدَب_پَسنٛد
साहित्यीक: ادبی
सिंगापुरी: سِنٛگا_پوٗرۍ
सिंदुरी: سِنٛدرِدار سِنٛدٕر_بٔرِتھ
सिंधी: سِندی سِنٛدی سِنٛدی سِنٛدی_ سِنٛدی
सिंहली: سِنۂلۍ _سری_لنکاہُک سِنۂلۍ سِنۂلۍ
सिएरा_लियोनी: سِیٚرا_لِیونیاہُک سِیٚرا_لِیونۍ سِیٚرالِیونِیَن
सिद्ध: ثٲبٕت ثٲبِت_گوٚمُت _پرکھومُت
सिद्धांतीक: نَظَریٲتی
सिने: فِلمی
सिनेगली: سِنِگََلُک سِنِگٲلے
सिरियायी: شامُک سیٖریاہُک
सुंदर: خوٗبصوٗرتمٲرۍ_موٚنٛد خۄشوُن_ خۄش_گَوار_ اَصٕل لوٗب_وُن مٲرۍموٚنٛد خۄشوٕنۍ خوٗبصوٗرت_ _حسیٖن خوٗبصوٗرَت حٔسیٖن مٲرۍ_موٚنٛد
सुंदर_अक्षरवळणाचो: اَصٕل_دَسخَط_وول _اَصٕل_لِکھاوَٹ_وول خُشخَط
सुंदर_दंडांचें: خوٗبصوٗرت_نَرِ_وول لوٗبوُن_نَرِ_وول
सुंदर_पांखांचें: خوٗبصوٗرَت_تیٖرِ_وول مٲرموٚنٛد_پَکھہٕ_وول
सुंदर_मानेचें: خوبصوٗرَت_گَردَن_واجیٚنۍ
सुंदरी: خوٗبصوٗرت حٔسیٖن
सुकडें: زٲویُلنیُک أڑِجوٗ
सुकप: ژھوٚرُے_تہٕ_چھوٚنُے_ خٲلی _کورَے
सुकिल्लें: نَنٛگہٕ ہوٚکھمُت_ ہوٚکھ زَۄزریمُت_ _زَردیومُت
सुकुमार: نوزُک
सुकें: زٲویُلنیُک خۄشٕکہوٚکھ ہوٚکھمُت_ ہوٚکھ خۄشِک_ _ہوٚکھ مایِہ_روٚس _محبتہٕ_روٚس
सुक्षीम: زٲویوٗل زٲوِیُٛل_ نِیُٛک_ _توٚن زٲوِیُٛل_ _توٚن_ _نِچ_ _مِہینہٕ
सुक्षीमदर्शी: بۄدٕ_دار _ذٔہیٖن
सुक्ष्म: زٲویوٗل
सुख: خۄش_حالسۄکھ_شیٖل
सुखदिणी: خۄش_وُن_ لوٗب_وُن
सुखांतीक: خوش_نُما _خۄش_حال _اَصٕل جان _پُرمَسَرَت پُر_لُطُف
सुखाची: خۄش_وُن_ لوٗب_وُن
सुखात्मक: خوش_نُما _خۄش_حال _اَصٕل جان _پُرمَسَرَت پُر_لُطُف
सुखाळ: خۄش_وُن_ لوٗب_وُن
सुखासीन: آرام_سان زَنٛگہٕ_وَہرٲوِتھ اِطمینان_سان
सुखी: خۄش_حالسۄکھ_شیٖل
सुगंधीत: خُۄشبودار _مٕشک_دار_ خۄش_گُوار
सुगरण: تٔمیٖزدار سلیٖقہٕ_مَںٛد شعوٗردار شٲیِستہٕ سٔلیقہٕ_مَںٛد
सुग्राही: جان
सुग्र्याह: سَہَل آسان
सुचक: خبری خبردِنہٕ_وول شیٚچھ_وَنن_وول شیٚچھ_دِنہٕ_وول
सुचरित्री: باکِردار
सुचीत: باخبر حَوالہٕ_دِتھ
सुझ्य: مل_دار
सुटनासपी: حَل_گَژھنَے
सुटसुटीत: گٔرِتھ_تہٕ_ژٔرِتھ _میٖنِتھ_تہٕ_میٖژِتھ
सुटिल्लें: ویوٚٹھ ویٚوٹھ_پوٗٹھ
सुडानी: سوٗڈٲنۍ
सुतलावपी: دونٛکھٕ_باز دَغاباز تارَن_گوٚر ژوٗر تھَپَل
सुती: سوٗتُک
सुदारिल्लो: ترقی_یافت
सुदारीत: ترقی_یافت عُمدَہ _جان بہتٔریٖن
सुनयनी: خوبصوٗرَت_أچھ_وول اَصٕل_أچھ_وول_دِلکَش_أچھ_وول
सुनिश्चीत: واضح
सुनेत्री: خوبصوٗرَت_أچھ_وول اَصٕل_أچھ_وول_دِلکَش_أچھ_وول
सुन्न: بَد_حَواس مُصیٖبَت_زَد _صَدمہٕ_لَد_ دَم_پھٕٹۍ
सुपरिचीत: زٲنۍ_یاب
सुपाच्य: ہَلکہٕ
सुपीक: آباد_ زَرخیز
सुपुल्लें: ژھوٚٹ لۄکُٹ پیونٛت
सुप्त: _بےٚحٮ۪س_ _سُست_ _بےٚ_حرکت _گُپتھ
सुप्रसिद्ध: مَشوٗر
सुफी: صوٗفی صوٗفیانہٕ
सुबेज: بُتھۍ_پھیُربد_لِحاظہٕ بَد_لِحاظ _بَد_تٔمیٖز _بَدسٔلوٗک زَبان_دَراز بَد_زَبان بٕتھۍ_پُھیر
सुरक्षीत: مَحفوٗظ محفوٗظ محفوٗظ حِفاظتی محفوٗظ محفوٗظ
सुरयीकारी: صُرے_دار صُرے_ہیوٗ أنٛز_ہیوٗ
सुरवातीचें: اِبتِدٲیی _شروعٲتی
सुरांटो: شرٲبۍ
सुरांडो: شرٲبۍ شرٲبۍ شرٲبۍ
सुरिनामी: سوٗریہِ_نٲمۍ سوٗرِیہِ_نٲمیٖس
सुरू: جٲری چالوٗ ٲڑروومُت شُروٗعٲتی اِبتِدٲیی
सुरू_आशिल्लें: پَکوُن
सुलक्षण: اَصٕل_کیرَن_وول _اَصٕل_صِفَت_وول
सुलक्षणी: کِردار_واجٕنۍ فَطرت_واجٕنۍ باکِردار
सुलतानी: بادشٲہی_ _سُلطٲنی
सुलभ: گَژھنس_لایق سٕہلآسان قٲبلہِ_حَصوٗل
सुलिखीत: مۄکھتہٕ_ہیو_لٮ۪کِھتھ_ صاف_لٮ۪کِھتھ_ اَصٕل_لٮ۪کِھتھ
सुलेमानी: سُلیمٲنی
सुळसुळीत: ہموار_ __سوٚم_ _پِِشُل
सुळ्यांचें: زیٖتھۍ_دَںٛدٕ_وول
सुवर्णी: خوٗبصوٗرَت حٔسیٖن مٲرۍ_موٚنٛد
सुवादाचें: مَزٕدار
सुवादीक: مَزٕدار مَزٕ_دار_ لٔزیٖز_ میوٗٹھ
सुवादीन: وَقٕف
सुवार्था_बगर: مَطلَب_بَغٲر_ مطلَب_روٚس
सुवार्थी: خۄدغرَض_ غَرَض_اوٚن مطلٔبی
सुवासहीण: مشکہٕ_روٚس
सुवासाचें: خُۄشبودار _مٕشک_دار_ خۄش_گُوار
सुवासीक: مُشکہٕ_دار _خۄشبو_دار
सुवासीत: مٕشکاونہٕ_آمُت _مُشکاونہٕ_آمُت
सुशिक्षीत: پوٚرمُت_لیوٚکھمُت اَصٕل_تَربِیَت__دار_ اَصِٕل_تَربِیَت_وول
सुशील: رُت رٕژِسیٖرَت_وول
सुशेगाद: کٲہِلسُست
सुश्रूत: نام_وَر مَشوٗر
सुसंस्कृत: سٔخی_ _فِراخ_دِل مُہَزِب
सुसेगदिणी: آرام_دِہ سۄکھ_واتناوَن_وول
सुसेगाद: پُر_سٕکوٗن وارٕوارٕ_ _ژھۄکیومُت
सुस्त: کٲہِلسُست وارٕوارٕ_ _ژھۄکیومُت
सूखदिणें: مََزٕ_دار _پُر_مَسرَت
सूरहीण: بٮ۪گُر _طرزٕ_روٚس
सूर्यवंशी: سوٗریہِ_وَنٛشی سوٗریہِ_وَنٛشُک
सृजक: بَناوَن_وول
सृजनकर्तो: بَناوَن_وول
सृजनात्मक: تَخلیٖقی
सॅटिनाचें: اُتلاس _أتلاس أتلاس
सेगीत: لَگاتار
सेचाळिसावें: شیٚیِہ_تٲجٕمۍ
सेवक: خدمت_گار_ _نوکَر خٔدمَت_گار
सेवनाचें: کھٮ۪نس_لایق
सेवा_करपी: تیٖماردار_ _خدمت_گار
सेवानिवृत्त: رِٹایر
सेवाभावी: خٔدمَت_گار
सेवी: خدمت_گار_ _نوکَر
सेवीत: خدمَتَس_لایق
सेशिल्जी: سیشیٖٖلزُک
सैनिकी: فوجُک فوٗجی فوٗجی سِپاہ_ہیوٗ فوجی_ہیوٗ فوجدٲری
सैन्य: فوجُک
सैन्या_बगरचें: فوجہِ_روٚستُے _فوجہِ_وَرٲے _فوجہِ_بَغٲر
सैन्या_विरयत: فوجہِ_روٚستُے _فوجہِ_وَرٲے _فوجہِ_بَغٲر
सैमीक: قدرٔتی خدٲیی قدرتی
सैल: ڈیوٚل کھوٚل ڈیوٚل یَلَے نَرٕم
सोंपते_तारखेचें: وَقت_گوٚمُت وَقت_مۄکلیومُت ایٚکٕسپَیَر_گوٚمُت
सोंपूंक_नाशिल्लें: اوٚڑٕے_ نامُکَمَل
सोंपे: قٲبلہِ_حَصوٗل
सोंपें: گَژھنس_لایق سہل _آسان سَہَل_ _سُہوٗلیَت_دار_ _سُہوٗلَت_وول
सोंपेपणाचें: سَہَل_ _سُہوٗلیَت_دار_ _سُہوٗلَت_وول
सोंपो: سٕہلآسان
सोंशीक: بَرداش_کَرَن_وول
सोकिल्लें: شرٛوٚپِتھ
सोकून_घेतिल्लें: شرٛوٚپِتھ
सोडिल्ले: پسپٲیی_کَرَن_وول
सोडिल्लें: ترٛٲومٕژ سوٗزمُت_ _روانہٕ_کوٚرمُت درٛامُت
सोडून_गेल्लें: پسپٲیی_کَرَن_وول
सोडोवंक_जायना_अशें: حَل_گَژھنَے
सोद_घेय_सारकें: تحقیٖق_کرنس_لایق
सोदक: تحقیٖق_کَرَن_وول
सोदपी: مُکبِر
सोदर्यात्मक: جَمٲلیٲتی حُسُن_شِناس
सोदिल्लें: تحقیٖق_کَرنہٕ_آمُت
सोप्पाचें: خَتَم_ _خَتَم_شُد
सोबता_अशें: شٲیِستہٕ
सोबना_अशे: ناشٲیِستہٕ بےٚاَدب نازیبا
सोबपी: شٲیِستہٕ
सोबसारकें: شٲیِستہٕ
सोबीत: خوٗبصوٗرتمٲرۍ_موٚنٛد شوٗبدار _زیٖنَت_وول_ زیٖنَت_دار مٲرۍموٚنٛد خۄشوٕنۍ خوٗبصوٗرت_ _حسیٖن جان خوٗبصوٗرَت حٔسیٖن مٲرۍ_موٚنٛد
सोमाराचें: ژٔندٕر_وار_ہُند
सोमारी: ژٔندٕر_وار_ہُند
सोमाली: سومالِیاہُک سومالِیَن سومٲلۍ سومالیاہَس_سۭۭتۍ_وابستہٕ
सोयरीक_जाल्लें: نِشٲنۍ_وول نِشٲنۍ_واجیٚنۍ
सोयरीक_जुळिल्ले: نِشٲنۍ_وول نِشٲنۍ_واجیٚنۍ
सोरपा_आकाराचें: آرٕ_کرِتھ
सोरेकार: شرٲبۍ
सोर्‍याकार: شرٲبۍ
सोलिल्लीं: کنٛجہِ_روٚس_ _دٮ۪لہٕ_روٚس_ _گۄلرِ_روٚس
सोलिल्लें: زٕلِتھ
सोलूंक_नाशिल्लें: زٕلنے
सोळा: شُراہ
सोळावें: شُرٲہِم
सोशीक: بَرداشَس_لایَق
सोसूंक_जायना_अशें: ناقٲبلہِ_برداش ژالُن_نہٕ
सौम्य: نَرٕم_مِزازُک _نَرٕم
स्कॅण्डिनेवियी: سٕکینڑِنیویاہُک نورُس
स्टार्चान_भरिल्लें: مایہِدار
स्टोनियायी: ایٚسٹونِیاہُک ایٚٹونیٲیۍ ایٚسٹونِیَن ایٚٹونِیَن
स्तन्य: میمری_ _میمری_گِٕلینٛڑ
स्तराचें: سَطحُک پایُک دَرجُک
स्तरीय: سَطحُک پایُک دَرجُک
स्तुतीपाठक: مانَن_وول
स्त्री: مادٕ
स्थगीत: مُلتٔوی_کَرنہٕ_آمُت
स्थानीक: مُقٲمی
स्थापणूक_करी_सारकें: قٲیِم_کَرنَس_لایَق
स्थापी_सारकें: قٲیِم_کَرنَس_لایَق
स्थापीत: قٲیِم_کوٚرمُت
स्थायी: لافٲنیہمیٚشہِ_روزن_وول مُستقِل
स्थायीक: بٔسِتھ آباد گُلزار
स्थालांतरीत: غٲر_ریاستی _غٲر_مٕلکی
स्थावर: نہ_پَکوٕنۍ _روٗزِتھ _بِہِتھ غٲرمنٛکولہ
स्थीर: بِہِت_گٔمٕژ _رُکِتھ نہ_پَکوٕنۍ _روٗزِتھ _بِہِتھ رُکِتھ غٲرمنٛکولہ اَلہٕ_اَلہٕ_دار_ تَھرٕ_تَھرٕ_دار خاموش ٹٕھہرتھ ممنِتھ رُکِتھ مُستَقِل ثٲبِِِت_قدم ڈٔٹِتھ
स्थूल: ویوٚٹھہُنیومُت
स्नेही: مایہِ_بوٚرُتھ _لولہٕ_بوٚرُتھ _محبتی _شَفکٔتی
स्पटिकी: سۄتھکَک_ہیوٗ
स्पर्श_करी_सारकें: اَتھہٕ_لاگنَس_لایَق
स्पर्श_करूंक_नाशिल्लें: صاف سِر _اَتھہٕ_لاگنَے
स्पर्शीत: اتھ_لوٚگمُت
स्पश्ट: صاف _واضح نٔنۍ_ صاف_
स्पश्टवादी: صاف_دِل_ _ٹاس_پَٹٲسۍ _رَلہٕ_وُن_ _مِلہٕ_وُن
स्पृश्य: اَتھہٕ_لاگنَس_لایَق
स्पॅनीश: اِسپینُک اِسپینی سٕپینی سٕپینی سٕپینِش
स्फटिका_भशेन: سۄتھکَک_ہیوٗ
स्फटिकाचें: سۄتھکُک سۄتھکَک_ہیوٗ
स्फूर्तहीण: دِلچَسپی_روٚژھ
स्फूर्तीदायक: پھُرتی_دار
स्फोटक: دھماکہٕ_خیٚز _آتَش_خیز
स्मरणीय: یادگار
स्लोवाकी: سُلواکِیاہُک سُلواکِیٲیۍ
स्लोवेनियाचें: سٔلویٖنِیاہُک سٔلویٖنِیَن سٔلویٖنِیٲیۍ
स्लोवेनियायी: سٔلویٖنِیاہُک سٔلویٖنِیَن سٔلویٖنِیٲیۍ سٔلویٖنِیٲیۍ سٔلویٖنِیَن
स्वखोसयेचें: آرام_مُطٲبِق
स्वगत: دِلٕکۍ
स्वच्छ: شَفاف _خٲلِص
स्वजातीय: زٲژ
स्वतंत्र: آزاد آزاد
स्वता_कमयिल्लें: پانہٕ_حٲصِل_کوٚرمُت
स्वता_जोडिल्लें: پانہٕ_حٲصِل_کوٚرمُت
स्वता_मेळयिल्लें: پانہٕ_حٲصِل_کوٚرمُت
स्वताचें: ذٲتی _پَنُن
स्वताचो: پَنُن_ زٲتی
स्वदेशी: قومی
स्वनिर्भर: خۄدکٔفیٖل
स्वपक्षी: پَنُن
स्वभावीक: فطرٔتی
स्वयंसिद्ध: پٲنۍ_پانَےثٲبِت_گَژھَن_وول
स्वर्णीम: سۄنٛہری
स्वशिक्षीत: پانے_پوٚرمُت_ پانے_ہیوٚچھمُت
स्वाजी: سٕویزی_ _سٕویزِیُک
स्वाभावीक: قدرتی
स्वाभिमानहीण: بےٚغٲرت
स्वाभिमानी: خۄد_دار_ _غٲرتمنٛد
स्वायत्त: خۄد_مۄختار
स्वार्थी: مَطلبی خۄدغرِض
स्वावलंबी: خۄدمۄختار خۄدمۄختار خۄدکٔفیٖل
स्वाहिली: سَوٲہلی سَواہِِلِیا_چہِ_زَبٲنۍ_مُتعلِق کِسوٲہلی
स्विकार_करी_सारकें: قٲبلہِ_قَبوٗل_ قٲبلہِ_تَسلیٖم
स्विकारपा_सारकें: قٲبلہِ_قَبوٗل_ قٲبلہِ_تَسلیٖم
स्विकारिल्ली: منٛظوٗر منٛظوٗر
स्विकारिल्लें: اِختِیٲری_ _قبوٗل_کوٚرمُت
स्विकारूंक_नाशिल्लें: نامنٛظوٗر
स्विकृत: منٛظوٗر_کوٚرمُت _اِجازَت_دیُتمُت منٛظوٗر
स्विडीश: سویڑَنُک سویٖڑِش سُویٖڑِس
स्वित्झरलॅण्डी: سُوِزَر_لیٛنڈُک سُوِس
हंसगामिनी: أنٛز_چالہِ_وول
हकारांती: ہ_اَچَھر_وول
हक्क_आशिल्लो: حقدار
हक्काचें: ملیقیٲتی _وَراستی
हजर: حٲضِر _موجوٗد
हजरजबाबी: حٲضِر_جواب
हजार: ساس_ داہ_شَتھ
हजारांनी: ساسہٕ_بَدۍ
हजारावें: سٲسِم
हजारेक: لَگ_بَگ_ساس ساس_تام
हट्टी: ہَٹ_دَرَم ۂٹی _اَکڑی
हडपिल्लें: زَبٕد_ کُرِکۍ_کٔرِتھ ہَضٕم
हमाली: بور_سارَن_وول
हयकारी: اِقرٲری
हरवें: خامکوٚچنیوٗلُے کوٚچ_ _نیوٗلُے اَڈٕ_پوک سَبٕز
हरामी: حرام_زادٕ
हरियाणी: ۂریاناہُک ۂریٲنۍ
हलंत: مصمتہِ
हलकट: بَد_زَبان زَباندَراز
हलकें: لوٚت چھوٚت_ _ہلکہٕ خۄشہٕ_وُن تھوڑا کَم کَم_کینٛژھا
हलको: لوٚتہلکہٕ
हलाल: حَلال
हळडुवें: لیٚدُر زَرٕد زَرنَک
हळू: لوٚت
हळू_हळू: کملوٚتوارٕ_وارٕ
हवनी: ہَونٕکۍ ہَونَس_لایَق
हवाई: ہَوٲیی
हवादार: ہَوادار
हवाबंद: ہَوابَنٛد _ایَرٹَیِٹ
हसतमूख: خۄش_وُن
हस्तनिर्मीत: اَتھہٕ_بَنیومُت
हस्तलिखीत: قَلمی_ اَتھو_لٮ۪کِھِتھ _اَتَھو_لیٚکھِمٕتۍ
हस्तीदंती: ۂسۍ_دندُک
हांडेकार: أمیٖررۄپیہِ_وولسَرمایہِ_دار
हांशाक_म्हारग: مَزاقِیہ
हांशाचें: مَزاقِیہ
हांश्यास्पद: اسُن_ _مزاکیہ_ ٹھٹھٕ_باز
हांसकुरें: اسُن_ _مزاکیہ_ ٹھٹھٕ_باز
हांसपी: اَسٕوُن_ اَسوُن_گِنٛدوُن اَسہٕوُن ہَسمُکھ
हांसमूख: اَسوُن
हांसयाळें: اسُن_ _مزاکیہ_ ٹھٹھٕ_باز اَسٕوُن_ اَسوُن_گِنٛدوُن
हांसरें: اَسوُن
हांसोवपी: مَزاقِیہ_ مَزاق_دار اَسَن_دار
हांस्यहीण: اَسناوَن_وانہِ
हाचे_सारको: یُتھ_ _ییٚمِس_ہیو_ _ییٚمہِ_شَکلہِ_ہُنٛد
हाडकुळें: أڑِجہِ_کرٛنٛز زٲویُلنیُک أڑِجوٗ
हाडांचें: أڑجِدار _أڑِجوٗ
हात_मारपी: دونٛکھٕ_باز دَغاباز تارَن_گوٚر
हातबरपाचें: قَلمی_ اَتھو_لٮ۪کِھِتھ _اَتَھو_لیٚکھِمٕتۍ
हाता_खालचें: ماتحَت
हातांत_जाता_अशें: خۄدمۄختار
हातांत_जाय_सारकें: خۄدمۄختار
हारिल्लो: پَتھ_روٗدٕمُت ناکام_ _شٕخَصت
हालत: گیٖران _نزان
हालपी: نامَنٛظوٗر
हालयिल्लें: ہَٹوومُت ڈولمُت ہِلیومُت لَرزیومُت
हाल्मिखुशाल: زِنٛدٕ_دِل
हावरट: لالچی خۄدغَرٕض مَطلٔبی یٔڈَل
हावरें: لالچی خۄدغَرٕض مَطلٔبی
हावी: ہٲوی قٲبِز
हावेसाचें: خوٲہِش_مَنٛد یوٚژھمُت _اُمیٖد_کوٚرمُت _وۄمید_کوٚرمُت
हासयाळें: اَسوُن
हास्य: مَزاقِیہ
हिंदी: ہیٚنٛدی
हिंदुस्थानी: ہِنٛدُستٲنۍ _ہِنٛدُستانُک
हिंसक: ظٲلِم سَخٕت_ شٔدیٖد
हिजडो: نامَرٕد
हितकारी: فٲیدٕ_مَنٛد
हिमटो: کٔنٛجوٗسکوٚنٛڑ
हिमालयी: ہِمالِیاہُک
हिवाळी: وَنٛدُک
हिसबा_भायलें: بے_شُمار
हीणपणाचें: گِریومُت
हुंड्याचें: داجُک
हुंपूंक_जायनाशिल्लो: ناقٲبلہِ_حَصوٗل
हुंवारग्रस्त: سٔہلاب_سۭتۍ_مُتٲثِر _سٔہلاب_لَد _سٔہلاب_زَد سٔہلاب_لَد _سٔہلاب_زَد
हुंवारान_पिडेस्त: سٔہلاب_لَد _سٔہلاب_زَد
हुनहुनीत: توٚت_توٚت_ _گَرٕم_گَرٕم_ _گَرما_گَرٕم پویہٕ_مُت توٚت _گَرٕم
हुप_सारकें: ترنَس_لایَق
हुबेहुब: ہوٗبہوٗ ہِیوٗ
हुमटपी: مُلہٕ_کَڑَن_وول
हुमटायिल्लें: مُلہٕ_کوٚڑمُت
हुमेचें: عٲرقہٕ_سۭتۍ_وۄتَھن_وول عٲرقہٕ_سۭتۍ_پٲدٕ_گَژھَن__وول
हुमेल्ली: عٲرقہٕ_ہوٚت_ _عٲرقہٕ__اوٚدُر
हुलपल्लें: دوٚدمُت
हुलपावपी: دزن_وول
हुल्लडबाज: فاس_تراون_وول _فَسٲدۍ
हुशार: قٲبِلہُنر_منٛدمٲہِِر عقل_مَنٛدسَمَجھداردٮ۪ماغدارذٔہیٖندٲنِش_منٛد بہتَر_ _ٹھیٖک_ _مُنٲسِب چالاک تیز ہُشار رِنٛدٕ زِنٛدٕ_دِل چالاک_ _عٲقٕل__ _ذہیٖن_ __شٲطِر _تُرٛک_ _گاٹُل
हुसक्यामेकळें: بےٚ_فِکِر
हुसक्यामेकळो: بےٚفِکِر _فِکرِروٚس
हुस्को: فِکِر_مَنٛد
हुस्क्याचें: پریشان_کَرٕوُن_ _دۄکھ_واتناوَن_وول_ _فِکِر_منٛد_کَرَن_وول
हून: توٚتگرٕموٕشُن پویہٕ_مُت وٕشنیردار توٚت _گَرٕم
हॅटीचें: ہیٹی_ہُنٛد ہیٹِیَن
हॅटीयी: ہیٹی_ہُنٛد ہیٹِیَن
हे_तरेचें: تیُتھ
हे_तरेचो: یُتھ_ _ییٚمِس_ہیو_ _ییٚمہِ_شَکلہِ_ہُنٛد
हे_भशेचें: تیُتھ
हे_सारकें: تیُتھ
हे_सारको: یُتھ_ _ییٚمِس_ہیو_ _ییٚمہِ_شَکلہِ_ہُنٛد
हेच_तरेन: یُتُھے_ _ییٚتھۍ_ہِیوٗ
हेच_भशेन: یُتُھے_ _ییٚتھۍ_ہِیوٗ
हेडगें: پھیروُن نَژوُن خانہٕ_بَدوش_ _ٹھِکانہٕ_روٚس_ _دَر_بہٕ_دَر_پھیرَن_وول
हेर: بییٚہِباقٕے باقٕے _دٔیمہِ غٲر مَزید
हेर_कोराचें: بیٚیہِ_کُنہِ_رنٛگُک
हेर_रंगाचें: بیٚیہِ_کُنہِ_رنٛگُک
हेरगिरीचें: جاسوٗسی
हेरवर्णी: بیٚیہِ_کُنہِ_رنٛگُک
हेरांचें: بیٚیہِ_سُنٛد
हैदराबादी: حیدَرآبادُک حیدرآبٲدۍ حیدَرآبٲدی
हॉडुरसी: ہانٛڑوٗرسُک ہانٛڑوٗرٔسۍ ہانٛڑوٗرَن
होंवरेंत_रावपी: گۄپھہِ_منٛز_روزَن_وول
