"ଉପରୋକ୍ତ: മേല്പറഞ്ഞ മുമ്പേ_പറയപ്പെട്ട
53_: അന്പത്തി_മൂന്ന്
54: അന്പത്തി_നാല്
61: അറുപത്തി_ഒന്ന്
63: അറുപത്തി_മൂന്ന്
67: അറുപത്തി_ഏഴ്
71: എഴുപത്തി_ഒന്ന്
|: സ്ഥാപിക്കപ്പെട്ട.
ଅଂସସ୍କୃତ: അപരിഷ്കൃതമായ മാന്യമല്ലാത്ത സംസ്കാരമില്ലാത്ത_പ്രാകൃതപ്പെരുമാറ്റമുള്ള
ଅଇଁଠା: ഉച്ഛിഷ്ടമായ എച്ചിലായ ഫേലമായ ചണ്ടിയായ ശേഷിച്ച
ଅକଣ୍ଟକ: വിഘ്നം_ഇല്ലാത്ത്. മുള്ളില്ലാത്ത.
ଅକଥନୀୟ: പറയുവാന്_കൊള്ളാത്ത. പറയുവാന്_പറ്റാത്തത്.
ଅକଥିତ: പറയാത്ത
ଅକଥ୍ୟ: പറയുവാന്_കൊള്ളാത്ത.
ଅକର୍ତ୍ତା: ജോലി_ചെയ്യാത്ത.
ଅକର୍ମଣ୍ୟ: അങ്ഗ_വൈകല്യമുള്ള.
ଅକର୍ମା: അംഗവൈകല്ല്യമുള്ള.
ଅକର୍ମା_: പണിയെടുക്കാത്ത.
ଅକର୍ଷିତ: ക്ര്‌ഷിയില്ലാത്ത ക്ര്‌ഷിപ്പണി_നടക്കാത്ത.
ଅକଲ୍ୟାଣକାମୀ: അമംഗളകരം_ഇഷ്ട്ടപ്പെടുന്നവന് അശുഭ_ചിന്തകന്ന്.
ଅକଲ୍ୟାଣକାରୀ: അമംഗളകരമായ.
ଅକଳାତ୍ମକ|: പ്രവ്ര്ത്തിയിലെ_കൌശലമില്ലായ്മ.
ଅକଳ୍ପନୀୟ: സങ്കല്പ്പിക്കാവുന്നതിനപ്പുറം.
ଅକଳ୍ପିତ: സങ്കല്പ്പിക്കാവുന്നതിനപ്പുറം.
ଅକାଟ: അതിക്രമിച്ചുകൂടാത്ത.
ଅକାଟ୍ୟ: അതിക്രമിച്ചുകൂടാത്ത.
ଅକାଧିପତି: സമ്രാട്ട് ചക്രവര്ത്തി.
ଅକାମି: നിരസിക്കപ്പെട്ട റദ്ദാക്ക്പ്പെട്ട.
ଅକାରଣ: അകാരണമായ
ଅକାରଣ_: ഉപയോഗശൂന്യ്മായ.
ଅକାଳ: നിശ്ചിതസമയത്തല്ലാത്ത.
ଅକାଳଜାତ: അകാലത്തില്_ജനിച്ച.
ଅକାଳିକ: നിശ്ചിതസമയത്തല്ലാത്ത.
ଅକିଞ୍ଚନ_: പ്രാധാന്യമില്ലാത്ത.
ଅକୁଟିଳ: കാപട്യമില്ലാത്ത നിഷ്കളങ്കരായ ശാന്തസ്വഭാവമുള്ള
ଅକୁଳାଣ: അപര്യാപ്തമായത് അപൂറ്ണ്ണമായത്.
ଅକୁଳୀନ: താഴ്ന്ന.
ଅକୁଶଳୀ: സാമറ്ത്ഥ്യമില്ലാത്ത മിടുക്കില്ലാത്ത നൈപുണ്യമില്ലാത്ത കുശലതയില്ലാത്ത കാര്യക്ഷമയില്ലാതാത്ത വൈദ്ഗദ്ധ്യമില്ലാത്ത പ്രാഗ്ലഭ്യമില്ലാത്ത പ്രവീണ്യമില്ലാത്ത ചാതുര്യമില്ലാത്ത മികവില്ലാത്ത പാടവമില്ലാത്ത വിരിതില്ലാത്ത.
ଅକୁହା: പറയാത്ത
ଅକୃତ|: ചെയ്യാത്തത്.
ଅକୃତକାର୍ଯ୍ୟ: തോറ്റുപോയ തോറ്റ പരാജയപ്പെട്ട വിഫലമായ അപജയപ്പെട്ട.
ଅକୃତଜ୍ଞ: നന്ദികെട്ട ഉപകാരസ്മരണയില്ലാത്ത.
ଅକୃତିମ_: സ്വാഭാവികമായ ഭൌതികമായ നൈസര്‍ഗ്ഗികമായ സ്വാഭാവികമായ.
ଅକୃଷ୍ଟ: ക്ര്‌ഷിയില്ലാത്ത ക്ര്‌ഷിപ്പണി_നടക്കാത്ത.
ଅକ୍ରୋଧୀ|: ക്രോധമില്ലാത്ത്.
ଅକ୍ଲାନ୍ତ: ക്ഷീണിക്കാത്ത മടുക്കാത്ത.
ଅକ୍ଳିଷ୍ଟ: മനസ്സിലാക്കാവുന്ന ധരിക്കാവുന്ന.
ଅକ୍ଷତ: നസിക്കാതെ. മുഴുവനായുള്ള. തിരിചചടിക്കാത്ത.
ଅକ୍ଷମ: സാമര്ഥ്യം_ഇല്ലാത്ത.
ଅକ୍ଷମ୍ୟ: ക്ഷമിക്കാന്_പറ്റാത്തത്.
ଅକ୍ଷୁଣ୍ଣ: വിഭജിക്കപ്പെടാത്ത അഖ്ണ്ഡമായ കൂടിചേര്ന്ന.
ଅକ୍ଷୟ: ദഹനമില്ലായ്മ.
ଅଖଂଡ୍ୟ: അതിക്രമിച്ചുകൂടാത്ത. അഭേദ്യമായ.
ଅଖଣ୍ଡ: വിഭജിക്കപ്പെടാത്ത അഖ്ണ്ഡമായ കൂടിചേര്ന്ന.
ଅଖଣ୍ଡନୀୟ: അതിക്രമിച്ചുകൂടാത്ത. അഭേദ്യമായ.
ଅଖଣ୍ଡିତ: വിഭജിക്കപ്പെടാത്ത അഖ്ണ്ഡമായ കൂടിചേര്ന്ന. പരുക്കില്ലാത്ത
ଅଖଣ୍ଡିତ_: മുഴുവനായുള്ള.
ଅଖାଡୁଆ: നിയന്ത്രണമില്ലാത്ത തോന്ന്യാസമുള്ള ധിക്കാരപരമായ.
ଅଖାଦ୍ୟ: ആഹാരമല്ലാത്തത്.
ଅଖ୍ୟାତ: പ്രസിദ്ധമല്ലാത്ത.
ଅଗଡବଗଡ_: അസംബന്ധം.
ଅଗଢା: ശരിയായ_രൂപമില്ലാത്ത രൂപപെടുത്ത ആക്ര്‌തിയില്ലാത്ത വടിവില്ലാത്ത.
ଅଗଣନ: അസംഖ്യം.
ଅଗଣନୀୟ: അസംഖ്യം.
ଅଗଣିତ: അസംഖ്യം. എണ്ണാത്ത
ଅଗତି: ചലനമില്ലാത്ത ചലിക്കാത്ത ഗതിരോധമുള്ള.
ଅଗଭୀର: ആഴമില്ലാത്ത ആഴം_കുറഞ്ഞ താഴ്ച_കുറഞ്ഞ
ଅଗମ୍ୟ: ബുദ്ധിമുട്ടുള്ള_. ജയിക്കാന്_പറ്റാത്ത. അസീമമായ ചെന്നെത്താന്_പറ്റാത്ത.
ଅଗମ୍ୟ|: പ്രവേശിക്കാന്_പറ്റാത്ത.
ଅଗହିରିଆ: ആഴമില്ലാത്ത ആഴം_കുറഞ്ഞ താഴ്ച_കുറഞ്ഞ
ଅଗାଧ: വളരേ_ആഴമുള്ള അഗാധമായ. വളരേ.
ଅଗୁଣୀ: ദുര്ഗുണ്ങളുള്ള
ଅଗୁପ୍ତ: പരസ്യമായ.
ଅଗୋପନୀୟ: രഹസ്യസ്വഭാവമല്ലാത്ത രഹസ്യമല്ലാത്ത.
ଅଗ୍ର: ആദ്യത്തെ.
ଅଗ୍ରଗଣ୍ୟ: പ്രമുഖന്‍. ബഹുമാനിക്കപ്പെട്ട ആദരിക്കപ്പെട്ട. കുറേ_കൂടി_ഭേദമായ കൂടുതല്_മെച്ചപ്പെട്ടതായ.
ଅଗ୍ରଗତ: പുരോഗതിയുള്ള ഉയര്‍ച്ചയുള്ള ഉന്നതിയുള്ള.
ଅଗ୍ରଗାମୀ: മുന്പേ_നടക്കുന്ന മുന്പനായ ശ്രേഷ്ഠനായ. മുന്നേറുന്ന പുരോഗമനോന്മുഖമായ. പുരോഗമന_വാദി.
ଅଗ୍ରଣୀ: പുരോഗതിയുള്ള ഉയര്‍ച്ചയുള്ള ഉന്നതിയുള്ള. പ്രമുഖന്‍.
ଅଗ୍ରପ୍ରେଷିତ: മുന്പില്_പോകുന്ന.
ଅଗ୍ରବର୍ତ୍ତୀ: ആദ്യത്തെ.
ଅଗ୍ରାହ୍ୟ|: നിരസിക്കപ്പെട്ട റദ്ദാക്ക്പ്പെട്ട.
ଅଘଞ୍ଚ: ഇടതൂര്ന്നതല്ലാത്ത.
ଅଘଟନୀୟ: സംഭവിക്കുവാനല്ലാത്തത്.
ଅଘଟିତ: സംഭവിക്കാത്ത അസാധ്യമായ.
ଅଘଟ୍ୟ|: സംഭവിക്കുവാനല്ലാത്തത്.
ଅଘନ: ഇടതൂര്ന്നതല്ലാത്ത.
ଅଙ୍କାବଙ୍କା: പരുപരുത്ത
ଅଙ୍କୁରିତ: മുളച്ച.
ଅଙ୍ଗଧାରୀ: ശരീരമുള്ള
ଅଙ୍ଗହୀନ: അംഗവിഹീന വികലാംഗ അംഗഭംഗ അംഗവൈകല്യമുള്ള കോട്ടം_വന്ന ശരീരക്ഷ്തം_വന്ന.
ଅଙ୍ଗହୀନ_: മുടന്തനായ.
ଅଙ୍ଗାରକଳା: ഭയങ്ങ്കരമായി_കറുത്ത.
ଅଙ୍ଗିଭୁତ: ഗ്രസിക്കപ്പെട്ട.
ଅଙ୍ଗୀ: ശരീരമുള്ള
ଅଙ୍ଗୀକୃତ: സ്വന്തമായി_തിരഞ്ഞെടുത്ത.
ଅଚଞ୍ଚଳ: മാറാത്ത ഇളക്കപ്പെടാത്ത സ്ഥിരമായ അചഞ്ഞലമായ. ഗൌരവമുള്ള പതറാത്ത സുദൃഢമായ സുസ്ഥിരമായ വളരേ_ശാന്തമായ_മനസ്സുള്ള.
ଅଚଳ: ക്രിത്രിമമായ.
ଅଚଳ_ସ୍ଥାବର: സ്ഥാവരങള്.
ଅଚାନକ: പെട്ടെന്നുള്ള.
ଅଚିଂତ୍ୟ: സങ്കല്പ്പിക്കാവുന്നതിനപ്പുറം.
ଅଚିକିତ୍ସିତ: ശുശ്രൂഷിക്കപ്പെട്ട ചികിത്സിക്കപ്പെട്ട ചികിത്സ_നല്‍കപെട്ട.
ଅଚିତ୍ରିତ_: വര്ണ്ണിക്കാത്ത്
ଅଚିନ୍ତନୀୟ_: സങ്കല്പ്പിക്കാവുന്നതിനപ്പുറം. വിചാരിക്കാത്തത്.
ଅଚିନ୍ତା: കൂസലില്ലാത്ത.
ଅଚିନ୍ତା_: ചിന്താഹീനനായ.
ଅଚିନ୍ତିତ_: വിചാരിക്കാതെ അവിചാരിതമായി.
ଅଚିହ୍ନା_: അപരിചിതമായ.
ଅଚେତ: ബോധമില്ലാത്ത.
ଅଚେତନ: ബോധമില്ലാത്ത. ജഡം.
ଅଚୈତନ୍ୟ: ജഡം.
ଅଛଡା: തൊലി_കളയാത്ത
ଅଛିଡା: പ്രശ്നപരിഹാരമില്ലാത്ത പ്രശ്നം_പരിഹരിക്കാത്ത.
ଅଛିଣ୍ଡା: പ്രശ്നപരിഹാരമില്ലാത്ത പ്രശ്നം_പരിഹരിക്കാത്ത.
ଅଛିନ୍ଦ୍ରାନ୍ବେଷକ_: ചിദ്രമില്ലാത്ത ദോഷരഹിതമായ
ଅଛୁଁଆ_: തൊട്ടുകൂടാത്ത.
ଅଛୁଆଁ: തൊടാത്ത
ଅଛୁତ: തൊട്ടുകൂടാത്ത.
ଅଛେଦ୍ୟ: ഭേദിക്കാന്‍_പറ്റാത്തത് തുളക്കുവാന്‍_പറ്റാത്തത് അവിഭാജ്യം.
ଅଜଣା: അപമാനിക്കപ്പെട്ട അനാദരിക്കപ്പെട്ട. ബോധ്യമില്ലാത്ത അറിവില്ലാത്ത.
ଅଜବ: പ്രത്യേകതയുള്ള അപൂര്വമായ.വ്യത്യാസമായ.
ଅଜିତ: അജയ്യ്ന് തോല്പ്പിക്കാന_്വയ്യാത്ത.
ଅଜୁଟ: വിഭജിക്കപ്പെടാത്ത അഖ്ണ്ഡമായ കൂടിചേര്ന്ന.
ଅଜେୟ: അജയ്യ്ന് തോല്പ്പിക്കാന_്വയ്യാത്ത.
ଅଜ୍ଞ: അറിവില്ലാത്ത് അറിഞ്ഞുകൂടാത്ത.
ଅଜ୍ଞାତ: അപരിചിതമായ. മൂടിയ ഒളിച്ച.
ଅଜ୍ଞାତ_: ബോധ്യമില്ലാത്ത അറിവില്ലാത്ത.
ଅଜ୍ଞାନୀ: അവിവേകി.
ଅଜ୍ଞେୟ: ജയിക്കാന്_പറ്റാത്ത.
ଅଟକାଣ: അടഞ്ഞുപ്പോയ
ଅଟକି_ଯାଇଥିବା: ഒടക്കിയ.
ଅଟକିଥିବା|: പ്രവഹിക്കാത്ത ശാന്ത_മായ നില്‍ക്കുന്ന സ്ഥിരമായ ഗതിഹീനമായ.
ଅଟଳ: സ്ഥിരമായ. ദ്രിഢമായ. അനിവാര്യമായ.
ଅଟ୍ଟାଳିକାର: കെട്ടിട_സംബന്ധിച്ച കെട്ടിട_സംബന്ധമായ.
ଅଠସ୍ତରିତମ: എഴുപത്തി_എട്ടാമത്തെ
ଅଠାଅଶୀତମ: എണ്പത്തി_എട്ടാമത്തെ.
ଅଠାନବେତମ: തൊണ്ണൂറ്റി_എട്ടാമത്തെ
ଅଡୁଆରହିତ|: കെട്ടു_കുടുങ്ങാത്ത.
ଅଢଙ୍କା: തുറന്ന മൂടി_നീക്കിയ അടപ്പു_മാറ്റിയ
ଅଢାଇ|: രണ്ടര
ଅଢେଇ: രണ്ടര
ଅଣ-ପ୍ରତିସ୍ବାକ୍ଷରିତ: നേരാണെന്ന്_തെളിയിക്കാവുന്ന.
ଅଣଅର୍ଜିତ: ആര്ജ്ജിക്കാത്ത
ଅଣଉତ୍ପାଦିତ: ഉത്പാദനമില്ലാത്ത
ଅଣଉପାର୍ଜିତ: അധ്വാനിക്കാതെ_സമ്പാദിച്ച
ଅଣକର୍ତ୍ତା: ജോലി_ചെയ്യാത്ത.
ଅଣକୁହା: പറയാത്ത
ଅଣଟେକନିକୀୟ: സാങ്കേതികമല്ലാത്ത.
ଅଣଟ୍ରେଣ୍ଡ୍: ശിക്ഷണം_ചെയ്യപ്പെടാത്ത പരിശീലിപ്പിക്കാത്ത ശീലിപ്പിക്കാത്ത.
ଅଣତଉଲା: കണക്കില്ലാത്ത
ଅଣନିମନ୍ତ୍ରିତ: ക്ഷണിക്കപ്പെടാത്ത
ଅଣପରଖା: പരിശോധിക്കാത്ത അന്വേഷിക്കാത്ത പരീക്ഷിക്കാത്ത.
ଅଣପାରିବାରିକ: കുടുമ്ബപരമല്ലാത്ത.
ଅଣପ୍ରତିଯୋଗୀ: മത്സരിക്കത്തവന്‍.
ଅଣବୁଝା: മണ്ടന്മാരായ
ଅଣଯୁକ୍ତ_: നിയോഗിക്കപ്പെടാത്ത
ଅଣଯୋଗୀ_: നിയോഗമില്ലാത്ത
ଅଣରକ୍ଷା: സൂക്ഷിക്കാത്ത
ଅଣଷଠିତମ: അന്പത്തി_ഒന്പതാമത്തെ
ଅଣସ୍ତରିତମ: അറുപത്തി_ഒന്പതാം
ଅଣସ୍ବାକ୍ଷରିତ: ഒപ്പു_കൂടാതെയുള്ള ഒപ്പു_വൈക്കാത്ത.
ଅଣହାଜିର: അസന്നിഹിതനായ ഇല്ലാത്ത ഹാജരില്ലാത്ത വരത്ത
ଅଣାଅଶୀ: എഴുപത്തി_ഒന്പത്
ଅଣାଅଶୀତମ: എഴുപത്തി_ഒന്പതാമത്തെ
ଅଣାକାର: ക്ലിപ്തരൂപമില്ലാത്ത.
ଅଣାନବେତମ: തൊണ്ണൂറാമത്തെ.
ଅଣୁପାୟ_: ഉപായമില്ലാതെ നിവാരണമില്ലാത്ത
ଅଣ୍ଡଜ: മുട്ടയിടുന്ന.
ଅଣ୍ଡାକାର: അണ്ണ്ഡാക്ര്തിയിലുള്ള_.
ଅଣ୍ଡାକୃତି: അണ്ണ്ഡാക്ര്തിയിലുള്ള_.
ଅତଳ: ആഴമുള്ള താഴ്ചയുള്ള
ଅତି: വളരേ.
ଅତି_ଅଳ୍ପ: ലേശം_മാത്രം.
ଅତି_ଆଧୁନିକ: അത്യാധുനികമായ അതി_നൂതനമായ അതി_നവീനമായ.
ଅତି_ଆବିଷ୍ଟ: വളരേ_ഭയങ്കരമായ കഠിനമായ.
ଅତି_କଟୁ: വളരെ_കൈപ്പുള്ള അത്യധികം_കൈപ്പേറിയ അപ്രിയമായ.
ଅତି_କ୍ଷୀଣକାୟ: എല്ലും_തോലാകുക.
ଅତି_ସୂକ୍ଷ୍ମ: അത്യധികം_സൂക്ഷ്മമായ.
ଅତିଅଧିକ: വളരേയധികം.
ଅତିଆବଶ୍ଯକ: അത്യന്താപേക്ഷിതമാണ്‍ അനിവാര്യമാണ്‍ അവശ്യം_വേണ്ടുന്ന അപരിഹാര്യ വേണ്ടതായ ഒഴിച്ചു_നിര്‍ത്താനാവാത്ത ഒഴിവാക്കാനാവാത്ത അത്യാവശ്യമായ സര്‍വപ്രധാനമായ കൂടിയെ_കഴിയു_എന്നുള്ള ആവശ്യകമായ അടിസ്ഥാനപരമായ മര്‍മ്മപ്രധാനമായ.
ଅତିକ: വളരേ.
ଅତିକଳା: ഭയങ്ങ്കരമായി_കറുത്ത.
ଅତିକ୍ରମଣୀୟ_: അനുസരിക്കാതിരിക്കല്
ଅତିକ୍ରମିତ: ലംഘനം_ചെയ്യപ്പെട്ട.
ଅତିକ୍ରାନ୍ତ: ലംഘനം_ചെയ്യപ്പെട്ട. നിയമം_ലംഘിക്കല്‍
ଅତିକ୍ରୁଦ୍ଧ: അത്യധികം_ക്രോധ്ധമുള്ള.
ଅତିଖିଆ: അധികം_ഭക്ഷിക്കുന്ന വേഗം_വേഗം_ഭക്ഷിക്കുന്ന ഭക്ഷണപ്രിയനായ വയറനായ കൊതിയനായ.
ଅତିଗୂଢ: ദുരൂഹതയുള്ള.
ଅତିଦାନୀ: വളരെ_ദാനശീലനായ.
ଅତିନିମ୍ନ|: നീചമായ ഹീനമായ.
ଅତିପରାକ୍ରମୀ: അതിശക്തനായ.
ଅତିବ୍ୟୟୀ_: നന്നായി_ചിലവു_ചെയ്യുന്ന ദുര്‍വ്യയം_ചെയ്യുന്ന.
ଅତିରିକ୍ତ: കൂടാതെ അല്ലാതെ
ଅତିଶୟ: വളരേ.
ଅତୀତ: കഴിഞ്ഞുപോയ.
ଅତୀତକାଳର: പശ്ഴയ_കാലത്തെ.
ଅତୀନ୍ଦ୍ରିୟ: ഇന്ദ്രിയാതീതമായ.
ଅତୁଳନୀୟ: ഉപമയില്ലാത്ത അതുല്യമായ. തുല്യപ്പെടുത്താനില്ലാത്തത്.
ଅତୁଷ୍ଟ: അത്രുപ്തം.
ଅତୃପ୍ତ: അത്രുപ്തം.
ଅତ୍ଯାବଶ୍ଯକ: അത്യന്താപേക്ഷിതമാണ്‍ അനിവാര്യമാണ്‍ അവശ്യം_വേണ്ടുന്ന അപരിഹാര്യ വേണ്ടതായ ഒഴിച്ചു_നിര്‍ത്താനാവാത്ത ഒഴിവാക്കാനാവാത്ത അത്യാവശ്യമായ സര്‍വപ്രധാനമായ കൂടിയെ_കഴിയു_എന്നുള്ള ആവശ്യകമായ അടിസ്ഥാനപരമായ മര്‍മ്മപ്രധാനമായ.
ଅତ୍ୟଧିକ: വളരേയധികം.
ଅତ୍ୟନ୍ତ_ମଝବୁତ: സുദ്ര്‌ഢമായ കൂടുതല്‍_ശക്തിയുള്ള ദ്ര്‌ഢതയുള്ള ബലമുള്ള ഉറപ്പുള്ള സുസ്ഥാപിതമായ കനത്ത കഠിനമായ കരുത്തുള്ള ഗാഢമായ.
ଅତ୍ୟନ୍ତିକ: വളരേ.
ଅତ୍ୟଳ୍ପ: ലേശം_മാത്രം.
ଅତ୍ୟାଚାରୀ: സദാചാരമില്ലാത്ത മറ്റുള്ളവരേ_ഉപദ്രവിക്ക്ല്.
ଅତ୍ୟାଧୁନିକ: അത്യാധുനികമായ അതി_നൂതനമായ അതി_നവീനമായ.
ଅତ୍ୟାହାରୀ: അധികം_ഭക്ഷിക്കുന്ന വേഗം_വേഗം_ഭക്ഷിക്കുന്ന ഭക്ഷണപ്രിയനായ വയറനായ കൊതിയനായ.
ଅତ୍ୟୁଚ୍ଚ: മ്ര്‌ദുവായ നേറ്മ്മയുള്ള‌ കനം_കുറഞ്ഞ ആറ്ദ്രമായ സൌമ്യതയുള്ള.
ଅଥଳ: വളരേ_ആഴമുള്ള അഗാധമായ.
ଅଦମ୍ୟ: അടക്കാന്_പടാത്ത പ്രബലമായ ജയിക്കാന്_പറ്റാത്ത.
ଅଦରକାରୀ: അനാവശ്യമായ.
ଅଦର୍ଶନୀୟ: കാണാന്_കൊള്ളാത്ത.
ଅଦିନିଆ: കാലത്തിനല്ലാത്ത
ଅଦୂରଦର୍ଶୀ: മുന്നാലോചന_ഇല്ലാത്ത.
ଅଦୃଶ୍ୟ: കണ്ണുകൊണ്ടു_കാണാന്_പറ്റാത്തത്.
ଅଦୃଶ୍ୟମାନ: കണ്ണുകൊണ്ടു_കാണാന്_പറ്റാത്തത്.
ଅଦୃଶ୍ୟାତ୍ମା: അശരീരി.
ଅଦୃଷ୍ଟ: കണ്ണുകൊണ്ടു_കാണാന്_പറ്റാത്തത്. നിരീക്ഷിക്കതക്കതല്ലാത്ത.
ଅଦେଖା: കണ്ണുകൊണ്ടു_കാണാന്_പറ്റാത്തത്. നിരീക്ഷിക്കതക്കതല്ലാത്ത.
ଅଦେୟ|: വീട്ടാന്_പറ്റാത്തത്.
ଅଦ୍ଧବାର୍ଷିକ: അരകൊല്ലത്തെ.
ଅଦ୍ବିତୀୟ: ഉപമയില്ലാത്ത അതുല്യമായ.
ଅଦ୍ଭୁତ: അസാമാന്യമായ അത്ഭുതകരമായ വിസ്മയകരമായ. പ്രത്യേകതയുള്ള അപൂര്വമായ.വ്യത്യാസമായ.
ଅଦ୍ଭୁତପୂର୍ବ: പ്രത്യേകതയുള്ള അപൂര്വമായ.വ്യത്യാസമായ.
ଅଦ୍ୟ: മുമ്പുള്ള പ്രാരംഭികമായ ആദ്യമായ.
ଅଦ୍ୟତନ: ആധുനികം.
ଅଦ୍ୱକ୍ଷ: സാമറ്ത്ഥ്യമില്ലാത്ത മിടുക്കില്ലാത്ത നൈപുണ്യമില്ലാത്ത കുശലതയില്ലാത്ത കാര്യക്ഷമയില്ലാതാത്ത വൈദ്ഗദ്ധ്യമില്ലാത്ത പ്രാഗ്ലഭ്യമില്ലാത്ത പ്രവീണ്യമില്ലാത്ത ചാതുര്യമില്ലാത്ത മികവില്ലാത്ത പാടവമില്ലാത്ത വിരിതില്ലാത്ത.
ଅଧପତିତ: താഴേക്കു_പോകുന്നവന്‍.
ଅଧମ: ദുഷ്ട ദുഷിച്ച ചീത്ത നീച
ଅଧମରା: പകുതി_മരിച്ച.
ଅଧର୍ମୀ: ധര്‍മ്മബോധമില്ലാത്ത ധര്‍മ്മവിരുദ്ധിയായ
ଅଧର୍ଯ୍ୟ|: ഇളകിമറിഞ്ഞ തകിടം_മറിഞ്ഞ.
ଅଧସ୍ଥନ: കീഴ്പെട്ട അധീനതയുള്ള.
ଅଧା: പകുതി.
ଅଧାକଞ୍ଚା: പകുതി_പഴുത്ത.
ଅଧାଖଣ୍ଡିଆ: മുഴുവനാകാത്ത.
ଅଧାଖୋଲା: പകുതി_അടഞ്ഞ.
ଅଧାପାଚିଲା: പകുതി_പഴുത്ത.
ଅଧାମୁଦା: പകുതി_അടഞ്ഞ.
ଅଧାରୁଆ: മൂര്‍ച്ചയില്ലാതാക്കപെട്ട മുനയില്ലാതായ
ଅଧାର୍ମିକ: ധര്‍മ്മബോധമില്ലാത്ത ധര്‍മ്മവിരുദ്ധിയായ
ଅଧିକ: വളരേ. കുറേ_കൂടി_ഭേദമായ കൂടുതല്_മെച്ചപ്പെട്ടതായ.
ଅଧିକ_ଖରାପ: മോശമായ
ଅଧିକାର_ପ୍ରାପ୍ତ: അവകാസപ്പെട്ട് അധികാരപ്പെട്ട.
ଅଧିକାର_ଯୁକ୍ତ: അവകാസപ്പെട്ട് അധികാരപ്പെട്ട.
ଅଧିକାରପୂର୍ଣ୍ଣ: അധികാരപൂര്‍ണ്ണമായ അധികാരം_ഉള്ള്.
ଅଧିକାରଶୂନ୍ୟ: അനധിക്രിതമായ
ଅଧିକାରହୀନ|: അധികാര_ഹീനനായ ആധിപത്യം_ഇല്ലാത്ത നായകത്വം_ഇല്ലാത്ത.
ଅଧିକାରୀ: അവകാസപ്പെട്ട് അധികാരപ്പെട്ട.
ଅଧିକୃତ: കണ്ടുകെട്ട്പ്പെട്ട്.
ଅଧିକୃତ|: സ്വായത്തമാക്കിയ.
ଅଧିକ୍ରାନ୍ତ: ആക്ക്രമിക്കപ്പെട്ട
ଅଧିକ୍ଷିପ୍ତ: ഉപേക്ഷിച്ച
ଅଧିଗୁପ୍ତ: നിഗൂഢത
ଅଧିଗୃହୀତ: സ്വായത്തമാക്കിയ.
ଅଧିଯୁକ୍ତ: ജോലിക്ക്_വെച്ച
ଅଧିଷ୍ଟ: പൂജ്യനായ
ଅଧିଷ୍ଠାପିତ: സ്ഥാപിക്കപ്പെട്ട.
ଅଧିଷ୍ଠିତ: സ്ഥാപിക്കപ്പെട്ട.
ଅଧିଷ୍ଠିତ|: ക്രിത്യമായി_സ്ഥാന_നിര്ണ്യം_നടത്തിയ.
ଅଧୀନ: കീഴ്പെട്ട അധീനതയുള്ള. സ്വാതന്ത്ര്യമില്ലാത്ത അടിമയായ. നിയമം_പാലിക്കുന്ന.
ଅଧୀନସ୍ଥ: കീഴ്പെട്ട അധീനതയുള്ള.
ଅଧୀର: ചഞ്ചലചിത്തനായ അസ്ഥിരനായ ഇളകിമറിഞ്ഞ തകിടം_മറിഞ്ഞ.
ଅଧୁଆ: കഴുകാത്ത
ଅଧୁନାତନ: ആധുനികം.
ଅଧୃତ: ഇട്ടിട്ടില്ലാത്ത
ଅଧୈର୍ଯ୍ୟବାନ: ചഞ്ചലചിത്തനായ അസ്ഥിരനായ
ଅଧୋଗତ: താഴേക്കു_പോകുന്നവന്‍.
ଅଧ୍ୟକ୍ଷହୀନ_: അദ്ധ്യക്ഷവിഹീനമായ
ଅଧ୍ୟକ୍ଷୀୟ: അധ്യക്ഷീയ.
ଅଧ୍ୟବସାୟୀ: പരിശ്രമിക്കുക പ്രയത്നിക്കുക അധ്വാനിക്കുക കഠിനയത്നം_ചെയ്യുക സ്ഥിരമായി_പരിശ്രമിക്കുന്ന
ଅଧ୍ୟାପିତ: പഠിപ്പിച്ച
ଅଧ୍ୟାବସାୟୀ|: ഉത്സാഹമുള്ള_.
ଅଧ୍ୟାୟୀ: പഠിപ്പില്_ശ്രദ്ധിക്കുന്ന അദ്ധ്യാപനം
ଅଧ୍ୟେୟ: വായിക്കുവാന്_പറ്റിയ
ଅନତିକ୍ରମଣୀୟ_: അതിരുകടക്കാതെയുള്ള
ଅନତିକ୍ରମିତ: അതിക്രമിച്ചു_കയറാത്ത.
ଅନଧିକାର: അനധിക്രിതമായ
ଅନଧିକାରୀ: അനധിക്രിതമായി
ଅନଧ୍ୟକ୍ଷ: അദ്ധ്യക്ഷവിഹീനമായ
ଅନନ୍ତ: അവസാനമില്ലാത്ത അന്തമില്ലാത്ത. നിസ്സീമമായ അതിരറ്റ. എന്നും_നിലനില്ക്കുന്ന.
ଅନନ୍ତବିଶ୍ବୀୟ: ഈശ്വരന്_സ്രിഷ്ട്ടിച്ച_സമ്പൂര്ണ്ണ_വസ്തുക്കളുടേയും_സമൂഹത്തെ_സംബന്ധിക്കുന്നത്.
ଅନନ୍ତଲୋକୀୟ: ഈശ്വരന്_സ്രിഷ്ട്ടിച്ച_സമ്പൂര്ണ്ണ_വസ്തുക്കളുടേയും_സമൂഹത്തെ_സംബന്ധിക്കുന്നത്.
ଅନନ୍ୟଗତି: സന്ദേഹമില്ലാതെ ധാരണയോടെ ഉപായത്തോടെ നിശ്ചയത്തോടെ ധൈര്യത്തോടെ ഉറ്പ്പോടെ തീറ്ച്ചയോടെ.
ଅନପେକ୍ଷ_: ആഗ്രഹമില്ലാത്ത_പക്ഷപാതമില്ലാത്ത. ആഗ്രഹമില്ലാത്ത
ଅନପେକ୍ଷିତ: ആഗ്രഹിക്കാത്ത അപേക്ഷിക്കാത്ത മറ്റൊന്നിനെ_ആശ്രയിക്കാത്ത. ആഗ്രഹിക്കാത്ത.
ଅନବଗାହୀ_: അഗാധതയെ_മറി_കടക്കാത്ത.
ଅନବଗ୍ରହ_: തടയാന്_പറ്റാത്ത.
ଅନବଧାନ: ജാഗ്രതയില്ലാത്ത.
ଅନବଲୋକିତ|: നിരീക്ഷിക്കതക്കതല്ലാത്ത.
ଅନବସ୍ଥିତ: ചഞ്ചലചിത്തനായ അസ്ഥിരനായ
ଅନବହିତ: ജാഗ്രതയില്ലാത്ത.
ଅନବହେଳିତ_: തിരസ്ക്കരിക്കാതെയുള്ള ഉപേക്ഷിക്കാതെയുള്ള അവഗണിക്കപ്പെടാതെയുള്ള.
ଅନବିଦ୍ଧ|: തുളയ്ക്കപ്പെടാത്ത.
ଅନଭିଜ୍ଞ: പ്രായോഗികജ്ഞാനമില്ലാത്ത അഭ്യാസജ്ഞാനമില്ലാത്ത പ്രാവറ്ത്തികജ്ഞാനമില്ലാത്ത ക്രിയാത്മകജ്ഞാനമില്ലാത്ത അനുഭവസിദ്ധന്മല്ലാത്ത പക്വതയില്ലാത്ത.
ଅନଭିମତ: അനിഷ്ട്ടമായ
ଅନଭିମତ_: സ്വീകാര്യമല്ലാത്ത
ଅନଭିଳାଷୀ: ആഗ്രഹമില്ലാത്തവന്.
ଅନଭିଳାସୀ: ആഗ്രഹമില്ലായ്മ
ଅନଭ୍ୟସ୍ତ: പുതുതായി_പഠിച്ച അപക്വമായ ശിക്ഷണം_ചെയ്യപ്പെട്ട സിദ്ധിക്കപ്പെടാത്ത അഭ്യസിക്കാത്ത. അഭ്യസിക്കാത്ത.
ଅନମନୀୟ: അചഞ്ചലമായ മാറാത്ത നിശ്ചലമായ.
ଅନମିତ: മുട്ടു_മടക്കാത്ത കുനിയാത്തത വളയാത്ത.
ଅନର୍ଥକାରୀ: ദോഷം_ചെയ്യുന്ന അഹിതം_ചെയ്യുന്ന ഹാനികരമായ നിന്ദിക്കുന്ന അനാദരവു_കാണിക്കുന്ന ദ്വേഷം_ഉണ്‍ടാക്കുന്ന.
ଅନର୍ଥକାରୀ|: ദോഷം_ചെയ്യുന്ന.
ଅନଳଂକୃତ: അലംഗരിക്കാത്ത.
ଅନସୂୟ|: അസൂയ_ഇല്ലാതിരിക്കുക.
ଅନସ୍ତ: അസ്തമിക്കാത്ത
ଅନସ୍ତମିତ_: അസ്തമിക്കാത്ത
ଅନାକ୍ରାନ୍ତ_: ആക്രമിക്കാത്ത.
ଅନାଗତ|: വരാത്ത.
ଅନାଗମ୍ୟ: ബുദ്ധിമുട്ടുള്ള_.
ଅନାଚାରୀ: ദുശ്ചരിത്രം.
ଅନାଚ୍ଛାଦିତ: തുറന്ന മൂടി_നീക്കിയ അടപ്പു_മാറ്റിയ
ଅନାଜ୍ଞା_: അനുവാദം_കൂടാതെ
ଅନାଡି: സാമറ്ത്ഥ്യമില്ലാത്ത മിടുക്കില്ലാത്ത നൈപുണ്യമില്ലാത്ത കുശലതയില്ലാത്ത കാര്യക്ഷമയില്ലാതാത്ത വൈദ്ഗദ്ധ്യമില്ലാത്ത പ്രാഗ്ലഭ്യമില്ലാത്ത പ്രവീണ്യമില്ലാത്ത ചാതുര്യമില്ലാത്ത മികവില്ലാത്ത പാടവമില്ലാത്ത വിരിതില്ലാത്ത.
ଅନାତ୍ମ_: ആത്മാവില്ലാത്ത
ଅନାତ୍ମୀୟ: ആത്മാവില്ലാത്ത
ଅନାଥ: അനാഥ രക്ഷിതാവില്ലാത്ത രക്ഷയില്ലാത്ത ആശ്രയമില്ലാത്ത അഗതിയായ അഭയമില്ലാത്ത ഉടമയില്ലാത്ത. നിസ്സഹായ സഹായമില്ലാത്ത ആശ്രയമില്ലാത്ത നിരാലംബ അശരണ കെല്പില്ലാത്ത നിറ്ധനനായ. അനാഥന്
ଅନାଦରଣୀୟ: ആദരണീയനല്ലാത്ത
ଅନାଦି: നിസ്സീമമായ അതിരറ്റ.
ଅନାଦୃତ: അപമാനിതനായ ആദരിക്കപ്പെടാത്ത തിരസ്ക്രിതനായ
ଅନାଦ୍ର: വരണ്ട് ഉണങ്ങിയ ശുഷ്കമായ
ଅନାବଶ୍ୟକ: ഉപയോഗശൂന്യ്മായ. അനാവശ്യമായ. ആഗ്രഹമില്ലാത്ത_പക്ഷപാതമില്ലാത്ത.
ଅନାବାସିକ_: പുറമ്പോക്ക്_സ്ഥലം
ଅନାବିଳ: നിര്‍മ്മലമായ വിമലമായ പവിത്രമായ് ശുദ്ധമായ
ଅନାବୃତ: തുറന്ന
ଅନାବୃତ୍ତ: തുറന്ന മൂടി_നീക്കിയ അടപ്പു_മാറ്റിയ
ଅନାବୃତ୍ତ_: ആവര്ത്തിക്കാത്ത
ଅନାରକ୍ଷିତ: സംവരണം_ചെയ്തിറ്ട്ടില്ലാത്ത.
ଅନାଶ୍ରିତ: ദരിദ്രനായ.
ଅନାସକ୍ତ: ആസക്തനല്ലാത്ത.
ଅନାସ୍ବାଦ: സ്വാദില്ലാത്ത.
ଅନାହତ: നസിക്കാതെ.
ଅନାହାର_: ഉപവാസം നിരാഹാരം
ଅନାହାର୍ଯ୍ୟ|: ആഹാരമല്ലാത്തത്.
ଅନିକେତ: വീടില്ലാത്തവര്.
ଅନିଚ୍ଛିତ: ആഗ്രഹിക്കാത്ത.
ଅନିଚ୍ଛୁ: ആഗ്രഹമില്ലാത്തവന്.
ଅନିଚ୍ଛୁକ: ആഗ്രഹമില്ലാത്തവന്.
ଅନିଦ୍ରା: നിദ്രയില്ലാത്ത
ଅନିଦ୍ରିତ|: ഉണര്ന്നിരിക്കുന്ന.
ଅନିନ୍ଦନୀୟ_: നിന്ദിക്കാന്_പാടില്ലാത്ത
ଅନିନ୍ଦିତ_: നിന്ദിക്കാത്ത
ଅନିପୁଣ: സാമറ്ത്ഥ്യമില്ലാത്ത മിടുക്കില്ലാത്ത നൈപുണ്യമില്ലാത്ത കുശലതയില്ലാത്ത കാര്യക്ഷമയില്ലാതാത്ത വൈദ്ഗദ്ധ്യമില്ലാത്ത പ്രാഗ്ലഭ്യമില്ലാത്ത പ്രവീണ്യമില്ലാത്ത ചാതുര്യമില്ലാത്ത മികവില്ലാത്ത പാടവമില്ലാത്ത വിരിതില്ലാത്ത. സാമറ്ത്ഥ്യമില്ലാത്ത മിടുക്കില്ലാത്ത നൈപുണ്യമില്ലാത്ത കുശലതയില്ലാത്ത കാര്യക്ഷമയില്ലാതാത്ത വൈദ്ഗദ്ധ്യമില്ലാത്ത പ്രാഗ്ലഭ്യമില്ലാത്ത പ്രവീണ്യമില്ലാത്ത ചാതുര്യമില്ലാത്ത മികവില്ലാത്ത പാടവമില്ലാത്ത വിരിതില്ലാത്ത.
ଅନିବର୍ତୀ_: പിന്മാ‍റാത്ത
ଅନିବାରିତ_: തടയപ്പെടാത്ത
ଅନିବାର୍ଯ୍ୟ_: അനിവാര്യമായ.
ଅନିଭୃତ: പരസ്യമായ.
ଅନିମନ୍ତ୍ରିତ: ക്ഷണിക്കപ്പെടാത്ത
ଅନିରୂପିତ: ശരിയായ_രൂപമില്ലാത്ത വിക്ര്‌ത്കമായ മോശമായ.
ଅନିର୍ଜିତ_: തോറ്റ
ଅନିର୍ଦ୍ଦିଷ୍ଟ: അനിശ്ചിതമായ നിശ്ചയമില്ലാത്ത.
ଅନିର୍ଦ୍ଧାରିତ: ഉറപ്പു_വരുത്താത്ത നിശ്ചിതമല്ലാത്ത നിശ്ചയിക്കപ്പെടാത്ത.
ଅନିର୍ଧାଯ୍ୟ_: തീരുമാനമെടുക്കാനാവാത്ത വിമര്ശിക്കാനാവാത്ത
ଅନିର୍ବାଚ୍ୟ_: തെരഞ്ഞെടുക്കാന്_പറ്റാത്ത
ଅନିର୍ବାଯ୍ୟ: അനിവാര്യം.
ଅନିର୍ବାହ୍ୟ_: നിലനിര്ത്താത്ത ജീവിച്ചു_പോകാത്ത
ଅନିର୍ମଳ: മുഷിഞ്ഞ ശുചിയല്ലാത്ത അഴുക്കായ മലിനപ്പെട്ട വൃത്തിഹീനമായ
ଅନିର୍ମିତ: നിര്മ്മിക്കാത്ത. ശരിയായ_രൂപമില്ലാത്ത രൂപപെടുത്ത ആക്ര്‌തിയില്ലാത്ത വടിവില്ലാത്ത.
ଅନିଶ୍ଚିତ: ഉറപ്പു_വരുത്താത്ത നിശ്ചിതമല്ലാത്ത നിശ്ചയിക്കപ്പെടാത്ത. അനിശ്ചിതമായ നിശ്ചയമില്ലാത്ത.
ଅନିଶ୍ଚୟାତ୍ମକ: ഇതികര്‍ത്തവ്യതാമൂഢത_ഉണ്ടാക്കുന്ന ഇതികര്‍തവ്യതാമൂഢത_ജനിപ്പിക്കുന്ന.
ଅନିଷିଦ୍ଧ: നിഷിദ്ധമല്ലാത്ത.
ଅନିଷ୍ଟକାରୀ: അമംഗളകരമായ.
ଅନିଷ୍ଠକାରୀ: ദോഷം_ചെയ്യുന്ന അഹിതം_ചെയ്യുന്ന ഹാനികരമായ നിന്ദിക്കുന്ന അനാദരവു_കാണിക്കുന്ന ദ്വേഷം_ഉണ്‍ടാക്കുന്ന.
ଅନିୟତ: അനിശ്ചിതമായ നിശ്ചയമില്ലാത്ത.
ଅନିୟମିତ: ക്രമമില്ലാത്ത
ଅନୀତିଜ୍ଞ_: നിയമം_അറിയാത്ത
ଅନୀତିପୂର୍ଣ୍ଣ: ഉചിതമല്ലാത്ത അനീതിപൂര്‍ണ്ണമായ തെറ്റായ നീതിക്കു_വിരുദ്ധമായി.
ଅନୁକରଣକାରୀ: അനുകരിക്കുന്ന പിന്തുടരുന്ന അനുഗമിക്കുന്ന
ଅନୁକରଣକାରୀ_: പിന്തുടരുന്ന
ଅନୁକରଣୀୟ: അനുകരണീയം.
ଅନୁକୂଳ: യോജിക്കുന്ന അനുകൂലമായ ചേര്‍ച്ചയുള്ള പൊരുത്തമുള്ള ഐക്യമുള്ള കൂടികലരുന്ന സംയോജിക്കുന്ന.
ଅନୁକୂଳିତ_: അനുകൂലമായ
ଅନୁକୃତ: അനുകരണം വേറെ_ഒന്നിനെ_മാത്രികയാക്കല്‍ അനുവ്ര്‌ത്തി അനുകരിക്കല്‍ അനുകര്‍മ്മം അനുഗതി അനുപ്രവേശം അനുഹരണം അന്യര്‍ചെയ്യുന്നതു_പോലെ_ചെയ്യല്‍.
ଅନୁକ୍ତ: പറയാത്ത
ଅନୁକ୍ରମିକ: ക്രമത്തിലുള്ള.
ଅନୁଗଣିତ_: എണ്ണമില്ലാത്ത
ଅନୁଗତ: നിയമം_പാലിക്കുന്ന.
ଅନୁଗୃହୀତ: നന്ദിയുള്ള ഉപകാര_സ്മരണയുള്ള.
ଅନୁଗ୍ରହକାରୀ: ദയാലുവായ ക്രിപാലുവായ കാരുണികനായ മഹാമനസ്കനായ
ଅନୁଚିତ: ഉചിതമല്ലാത്ത അനീതിപൂര്‍ണ്ണമായ തെറ്റായ നീതിക്കു_വിരുദ്ധമായി. അനുചിതമായ അയുക്‌തമായ ശരിയല്ലാത്ത ഔചിത്യമില്ല്ലാത്ത അരുതാത്ത
ଅନୁଚ୍ଚ: കുറഞ്ഞ ചെറിയതായ.
ଅନୁଚ୍ଛିନ୍ନ_: പരുക്കില്ലാത്ത
ଅନୁଜ୍ଞାତ: സ്വീകരിച്ച സ്വീകരിക്കപ്പെട്ട അനുമതി_കിട്ടിയ അനുമതി_പ്രദാനം_ചെയ്ത.
ଅନୁଜ୍ଞାପିତ_: സ്വീക്രിതമായ
ଅନୁତାପି_: പശ്ചാതപിക്കുന്നവന്
ଅନୁତାପୀ: പശ്ചാത്തപിക്കുന്നവന്‍
ଅନୁତୀର୍ଣ୍ଣ: തോറ്റുപോയ തോറ്റ പരാജയപ്പെട്ട വിഫലമായ അപജയപ്പെട്ട.
ଅନୁତ୍ତର: ഉത്തരം_ഇല്ലാത്ത.
ଅନୁତ୍ତର|: മൌനമായ.
ଅନୁତ୍ତରଦାୟୀ: ചുമതലപ്പെടാത്ത.
ଅନୁତ୍ତରିତ: ഉത്തരമില്ലാത്ത.
ଅନୁତ୍ସାହୀ: അനുത്സാഹികളായ.
ଅନୁତ୍ସୁକ: ഉത്സാഹമില്ലാത്ത.
ଅନୁଦିତ: ഭാഷാന്തരം_ചെയ്യപ്പെട്ട തര്‍ജ്ജിമ_ചെയ്യപ്പെട്ട വിവര്‍ത്തനം_ചെയ്യപ്പെട്ട ഭാഷാന്തരം_ചെയ്യപ്പെട്ട.
ଅନୁଦ୍ଧୃତ_: ഉദ്ധരിക്കപ്പെട്ട
ଅନୁପକାରୀ: ദോഷം_ചെയ്യുന്ന അഹിതം_ചെയ്യുന്ന ഹാനികരമായ നിന്ദിക്കുന്ന അനാദരവു_കാണിക്കുന്ന ദ്വേഷം_ഉണ്‍ടാക്കുന്ന.
ଅନୁପଥ_: നേരെ_പോകുന്ന
ଅନୁପଭୁକ୍ତ: ഉപയോഗിക്കാത്തത്.
ଅନୁପମ: ഉപമയില്ലാത്ത അതുല്യമായ.
ଅନୁପଯୋଗୀ: ഉപയോഗശൂന്യ്മായ.
ଅନୁପଲବ୍ଧ: ലഭിച്ചിട്ടില്ലാത്ത്.
ଅନୁପସ୍ଥିତ: അസന്നിഹിതനായ ഇല്ലാത്ത ഹാജരില്ലാത്ത വരത്ത
ଅନୁପୂରକ: അനുബന്ധം
ଅନୁପେକ୍ଷିତ: തിരസ്ക്കരിക്കാതെയുള്ള ഉപേക്ഷിക്കാതെയുള്ള അവഗണിക്കപ്പെടാതെയുള്ള.
ଅନୁପ୍ରସ୍ଥ: കുറുകെയുള്ള വിലങ്ങനെയുള്ള ചെരിഞ്ഞ വളഞ്ഞ.
ଅନୁପ୍ରାଣିତ: ഉത്പ്രേരിതമായ
ଅନୁବଂଧିତ_: ബന്ധിക്കപ്പെടാത്ത സ്വാധീനമായ മുക്തമായ.
ଅନୁବକ୍ର: വക്രമായ
ଅନୁବଦ୍ଧ: ബന്ധിക്കപ്പെടാത്ത സ്വാധീനമായ മുക്തമായ.
ଅନୁବନ୍ଧିତ: ആഗിരണം_ചെയ്ത അനുബന്ധമായ.
ଅନୁବାଦକ: വിവവ്ര്ത്തകന്‍.
ଅନୁବାଦନୀୟ: തര്‍ജ്ജിമചെയ്യാവുന്ന.
ଅନୁବାଦିତ: ഭാഷാന്തരം_ചെയ്യപ്പെട്ട തര്‍ജ്ജിമ_ചെയ്യപ്പെട്ട വിവര്‍ത്തനം_ചെയ്യപ്പെട്ട ഭാഷാന്തരം_ചെയ്യപ്പെട്ട.
ଅନୁବିଷ୍ଟ: കുറിച്ചു_വച്ച.
ଅନୁବୃତ୍ତିକ: പെന്‍ഷനിന്റെ പെന്‍ഷനിന്റെ
ଅନୁଭବହୀନ: പ്രായോഗികജ്ഞാനമില്ലാത്ത അഭ്യാസജ്ഞാനമില്ലാത്ത പ്രാവറ്ത്തികജ്ഞാനമില്ലാത്ത ക്രിയാത്മകജ്ഞാനമില്ലാത്ത അനുഭവസിദ്ധന്മല്ലാത്ത പക്വതയില്ലാത്ത.
ଅନୁଭବି: ദ്രിഢ്വിശ്വാസമുള്ള
ଅନୁଭବୀ: പ്രായോഗികന്ജ്ഞാനമുള്ള അനുഭവന്ജ്ഞാനം_ഉള്ള പരിചയസമ്പന്നത_ഉള്ള ഇടപഴക്കമുള്ള പ്രായോഗികജ്ഞാനം_ഉള്ള വിഷയാസക്തനായ സുഖാന്വേഷിയായ അനുഭവസ്ഥന്‍ ദു ദ്രിക്സാക്ഷി.
ଅନୁଭୂତି_ପ୍ରବଣ: മ്രിദുല_വികാരങള്ക്ക്_അടിമപ്പെടുന്ന.
ଅନୁମତି_ଦିଆଯାଇନଥିବା|: വിധിപ്രകാരം_നല്കാത്ത.
ଅନୁମତି_ପ୍ରାପ୍ତ: സ്വീകരിച്ച സ്വീകരിക്കപ്പെട്ട അനുമതി_കിട്ടിയ അനുമതി_പ്രദാനം_ചെയ്ത. സ്വീക്രിതമായ
ଅନୁମାନଯୋଗ୍ୟ: അനുമാനിക്കാന്_യോഗ്യമായ
ଅନୁମାନସିଦ୍ଧ: അനുമാനിക്കാന്_യോഗ്യമായ
ଅନୁମାନାତୀତ: അപ്രതീക്ഷിതമായി.
ଅନୁଯୁକ୍ତ: അയോഗ്യനായ ഉപയോഗമില്ലാത്ത പറ്റാത്ത കൊള്ളാത്ത തെറ്റായ അശക്തമായ കഴിവില്ലാത്ത പ്രാപ്തിയില്ലാത്ത അനുയോജ്യമില്ലാത്ത അനുരൂപമല്ലാത്ത സന്മുചിതമല്ലാത്ത അനറ്ഘമായ യുക്തമല്ലാത്ത.
ଅନୁରକ୍ତ: പ്രേമാസക്തനായ.
ଅନୁରଞ୍ଜକ: അനുരാഗമുണ്ടാക്കുന്ന
ଅନୁରଞ୍ଜିତ: സ്നേഹം_നിറഞ്ഞ നിറമായ വറ്ണ്ണമായ ചായമായ രഞ്ജിതമായ അനുരഞ്ജിതമായ.
ଅନୁରାଗଯୁକ୍ତ: പ്രേമാസക്തനായ.
ଅନୁରାଗୀ: പ്രേമാസക്തനായ.
ଅନୁରୂପ: യോജിക്കുന്ന അനുകൂലമായ ചേര്‍ച്ചയുള്ള പൊരുത്തമുള്ള ഐക്യമുള്ള കൂടികലരുന്ന സംയോജിക്കുന്ന. തുല്യമായ സമമായ സമാനമായ ഒരു_പോലെയുള്ള സമാനരൂപിയായ തനിപ്പകര്‍പ്പ്. ചേര്‍ച്ചയുള്ള.
ଅନୁରୋପ: ത്ത്സ്വരൂപമായ പ്ര്തിരൂപമായ പകറ്പ്പായ സാദ്ര്ശ്മായ പ്തിച്ഛായയുള്ള്.‌
ଅନୁଲିପ୍ତ: സ്നേഹം_നിറഞ്ഞ
ଅନୁଶାସକ: ഭരണകര്‍ത്താവ് ആജ്ഞാപിക്കുന്നവന്‍.
ଅନୁଶାସନିକ: അച്ചടക്ക_സംബന്ധിയായ നിഷ്കര്‍ഷണ_സംബന്ധിയായ അനുനയ_സംബന്ധിയായ.
ଅନୁଶାସନୀୟ: അച്ചടക്കം_പാലിക്കുന്ന
ଅନୁଶୀଳନୀୟ: പരിശീലിച്ചു_പഠിച്ച
ଅନୁଶୀଳିତ: വേണ്ട്വിധം_പഠനം_ചെയ്യപ്പെടുക
ଅନୁସନ୍ଧାନି_: അന്വേഷണ
ଅନୁସନ୍ଧାନିତ: ഗവേഷണപരമായ
ଅନୁସନ୍ଧି: അന്വേഷണ
ଅନୁସନ୍ଧିଚ୍ଛୁକ: ചോദ്യങള്ക്കുള്ള
ଅନୁସରଣକାରୀ: അനുകരിക്കുന്ന
ଅନୁସାର: യോജിക്കുന്ന അനുകൂലമായ ചേര്‍ച്ചയുള്ള പൊരുത്തമുള്ള ഐക്യമുള്ള കൂടികലരുന്ന സംയോജിക്കുന്ന.
ଅନୁସୃତ: അനുകരണം വേറെ_ഒന്നിനെ_മാത്രികയാക്കല്‍ അനുവ്ര്‌ത്തി അനുകരിക്കല്‍ അനുകര്‍മ്മം അനുഗതി അനുപ്രവേശം അനുഹരണം അന്യര്‍ചെയ്യുന്നതു_പോലെ_ചെയ്യല്‍.
ଅନୁହବରହିତ: പ്രായോഗികജ്ഞാനമില്ലാത്ത അഭ്യാസജ്ഞാനമില്ലാത്ത പ്രാവറ്ത്തികജ്ഞാനമില്ലാത്ത ക്രിയാത്മകജ്ഞാനമില്ലാത്ത അനുഭവസിദ്ധന്മല്ലാത്ത പക്വതയില്ലാത്ത.
ଅନେକ: അനേകം ഒന്നിലധികമായ പല വളരെയേറേ അസംഖ്യം.
ଅନେକ_ପ୍ରକାର: പലവിധേനയുള്ള
ଅନେକାକ୍ଷର: അനേകാക്ഷരമുള്ള
ଅନେକାନ୍ତ: വിജനമല്ലാത്ത ഒറ്റ്യ്ക്കല്ലാത്ത തനിയെ_അല്ലാത്ത
ଅନେକାର୍ଥ: അനേകാര്‍ഥമുള്ള
ଅନେଶତତମ: തൊണ്ണൂറ്റ്_ഒന്പതാമത്തെ
ଅନୈଚ୍ଛିକ: ഇച്ഛാനുസരണമല്ലാത്ത ആഗ്രഹപൂര്‍ണ്ണമല്ലാത്ത.
ଅନୈତିକ: ഉചിതമല്ലാത്ത അനീതിപൂര്‍ണ്ണമായ തെറ്റായ നീതിക്കു_വിരുദ്ധമായി.
ଅନ୍ତ: അവസാനം.
ଅନ୍ତଃସତ୍ତ୍ବା: ഗര്ഭവതി ഗര്ഭിണി.
ଅନ୍ତକାରୀ: മരിക്കുവാന്‍_ഉതകുന്ന.
ଅନ୍ତବର୍ତ୍ତୀ: മധ്യ_ഭാഗത്ത്.
ଅନ୍ତବ୍ୟ_: പോകേണ്ട
ଅନ୍ତରଙ୍ଗ: ആന്തരികമായ. അടുത്ത.
ଅନ୍ତରାଭିମୁଖୀ: അന്തര്മുഖനായ മനസ്സിലേക്കു_നോക്കുന്ന.
ଅନ୍ତରାଷ୍ଟ୍ରୀୟ: അന്താരാഷ്ട്രീയമായ.
ଅନ୍ତର୍ଗତ: ഗ്രസിക്കപ്പെട്ട.
ଅନ୍ତର୍ବତ୍ତୀ: ആന്തരികമായ.
ଅନ୍ତର୍ମୁଖୀ: അന്തര്മുഖനായ മനസ്സിലേക്കു_നോക്കുന്ന.
ଅନ୍ତର୍ଲୀନ: മുഴുകിയ. അന്തര്മുഖനായ മനസ്സിലേക്കു_നോക്കുന്ന.
ଅନ୍ତର୍ହିତ: വംശനാശം_സംഭവിച്ചത്. കണ്ണുകൊണ്ടു_കാണാന്_പറ്റാത്തത്. മറയ്ക്കപ്പെട്ട് ഒളിയ്ക്കപ്പെട്ട്.
ଅନ୍ତସ୍ଥ: ആന്തരികമായ.
ଅନ୍ତହୀନ: അവസാനമില്ലാത്ത അന്തമില്ലാത്ത.
ଅନ୍ତିମ: അവസാനം. അവസാനത്തേതല്ലാത്ത
ଅନ୍ଧ: അന്ധനായ കാഴ്ചയില്ലാത്ത കണ്ണില്ലാത്ത
ଅନ୍ଧକାର: ഇരുട്ട്_നിറഞ്ഞ.
ଅନ୍ଧକାରପୂର୍ଣ୍ଣ: ഇരുട്ട്_നിറഞ്ഞ.
ଅନ୍ଧକାରମୟ: ഇരുട്ട്_നിറഞ്ഞ.
ଅନ୍ଧବିଶ୍ବାସୀ: അന്ധവിശ്വാസി
ଅନ୍ଧାର: ഇരുട്ട്_നിറഞ്ഞ.
ଅନ୍ଧାରପୂର୍ଣ୍ଣ: ഇരുട്ട്_നിറഞ്ഞ.
ଅନ୍ନଜାତ: കൊഴുപ്പ് കാര്‍ബൊഹൈഡ്രേറ്റ്
ଅନ୍ନମଗାଳି: ഭക്ഷണാര്‍ഥിയായ
ଅନ୍ନହାରୀ: ഭുജിക്കുന്നവന്‍
ଅନ୍ବର୍ଥ: അര്‍ത്ഥ്യുക്തമായ സാര്‍ത്ഥകമായ
ଅନ୍ବେଷିତ: ഗവേഷണപരമായ
ଅନ୍ୟ: വേറെയും മറ്റു മറ്റൊന്ന് രണ്ടാമത് അതല്ലാത്തത്.
ଅନ୍ୟ-ଅଧୀନ|: സ്വാതന്ത്ര്യമില്ലാത്ത അടിമയായ.
ଅନ୍ୟଏକ: വേറെയും മറ്റു
ଅନ୍ୟତମ: വളരെ_നല്ല്
ଅନ୍ୟଦେଶୀୟ: വിദേശി അന്യദേശക്കാരന്‍ വൈദേശികന്‍ അന്യന്‍ അന്യദിക്കുകാരന്‍ കുടിയേറ്രക്കാരന്‍.
ଅନ୍ୟମନସ୍କ: അന്യമനസ്കനായ
ଅନ୍ୟମନସ୍କ|: വിഷമിച്ച.
ଅନ୍ୟର: മറ്രുള്ളവരുടെ അന്യരുടെ അന്യമായ വേറെ_ആയ വൈദേശികമായ വിദേശിയായ തറ്റേതല്ലാത്ത പുറമേയുള്ള മറ്രൊന്നായ മറ്രേതായ ഇതരമായ സ്വന്തമല്ലാത്ത അപര.
ଅନ୍ୟାୟ: നിയമ_വിരുദ്ധമായ നിഷിദ്ധമായ.
ଅନ୍ୟାୟପୂର୍ଣ୍ଣ: അന്യായപൂര്‍ണ്ണമായ.
ଅନ୍ୟାୟବିଷୟକ: ന്യായ_വിരുദ്ധമായ നീതി_വിരുധ്ധ്ഹമായ.
ଅନ୍ୟାୟସମ୍ପର୍କୀତ: ന്യായ_വിരുദ്ധമായ നീതി_വിരുധ്ധ്ഹമായ.
ଅନ୍ୟାୟୀ: ന്യായമില്ലായ്മ അനീതി ന്യായവിരിദ്ധമായ_പെരുമാറ്റം അക്രമം അന്യായം_ചെയ്യുന്ന ദുരാചാരിയായ.
ଅପକର୍ମା: ദുഷ്കര്‍മ്മം_ചെയുന്നവന്‍.
ଅପକାରକ: ദോഷം_ചെയ്യുന്ന അഹിതം_ചെയ്യുന്ന ഹാനികരമായ നിന്ദിക്കുന്ന അനാദരവു_കാണിക്കുന്ന ദ്വേഷം_ഉണ്‍ടാക്കുന്ന.
ଅପକାରୀ: ദോഷം_ചെയ്യുന്ന അഹിതം_ചെയ്യുന്ന ഹാനികരമായ നിന്ദിക്കുന്ന അനാദരവു_കാണിക്കുന്ന ദ്വേഷം_ഉണ്‍ടാക്കുന്ന.
ଅପକ୍ଷ: താല്പര്യ_മില്ലായ്മ നിഷ്പക്ഷത. ചിറകൊടിഞ്ഞ
ଅପକ୍ୱ: പുതുതായി_പഠിച്ച അപക്വമായ ശിക്ഷണം_ചെയ്യപ്പെട്ട സിദ്ധിക്കപ്പെടാത്ത അഭ്യസിക്കാത്ത. പച്ചയായ പാകമല്ലാത്ത
ଅପଗୁଣୀ: ദുര്ഗുണ്ങളുള്ള
ଅପଚାରୀ: ദുശ്ചരിത്രം.
ଅପଟୁ: സാമറ്ത്ഥ്യമില്ലാത്ത മിടുക്കില്ലാത്ത നൈപുണ്യമില്ലാത്ത കുശലതയില്ലാത്ത കാര്യക്ഷമയില്ലാതാത്ത വൈദ്ഗദ്ധ്യമില്ലാത്ത പ്രാഗ്ലഭ്യമില്ലാത്ത പ്രവീണ്യമില്ലാത്ത ചാതുര്യമില്ലാത്ത മികവില്ലാത്ത പാടവമില്ലാത്ത വിരിതില്ലാത്ത.
ଅପଠନୀୟ: വായിക്കുവാന്‍_പറ്റാത്ത. വായനായോഗ്യമല്ലാത്ത
ଅପଠ୍ୟ: വായിക്കുവാന്‍_പറ്റാത്ത.
ଅପଢୁଆ: വിദ്യാഭാസമില്ലാത്ത പഠിപ്പില്ലാത്ത
ଅପଥ୍ୟ: ആരോഗ്യത്തിനു_ഹാനികരമായ
ଅପଦାର୍ଥ: അയോഗ്യനായ ഉപയോഗമില്ലാത്ത പറ്റാത്ത കൊള്ളാത്ത തെറ്റായ അശക്തമായ കഴിവില്ലാത്ത പ്രാപ്തിയില്ലാത്ത അനുയോജ്യമില്ലാത്ത അനുരൂപമല്ലാത്ത സന്മുചിതമല്ലാത്ത അനറ്ഘമായ യുക്തമല്ലാത്ത.
ଅପବର୍ତ୍ତିତ: മടക്കികൊണ്ടുവന്ന.
ଅପବାଦଯୁକ୍ତ: ആക്ഷേപകരമായ.
ଅପବାଦିତ: എതിര്‍ക്കപ്പെട്ട് തടയ്പ്പെട്ട്.
ଅପବାଦୀ|: നിന്ദിക്കുന്ന.
ଅପବିତ୍ର: അപവിത്രമായ അശുദ്ധമായ. മുഷിഞ്ഞ ശുചിയല്ലാത്ത അഴുക്കായ മലിനപ്പെട്ട വൃത്തിഹീനമായ
ଅପବ୍ୟୟୀ: നന്നായി_ചിലവു_ചെയ്യുന്ന ദുര്‍വ്യയം_ചെയ്യുന്ന. ധൂര്ത്തടിക്കുന്നവന്.
ଅପଭ୍ରଂଶ: മോശമായ ചീത്തയായ. ദുഷ്പദം
ଅପମାନକର୍ତ୍ତା: അനാദരവ്_കാണിക്കുന്ന
ଅପମାନକାରୀ: അപകര്‍ഷതയുള്ള
ଅପମାନଜନକ: പുച്ചിക്കുന്ന തിരസ്ക്കരണീയ അപമാന്യമായ അപമാനജനകമായ
ଅପମାନିତ: നിന്ദിക്കപ്പെട്ട അധിക്ഷേപിക്കപ്പെട്ട.
ଅପମାନୀ: അപമാനിക്കുന്ന
ଅପମିଶ୍ରିତ: അശുദ്ധം കലര്‍പ്പുള്ള മായം_ചേര്‍ത്ത.
ଅପର: വേറെയും മറ്റു
ଅପରାଜିତ: ജയിക്കപ്പെടാത്ത.
ଅପରାଜୟ: അജയ്യ്ന് തോല്പ്പിക്കാന_്വയ്യാത്ത.
ଅପରାଧ: തെറ്റായ ദുഷ്ക്ര്തമായ ചീത്തയായ ദുഷിച്ച തിന്മ_നിറഞ്ഞ ദോഷമുള്ള ദോഷകരമായ അധാറ്മ്മികമായ സദാചാര_വിരുദ്ധമായ അസന്മാറ്ഗ്ഗികമായ അന്യായമായ.
ଅପରାଧକର୍ତ୍ତା: അപരാധിയായ നിയമലംഘകനായ കുറ്റവാളിയായ പാപിയായ തെറ്റുകാരനായ
ଅପରାଧଶୀଳ: തെറ്റ്_ചെയ്യുന്ന കുറ്റം_ചെയ്യുന്ന പാപം_ചെയ്യുന്ന അക്രമം_ചെയ്യുന്ന കുറ്റക്ര്‌ത്യം_ചെയ്യുന്ന ദ്രോഹം_ചെയ്യുന്ന.
ଅପରାଧହୀନ: നല്ല.
ଅପରାଧୀ: അപരാധിയായ നിയമലംഘകനായ കുറ്റവാളിയായ പാപിയായ തെറ്റുകാരനായ
ଅପରାବର୍ତ୍ତୀ: പിന്നിലേക്ക്_മാറാത്ത പിന്വലിയാത്ത ഉത്സാഹം_ഉള്ള. പിന്നിലേക്ക്_മാറാത്ത പിന്വലിയാത്ത ഉത്സാഹം_ഉള്ള.
ଅପରାସ୍ତ|: ജയിക്കപ്പെടാത്ത.
ଅପରିକଳ୍ପିତ: അപരിചിതമായ പരിചിതമല്ലാത്ത അന്യമായ അവിദിതമായ പുതുമയുള്ള അജ്ഞാതമായ മുന്നറിവു_കിട്ടാത്ത.
ଅପରିଚିତ: ബോധ്യമില്ലാത്ത അറിവില്ലാത്ത. അപരിചിതമായ.
ଅପରିଣାମଦର୍ଶୀ|: മുന്നാലോചന_ഇല്ലാത്ത.
ଅପରିପକ୍ବ: പ്ക്വതയില്ലാത്ത പാകം_വരാത്ത പൂറ്ണ്ണ_വികാസം_പ്രാപിക്കാത്ത
ଅପରିପକ୍ବ|: പകുതി_പഴുത്ത.
ଅପରିପକ୍ୱ: പച്ചയായ പാകമല്ലാത്ത
ଅପରିପୂର୍ଣ୍ଣ: അപര്യാപ്തമായത് അപൂറ്ണ്ണമായത്.
ଅପରିବର୍ତ୍ତନଶୀଳ: മാറില്ലാത്ത മാറ്റംവരാത്ത.
ଅପରିବର୍ତ୍ତନୀୟ: മാറില്ലാത്ത മാറ്റംവരാത്ത.
ଅପରିବାରୀୟ: കുടുമ്ബപരമല്ലാത്ത.
ଅପରିମିତ: പരിമിതമല്ലാത്ത മിതമല്ലാത്ത.
ଅପରିମେୟ: നിസ്സീമമായ അതിരറ്റ.
ଅପରିଶୋଧିତ: ശുദ്ധീകരിക്കാത്ത പരിശോധിക്കാത്ത സംശുദ്ധിയാക്കാത്ത വിരേചനം_ചെയ്യാത്ത ശുചീകരിക്കാത്ത സംസ്കരിക്കാത്ത പരിപൂതമാക്കാത്ത. പൂറ്ത്തിയാക്കാത്ത അനുഭവൈക്കപ്പെടാത്ത തീരാത്ത.
ଅପରିଶୋଧ୍ୟ: വീട്ടാന്_പറ്റാത്തത്.
ଅପରିଷ୍କାର: മുഷിഞ്ഞ ശുചിയല്ലാത്ത അഴുക്കായ മലിനപ്പെട്ട വൃത്തിഹീനമായ മുഷിഞ്ഞ
ଅପରିଷ୍କୃତ: അശ്ലീലം.
ଅପରିହାର୍ଯ୍ୟ: അത്യന്താപേക്ഷിതമാണ്‍ അനിവാര്യമാണ്‍ അവശ്യം_വേണ്ടുന്ന അപരിഹാര്യ വേണ്ടതായ ഒഴിച്ചു_നിര്‍ത്താനാവാത്ത ഒഴിവാക്കാനാവാത്ത അത്യാവശ്യമായ സര്‍വപ്രധാനമായ കൂടിയെ_കഴിയു_എന്നുള്ള ആവശ്യകമായ അടിസ്ഥാനപരമായ മര്‍മ്മപ്രധാനമായ.
ଅପରିହିତ: നിസ്സീമമായ അതിരറ്റ.
ଅପରୀକ୍ଷିତ: പരിശോധിക്കാത്ത അന്വേഷിക്കാത്ത പരീക്ഷിക്കാത്ത.
ଅପର୍ଯ୍ୟାପ୍ତ: പരിമിതമല്ലാത്ത മിതമല്ലാത്ത.
ଅପସନ୍ଦ: ഇഷ്ട്ടപ്പെടാത്ത വെറുപ്പുണ്ടാക്കുന്ന.
ଅପହଞ୍ଚ: പ്രവേശനമില്ലാത്ത.
ଅପହରଣଯୋଗ୍ୟ: അപഹരിക്കാവുന്നത്. അപഹരിക്കാവുന്നത്.
ଅପହରଣୀୟ: അപഹരിക്കാവുന്നത്. അപഹരിക്കാവുന്നത്.
ଅପହାର୍ଯ୍ୟ: തട്ടിപ്പറിയ്ക്കാവുന്ന_വസ്തു.
ଅପହୃତ: അപഹരിക്കപ്പെട്ട്. അപഹരിക്കപ്പെട്ട്. അപഹരിക്കപ്പെട്ട.
ଅପହୃତ|: അപഹരിക്കപ്പെട്ട.
ଅପାଙ୍ଗ: വികലാംഗനായ
ଅପାଠୁଆ: വിദ്യാഭാസമില്ലാത്ത പഠിപ്പില്ലാത്ത
ଅପାଠ୍ୟ: വായിക്കുവാന്‍_പറ്റാത്ത. വായനായോഗ്യമല്ലാത്ത
ଅପାତ୍ର: അയോഗ്യനായ കൊള്ളരുതാത്ത.
ଅପାର: നിസ്സീമമായ അതിരറ്റ. അസീമമായ ചെന്നെത്താന്_പറ്റാത്ത. തിരിച്ചുകൊടുക്കാന്‍_പറ്റാത്ത.
ଅପାର_: വളരേ_ആഴമുള്ള അഗാധമായ.
ଅପାରଗ: അയോഗ്യനായ ഉപയോഗമില്ലാത്ത പറ്റാത്ത കൊള്ളാത്ത തെറ്റായ അശക്തമായ കഴിവില്ലാത്ത പ്രാപ്തിയില്ലാത്ത അനുയോജ്യമില്ലാത്ത അനുരൂപമല്ലാത്ത സന്മുചിതമല്ലാത്ത അനറ്ഘമായ യുക്തമല്ലാത്ത.
ଅପାରଗମ୍ୟ: അസീമമായ ചെന്നെത്താന്_പറ്റാത്ത.
ଅପାରିବାରିକ: കുടുമ്ബപരമല്ലാത്ത.
ଅପାରୀତ: സമ്മതമില്ലാത്ത.
ଅପିନ୍ଧା: ഇട്ടിട്ടില്ലാത്ത കോടിആയ.
ଅପୁଷ୍ପ: പുഷ്പങളില്ലാത്ത പൂക്കാത്ത പൂക്കലില്ലാത്ത പുഷ്പ്പിക്കാത്ത.
ଅପୁଷ୍ପିତ: പുഷ്പങളില്ലാത്ത പൂക്കാത്ത പൂക്കലില്ലാത്ത പുഷ്പ്പിക്കാത്ത. വിടരാത്ത.
ଅପୂଜନୀୟ: ആദരണീയനല്ലാത്ത
ଅପୂଜ୍ୟ: ആദരണീയനല്ലാത്ത
ଅପୂର୍ଣ୍ଣ: പൂര്‍ണ്ണമല്ലാത്തത് അപൂര്‍ണ്ണം. മുഴുവനാകാത്ത. അപര്യാപ്തമായത് അപൂറ്ണ്ണമായത്.
ଅପୂର୍ବ: ഉപമയില്ലാത്ത അതുല്യമായ. പ്രത്യേകതയുള്ള അപൂര്വമായ.വ്യത്യാസമായ. അഭൂതപൂര്വ്വമായ പണ്ണ്ടുണ്ടാവാത്ത.
ଅପୃଥକ: ഒന്നായത്.
ଅପେୟ: കുടിക്കുവാന്‍_കൊള്ളാത്ത. കുടിക്കുവാന്‍_പറ്റാത്ത.
ଅପୈତୃକ: അച്ഛനോടു_ബന്ധമില്ലാത്ത പിത്രു_സമ്പന്ധമല്ലാത്ത.
ଅପ୍ରକଟ୍ୟ: ഒളിക്കേണ്ടതായിട്ടുള്ള.
ଅପ୍ରକାଶ: മൂടിയ ഒളിച്ച.
ଅପ୍ରକାଶନୀୟ: പ്രസിദ്ധീകരിക്കാത്ത.
ଅପ୍ରକାଶିତ: പ്രസിദ്ധീകരിക്കാത്ത.
ଅପ୍ରକାଶ୍ୟ_: ഒളിക്കേണ്ടതായിട്ടുള്ള.
ଅପ୍ରଖର: മടിയുള്ള അലസതയുള്ള.
ଅପ୍ରଚଳିତ: പ്രചാരത്തിലില്ലാത്ത നടപ്പില്ലാത്ത പ്രസിദ്ധന്മില്ലാത്ത പരസ്യമല്ലാത്ത യുക്തമല്ലാത്ത പ്രാബല്യത്തിലില്ലാത്ത ആയുസ്സില്ലാത്ത.
ଅପ୍ରଚୁର: കുറച്ചു.
ଅପ୍ରତିକାର: തിരിച്ചുകൊടുക്കാന്‍_പറ്റാത്തത്.
ଅପ୍ରତିଦୃଦ୍ଧୀ: സ്വേച്ഛാധിപതിയായ അനിയന്ത്രിതനായ നിരങ്കുശനായ കടിഞ്ഞാണില്ലാത്ത.
ଅପ୍ରତିବଦ୍ଧ: സ്വേച്ഛാധിപതിയായ അനിയന്ത്രിതനായ നിരങ്കുശനായ കടിഞ്ഞാണില്ലാത്ത.
ଅପ୍ରତିମ: ഉപമയില്ലാത്ത അതുല്യമായ.
ଅପ୍ରତିଷ୍ଠିତ: അപമാനിക്കപ്പെട്ട അനാദരിക്കപ്പെട്ട.
ଅପ୍ରତିହତ: ജയിക്കപ്പെടാത്ത.
ଅପ୍ରତୀକ୍ଷିତ_: ആഗ്രഹിക്കാത്ത അപേക്ഷിക്കാത്ത മറ്റൊന്നിനെ_ആശ്രയിക്കാത്ത.
ଅପ୍ରତ୍ୟକ୍ଷ: അറിയാത്ത.
ଅପ୍ରତ୍ୟାଶିତ: ആഗ്രഹിക്കാത്ത അപേക്ഷിക്കാത്ത മറ്റൊന്നിനെ_ആശ്രയിക്കാത്ത. അപ്രതീക്ഷിതമായി.
ଅପ୍ରତ୍ୟାସିତ: പെട്ടെന്നുള്ള.
ଅପ୍ରଧାନ: പ്രമുഖനലാത്ത.
ଅପ୍ରବଳ: മടിയുള്ള അലസതയുള്ള.
ଅପ୍ରବାହ: പ്രവഹിക്കാത്ത ശാന്ത_മായ നില്‍ക്കുന്ന സ്ഥിരമായ ഗതിഹീനമായ.
ଅପ୍ରବିଣ: സാമറ്ത്ഥ്യമില്ലാത്ത മിടുക്കില്ലാത്ത നൈപുണ്യമില്ലാത്ത കുശലതയില്ലാത്ത കാര്യക്ഷമയില്ലാതാത്ത വൈദ്ഗദ്ധ്യമില്ലാത്ത പ്രാഗ്ലഭ്യമില്ലാത്ത പ്രവീണ്യമില്ലാത്ത ചാതുര്യമില്ലാത്ത മികവില്ലാത്ത പാടവമില്ലാത്ത വിരിതില്ലാത്ത.
ଅପ୍ରବିଷ୍ଟ: ഒന്നിലും_ഏര്‍പ്പെടാത്ത.
ଅପ୍ରବୃଦ୍ଧ: ഏറ്റവും_കുറവില്‍ അധികം_വലുതാകാത്ത.
ଅପ୍ରବେଶ୍ୟ: പ്രവേശിക്കാന്_പറ്റാത്ത.
ଅପ୍ରମତ୍ତ: ശ്രദ്ധയുള്ള.
ଅପ୍ରମାଣିତ: നേരാണെന്ന്_തെളിയിക്കാവുന്ന. തെളിയിക്കപ്പെടാത്ത.
ଅପ୍ରମୁଖ: പ്രമുഖനലാത്ത.
ଅପ୍ରଶଂସନୀୟ: പ്രശംസിക്കാന്‍_യോഗ്യമല്ലാത്ത.
ଅପ୍ରଶିକ୍ଷିତ: ശിക്ഷണം_ചെയ്യപ്പെടാത്ത പരിശീലിപ്പിക്കാത്ത ശീലിപ്പിക്കാത്ത.
ଅପ୍ରସଙ୍ଗ: സംബന്ധിക്കാത്ത ബന്ധമില്ലാത്ത.
ଅପ୍ରସନ୍ନ: ദു
ଅପ୍ରସିଦ୍ଧ: പ്രസിദ്ധമല്ലാത്ത.
ଅପ୍ରାକୃତ: ക്ര്‌ത്രിമമായ പ്രക്ര്‌തിവിരുദ്ധമായ.
ଅପ୍ରାକୃତିକ: ക്ര്‌ത്രിമമായ പ്രക്ര്‌തിവിരുദ്ധമായ.
ଅପ୍ରାକୃତିକ_: അസ്വാഭാവികമായ.
ଅପ୍ରାଚୀନ|: ആധുനികം.
ଅପ୍ରାପ୍ତ: ലഭിക്കാത്ത് കിട്ടാത്ത. പ്രാപ്യമല്ലാത്തത്.
ଅପ୍ରାପ୍ୟ|: ലഭിച്ചിട്ടില്ലാത്ത്. ദുര്ലഭമായ.
ଅପ୍ରାମାଣିକ: ആശ്രയമില്ലാത്ത അടിസ്ഥാനമില്ലാത്ത.
ଅପ୍ରାସଙ୍ଗିକ: സാന്ദര്ഭികമല്ലാത്ത അപ്രസക്തമായ. സാന്ദര്‍ഭികമല്ലാത്ത അനഭീഷ്ട്ടമായ അരുചികരമായ നന്നായിട്ട്_തോന്നാത്ത
ଅପ୍ରିୟ: വിരിദ്ധമായ അസന്തുഷ്ടമായ. ചീത്ത
ଅପ୍ରିୟବାଦୀ: ഇഷ്ട്ടമില്ലാത്തത്_സംസാരിക്കുന്ന സ്നേഹന്മില്ലാത്തതു_പറയുന്ന.
ଅପ୍ରିୟଭାଷୀ: ഇഷ്ട്ടമില്ലാത്തത്_സംസാരിക്കുന്ന സ്നേഹന്മില്ലാത്തതു_പറയുന്ന.
ଅପ୍ରୀତିକର: വിരിദ്ധമായ അസന്തുഷ്ടമായ.
ଅପ୍ରୟୋଜକ: പ്രയോഗിക്കാത്ത.
ଅଫଳନ୍ତି: ഫലഹീനമായത്.
ଅଫିମ: കറപ്പ്_തിന്നുന്നവന്‍.
ଅଫିସରିଆ: ആഫീസര്‍_എന്ന_പദവിക്ക്_തുല്യം. ഓഫീസ്_സംബന്ധമായ.
ଅଫୁଟା: വിടരാത്ത.
ଅଫେରନ୍ତ: മടക്കിക്കൊടുക്കാതത.
ଅବକ୍ର: നേരേ
ଅବକ୍ଷିପ୍ତ: തകര്‍ത്ത നിലത്തു_വീണ.
ଅବଗତ: മനസ്സിലാക്കാവുന്ന ധരിക്കാവുന്ന.
ଅବଗତ_: അറിവുള്ള
ଅବଜ୍ଞାକାରୀ: ആജ്ഞ്ഞ_അനുസരിക്കാത്ത
ଅବଧାରିତ_: വിധിപ്രകാരമുള്ള.
ଅବଧିହୀନ|: ആധിയില്ലാത്ത.
ଅବଧ୍ୟ: വധത്തിനര്‍ഹനല്ലാത്ത.
ଅବଧ୍ୟ?: വധത്തിനര്‍ഹനല്ലാത്ത.
ଅବନତ: താഴേക്കു_പോകുന്നവന്‍. മുന്നോട്ടു_കുനിഞ്ഞ.
ଅବନତିକାରୀ_: പതനത്തിന്‍_കാരണമായവന്‍.
ଅବନତିଶୀଳ: അധോഗതിശീലമുള്ള നശിച്ച്_ശീലമുള്ള.
ଅବନମିତ: കുനിയിക്കപ്പെട്ടവന്‍. മുട്ടു_മടക്കാത്ത കുനിയാത്തത വളയാത്ത.
ଅବମର୍ଦିତ|: ചവിട്ടി_അരച്ച.
ଅବମାନନାକାରୀ: ആജ്ഞ്ഞ_അനുസരിക്കാത്ത
ଅବରୁଦ୍ଧ: അടഞ്ഞുപ്പോയ
ଅବରୋଧକ: ഇന്സുലേറ്റര് തടയ്ല്.
ଅବରୋଧପୂର୍ଣ୍ଣ_: നിരോധനമുള്ള അവരോധമുള്ള.
ଅବରୋଧହୀନ: വിഘ്നം_ഇല്ലാത്ത്.
ଅବରୋଧିତ: ചുറ്റപ്പെട്ട ചുറ്റിയ.
ଅବରୋଧୀ|: ഇന്സുലേറ്റര് തടയ്ല്.
ଅବର୍ଣ୍ଣନୀୟ: പറയുവാന്_പറ്റാത്തത്.
ଅବର୍ଣ୍ଣିତ: വര്ണ്ണിക്കാത്ത്
ଅବଲମ୍ବନହୀନ: നിസ്സഹായ സഹായമില്ലാത്ത ആശ്രയമില്ലാത്ത നിരാലംബ അശരണ കെല്പില്ലാത്ത നിറ്ധനനായ.
ଅବଲମ୍ବିତ: പരാശ്രയി.
ଅବଲମ୍ବୀ_: ആശ്രയിക്കപ്പെട്ട.
ଅବଲୋକନୀୟ|: കാണാന്_കഴിയുന്ന.
ଅବଲୋକିତ: അവലോകനം_ചെയ്യപ്പെട്ട.
ଅବଶ: നിസ്സഹായനായ നിര്ബന്ധിതനായ
ଅବଶ୍ବସନୀୟ: വിശ്വസിക്കാന്_പറ്റാത്ത.
ଅବଶ୍ବସୀୟ: വിശ്വസിക്കാന്_പറ്റാത്ത.
ଅବଶ୍ୟମ୍ଭାବୀ: അനിവാര്യമായ.
ଅବସନ୍ନ: ക്ഷീണിച്ച.
ଅବସରପ୍ରାପ୍ତ: ജോലിയില്‍_നിന്ന്_വിരമിച്ച റിട്ടയറായ പെന്‍ഷന്‍_പറ്റിയ വിശ്രമയ_സമയം_പ്രാപിച്ച ഉദ്യോഗമൊഴിഞ്ഞ.
ଅବସାଦହୀନ|: ശോകരഹിതന്.
ଅବସ୍ଥିତ: ക്രിത്യമായി_സ്ഥാന_നിര്ണ്യം_നടത്തിയ.
ଅବାକ: മൌനമായ.
ଅବାଗିଆ: ശരിയായ_രൂപമില്ലാത്ത വിക്ര്‌ത്കമായ മോശമായ.
ଅବାଞ୍ଚନୀୟ: അനാവശ്യമായ.
ଅବାଞ୍ଛିତ: ആഗ്രഹിക്കാത്ത.
ଅବାଧ: വിഘ്നം_ഇല്ലാത്ത്.
ଅବାଧ୍ୟ: ബാധ്യതയില്ലാത്ത.
ଅବାସ୍ଥବିକ: കാല്പനീകമായ സാങ്കല്‍പ്പീകമായ വാസ്തവമല്ലാത്ത സങ്കല്പത്തിലുള്ള യാഥാറ്ത്ഥ്യമല്ലാത്ത സത്യ്മല്ലാത്ത ഭാവനയിലുള്ള കല്പിതമായ ഭാവനം_ചെയ്ത അനനുക്ര്‌തമായ മിഥ്യയായ അയഥാറ്ത്ഥമായ മായികമായ.
ଅବିକଳ: പകര്‍ത്തപ്പെട്ട് തനിപ്പകര്‍പ്പ്.
ଅବିକସିତ: വിടരാത്ത.
ଅବିକୃତ: വിക്രുതമല്ലാത്ത.
ଅବିଖ୍ୟାତ: പ്രസിദ്ധമല്ലാത്ത.
ଅବିଚଳ: സ്ഥിരമായ.
ଅବିଚଳିତ: സ്ഥിരമായ.
ଅବିଚଳିତ.ସ୍ଥିର: മാറാത്ത ഇളക്കപ്പെടാത്ത സ്ഥിരമായ അചഞ്ഞലമായ.
ଅବିଚାରଣୀୟ: വിചാരിക്കാത്തത്.
ଅବିଚାରିତ: വിചാരിക്കാതെ അവിചാരിതമായി. ശ്രദ്ധയില്ലാത്ത.
ଅବିଚାରୀ: അവിവേകി.
ଅବିଚାର୍ଯ୍ୟ: വിചാരിക്കാത്തത്.
ଅବିଚ୍ଛିନ୍ନ_: വിഭജിക്കപ്പെടാത്ത അഖ്ണ്ഡമായ കൂടിചേര്ന്ന.
ଅବିତା: കഴിഞ്ഞിട്ടില്ലാത്ത.
ଅବିଦ୍ଧ: തുളയ്ക്കപ്പെടാത്ത.
ଅବିଧିମାନ୍ୟ: നിയമ_വിരുദ്ധമായ നിഷിദ്ധമായ.
ଅବିନଶ୍ବର_: എന്നും_നിലനില്ക്കുന്ന.
ଅବିନାଶୀ: എന്നും_നിലനില്ക്കുന്ന.
ଅବିନୀତ: നിയന്ത്രണമില്ലാത്ത തോന്ന്യാസമുള്ള ധിക്കാരപരമായ. അഹങ്കാരിയായ അഹന്തയുള്ള അഹമ്മതിയുള്ള പൊങ്ങച്ചക്കാരിയായ
ଅବିନୟୀ: അഹങ്കാരിയായ അഹന്തയുള്ള അഹമ്മതിയുള്ള പൊങ്ങച്ചക്കാരിയായ
ଅବିବାହିତ: അവിവാഹിത്ന്.
ଅବିବାହିତା: അവിവാഹിത.
ଅବିବେକୀ: അവിവേകി.
ଅବିଭାଜ୍ୟ: വിഭജിക്കാന്‍_പറ്റാത്ത.
ଅବିଭୂଷିତ: അലംഗരിക്കാത്ത.
ଅବିମଳ: മുഷിഞ്ഞ ശുചിയല്ലാത്ത അഴുക്കായ മലിനപ്പെട്ട വൃത്തിഹീനമായ
ଅବିମିଶ୍ରିତ: ശുദ്ധമായ ഒന്നാംതരമായ
ଅବିରାମ_: ചലനാത്മകമായ പുരോഗമനപരമായ ക്രിയാത്മകമായ.
ଅବିଳମ୍ବ: താമസം_വിനാ താമസം_കൂടാതെ വിളംബിക്കാതെ അമാന്തിക്കാതെ.
ଅବିଶୁଦ୍ଧ: അശുദ്ധം കലര്‍പ്പുള്ള മായം_ചേര്‍ത്ത. മുഷിഞ്ഞ ശുചിയല്ലാത്ത അഴുക്കായ മലിനപ്പെട്ട വൃത്തിഹീനമായ
ଅବିଶ୍ବାସ_: വിശ്വാസമില്ലാത്ത.
ଅବିଶ୍ରାନ୍ତ_: ക്ഷീണിക്കാത്ത മടുക്കാത്ത.
ଅବୁଝା_: അറിവില്ലാത്ത മണ്ടന്മാരായ
ଅବେଧ୍ୟ: ഭേദിക്കാന്‍_പറ്റാത്തത് തുളക്കുവാന്‍_പറ്റാത്തത് അവിഭാജ്യം.
ଅବୈଜ୍ଞାନିକ: അശാസ്ത്രീയം. വിജ്ഞാനത്തെ_സംബന്ധിക്കാത്തത്.
ଅବୈଧାନିକ: നിയമ_വിരുദ്ധമായ നിഷിദ്ധമായ.
ଅବୋଧ: കാപട്യമില്ലാത്ത നിഷ്കളങ്കരായ ശാന്തസ്വഭാവമുള്ള
ଅବୋଧ_: അവിവേകി.
ଅବୋଧଗମ୍ୟ: ബോധ്യ_മാവാത്തത്ത്.
ଅବୋଧ୍ୟ: ജയിക്കാന്_പറ്റാത്ത. ബോധ്യ_മാവാത്തത്ത്.
ଅବୋଲା: പറയാത്ത
ଅବ୍ୟକ୍ତ_: അസ്പഷ്ട്ടമായ.
ଅବ୍ୟବସ୍ଥିତ: ക്രമപ്പെടുത്തപ്പെടാത്ത വ്യവസ്ഥയില്ലാത്ത മര്യാദയില്ലാത്ത. ശാന്തമല്ലാത്ത.
ଅବ୍ୟବହୃତ: പ്രചാരത്തിലില്ലാത്ത നടപ്പില്ലാത്ത പ്രസിദ്ധന്മില്ലാത്ത പരസ്യമല്ലാത്ത യുക്തമല്ലാത്ത പ്രാബല്യത്തിലില്ലാത്ത ആയുസ്സില്ലാത്ത. ഉപയോഗിക്കാത്തത്. കോടിആയ.
ଅଭକ୍ଷ: ആഹാരമല്ലാത്തത്.
ଅଭଙ୍ଗ: വിഭജിക്കപ്പെടാത്ത അഖ്ണ്ഡമായ കൂടിചേര്ന്ന.
ଅଭଙ୍ଗା: മുഴുവനായുള്ള. അഭേദ്യമായ തകര്ക്കാനാവാത്ത.
ଅଭଞ୍ଜନଶୀଳ: അഭേദ്യമായ തകര്ക്കാനാവാത്ത.
ଅଭଞ୍ଜନୀୟ: അഭേദ്യമായ.
ଅଭଦ୍ର: ബസാറിനോട്_ബന്ധപ്പെട്ട തരം_താണ്.
ଅଭାଂଜିତ: മുഴുവനായുള്ള.
ଅଭାଗା_: ദുര്ഭാഗ്യശാലി.
ଅଭାଜନ: അയോഗ്യനായ കൊള്ളരുതാത്ത.
ଅଭାବଗ୍ରସ୍ତ: ഇല്ലായ്മ_പിടിപ്പെട്ട.
ଅଭାବାତ୍ମକ: ഭാവരഹിത്മായ വികാരരഹിതമായ.
ଅଭିଗୋପ୍ତା: ശരിയായി_രക്ഷിക്കുന്ന.
ଅଭିଗ୍ରହ_: ക്ലിപ്തരൂപമില്ലാത്ത.
ଅଭିଜାତ: ഉന്നതകുലജാതനായ.
ଅଭିଜ୍ଞ: കുശാഗ്രബുദ്ധിമാനായ.
ଅଭିଜ୍ଞତାବିହୀନ: പ്രായോഗികജ്ഞാനമില്ലാത്ത അഭ്യാസജ്ഞാനമില്ലാത്ത പ്രാവറ്ത്തികജ്ഞാനമില്ലാത്ത ക്രിയാത്മകജ്ഞാനമില്ലാത്ത അനുഭവസിദ്ധന്മല്ലാത്ത പക്വതയില്ലാത്ത.
ଅଭିଜ୍ଞେୟ: പര്യവേക്ഷണത്തില്‍_നിന്ന്_കിട്ടുന്ന_വിശിഷ്ട്ട_ജ്ഞാനം.
ଅଭିତପ୍ତ: ഉരുക്കിയ
ଅଭିଦିଷ୍ଟ: സംകേതം_കാട്ടിയ.
ଅଭିନନ୍ଦନୀୟ: പ്രശംസനീയം
ଅଭିନନ୍ଦିତ: അഭിനന്ദിക്കപ്പെട്ട. പ്രശംസിക്കപ്പെട്ട
ଅଭିନବ: പുതിയ പുത്തനായ നവീനതമായ നൂതനമായ
ଅଭିନିବିଷ୍ଟ_: മുഴുകിയ.
ଅଭିନୀତ: അഭിനയിച്ച.
ଅଭିନ୍ନ: വിഭജിക്കപ്പെടാത്ത അഖ്ണ്ഡമായ കൂടിചേര്ന്ന. ഒന്നായത്.
ଅଭିପ୍ରାୟବିରୁଦ୍ଧ_: അനിഷ്ട്ടമായ
ଅଭିପ୍ରେତ: ഇച്ഛിച്ച് ആഗ്രഹിച്ച താല്പര്യപ്പെട്ട.
ଅଭିପ୍ସୁ_: ആഗ്രഹമുള്ള.
ଅଭିବ୍ୟକ୍ତ: വ്യക്തമാക്കപ്പെട്ട സ്പഷ്ട്ടമായ. വ്യക്തമാക്കപ്പെട്ട സ്പഷ്ട്ടമായ.
ଅଭିବ୍ୟଞ୍ଜିତ|: വ്യക്തമാക്കപ്പെട്ട സ്പഷ്ട്ടമായ.
ଅଭିଭକ୍ତ: വിഭജിക്കപ്പെടാത്ത അഖ്ണ്ഡമായ കൂടിചേര്ന്ന.
ଅଭିଭୂତ: ഊടും_പാവും_പോലെ_കോര്ക്കപ്പെട്ട.
ଅଭିଭୂଷିତ|: വേഷമിട്ട.
ଅଭିମଣ୍ଡିତ: അലങ്കരിച്ച ആഭരണമണിഞ്ഞ അലങ്ക്ര്തമായ.
ଅଭିମତ: സ്വീകാര്യമായ
ଅଭିମାନଶୂନ୍ୟ|: അഹങ്കാരമില്ലാത്ത വിനയമുള്ള ഗര്‍വ്വില്ലാത്ത.
ଅଭିମାନହୀନ: അഹങ്കാരമില്ലാത്ത വിനയമുള്ള ഗര്‍വ്വില്ലാത്ത.
ଅଭିଯୋଗକାରୀ: ആവലാദി.
ଅଭିଯୋଗପୂର୍ଣ୍ଣ: പരാതി.
ଅଭିରଞ୍ଜିତ: സ്നേഹം_നിറഞ്ഞ നിറമായ വറ്ണ്ണമായ ചായമായ രഞ്ജിതമായ അനുരഞ്ജിതമായ.
ଅଭିଲିଖିତ: ലേഖകന്‍_എഴുതിയ.
ଅଭିଳାଷ_ପୂର୍ଣ୍ଣ: ത്ര്പ്തിയുള്ള മനസ്സാലെയുള്ള.‌
ଅଭିଳାଷକ: ആഗ്രഹമുള്ള.
ଅଭିଳାଷୀ: ആഗ്രഹമുള്ള.
ଅଭିଷିକ୍ତ: നനയ്ക്കപ്പെട്ട.
ଅଭୁକ୍ତ: അനുഭവിക്കാത്ത ധാരണയില്ലാത്ത തഴക്കമില്ലാത്ത ഉള്‍ക്കാഴ്ച്ചയില്ലാത്ത.
ଅଭୁକ୍ତ|: ഉച്ഛിഷ്ടമായ എച്ചിലായ ഫേലമായ ചണ്ടിയായ ശേഷിച്ച ഭക്ഷിക്കാത്ത അനുഭവിക്കാത്ത.
ଅଭୂତପୂର୍ବ: അഭൂതപൂര്വ്വമായ പണ്ണ്ടുണ്ടാവാത്ത.
ଅଭେଦ: ഒന്നായത്.
ଅଭେଦ୍ୟ: ഭേദിക്കാന്‍_പറ്റാത്തത് തുളക്കുവാന്‍_പറ്റാത്തത് അവിഭാജ്യം. തുളയ്ക്കപ്പെടാത്ത.
ଅଭୋଗ୍ୟ: ഉപയോഗശ്യൂന്യമായ നിരുപയോഗമായ ഫലശ്യൂന്യമായ അയോഗ്യമായ നിഷ്ഫലമായ ഗുണമില്ലാത്ത വ്യ്ര്ത്ഥമായ പാഴായ.
ଅଭୋଜ୍ୟ: ആഹാരമല്ലാത്തത്.
ଅଭ୍ରାନ୍ତ: സന്ദേഹത്തിലകപ്പെടാത്ത ഭ്രമത്തില്‍_പെടാത്ത.
ଅଭ୍ୟସ୍ତ: അഭ്യസിക്കപ്പെട്ട് പരിശീലിപ്പിക്കപ്പെട്ട.
ଅଭ୍ୟାସହୀନ|: അഭ്യസിക്കാത്ത.
ଅଭ୍ୟୁଥିତ: വികസിതമായ.
ଅଭୟ: രക്ഷിക്കുന്ന.
ଅମଙ୍ଗଳକାରୀ: അമംഗളകരമായ.
ଅମଣ୍ଡିତ: അലംഗരിക്കാത്ത.
ଅମତ: അഭിപ്രായൈക്യമില്ലാത്ത
ଅମନଯୋଗୀ: ജാഗ്രതയില്ലാത്ത.
ଅମନସ୍କ_: ആഗ്രഹമില്ലായ്മ
ଅମପା: അളക്കാത്ത. കണക്കില്ലാത്ത
ଅମର: അമരന്‍ മൃത്യുഞ്ഞയന്‍ ചിരഞ്ഞീവി അമര്‍ത്യന്‍ ചിരഞ്ജീവി.
ଅମର୍ତ୍ୟ: അമരന്‍ മൃത്യുഞ്ഞയന്‍ ചിരഞ്ഞീവി അമര്‍ത്യന്‍
ଅମର୍ଯ୍ୟାଦା: നിന്ദിക്കപ്പെട്ട അധിക്ഷേപിക്കപ്പെട്ട.
ଅମଳିନ: പരിഷ്ക്കരിച്ച ശുദ്ധീകരിച്ച സ്ഫുടം_ചെയ്ത.
ଅମହତ୍ତ୍ବାକାଂକ୍ଷୀ|: ഔന്നത്യത്തിനുള്ള_അഭിലാഷം_ഇല്ലാത്ത്.
ଅମାନନୀୟ_: ആദരണീയനല്ലാത്ത
ଅମାନ୍ୟ: ആദരണീയനല്ലാത്ത
ଅମାପ: നിസ്സീമമായ അതിരറ്റ. പരിമിതമല്ലാത്ത മിതമല്ലാത്ത.
ଅମାର୍ଜିତ: അശ്ലീലം.
ଅମାର୍ମିକ: ഭാവരഹിത്മായ വികാരരഹിതമായ.
ଅମିତ: വളരേയധികം.
ଅମିଳ: ലഭിച്ചിട്ടില്ലാത്ത്.
ଅମିଶା: ശുദ്ധമായതു.
ଅମିଶ୍ରିତ: ശുദ്ധമായ ഒന്നാംതരമായ കൂടി_ചേരാത്ത.
ଅମୀତ_: നിസ്സീമമായ അതിരറ്റ.
ଅମୁକ-ସମୁକ: ഇന്നതായ
ଅମୁକ_ବ୍ୟକ୍ତି: ഇന്ന ഇന്നതായ.
ଅମୁକ୍ତ_: മോക്ഷം_ലഭിക്കാത്ത മുക്തി_ലഭിക്കാത്ത പാപമോചനം_ലഭിക്കാത്ത മേള്ഗതി_ലഭിക്കാത്ത രക്ഷ_ലഭിക്കാത്ത വരഗതി_ലഭിക്കാത്ത പരമഗതി_ലഭിക്കാത്ത നിറ്വ്വാണം_ലഭിക്കാത്ത.
ଅମୁକ୍ତ|: ബന്ധിക്കപ്പെട്ട.
ଅମୂର୍ତ୍ତ: ക്ലിപ്തരൂപമില്ലാത്ത.
ଅମୂଲ୍ୟ: വിലയേറിയത്.
ଅମୂଳକ: നുണ കള്ളം അസത്യം
ଅମେଣ୍ଟଣ|: നശിക്കാത്ത മായാത്ത സ്ഥായിയായ.
ଅମେଳ|: യോജിപ്പില്ലാത്ത_അവസ്ഥ.
ଅମେଳାପି: ആരോടും_ഇടപഴകാത്ത.
ଅମୋକ୍ଷ: മോക്ഷം_ലഭിക്കാത്ത മുക്തി_ലഭിക്കാത്ത പാപമോചനം_ലഭിക്കാത്ത മേള്ഗതി_ലഭിക്കാത്ത രക്ഷ_ലഭിക്കാത്ത വരഗതി_ലഭിക്കാത്ത പരമഗതി_ലഭിക്കാത്ത നിറ്വ്വാണം_ലഭിക്കാത്ത.
ଅମୌଳ: അനുകരണം വേറെ_ഒന്നിനെ_മാത്രികയാക്കല്‍ അനുവ്ര്‌ത്തി അനുകരിക്കല്‍ അനുകര്‍മ്മം അനുഗതി അനുപ്രവേശം അനുഹരണം അന്യര്‍ചെയ്യുന്നതു_പോലെ_ചെയ്യല്‍.
ଅମ୍ଳାନ: നിര്‍മ്മലമായ വിമലമായ പവിത്രമായ് ശുദ്ധമായ പുതിയ പുത്തന്‍
ଅମ୍ଳୀୟ: പുളിയുള്ള അംളരസമുള്ള
ଅଯଥା: കാല്പനീകമായ സാങ്കല്‍പ്പീകമായ വാസ്തവമല്ലാത്ത സങ്കല്പത്തിലുള്ള യാഥാറ്ത്ഥ്യമല്ലാത്ത സത്യ്മല്ലാത്ത ഭാവനയിലുള്ള കല്പിതമായ ഭാവനം_ചെയ്ത അനനുക്ര്‌തമായ മിഥ്യയായ അയഥാറ്ത്ഥമായ മായികമായ. അകാരണമായ
ଅଯଥା_ଖର୍ଚ୍ଚୀ|: ധൂര്ത്തടിക്കുന്നവന്.
ଅଯଥାର୍ଥ: അനുചിതമായ അയുക്‌തമായ ശരിയല്ലാത്ത ഔചിത്യമില്ല്ലാത്ത അരുതാത്ത
ଅଯୋଗ୍ୟ: അയോഗ്യനായ ഉപയോഗമില്ലാത്ത പറ്റാത്ത കൊള്ളാത്ത തെറ്റായ അശക്തമായ കഴിവില്ലാത്ത പ്രാപ്തിയില്ലാത്ത അനുയോജ്യമില്ലാത്ത അനുരൂപമല്ലാത്ത സന്മുചിതമല്ലാത്ത അനറ്ഘമായ യുക്തമല്ലാത്ത.
ଅରଚିତ|: നിര്മ്മിക്കാത്ത.
ଅରଜୋନିବୃତ୍ତି_: ആര്ത്തവമില്ലാത്ത
ଅରାଜି: അഭിപ്രായൈക്യമില്ലാത്ത
ଅରୁଚିକର: അരുചികരമായ ഇഷ്ട്ടപ്പെടാത്ത. രുചിയില്ലാത്ത സ്വാദില്ലാത്ത രോചകമല്ലാത്ത ചുവയില്ലാത്ത രോചനയില്ലാത്ത രുചിതമല്ലാത്ത രുച്യമല്ലാത്ത അരുചിയുള്ള.
ଅରୁଣ: ചുവന്ന്.
ଅରୁଣାଚଳୀୟ: അരുണാചലത്തിലെ.
ଅରୁଣାଭ: ചുവന്ന്.
ଅରୂପ: ക്ലിപ്തരൂപമില്ലാത്ത.
ଅରୂପିତ|: ശരിയായ_രൂപമില്ലാത്ത വിക്ര്‌ത്കമായ മോശമായ.
ଅରୂପୀ: വിരൂപനായ വിലക്ഷണമായ ഭംഗിയില്ലാത്ത വികൃതമായ
ଅରୋଚକ: അരുചികരമായ ഇഷ്ട്ടപ്പെടാത്ത.
ଅର୍ଜନୀୟ: നേടിയെടുക്കേണ്ട നേടേണ്ട ലഭിക്കേണ്ട കിട്ടേണ്ട കൈവരേണ്ട.
ଅର୍ଜିତ: നേടിയത്
ଅର୍ଥପୂର୍ଣ୍ଣ: മഹത്വപൂര്ണ്ണമായ.
ଅର୍ଥଶାସ୍ତ୍ରୀୟ_: ധനത്തെ_സംബന്ധിക്കുന്ന_ശാസ്ത്രം.
ଅର୍ଥହୀନ: പാവപെട്ട ദരിദ്രനായ നിര്‍ദ്ധനനായ പാപപരായ അഗതിയായ
ଅର୍ଦ୍ଧ: പകുതി.
ଅର୍ଦ୍ଧ-ସରକାରୀ: അര്‍ദ്ധ്_സര്‍ക്കറിന്റെ.
ଅର୍ଦ୍ଧମୁକୁଳିତ|: പകുതി_അടഞ്ഞ.
ଅର୍ଦ୍ଧମୃତ|: പകുതി_മരിച്ച.
ଅର୍ନ୍ତଦେଶୀୟ: അന്തര്‍ദേശീയം.
ଅର୍ନ୍ତପ୍ରଦେଶସ୍ତରୀୟ: ആഭ്യന്തരം.
ଅର୍ନ୍ତପ୍ରଦେଶୀୟ: ആഭ്യന്തരം.
ଅର୍ନ୍ତରାଜ୍ୟ: ആഭ്യന്തരം.
ଅର୍ପିତ: അറ്പ്പിച്ച സമറ്പ്പിച്ച തറ്പ്പിച്ച
ଅଲକ୍ଷିତ|: കണ്ണുകൊണ്ടു_കാണാന്_പറ്റാത്തത്.
ଅଲକ୍ଷ୍ୟ: കണ്ണുകൊണ്ടു_കാണാന്_പറ്റാത്തത്.
ଅଲଗା: മറ്റൊന്ന് രണ്ടാമത് അതല്ലാത്തത്. വേര്തിരിക്കുക.
ଅଲଜ୍ଜା|: നാണ്മില്ലാത്ത.
ଅଲବାନିୟାଈ: അല്‍ബാനിയയുടെ. അല്‍ബാനിയയുടെ.
ଅଲବେନିୟାଈ: അല്‍ബാനിയയുടെ.
ଅଲବ୍ଧ: ലഭിക്കാത്ത് കിട്ടാത്ത.
ଅଲଭ୍ୟ: ലഭിക്കാത്ത് കിട്ടാത്ത. ലഭിച്ചിട്ടില്ലാത്ത്. വിലയേറിയത്. ദുര്ലഭമായ.
ଅଲଭ୍ୟ_: ദുര്ഗ്ഗമമായ
ଅଲାଭପ୍ରଦ_: ലാഭഹീനമായ.
ଅଲିଖିତ: പ്രബന്ധമില്ലാത്ത.
ଅଲିପିବଦ୍ଧ: പ്രബന്ധമില്ലാത്ത.
ଅଲିଭା: നശിക്കാത്ത മായാത്ത സ്ഥായിയായ.
ଅଲୁଚା: രഹസ്യസ്വഭാവമല്ലാത്ത രഹസ്യമല്ലാത്ത.
ଅଲୋଡା: ആഗ്രഹിക്കാത്ത. ഉപയോഗിക്കാത്തത്.
ଅଲୌକିକ: പ്രത്യേകതയുള്ള അപൂര്വമായ.വ്യത്യാസമായ. അമാനുഷികമായ ലൌകികമല്ലാത്ത പരലോകസംബന്ധമായ.
ଅଲ୍ବାନିୟାଈ: അല്‍ബാനിയയുടെ.
ଅଳଙ୍କୃତ: അലംകരിക്കപ്പെട്ട ഒരുക്കപ്പെട്ട. അലങ്കരിച്ച ആഭരണമണിഞ്ഞ അലങ്ക്ര്തമായ.
ଅଳସୁଆ: അലസനായ മടിയനായ ആലസ്യമുള്ള
ଅଳ୍ପ: കുറച്ചു. ചെറിയ.
ଅଳ୍ପ_କାଳୀନ: ക്ഷണികമായ നൈമിഷികമായ.
ଅଳ୍ପ_ପାଠୁଆ: അല്പം_വിദ്യയുള്ള.
ଅଳ୍ପ_ଶିକ୍ଷିତ: അല്പം_വിദ്യയുള്ള.
ଅଳ୍ପଦାମ: വിലക്കുറവു
ଅଳ୍ପବୁଦ୍ଧି: അവിവേകിയായ ജളനായ ഭോഷനായ മൂഢനായ മന്ദതയുള്ള ജളത്വമുള്ള
ଅଳ୍ପବୟସ୍କ: വയസ്സില്ലാത്ത.
ଅଳ୍ପଭାଷୀ: അല്പം_സംസാരിക്കുന്നത്.
ଅଳ୍ପଭୋଜୀ: അല്പമായും_ക്രമീക്ര്‌തമായും_ആഹാരം_കഴിക്കുന്ന മിതമായി_ഭക്ഷിക്കുന്ന സ്വല്പം_ഭക്ഷിക്കുന്ന.
ଅଳ୍ପମୂଲ୍ୟ: വിലക്കുറവു
ଅଳ୍ପସଂଖ୍ୟକ: ന്യൂന_പക്ഷം.
ଅଳ୍ପାଂଶୀୟ: ചെറിയ.
ଅଳ୍ପାହାରୀ: അല്പമായും_ക്രമീക്ര്‌തമായും_ആഹാരം_കഴിക്കുന്ന മിതമായി_ഭക്ഷിക്കുന്ന സ്വല്പം_ഭക്ഷിക്കുന്ന.
ଅଳ୍ପାୟୁ: അല്പായുസ്സുള്ള ആയുസ്സ്_കുറഞ്ഞ.
ଅଳ୍ପାୟୁଷ: അല്പായുസ്സുള്ള ആയുസ്സ്_കുറഞ്ഞ.
ଅଶରୀରୀ: ദേഹമില്ലാത്ത. അശരീരി.
ଅଶାନ୍ତ: ശാന്തമല്ലാത്ത.
ଅଶାନ୍ତିପୂର୍ଣ୍ଣ: അശാന്തിപൂര്ണ്ണമായ.
ଅଶାଳୀନ: നിയന്ത്രണമില്ലാത്ത തോന്ന്യാസമുള്ള ധിക്കാരപരമായ. അശ്ലീലം.
ଅଶାଳୀନ|: ബസാറിനോട്_ബന്ധപ്പെട്ട തരം_താണ്.
ଅଶିକ୍ଷିତ: വിദ്യാഭാസമില്ലാത്ത പഠിപ്പില്ലാത്ത
ଅଶିଷ୍ଟ: അപരിഷ്കൃതമായ മാന്യമല്ലാത്ത സംസ്കാരമില്ലാത്ത_പ്രാകൃതപ്പെരുമാറ്റമുള്ള
ଅଶୀତିତମ: എണ്പത്തി_ഒന്നാമത്തെ
ଅଶୁଣା: ഇതുവരെയും_കേള്ക്കാത്ത്ത്.
ଅଶୁଦ୍ଧ: ശുദ്ധീകരിക്കാത്ത പരിശോധിക്കാത്ത സംശുദ്ധിയാക്കാത്ത വിരേചനം_ചെയ്യാത്ത ശുചീകരിക്കാത്ത സംസ്കരിക്കാത്ത പരിപൂതമാക്കാത്ത. അശുദ്ധം കലര്‍പ്പുള്ള മായം_ചേര്‍ത്ത. അപവിത്രമായ അശുദ്ധമായ. മുഷിഞ്ഞ ശുചിയല്ലാത്ത അഴുക്കായ മലിനപ്പെട്ട വൃത്തിഹീനമായ
ଅଶୁଭକାରୀ: അമംഗളകരമായ.
ଅଶୁଭଚିନ୍ତକ: അമംഗളകരം_ഇഷ്ട്ടപ്പെടുന്നവന് അശുഭ_ചിന്തകന്ന്.
ଅଶେଷ: അവസാനമില്ലാത്ത അന്തമില്ലാത്ത. അസംഖ്യം.
ଅଶୋକ: ശോകരഹിതന്.
ଅଶୋଧିତ: ശുദ്ധീകരിക്കാത്ത പരിശോധിക്കാത്ത സംശുദ്ധിയാക്കാത്ത വിരേചനം_ചെയ്യാത്ത ശുചീകരിക്കാത്ത സംസ്കരിക്കാത്ത പരിപൂതമാക്കാത്ത.
ଅଶୋଭନୀୟ: മാന്യമല്ലാത്ത.
ଅଶୌଚ_: അപവിത്രമായ അശുദ്ധമായ.
ଅଶ୍ବେତ: കറുപ്പ്.
ଅଶ୍ରାବ୍ୟ: കേള്ക്കുവാന്_പറ്റാത്തത്.
ଅଶ୍ରୁତ: ഇതുവരെയും_കേള്ക്കാത്ത്ത്.
ଅଶ୍ରୁପୂର୍ଣ୍ଣ: അശ്രു_പൂര്ണ്ണം.
ଅଶ୍ରୁଯୁକ୍ତ|: അശ്രു_പൂര്ണ്ണം.
ଅଶ୍ଲୀଳ: അശ്ലീലം.
ଅଶ୍ଳୀଳ: അപരിഷ്കൃതമായ മാന്യമല്ലാത്ത സംസ്കാരമില്ലാത്ത_പ്രാകൃതപ്പെരുമാറ്റമുള്ള
ଅଶ୍ୱେତ: കറുത്ത
ଅଷ୍ଟମ: എട്ട് 8 എട്ടാം എട്ടാമത്തെ
ଅଷ୍ଟାଦଶ: പതിനെട്ടാം പതിനെട്ടാമത്തെ
ଅଷ୍ଟ୍ରେଲିଆ_ସମ୍ବନ୍ଧିତ: ആസ്ട്രേലിയന്‍ ആസ്ട്രേലിയയുടെ.
ଅଷ୍ଟ୍ରେଲୀୟ: ആസ്ട്രേലിയന്‍ ആസ്ട്രേലിയയുടെ.
ଅସଂଖ୍ୟ: അസംഖ്യം.
ଅସଂଦିଗ୍ଧ: സംശയാസ്പദമല്ലാത്ത സുനിശ്ചിതാവസ്ഥയിലുള്ള്.
ଅସଂପୂର୍ଣ୍ଣ_|: മുഴുവനാകാത്ത.
ଅସଂପୂର୍ଣ୍ଣ_ଅପରିପୂର୍ଣ୍ଣ_: പൂര്‍ണ്ണമല്ലാത്തത് അപൂര്‍ണ്ണം.
ଅସଂଯମୀ_: ആത്മ_നിയന്ത്രണമില്ലാത്ത മിതത്വമില്ലാത്ത മിത_ഭോജി_അല്ലാത്ത സമചിത്തതയില്ലാത്ത.
ଅସଂଶୋଧିତ: ശുദ്ധീകരിക്കാത്ത പരിശോധിക്കാത്ത സംശുദ്ധിയാക്കാത്ത വിരേചനം_ചെയ്യാത്ത ശുചീകരിക്കാത്ത സംസ്കരിക്കാത്ത പരിപൂതമാക്കാത്ത.
ଅସଂସ୍କୃତ: അശ്ലീലം.
ଅସଙ୍ଗଠିତ: ഐക്യം ഐഖ്യമത്യം അഖണ്ഡത ഏകത ഏകചിത്തത രജ്ഞിപ്പ് ഏകോപനം ഒരുമിപ്പ് ഏകമനസ്സ് ഏകീകരണം പൊരുത്തം ഇണക്കം ഏകീഭാവം സഹകരണം സ്വരുമ സ്വരുമിപ്പ്.
ଅସଙ୍ଗତ: അനുചിതമായ അയുക്‌തമായ ശരിയല്ലാത്ത ഔചിത്യമില്ല്ലാത്ത അരുതാത്ത അസംബന്ധം.
ଅସଜତା: ക്രമപ്പെടുത്തപ്പെടാത്ത വ്യവസ്ഥയില്ലാത്ത മര്യാദയില്ലാത്ത.
ଅସଜ୍ଜିତ: അലംഗരിക്കാത്ത.
ଅସତ୍ୟ: നുണ കള്ളം അസത്യം
ଅସତ୍ୟବାଦୀ: നുണയന്‍ അസത്യം_പറയുന്നവന്‍ അസത്യം_പറയുന്നവന്‍ എതിര്‍_വാദം_ചെയ്യുന്നയാള്‍ കള്ളം_പറയുന്നയാള്‍.
ଅସନ୍ତୁଷ୍ଟ: അത്രുപ്തം.
ଅସନ୍ତୋଷୀ|: അത്രുപ്തം.
ଅସଫଳ: അസഫലമായ.
ଅସଭ୍ୟ: അപരിഷ്കൃതമായ മാന്യമല്ലാത്ത സംസ്കാരമില്ലാത്ത_പ്രാകൃതപ്പെരുമാറ്റമുള്ള
ଅସମକ୍ଷ: അറിയാത്ത.
ଅସମତଳ: പരുപരുപ്പുള്ള ഉയര്‍ന്നതും_താണതുമായ തുല്യമല്ലാത്ത പൊങിറ്യതും_താണതുമായ കുണ്ടും_കുഴിയുമായ യോജിക്കാത്ത ചേര്‍ച്ചയില്ലാത്ത. പരുപരുത്ത
ଅସମର୍ଥ: സാമര്ഥ്യം_ഇല്ലാത്ത.
ଅସମର୍ଥ୍: അയോഗ്യനായ ഉപയോഗമില്ലാത്ത പറ്റാത്ത കൊള്ളാത്ത തെറ്റായ അശക്തമായ കഴിവില്ലാത്ത പ്രാപ്തിയില്ലാത്ത അനുയോജ്യമില്ലാത്ത അനുരൂപമല്ലാത്ത സന്മുചിതമല്ലാത്ത അനറ്ഘമായ യുക്തമല്ലാത്ത.
ଅସମାଧିତ: പ്രശ്നപരിഹാരമില്ലാത്ത പ്രശ്നം_പരിഹരിക്കാത്ത.
ଅସମାପ୍ତ: അവസാനമില്ലാത്ത അന്തമില്ലാത്ത. മുഴുവനാകാത്ത.
ଅସମାହିତ: പ്രശ്നപരിഹാരമില്ലാത്ത പ്രശ്നം_പരിഹരിക്കാത്ത. അറിവില്ലാത്ത.
ଅସମିଆ: ആസാമിന്റേതായ.
ଅସମୃଦ୍ଧ: പാവപെട്ട ദരിദ്രനായ നിര്‍ദ്ധനനായ പാപപരായ അഗതിയായ
ଅସମୃଦ୍ଧିପ୍ରଦ: അഭിവ്ര്ദ്ധിയില്ലാത്ത് ഐശ്വര്യമില്ലാത്ത്.
ଅସମ୍ପର୍ଣ୍ଣ: പാവപെട്ട ദരിദ്രനായ നിര്‍ദ്ധനനായ പാപപരായ അഗതിയായ
ଅସମ୍ବନ୍ଧିତ|: സംബന്ധിക്കാത്ത ബന്ധമില്ലാത്ത.
ଅସମ୍ଭବ: അസംഭാവ്യമായ.
ଅସମ୍ଭାବିତ: അസംഭാവ്യമായ.
ଅସମ୍ମତ: അഭിപ്രായൈക്യമില്ലാത്ത
ଅସମ୍ମାନନୀୟ: ആദരണീയനല്ലാത്ത
ଅସମୟ.ଅସାମୟିକ: നിശ്ചിതസമയത്തല്ലാത്ത.
ଅସମୟୋଚିତ_: നിശ്ചിതസമയത്തല്ലാത്ത.
ଅସରନ୍ତି: ദഹനമില്ലായ്മ.
ଅସଲି: ശുദ്ധമായ ഒന്നാംതരമായ ശുദ്ധമായതു. വാസ്തവികമായ യദാര്ഥമായ. ശരിആയത്.
ଅସହନଶୀଳ: സഹിക്കാത്ത.
ଅସହନୀୟ: അസഹ്യമായ.
ଅସହମତ: അഭിപ്രായൈക്യമില്ലാത്ത
ଅସହାୟ: നിസ്സഹായ സഹായമില്ലാത്ത ആശ്രയമില്ലാത്ത നിരാലംബ അശരണ കെല്പില്ലാത്ത നിറ്ധനനായ.
ଅସହିଷ୍ଣୁ: സഹിക്കാത്ത.
ଅସହ୍ୟ: അസഹ്യമായ.
ଅସାଧାରଣ: ഉപമയില്ലാത്ത അതുല്യമായ. അസാമാന്യമായ സാധാരണമല്ലാത്ത.
ଅସାଧୁ: അപരിഷ്കൃതമായ മാന്യമല്ലാത്ത സംസ്കാരമില്ലാത്ത_പ്രാകൃതപ്പെരുമാറ്റമുള്ള ദുഷ്ട ദുഷിച്ച ചീത്ത നീച
ଅସାଧ୍ୟ: അസാധ്യമായത്. അസാദ്ധ്യമായത്.
ଅସାବଧାନ: ജാഗ്രതയില്ലാത്ത.
ଅସାମଞ୍ଜସ୍ୟ: യോജിപ്പില്ലാത്ത_അവസ്ഥ.
ଅସାମାନ୍ୟ: അസാമാന്യമായ സാധാരണമല്ലാത്ത.
ଅସାମାନ୍ୟ_: വിശേഷവും
ଅସାହସିକ: ഭീരുത്വമുള്ള ഭയശീലമുള്ള ആണത്തമില്ലാത്ത നെഞ്ഞുരപ്പില്ലാത്ത
ଅସିଝା|: പച്ചയായ.
ଅସିଡିୟ_: അമ്ലസംബന്ധി
ଅସିତ: കറുപ്പ്.
ଅସିଦ୍ଧ: പച്ചയായ.
ଅସିଧାରୀ: വാള്‍പ്രയോഗ_വിദ്ഗ്ധന്‍.
ଅସୀମ: വളരേയധികം. നിസ്സീമമായ അതിരറ്റ. വളരേ_ആഴമുള്ള അഗാധമായ. തിരിച്ചുകൊടുക്കാന്‍_പറ്റാത്ത. പരിമിതമല്ലാത്ത മിതമല്ലാത്ത.
ଅସୀମାଙ୍କିତ: അതിര്‍ത്തി_തിരിക്കാത്ത.
ଅସୀମିତ: നിസ്സീമമായ അതിരറ്റ.
ଅସୁଗମ_: ബുദ്ധിമുട്ടുള്ള_.
ଅସୁନ୍ଦର: വിരൂപനായ വിലക്ഷണമായ ഭംഗിയില്ലാത്ത വികൃതമായ
ଅସୁବିଧାଜନକ: സൌകര്യപ്രദമല്ലാത്ത.
ଅସୁବିଧାପୂର୍ଣ୍ଣ: സൌകര്യപ്രദമല്ലാത്ത.
ଅସୁମାରି: എണ്ണാത്ത
ଅସୁଲଭ: ദുര്ലഭമായ.
ଅସୁସ୍ଥ: രോഗി രോഗാതുരന്‍ രോഗബാധിതന്‍
ଅସୂଚି: അപവിത്രമായ അശുദ്ധമായ.
ଅସ୍ତ: ഒളിക്കപ്പെടുന്ന
ଅସ୍ତ_|: ആഴ്ന്നിറങിയ മുങിയ.
ଅସ୍ତଗତ: ആഴ്ന്നിറങിയ മുങിയ.
ଅସ୍ତ୍ରଶସ୍ତ୍ରଧାରୀ: ആയുധധാരികളായ ആയുധം_ധരിച്ച ആയുധം_കൈയിലുള്ള.
ଅସ୍ଥାବର: ചലിക്കുന്ന ചലിക്കാന്‍_സാധിക്കുന്ന ജീവനുള്ള.
ଅସ୍ଥାୟୀ: ക്ഷണികമായ നൈമിഷികമായ. സ്ഥിരം_അല്ലാത്ത
ଅସ୍ଥି_ନିର୍ମିତ: അസ്ഥികളെ_കൊണ്ട്_നിര്‍മ്മിച്ചത്.
ଅସ୍ଥିତ୍ବହୀନ: അസ്ഥി_ഇല്ലാത്ത_.
ଅସ୍ଥିମୟ: അസ്ഥി_പഞരം_പോലെ എല്ലും_തോലും_മാത്രമാവുക. അസ്ഥികളെ_കൊണ്ട്_നിര്‍മ്മിച്ചത്.
ଅସ୍ଥିର: മാറിയ ഇളക്കപ്പെട്ട അസ്ഥിരമായ ചഞ്ചലമായ പരിഭ്രമിച്ച. ചഞ്ഞ്ചലിതമായ.
ଅସ୍ଥିରଚିତ: ശാന്തമല്ലാത്ത.
ଅସ୍ପର୍ଶିତ: തൊടാത്ത
ଅସ୍ପଷ୍ଟ: അസ്പഷ്ട്ടമായ. മങ്ങലുള്ള വ്യ്ക്‌തമല്ലാത്ത അസ്പഷ്ടമായ അവ്യക്‌തമായ
ଅସ୍ପୁଟଭାଷା: കൊഞ്ചി_പ്പറയുന്ന
ଅସ୍ପୃଶ୍ୟ: തൊട്ടുകൂടാത്ത.
ଅସ୍ଫୁଟ: അസ്പഷ്ട്ടമായ.
ଅସ୍ବଚ୍ଛ: മുഷിഞ്ഞ ശുചിയല്ലാത്ത അഴുക്കായ മലിനപ്പെട്ട വൃത്തിഹീനമായ
ଅସ୍ବାକ୍ଷରିତ: ഒപ്പു_കൂടാതെയുള്ള ഒപ്പു_വൈക്കാത്ത.
ଅସ୍ବାଦିଷ୍ଟ: സ്വാദില്ലാത്ത.
ଅସ୍ବାଦୁ_: സ്വാദില്ലാത്ത.
ଅସ୍ବାଭାବିକ: അസ്വാഭാവികമായ.
ଅସ୍ବାଭିମାନୀ: സ്വാഭിമാനം_ഇല്ലാത്ത.
ଅସ୍ବୀକାରତ୍ମକ: നിഷേധാത്മകമായി.
ଅସ୍ବୀକୃତ: നിരാകരിച്ച സമ്മതിക്കാത്ത് സമ്മതമില്ലാത്ത സമ്മതം_ലഭിക്കാത്ത സമ്മതംകിട്ടാത്ത. വിധിപ്രകാരം_നല്കാത്ത. സമ്മതമില്ലാത്ത. സ്വീകരിക്കാത്ത.
ଅହଂଭାବପୂର୍ଣ୍ଣ: ഉദ്ധതനായ അഹങ്കാരി_ആയ അഹന്തയുള്ള ഞാന്‍_വമ്പനാണെന്ന_ഭാവം അഹമ്മതിഉള്ള അകനിന്ദയുള്ള അഹമ്മമതയുള്ള കെര്രുവുള്ള ഞാനെന്ന_ഭാവമുള്ള.
ଅହଙ୍କାରୀ: ഉദ്ധതനായ അഹങ്കാരി_ആയ അഹന്തയുള്ള ഞാന്‍_വമ്പനാണെന്ന_ഭാവം അഹമ്മതിഉള്ള അകനിന്ദയുള്ള അഹമ്മമതയുള്ള കെര്രുവുള്ള ഞാനെന്ന_ഭാവമുള്ള. അഹങ്കാരിയായ അഹന്തയുള്ള അഹമ്മതിയുള്ള പൊങ്ങച്ചക്കാരിയായ
ଅହିଂସ: ഹിംസ_ചെയ്യാത്ത.
ଅହିଂସକ: ഹിംസ_ചെയ്യാത്ത.
ଅହିତକର: ആരോഗ്യത്തിനു_ഹാനികരമായ
ଅହିତକାରୀ|: അമംഗളകരമായ.
ଅୟୁତ: പതിനായിരം പത്ത്_ആയിരം.
ଆଂକାକ୍ଷୀ: ആഗ്രഹമുള്ള.
ଆଂଚଳିକ|: പ്രദേശത്തെ_സംബന്ധിക്കുന്ന.
ଆଇରିଶ: ഐറിഷ്
ଆଇସଲ୍ୟାଣ୍ଡୀୟ: അയിസ്ലാണ്ഡിന്റെ.
ଆଉଟ_ଅଫ୍‌_ଡେଟ୍‌: പ്രചാരത്തിലില്ലാത്ത നടപ്പില്ലാത്ത പ്രസിദ്ധന്മില്ലാത്ത പരസ്യമല്ലാത്ത യുക്തമല്ലാത്ത പ്രാബല്യത്തിലില്ലാത്ത ആയുസ്സില്ലാത്ത.
ଆଉଟଡେଟେଡ: പ്രചാരത്തിലില്ലാത്ത നടപ്പില്ലാത്ത പ്രസിദ്ധന്മില്ലാത്ത പരസ്യമല്ലാത്ത യുക്തമല്ലാത്ത പ്രാബല്യത്തിലില്ലാത്ത ആയുസ്സില്ലാത്ത.
ଆକର୍ଷକ: ആകര്‍ഷിക്കുന്ന ആകര്‍ഷകമായ ആകര്‍ഷണീയമായ വശ്യ മാസ്മരശക്‌തിയുള്ള മാദകമായ ചേതോഹാരിയായ ആനന്ദിപ്പിക്കുന്ന വശീകൃതമായ
ଆକର୍ଷଣୀୟ: ആകര്‍ഷിക്കുന്ന ആകര്‍ഷകമായ ആകര്‍ഷണീയമായ വശ്യ മാസ്മരശക്‌തിയുള്ള മാദകമായ ചേതോഹാരിയായ ആനന്ദിപ്പിക്കുന്ന വശീകൃതമായ
ଆକଳନୀୟ: എണ്ണപ്പെടാവുന്ന കണക്കാക്കത്തക്ക അംഗീകരിക്കപ്പെടേണ്ട്.
ଆକସ୍ମିକ: പെട്ടെന്നുള്ള.
ଆକାଂକ୍ଷାହୀନ: ആഗ്രഹമില്ലാത്തവന്.
ଆକାଂକ୍ଷିତ_: ഇച്ഛിച്ച് ആഗ്രഹിച്ച താല്പര്യപ്പെട്ട.
ଆକାଙ୍କ୍ଷିତ: തിരയുന്ന അന്വേഷിക്കുന്ന
ଆକାରବାନ୍: ആകാരമുള്ള
ଆକାରଯୁକ୍ତ_: ആകാരമുള്ള
ଆକାରହୀନ: ക്ലിപ്തരൂപമില്ലാത്ത.
ଆକାଶଭେଦୀ: ആകാശത്തെ_ഭെദിക്കുന്ന.
ଆକାଶି_ନୀଳ: ആകാശനീല.
ଆକାଶୀ: ആകാശത്തില്_കൂടിയുള്ള
ଆକାଶୀୟ: ആകാശത്തില്_കൂടിയുള്ള
ଆକୁଳ: ചഞ്ഞ്ചലിതമായ.
ଆକ୍ରମକ: ആക്രമ_സ്വഭാവമുള്ള. ആക്രമിക്കുന്ന.
ଆକ୍ରମଣକର୍ତ୍ତା: ആക്രമ_സ്വഭാവമുള്ള.
ଆକ୍ରମଣକାରୀ: ആക്രമ_സ്വഭാവമുള്ള.
ଆକ୍ରମଣାତ୍ମକ: ആക്രമിക്കുന്ന.
ଆକ୍ରମିତ: ആക്രമിക്കപ്പെട്ട ഉപദ്രവിക്കപ്പെട്ട.
ଆକ୍ରାନ୍ତ_: തോല്‌പ്പിക്കപ്പെട്ട
ଆକ୍ରାନ୍ତହୀନ: ആക്രമിക്കാത്ത.
ଆକ୍ଷେପକ: ആക്ഷേപിക്കുന്ന വലിച്ചെറിയുന്നവന്
ଆଖ୍ୟାତ: പ്രസിദ്ധയായ കേള്‍വിപ്പെട്ട പേരുകേട്ട യശസ്വിയായ പ്രഖ്യാതമായ അറിയപ്പെട്ട വിഖ്യാതിയായ
ଆଗ: ആദ്യത്തെ.
ଆଗତ: വന്ന തിരിച്ചു_വന്ന വന്നുചേര്‍ന്ന എത്തിയ ആഗമിച്ച ആഗതനായ പ്രാപിച്ച എത്തിച്ചെര്‍ന്ന എത്തിക്കഴിഞ സമീപിക്കുന്ന കയറിക്കൂടിയ വസിക്കുന്ന ചെന്നെത്തിയ. പ്രവേശിച്ച ഏര്പ്പെട്ട.
ଆଗାମୀ: വരാന്‍_പോകുന്ന ഭാവികാലത്തെ_സംബന്ധിച്ച. വരാന്_പോകുന്ന ഭാവിയിലുള്ള വരാനിരിക്കുന്ന.
ଆଗିଲା\: വരാന്_പോകുന്ന ഭാവിയിലുള്ള വരാനിരിക്കുന്ന.
ଆଗ୍ରହକର୍ତ୍ତା: നിര്‍ബന്ധബുദ്ധിയുള്ള
ଆଗ୍ରହୀ: നിര്‍ബന്ധബുദ്ധിയുള്ള
ଆଘାତଶୂନ୍ୟ: തിരിചചടിക്കാത്ത.
ଆଚମ୍ବିତ: വിസ്മയിച്ച പരിഭ്രമിച്ച അമ്പരന്ന.
ଆଚ୍ଛା: നല്ല നന്മയുള്ള വലിയ ഉത്തമമായ ഗുണമുള്ള മെച്ചപ്പെട്ട വൈശിഷ്ട്യമുള്ള സദ്ഗുണമുള്ള ഗുണകരമായ ശുദ്ധമായ ഉതകുന്ന കൊള്ളാവുന്ന.
ଆଚ୍ଛାଦିତ: മൂടിയ നിറഞ്ഞ.
ଆଜାରବୈଜାନ: അസറ്ബൈജാനിയന്‍
ଆଜାରବୈଜାନ_ସମ୍ବନ୍ଧିତ: അസറ്ബൈജാനിയന്‍
ଆଜିକାଲି: ആധുനികം.
ଆଜ୍ଞପ୍ତ: ആജ്ഞാപിക്കപ്പെട്ട നിറ്‌ദ്ദേശിക്കപ്പെട്ട കല്പിക്കപെട്ട ഏല്‍പ്പിക്കപ്പെട്ട.
ଆଜ୍ଞାଦାନକାରୀ: ആജ്ഞ്ഞാപിക്കുന്ന.
ଆଜ୍ଞାହୀନ_: കല്പ്പിക്കപ്പെടാത്ത
ଆଟବିକ: വനത്തെ_സംബന്ധിക്കുന്ന.
ଆଠ: എട്ട് 8
ଆଠଗୁଣା: എട്ടുമടങ്ങ്
ଆତଙ୍କପୂର୍ଣ୍ଣ|: ഭയപൂര്ണ്ണമായ.
ଆତଙ୍କିତ: പേടിച്ച. ഭയവിഹ്വലനായ.
ଆତୁର: ഇളകിമറിഞ്ഞ തകിടം_മറിഞ്ഞ.
ଆତ୍ମଜନୀୟ: എന്നെ_സംബന്ധിക്കുന്ന എന്റേതായ സ്വന്തം തന്റേതായ.
ଆତ୍ମପରକ: സ്വാര്ഥതയുള്ള
ଆତ୍ମପ୍ରଶଂସକ: അഹങ്കാരിയായ അഹങ്കാരമുള്ള ആത്മപ്രശംസകനായ
ଆତ୍ମବଲମ୍ବୀ: സ്വയം_ആശ്രയിക്കുന്ന.
ଆତ୍ମାବଲମ୍ବିନୀ: സ്വതന്ത്രമായ.
ଆତ୍ମାଭିମାନୀ|: ആത്മാഭിമാനമുള്ള.
ଆତ୍ମାଭିମୁଖୀ_: അന്തര്മുഖനായ മനസ്സിലേക്കു_നോക്കുന്ന.
ଆତ୍ମାରୂପୀ|: അശരീരി.
ଆତ୍ମୀୟ_: അടുത്ത.
ଆଦରଣୀୟ: ആദരണീയനായ.
ଆଦରଣୀୟା: ആദരിക്കപ്പെട്ട.
ଆଦର୍ଶ: ആദര്ശവാനായ
ଆଦର୍ଶବାଦୀ: പ്രദര്‍ശിപ്പിക്കുന്ന കാണിക്കുന്ന.
ଆଦେଶହୀନ: കല്പ്പിക്കപ്പെടാത്ത
ଆଦ୍ର: നനവുള്ള ഈറനായ ആറ്‍ദ്രമായ കുതിറ്‍ന്ന ഈറ്‍പ്പമുള്ള
ଆଦ୍ୟ: മുമ്പുള്ള പ്രാരംഭികമായ ആദ്യമായ.
ଆଧାରହୀନ: ആശ്രയമില്ലാത്ത അടിസ്ഥാനമില്ലാത്ത.
ଆଧାରିତ: ആശ്രയിക്കപ്പെട്ട.
ଆଧୁନିକ: ആധുനികം. നിലവിലുള്ള്_കാലത്തെ
ଆନନ୍ଦକାରୀ: ആനന്ദപ്രദം ആനന്ദ_ദായകം സുഖപ്രദം പ്രസന്നതാദായകം ആനന്ദദായി ആനന്ദകാരി ആഹ്ലാദി.
ଆନନ୍ଦଦାୟକ: ആനന്ദപ്രദം ആനന്ദ_ദായകം സുഖപ്രദം പ്രസന്നതാദായകം ആനന്ദദായി ആനന്ദകാരി ആഹ്ലാദി. ആനന്ദപൂര്‍ണ്ണം ആനന്ദമയം ഉല്ലാസപൂര്‍ണ്ണം സാനന്ദം.
ଆନନ୍ଦଦାୟୀ: ആനന്ദപ്രദം ആനന്ദ_ദായകം സുഖപ്രദം പ്രസന്നതാദായകം ആനന്ദദായി ആനന്ദകാരി ആഹ്ലാദി.
ଆନନ୍ଦପୂର୍ଣ୍ଣ: ആനന്ദപൂര്‍ണ്ണം ആനന്ദമയം ഉല്ലാസപൂര്‍ണ്ണം സാനന്ദം.
ଆନନ୍ଦପ୍ରଦ: രസകരമായ വിനോദപ്രദമായ.
ଆନନ୍ଦପ୍ରଦ୍: ആനന്ദപ്രദം ആനന്ദ_ദായകം സുഖപ്രദം പ്രസന്നതാദായകം ആനന്ദദായി ആനന്ദകാരി ആഹ്ലാദി.
ଆନନ୍ଦିତ: ആനന്ദം_നിറഞ്ഞ സന്തോഷം_പ്രകടിപ്പിക്കുന്ന. സന്തോഷമുള്ള്വരാകുക.
ଆନମନା: വിഷമിച്ച.
ଆନୁବଂଶିକ: പിന്തുടര്‍ച്ചയായി_ലഭിച്ച.
ଆନୁଭୂମିକ: കുറുകെയുള്ള വിലങ്ങനെയുള്ള ചെരിഞ്ഞ വളഞ്ഞ.
ଆନୁଲମ୍ବିକ: മുകളില്‍ ഉയരത്തില്‍.
ଆନ୍ତରିକ: ആന്തരികമായ.
ଆନ୍ତ୍ରିକ: കുട്ല്_സംബന്ധമായ.
ଆପଣଙ୍କ: താങ്കളുടെ
ଆପଣାର: അവനവന്റെ സ്വന്തമായ തന്റെ തന്റേതായ. എന്റെ_പക്ഷത്തുള്ള സ്വ്ന്തം_ഭാഗത്തുള്ള തന്റെ തന്റെ_പക്ഷത്തുള്ള സ്വപക്ഷത്തുള്ള.
ଆପଦଗ୍ରସ୍ତ: സംകടം_പിടിപ്പെട്ട
ଆଫଗାନୀ: അഫ്ഘാനിന്റെ.
ଆବଦ୍ଧ: ബന്ധിക്കപ്പെട്ട.
ଆବରଣରହିତ: തിരശ്ശീല_ഇല്ലാത്ത ആവരണം_ഇല്ലാത്ത യവനിക_ഇല്ലാത്ത.
ଆବରଣହୀନ: തുറന്ന മൂടി_നീക്കിയ അടപ്പു_മാറ്റിയ തിരശ്ശീല_ഇല്ലാത്ത ആവരണം_ഇല്ലാത്ത യവനിക_ഇല്ലാത്ത. മുഖപടം മുഖാവരണം മൂടുപടം.
ଆବଶ୍ୟକ: പ്രയോഗിച്ച ഉപയോഗിച്ച. അനിവാര്യം.
ଆବଶ୍ୟକୀୟ: പ്രയോഗിച്ച ഉപയോഗിച്ച. ആവശ്യമുള്ള പ്രധാനമായ തീര്‍ച്ചയായും_വേണ്ട്തായ കടപ്പാടുള്ള ഒഴിച്ച്കൂടാനാവാത്ത.
ଆବାଦ: താമസിക്കുന്ന നില്‍ക്കാന്‍_യോഗ്യമ്മായ.
ଆବାସଯୁକ୍ତ: താമസ_യോഗ്യമായ വീടുള്ളത്
ଆବାସହୀନ: വീടില്ലാത്തവര്.
ଆବାସିକ: താമസ_യോഗ്യമായ വീടുള്ളത് വസിക്കുന്നതിനുള്ള.
ଆବାସିକ|: ശബ്ദങളുടെ.
ଆବାସିତ: താമസിക്കുന്ന നില്‍ക്കാന്‍_യോഗ്യമ്മായ.
ଆବାସୀୟ: ശബ്ദങളുടെ. വസിക്കുന്നതിനുള്ള.
ଆବିଳ|: മുഷിഞ്ഞ ശുചിയല്ലാത്ത അഴുക്കായ മലിനപ്പെട്ട വൃത്തിഹീനമായ
ଆବିଷ୍କାର_କର୍ତ୍ତା: കണ്ടു_പിടിത്തം_നടത്തിയ_ആള്‍.
ଆବିଷ୍କାରକ: കണ്ടു_പിടിത്തം_നടത്തിയ_ആള്‍.
ଆବିଷ୍ଟ: ബാധിച്ച തീവ്രമായ_വികാരം_നിറഞ്ഞ തീവ്രമായ_വികാരം_നിറഞ്ഞ
ଆବିଷ୍‌କର୍ତ୍ତା: കണ്ടു_പിടിത്തം_നടത്തിയ_ആള്‍.
ଆବୃତ: മൂടിയ നിറഞ്ഞ.
ଆବେଦକ: അപേക്ഷകന്.
ଆବେଦନକର୍ତ୍ତା|: അപേക്ഷകന്.
ଆବେଦନକାରୀ: അപേക്ഷകന്.
ଆବେଦିତ: അപേക്ഷ_സമര്‍പ്പിക്കുന്ന.
ଆବେଶପୂର୍ଣ୍ଣ: ബാധിച്ച തീവ്രമായ_വികാരം_നിറഞ്ഞ തീവ്രമായ_വികാരം_നിറഞ്ഞ
ଆବେଷ୍ଟିତ: ചുറ്റപ്പെട്ട ചുറ്റിയ.
ଆଭୂଷିତ: അലങ്കരിച്ച ആഭരണമണിഞ്ഞ അലങ്ക്ര്തമായ.
ଆଭ୍ୟନ୍ତର: ആന്തരികമായ.
ଆମୋଦକ: രസകരമായ വിനോദപ്രദമായ.
ଆମୋଦପ୍ରଦ_: രസകരമായ വിനോദപ്രദമായ.
ଆମୋଦିତ: ആനന്ദം_നിറഞ്ഞ സന്തോഷം_പ്രകടിപ്പിക്കുന്ന.
ଆମୋଦୀ: വിനോദപ്രിയനായ ആനന്ദം_പൂണ്ടവന്‍
ଆମ୍ବିଳିଆ: പുളിയുള്ള അംളരസമുള്ള
ଆରକ୍ଷିତ: കരുതല്.
ଆରଣ୍ୟ: വനത്തെ_സംബന്ധിക്കുന്ന.
ଆରଣ୍ୟକ: വന്യ കാടന്‍
ଆରମେନିୟା_ସମ୍ବନ୍ଧିତ: അറ്മേനിയന്‍
ଆରମେନିୟାନ୍: അറ്മേനിയന്‍
ଆରମ୍ଭ_ହୋଇଥିବା: ആരംഭിച്ച തുടക്കമിട്ട പ്രാരംഭിച്ച സമാരംഭിച്ച.
ଆରମ୍ଭ|: മുമ്പുള്ള പ്രാരംഭികമായ ആദ്യമായ.
ଆରମ୍ଭିକ: ആരംഭിച്ച തുടക്കമിട്ട പ്രാരംഭിച്ച സമാരംഭിച്ച.
ଆରାମଦାୟକ: വിശ്രമദായകമായ വിശ്രമം_നല്കുന്ന ക്ഷീണമകറ്റുന്ന ആശ്വാസം_നല്കുന്ന.
ଆରାମପ୍ରଦ: വിശ്രമദായകമായ വിശ്രമം_നല്കുന്ന ക്ഷീണമകറ്റുന്ന ആശ്വാസം_നല്കുന്ന.
ଆରୋଗ୍ୟପ୍ରଦ: ആരോഗ്യപ്രദമായ.
ଆରୋପକାରୀ: തെറ്റായ_കുറ്റാരോപണം അപകീര്‍ത്തിപ്പെടുത്തല്‍. ആരോപിക്കുന്ന്യാള്‍.
ଆରୋହକ: ആരോഹണ കയറുന്ന ആരോഹണം_ചെയ്യുന്ന.
ଆରୋହଣଯୋଗ୍ୟ: കയറുവാന്‍_പറ്റുന്ന.
ଆରୋହୀ: ആരോഹണ കയറുന്ന ആരോഹണം_ചെയ്യുന്ന.
ଆର୍ଜେଣ୍ଟିନାର_: അര്‍ജന്റീനയുടെ.
ଆର୍ତ୍ତ: ദു
ଆର୍ଥିକ: സാമ്പത്തിക_സ്ഥിതി.
ଆର୍ଯ୍ୟ_ଜାତୀୟ|: ആര്യജാതിയില്പെട്ട.
ଆଲୋକପୂର୍ଣ୍ଣ: പ്രകാശപൂര്‍ണ്ണമായ പ്രകാശമാനമായ.
ଆଲୋକିକ: തേജസ്സാര്ന്ന തിളങുന്ന.
ଆଲୋକିତ: പ്രകാശപൂര്‍ണ്ണമായ പ്രകാശമാനമായ.
ଆଲ୍ଲାଦିତ: സന്തോഷമുള്ള്വരാകുക.
ଆଳସ୍ୟପୂର୍ଣ୍ଣ: അലസനായ മടിയനായ ആലസ്യമുള്ള
ଆଳସ୍ୟଭରା: അലസനായ മടിയനായ ആലസ്യമുള്ള
ଆଶଂକା_ପୂର୍ଣ୍ଣ: ആശങ്കിക്കപ്പെട്ട ചിന്തയുള്ളവന്‍ വിചാരമുള്ളവന്‍ ഭയപ്പെടുന്നവന്‍ ആപത്തു_പ്രതീക്ഷിക്കുന്നവന്‍ അശുഭം_പ്രതീക്ഷിക്കുന്നവന്‍ പരുങുന്നവന്‍ അറച്ചു_നില്‍ക്കുന്നവന്‍ സന്ദേഹിക്കുന്നവന്‍.
ଆଶଂକିତ: ആശങ്കിക്കപ്പെട്ട ചിന്തയുള്ളവന്‍ വിചാരമുള്ളവന്‍ ഭയപ്പെടുന്നവന്‍ ആപത്തു_പ്രതീക്ഷിക്കുന്നവന്‍ അശുഭം_പ്രതീക്ഷിക്കുന്നവന്‍ പരുങുന്നവന്‍ അറച്ചു_നില്‍ക്കുന്നവന്‍ സന്ദേഹിക്കുന്നവന്‍.
ଆଶକ୍ତ: പ്രേമാസക്തനായ.
ଆଶଙ୍କାହୀନ: ആശങ്കയില്ലാത്ത ഭയമില്ലാത്ത ശങ്കയില്ലാത്ത ചിന്തയില്ലാത്ത കൂസലില്ലാത്ത.
ଆଶାଜନକ: ആശാജനകമായ.
ଆଶାତୀତ: അപ്രതീക്ഷിതമായി.
ଆଶାନୁକୂଳ: പ്രതീക്ഷയുള്ള ആശയുള്ള.
ଆଶାନୁରୂପ_: ആശാജനകമായ.
ଆଶାନ୍ବିତ: പ്രതീക്ഷയുള്ള ആശയുള്ള.
ଆଶାବାଦୀ: പ്രതീക്ഷയുള്ള ആശയുള്ള. ശുഭാപ്തിവിശ്വാസത്തിന്റെ.
ଆଶାବାନ୍: പ്രതീക്ഷയുള്ള ആശയുള്ള.
ଆଶାହୀନ: പ്രതീക്ഷ_ഇല്ലാത്ത ആശ_നഷ്ട്ടപ്പെട്ട ആശയറ്റ.
ଆଶ୍ଚର୍ଯ୍ୟଜନକ: പ്രത്യേകതയുള്ള അപൂര്വമായ.വ്യത്യാസമായ.
ଆଶ୍ଚର୍ୟଚକିତ: വിസ്മയിച്ച പരിഭ്രമിച്ച അമ്പരന്ന.
ଆଶ୍ଚର୍ୟାନ୍ବିତ: വിസ്മയിച്ച പരിഭ്രമിച്ച അമ്പരന്ന.
ଆଶ୍ରାହୀନ: ദരിദ്രനായ.
ଆଶ୍ରିତ: ആശ്രയിക്കപ്പെട്ട. പരാശ്രയി.
ଆଶ୍ରୟହୀନ: ദരിദ്രനായ. വീടില്ലാത്തവര്.
ଆଷ୍ଟ୍ରିୟାଈ: ആസ്ട്രിയയുടെ_. ആസ്ട്രിയയുടെ.
ଆସକ୍ତ: ആസക്തനായ താല്പര്യമുള്ള വിശ്വാസമുള്ള അനുരാഗമുള്ള താത്പര്യമുള്ള ശുഷ്കാന്തിയുള്ള മോഹമുള്ള അനുരക്തനായ.
ଆସନ୍ତା: വരാന്_പോകുന്ന ഭാവിയിലുള്ള വരാനിരിക്കുന്ന.
ଆସନ୍ନ: അടുത്തു_വന്ന അടുത്തെത്തിയ.
ଆସବିତ_ଜଳ: വാറ്റിയ
ଆସାମୀ: ആസാമിലെ ആസാമിലെ
ଆସାମୀ|: ആസാമിന്റേതായ.
ଆହତ: മുറിവേറ്റ ക്ഷതമേറ്റ.
ଆହାର: ഭക്ഷണയോഗ്യമായ ഭക്ഷണ_പദാര്‍ഥം.
ଆହ୍ଲାଦପ୍ରଦ: ത്രിപ്തിപ്പെടുത്തുന്നയാള്‍.
ଆହ୍ଲାଦିତ: ആനന്ദം_നിറഞ്ഞ സന്തോഷം_പ്രകടിപ്പിക്കുന്ന.
ଆହ୍ଳାଦି: ആനന്ദപ്രദം ആനന്ദ_ദായകം സുഖപ്രദം പ്രസന്നതാദായകം ആനന്ദദായി ആനന്ദകാരി ആഹ്ലാദി.
ଆୟତ୍ତ: നിയമം_പാലിക്കുന്ന.
ଆୟାରଲ୍ୟାଣ୍ଡୀ: അയര്‍ലാന്റിലെ
ଆୟାରଲ୍ୟାଣ୍ଡୀୟ: അയര്‍ലാന്റിലെ
ଆୟାସୀ: സ്ത്രീ_ലംബടനായ വിലാസപ്രിയനായ ഭോഗപ്രിയനായ.
ଆୟୁଷ୍ମାନ: ചിരഞ്ജീവി.
ଆୟୋଜିତ_: തയ്യാറാക്കിയ
ଇଂଗ୍ରାଜୀ: ഇംഗ്ലീഷുകാര്‍
ଇଂରାଜୀ: ഇംഗലീഷ്
ଇଆଡେସିଆଡେ_ପଡିଥିବା: ചിതറിയ പരന്നു_കിടക്കുന്ന നുറുക്കുകളായ.
ଇଚ୍ଛା_ପୂର୍ଣ୍ଣ: ത്ര്പ്തിയുള്ള മനസ്സാലെയുള്ള.‌
ଇଚ୍ଛାନୁସାରେ_ଐଚ୍ଛିକ: ഇച്ഛയനുസരിച്ചുള്ള് ഇഷ്ടത്തിനനുസ്രിതമായ ഉദ്ദേശ്യത്തോടെയുള്ള.
ଇଚ୍ଛାହୀନ: ആഗ്രഹമില്ലാത്തവന്. ആഗ്രഹമില്ലായ്മ
ଇଚ୍ଛିତ: ഇച്ഛിച്ച് ആഗ്രഹിച്ച താല്പര്യപ്പെട്ട.
ଇଚ୍ଛୁକ: തിരയുന്ന അന്വേഷിക്കുന്ന
ଇଛୁକ: ആഗ്രഹമുള്ള.
ଇଟାଲୀ: ഇറ്റലിയുടെ.
ଇଟାଲୀୟ: ഇറ്റാലിയന്‍.
ଇଣ୍ଡୋନେଶିୟା: ഇന്ദോനേഷ്യയുടെ
ଇଥିଓପିଆନ୍: എത്യോപ്യന് എത്യോപ്യ.
ଇଦାନୀଂ: ആധുനികം.
ଇଦାନୀଂତନ: ആധുനികം.
ଇଦୃଶ: ഇതതരത്തിലുള്ള.
ଇନ୍ଦ୍ରିୟ_ଗୋଚର: ഇന്ദ്രിയങള്‍ക്ക്_വിഷയമാകത്തക്ക.
ଇନ୍ଦ୍ରିୟଗମ୍ୟ: ഇന്ദ്രിയങള്‍ക്ക്_വിഷയമാകത്തക്ക.
ଇନ୍ଦ୍ରିୟଲୋଲୁପ: കാമിയായ കാമ_വികാരമുള്ള ക്രീഡാസക്തിയുള്ള.
ଇନ୍ଦ୍ରିୟାତୀତ: ഇന്ദ്രിയാതീതമായ.
ଇନ୍ଦ୍ରିୟାଶକ୍ତ: കാമിയായ കാമ_വികാരമുള്ള ക്രീഡാസക്തിയുള്ള.
ଇନ୍ଫ୍ରାରେଡ୍_ରଶ୍ମି: അപരക്ത ഇന്‍ഫ്രാറെഡ്.
ଇପ୍ସିତ: തിരയുന്ന അന്വേഷിക്കുന്ന
ଇରାକୀ: ഇറാക്കിലെ ഇറാക്ക്_രാജ്യത്തെ.
ଇରାନୀ: ഇറാനി പേര്‍ശ്യന്‍ ഇറാനിന്റെ
ଇର୍ଷାପୂର୍ଣ୍ଣ: അസൂയ_നിറഞ്ഞ.
ଇସ୍ପାତୀ: ഉരുക്കുകൊണ്ടുള്ള. ഉരുക്കുകൊണ്ട്_നിര്മ്മിച്ച. ഉറപ്പുള്ള.
ଇସ୍ରାଏଲୀୟ: ഇസ്രേയേലിയന്‍.
ଇହୁଦୀ: യഹൂദ ജൂത.
ଈର୍ଷାହୀନ: അസൂയ_ഇല്ലാതിരിക്കുക.
ଈଶ୍ବରୀୟ: ഈശ്വരനെ_സംബന്ധിക്കുന്ന ദേവിയെ_സംബന്ധിക്കുന്ന പരമേശ്വരിയെ_സംബന്ധിക്കുന്ന.
ଉଗାଣ୍ଡାନ୍: ഉഗാണ്ടിയന്
ଉଗ୍ର: സൂക്ഷ്മ_ഗ്രാഹിത്വം. പ്രബലമായി.
ଉଗ୍ରପନ୍ଥୀ: ഉഗ്രവാദി തീവ്രവാദി.
ଉଗ୍ରବାଦୀ: ഉഗ്രവാദി തീവ്രവാദി.
ଉଚିତ: സാന്മാര്‍ഗ്ഗികത സാന്മാര്‍ഗ്ഗികാചരണം. യുക്തമായ ഉചിതമായ ഒത്ത തക്ക
ଉଚ୍ଚ: ഉയര്‍ന്ന പൊക്കമുള്ള ഉയര്ന്ന്.
ଉଚ୍ଚ_ବଂଶୀୟ: ഉന്നതകുലജാതനായ.
ଉଚ୍ଚା: ഉയര്‍ന്ന പൊക്കമുള്ള ഉയര്ന്ന പൊങ്ങിയ ഉയര്ന്നു_നില്ക്കുന്ന.
ଉଚ୍ଚା|: ഉയര്ന്ന്.
ଉଚ୍ଚାକାଂକ୍ଷୀ: ഔന്നത്ത്യത്തിനുള്ള_അഭിലാഷം വലുതാകാനുള്ള_ആഗ്രഹം.
ଉଚ୍ଚାନିଚା: പരുപരുപ്പുള്ള ഉയര്‍ന്നതും_താണതുമായ തുല്യമല്ലാത്ത പൊങിറ്യതും_താണതുമായ കുണ്ടും_കുഴിയുമായ യോജിക്കാത്ത ചേര്‍ച്ചയില്ലാത്ത.
ଉଚ୍ଛନ୍ନ: മരിച്ച നശിച്ച നശിപ്പിക്കപ്പെട്ട.
ଉଚ୍ଛୃଙ୍ଖଳ: നിയന്ത്രണമില്ലാത്ത തോന്ന്യാസമുള്ള ധിക്കാരപരമായ.
ଉଚ୍ଛୃଙ୍ଖଳିତ: ക്രമമല്ലാത്ത.
ଉଛିଷ୍ଟ: ഉച്ഛിഷ്ടമായ എച്ചിലായ ഫേലമായ ചണ്ടിയായ ശേഷിച്ച
ଉଜବେକିସ୍ତାନୀ: ഉസ്ബെക്കിസ്താനിന്റെ.
ଉଜୁଡା: വാസമില്ലാത്ത നശിച്ചു_പോയ ഉപേക്ഷിച്ച അന്യമായ.
ଉଜୁଡିଯାଇଥିବା: വിജനമാ‍യ ആള്‍പാറ്പ്പില്ലാത്ത ജനങ്ങളില്ലാത്ത നിറ്ജ്ജനമായ മനുഷ്യരില്ലാത്ത സഹവാസമില്ലാത്ത.
ଉଜ୍ଜଳ: തേജസ്സാര്ന്ന തിളങുന്ന. തിളങ്ങുന്ന ശോഭയുള്ള തെളിമയുള്ള ശുദ്ധമായ സ്പഷ്ട്ടമായ.
ଉଜ୍ଜଳ_: വെളുത്തത്.
ଉଜ୍ବଳ: പ്രകാശപൂര്‍ണ്ണമായ പ്രകാശമാനമായ.
ଉଞ୍ଚ: ഉയര്‍ന്ന പൊക്കമുള്ള
ଉଞ୍ଚା: ഉയര്‍ന്ന പൊക്കമുള്ള
ଉଠାଣିଆ: ഉയര്ന്ന പൊങ്ങിയ ഉയര്ന്നു_നില്ക്കുന്ന.
ଉଡନ୍ତା: വേഗതയുള്ള ചുണയുള്ള തീക്ഷ്ണമായ.
ଉତ୍କୃଷ୍ଟ: ഉത്തമമായ.
ଉତ୍ତମ: ഉത്തമമായ. കുറേ_കൂടി_ഭേദമായ കൂടുതല്_മെച്ചപ്പെട്ടതായ.
ଉତ୍ତର: വടക്കിനെ_സംബന്ധിക്കുന്ന.
ଉତ୍ତର_ଆମେରିକୀୟ_: വടക്കേ_അമേരിക്കയിലെ.
ଉତ୍ତର_କୋରିଆ: ഉത്തര_കൊറിയന്‍.
ଉତ୍ତରକାଳୀନ: ഉത്തരകാലീനമായ.
ଉତ୍ତରଦାତା: ഉത്തരം_നല്‍കുന്ന ഉത്തരം_പറയുന്ന.
ଉତ୍ତରଦାୟକ: ഉത്തരവാദിത്വമുള്ള ഉത്തരവാദപ്പെട്ട
ଉତ୍ତରଦାୟୀ: ഉത്തരവാദിത്വമുള്ള ഉത്തരവാദപ്പെട്ട
ଉତ୍ତୀର୍ଣ୍ଣ: വിജയിച്ച ജയിച്ച്ച സഫലമായ.
ଉତ୍ତୁଙ୍ଗ: ഉയര്‍ന്ന പൊക്കമുള്ള
ଉତ୍ତେଜକ: ഉത്തേജിപ്പിക്കുന്ന പ്രേരിപ്പിക്കുന്ന ജ്വലിപ്പിക്കുന്ന.
ଉତ୍ତେଜନା_ପ୍ରଦ: ഉത്തേജിപ്പിക്കുന്ന പ്രേരിപ്പിക്കുന്ന ജ്വലിപ്പിക്കുന്ന.
ଉତ୍ତେଜନାଶୂନ୍ୟ: തണുത്ത.
ଉତ୍ତେଜନୀୟ: സ്തോഭജനകമായ
ଉତ୍ତେଜିତ: ഉതേജിപ്പിക്കുക ജ്വലിപ്പിക്കുക.
ଉତ୍ପନ୍ନ: ഉത്പാദിപ്പിക്കുന്ന ഉത്ഭവിക്കുന്ന ഔല്പാദികമായ ഉല്പാദിക്കപ്പെട്ട് ഉല്പാദിത ഉല്പാദിപ്പിക്കപ്പെട്ട ഉല്പാദ്യ് സ്ര്‌ഷ്ടിപരമായ നിറ്മ്മാണാത്മകമായ രചനാത്മകമായ.
ଉତ୍ପାଟିତ: തുള ദ്വാരം.
ଉତ୍ପାଦିତ: ഉത്പാദിപ്പിക്കുന്ന ഉത്ഭവിക്കുന്ന ഔല്പാദികമായ ഉല്പാദിക്കപ്പെട്ട് ഉല്പാദിത ഉല്പാദിപ്പിക്കപ്പെട്ട ഉല്പാദ്യ് സ്ര്‌ഷ്ടിപരമായ നിറ്മ്മാണാത്മകമായ രചനാത്മകമായ. ഉത്പാദിപ്പിക്കപ്പെട്ട.
ଉତ୍ପୀଡିତ: പീടിപ്പിക്കപ്പെട്ട.
ଉତ୍ସର୍ଗୀକୃତ: അറ്പ്പിച്ച സമറ്പ്പിച്ച തറ്പ്പിച്ച
ଉତ୍ସାହଯୁକ୍ତ: ഉത്സാഹമുള്ള_.
ଉତ୍ସାହଶୂନ୍ୟ: നിരുത്സാഹകന്‍ പ്രവര്‍ത്തിക്കാത്തവന്‍.
ଉତ୍ସାହହୀନ: അനുത്സാഹികളായ. നിരുത്സാഹകന്‍ പ്രവര്‍ത്തിക്കാത്തവന്‍.
ଉତ୍ସାହୀ: ഉത്സാഹമുള്ള_. തത്പരമായ ആഭിമുഖ്യമുള്ള പ്രതിപത്തിയുള്ള ശുഷ്കാന്തിയുള്ള വാഞ്ജയുള്ള താല്‍പര്യമുള്ള ഉത്സാഹമുള്ള സന്നദ്ധതയുള്ള
ଉତ୍ସୁକ: അറിയാനാഗ്രഹമുള്ള ജിജ്ഞാസു.
ଉତ୍ସୁକହୀନ: ഉത്സാഹമില്ലാത്ത.
ଉତ୍‌କଣ୍ଠିତ: ശാന്തമല്ലാത്ത.
ଉଦଘୋଷକ: വിളംബരം_ചെയ്യുന്ന ഉദ്ഘോഷിക്കുന്ന ഘോഷിക്കുന്ന പ്രസ്താവിക്കുന്ന പ്രഖ്യാപിക്കുന്ന.
ଉଦଯୋଗହୀନ: പരിശ്രമഹീനനായ ശക്തിഹീനനായ ബലഹീനനായ.
ଉଦର: വിരക്ത്തിയുള്ള_.
ଉଦାର: ഉദാരമായ ദാനശീലമുള്ള. ഉദാരമതിയായ വിശാലഹ്രിദയനായ .
ଉଦାରଚିତ୍ତ: ഉദാരമതിയായ വിശാലഹ്രിദയനായ .
ଉଦାରତାବାଦୀ: ഉദാരമായ ദാനശീലമുള്ള.
ଉଦାରବାଦୀ: ഉദാരമായ ദാനശീലമുള്ള.
ଉଦାରମନା: ഉദാരമതിയായ വിശാലഹ്രിദയനായ .
ଉଦାସ: വിഷമിച്ച.
ଉଦିତ|: ഉദിച്ച ഉയര്ന്ന.
ଉଦ୍ଦୀପକ: ഉത്തേജിപ്പിക്കുന്ന പ്രേരിപ്പിക്കുന്ന ജ്വലിപ്പിക്കുന്ന.
ଉଦ୍ଦୀପିତ: ഉതേജിപ്പിക്കുക ജ്വലിപ്പിക്കുക.
ଉଦ୍ଦୀପ୍ତ: ഉതേജിപ്പിക്കുക ജ്വലിപ്പിക്കുക.
ଉଦ୍ଧତ: നിയന്ത്രണമില്ലാത്ത തോന്ന്യാസമുള്ള ധിക്കാരപരമായ.
ଉଦ୍ଧୃତ: സംകേതം_കാട്ടിയ.
ଉଦ୍ବିଗ୍ନ: അസ്വസ്ഥമായ.
ଉଦ୍ୟମଶୀଳ: സ്ഥിരമായി_പരിശ്രമിക്കുന്ന
ଉଦ୍ୟମହୀନ: പരിശ്രമഹീനനായ ശക്തിഹീനനായ ബലഹീനനായ. പ്രതികാരം_ചെയ്യാത്ത.
ଉଦ୍ୟମୀ: പരിശ്രമിക്കുന്ന പ്രയത്നിക്കുന്ന.
ଉଦ୍ୟୋଗ_ବିଷୟକ: ഔദ്യോഗികമായ.
ଉଦ୍ୟୋଗ_ସମ୍ପର୍କିତ: ഔദ്യോഗികമായ.
ଉଦ୍ୟୋଗୀ: ജോലിത്തിരക്കുള്ള ഉദ്യോഗമുള്ള പരിശ്രമിയായ കര്‍മ്മനിരതയായ വ്യവസായ_നിരതയായ തൊഴില്‍_നിരതയായ. പരിശ്രമിക്കുന്ന പ്രയത്നിക്കുന്ന.
ଉନବିଂଶତିତମ: പത്തൊന്‍പതാം പത്തൊന്‍പതാമത്തെ
ଉନ୍ନତ: ഉയര്‍ന്ന പൊക്കമുള്ള വികസിതമായ. കുറേ_കൂടി_ഭേദമായ കൂടുതല്_മെച്ചപ്പെട്ടതായ.
ଉନ୍ନତତର: കുറേ_കൂടി_ഭേദമായ കൂടുതല്_മെച്ചപ്പെട്ടതായ.
ଉନ୍ନତିକାରକ: കയറ്റം_കിട്ടുന്നത് ഉയര്‍ച്ചകിട്ടുന്നത് വ്ര്ദ്ധി_ഉണ്ാകുന്നത് അഭിവ്ര്ദ്ധി_ഉണ്ടാകുന്നത് പുരോഗ്തി_ഉണ്ടാകുന്നത്.
ଉନ୍ନତିକାରୀ: കയറ്റം_കിട്ടുന്നത് ഉയര്‍ച്ചകിട്ടുന്നത് വ്ര്ദ്ധി_ഉണ്ാകുന്നത് അഭിവ്ര്ദ്ധി_ഉണ്ടാകുന്നത് പുരോഗ്തി_ഉണ്ടാകുന്നത്.
ଉନ୍ମତ୍ତ: വീതി
ଉନ୍ମାଦ: വീതി
ଉନ୍ମୁକ୍ତ: സ്വ്തന്ത്റനായ തുറന്ന തുറന്ന പരസ്യമാക്കിയ ആരംഭിച്ച വെളിപ്പെടുത്തിയ.
ଉପକାରୀ: ഉപകാരം_ചെയ്യുന്ന സഹായിക്കുന്ന നന്മ_ചെയ്യുന്ന
ଉପକୃତ_: നന്ദിയുള്ള ഉപകാര_സ്മരണയുള്ള.
ଉପଚାର୍ଯ୍ୟ: ചികിത്സിക്കാവുന്നത്.
ଉପଦେଶକ: ഉപദേശകന്.
ଉପଦେଶଦାତା: ഉപദേശകന്.
ଉପଦେଷ୍ଟା: ഉപദേശകന്.
ଉପଦ୍ରବଗ୍ରସ୍ତ: അശാന്തിപൂര്ണ്ണമായ.
ଉପନ୍ୟାସିକ: നോവലിനെ_സംബന്ധിച്ച.
ଉପପାଦ୍ୟ: യഥാറ്ത്ഥ_ജ്ഞാനം_അനുസരിച്ചുള്ള ശാസ്ത്രം_അനുസരിച്ചുള്ള തെളിയിച്ചിട്ടുള്ള.
ଉପଭୋଗୀ: പിന്തുടരുന്ന അനുഗമിക്കുന്ന
ଉପଭୋଗ୍ୟ: ഉപയോഗ്യമായ.
ଉପଯୁକ୍ତ: യോഗ്യനായ കാര്യശേഷിയുള്ള നിപുണനായ സമര്ത്ഥനായ ശക്തനായ വിദഗ്ദ്ധനായ ചുണയുള്ള ചെയ്തുതഴക്കമുള്ള ചതുരനായ ചുറുചുറുക്കുള്ള ജ്ഞാനമുള്ള കെല്‍പ്പുള്ള പാടവമുള്ള കൌശലമുള്ള കഴിവുള്ള യുക്തമായ ഉചിതമായ ഒത്ത തക്ക
ଉପଯୋଗହୀନ: ഉപയോഗശൂന്യ്മായ.
ଉପଯୋଗି: പ്രയോഗിച്ച ഉപയോഗിച്ച.
ଉପଯୋଗୀ: ലാഭദായകം ഗുണകരം ഉപയോഗപ്രദം. ഉപയോഗമുള്ള പ്രയോജനമുള്ള
ଉପର: മുകളിലുള്ള.
ଉପରଲିଖିତ: മേല്പറഞ്ഞ മുമ്പേ_പറയപ്പെട്ട
ଉପରି: മുകളിലുള്ള.
ଉପର୍ୟୁକ୍ତ: മേല്പറഞ്ഞ മുമ്പേ_പറയപ്പെട്ട
ଉପଲବ୍ଧ: ലഭിച്ച നേടിയ സ്വീകരിക്കപ്പെട്ട.
ଉପସ୍ଥିତ: ഹാജരുള്ള സന്നിഹിതമായ വന്ന ഉള്ള വന്നു_ചേര്‍ന്ന.
ଉପସ୍ଥିତ|: സമകാലീന വറ്ത്തമാനകാല ഇപ്പോഴുള്ള നിലവിലുള്ള.
ଉପହସନୀୟ: പരിഹാസത്തിനു_അര്‍ഹനായ നിന്ദായോഗ്യമായ.
ଉପହାସ୍ୟ: പരിഹാസത്തിനു_അര്‍ഹനായ നിന്ദായോഗ്യമായ.
ଉପାଦେୟ: ഉപയോഗമുള്ള പ്രയോജനമുള്ള
ଉପାର୍ଜନକ୍ଷମ: സമ്പാദിക്കുന്ന.
ଉପାର୍ଜିତ: കിട്ടിയ നേടിയ.
ଉପାର୍ଜିତ_: നേടിയത്
ଉପାୟହୀନ: സന്ദേഹമില്ലാതെ ധാരണയോടെ ഉപായത്തോടെ നിശ്ചയത്തോടെ ധൈര്യത്തോടെ ഉറ്പ്പോടെ തീറ്ച്ചയോടെ.
ଉପୁଡିବା_ଯୋଗ୍ୟ: തുളഞ്ഞ.
ଉପେକ୍ଷଣୀୟ|: ഉപേക്ഷിക്കത്തക്ക അവഹേളിക്കത്തക്ക.
ଉପେକ୍ଷିତ: ഉപേക്ഷിക്കപ്പെട്ട. അപമാനിതനായ ആദരിക്കപ്പെടാത്ത തിരസ്ക്രിതനായ ഉപേക്ഷിക്കപ്പെട്ട തിരസ്ക്കരിക്കപ്പെട്ട
ଉଭୟଚର: ഉഭയചര വെള്ളത്തിലും_കരയിലും_ജീവിക്കുന്ന.
ଉରୁଗୁଏ_ସମ୍ବନ୍ଧୀୟ: ഉറ്ഗുവേയന്.
ଉରୁଗୁଏନ୍: ഉറ്ഗുവേയന്.
ଉର୍ଦ୍ଧ: മുകളില്‍ ഉയരത്തില്‍.
ଉର୍ବର: ഉല്പാദനക്ഷമമായ ഫലഭൂയിഷ്ഠമായ സംരിദ്ധമായ സമ്പന്നമായ.
ଉର୍ମିଳ|: തിരയടിക്കുന്ന ഇളകുന്ന.
ଉଲଙ୍ଘନୀୟ: അനുസരിക്കാതിരിക്കല്
ଉଲ୍|: കമ്പിളി.
ଉଲ୍ଲଂଘିତ: നിയമം_ലംഘിക്കല്‍
ଉଲ୍ଲସିତ: ആനന്ദം_നിറഞ്ഞ സന്തോഷം_പ്രകടിപ്പിക്കുന്ന.
ଉଲ୍ଲାସପୂର୍ଣ୍ଣ: ആനന്ദപൂര്‍ണ്ണം ആനന്ദമയം ഉല്ലാസപൂര്‍ണ്ണം സാനന്ദം.
ଉଲ୍ଲାସମୟ: ആനന്ദപൂര്‍ണ്ണം ആനന്ദമയം ഉല്ലാസപൂര്‍ണ്ണം സാനന്ദം.
ଉଲ୍ଲେଖିତ: മേല്പറഞ്ഞ മുമ്പേ_പറയപ്പെട്ട
ଉଷୁମ|: നേരിയ_ചോടുള്ള_വെള്ളം.
ଉଷ୍ଣ: ചൂടു ഉഷ്ണം
ଉଷ୍ଣକଟିବନ୍ଧୀୟ: ഉഷ്ണമേഖലയെ_സംബന്ധിക്കുന്ന.
ଉଷ୍ମ: ചൂടേകുന്ന ചൂട്പകരുന്ന.
ଋଣକାରୀ|: കടക്കാരന്.
ଋଣୀ: കടക്കാരന്.
ଏକ: ഒരു ഒന്ന് 1.
ଏକଆଖିଆ: ഒറ്റക്കണ്ണുള്ള.
ଏକଖୁଣ୍ଟିଆ: ഒറ്റക്കാല്‍_നാട്ടിയ_കൂടാരം.
ଏକତରଫା|: ഏകപക്ഷീയമായ.
ଏକତାପୂର୍ଣ୍ଣ: ഒരുമയോടെ അഖണ്ഡമായ അനന്യമായ ഏകീക്ര്‌തമായ ഒന്നായ സംഗതമായ പൊരുത്തപ്പെട്ട ഏക സംഘടിതമായ ഏകീഭവിച്ച ഏകചിത്തമായ യോജിച്ച ഏകകണ്ഡമായ.
ଏକତାହୀନ: ഐക്യം ഐഖ്യമത്യം അഖണ്ഡത ഏകത ഏകചിത്തത രജ്ഞിപ്പ് ഏകോപനം ഒരുമിപ്പ് ഏകമനസ്സ് ഏകീകരണം പൊരുത്തം ഇണക്കം ഏകീഭാവം സഹകരണം സ്വരുമ സ്വരുമിപ്പ്.
ଏକତ୍ର: ഒന്നിച്ചു_ചേര്‍ന്ന ശേഖരിച്ച കൂട്ടിചേര്‍ത്ത.
ଏକତ୍ରିତ: ഒന്നിച്ചു_ചേര്‍ന്ന ശേഖരിച്ച കൂട്ടിചേര്‍ത്ത.
ଏକଫସଲି: ഒരു_പൂ_ക്രിഷി_ചെയ്യുന്ന__സ്ഥലം.
ଏକମାତ୍ର: ഒരേയൊരു.
ଏକଲା: ഒരേയൊരു. ഏകാന്തവാസി.
ଏକଶତ_ଏକ: നൂറ്റി_ഒന്ന്
ଏକଶହ: നൂറാമത്തെ.
ଏକଶିଙ୍ଗୀ: ഒറ്റക്കൊമ്പുള്ള.
ଏକଷଠି: അറുപത്തി_ഒന്ന്
ଏକଷଠିତମ: അറുപത്തി_രണ്ട്
ଏକସ୍ତରି: എഴുപത്തി_ഒന്ന്
ଏକସ୍ତରିତମ: എഴുപത്തി_ഒന്നാം
ଏକା: ഏകാന്തമായ തനിയേ_ഉള്ള ഒറ്റയായ അനാഥമായ
ଏକା_ଭଳି: ഒരു_പോലെയുള്ള സമാനരൂപിയായ
ଏକା_ମାଆ_ପେଟ_ଭାଇ|: കൂടെ_പിറന്ന.
ଏକାଅଶୀ: എണ്പത്തി_ഒന്ന്
ଏକାଅଶୀତମ: ഇരുപത്തി_ഒന്നാമത്തെ
ଏକାକୀ: ഉപമയില്ലാത്ത അതുല്യമായ. ഏകാന്തമായ തനിയേ_ഉള്ള ഒറ്റയായ അനാഥമായ
ଏକାକ୍ଷରୀ: ഏകാക്ഷര.
ଏକାଦଶ: പതിനൊന്നാം പതിനൊന്നാമത്തെ
ଏକାଧିକ: അനേകം ഒന്നിലധികമായ പല വളരെയേറേ അസംഖ്യം.
ଏକାନବେ: തൊണ്ണൂറ്റി_ഒന്ന്
ଏକାନବେତମ: തൊണ്ണൂറ്റി_ഒന്നാമത്തെ.
ଏକାନ୍ତ: നിര്ജ്ജനം ഏകാന്തം.
ଏକାନ୍ତବାସୀ: ഏകാന്തവാസി.
ଏକାନ୍ତହୀନ: വിജനമല്ലാത്ത ഒറ്റ്യ്ക്കല്ലാത്ത തനിയെ_അല്ലാത്ത
ଏକାପରି: സമമായ തുല്യമൂല്യമായ.
ଏକାପ୍ରକାର: തുല്യമായ സമമായ സമാനമായ
ଏକାପ୍ରକାରର: ത്ത്സ്വരൂപമായ പ്ര്തിരൂപമായ പകറ്പ്പായ സാദ്ര്ശ്മായ പ്തിച്ഛായയുള്ള്.‌
ଏକାବନ: അന്പത്തി_ഒന്ന്
ଏକାବନତମ: അന്പത്തി_ഒന്നാം
ଏକାଭଳି: തുല്യമായ സമമായ സമാനമായ
ଏକୁଟିଆ: ഏകാന്തമായ തനിയേ_ഉള്ള ഒറ്റയായ അനാഥമായ ഏകാന്തവാസി.
ଏକୁଟିଆ_: ഗ്രഹിക്കപ്പെട്ട
ଏକେଲା: ഏകാന്തമായ തനിയേ_ഉള്ള ഒറ്റയായ അനാഥമായ
ଏକୋଇ_: ഒരേയൊരു.
ଏଗାର_ଦିନ: പതിനൊന്നാം പതിനൊന്നാമത്തെ
ଏତାଦୃଶ: ഇതതരത്തിലുള്ള.
ଏପରି-ସେପରି: ഇന്നതായ
ଏବର: ആധുനികം.
ଏଭଳି: ഇതതരത്തിലുള്ള.
ଏମିତି_ସେମିତି: പ്രാധാന്യമില്ലാത്ത.
ଏରିଟ୍ରିୟାନ୍: എറിട്രിയന്
ଏସିଆ_ସମ୍ବନ୍ଧିତ: ഏഷ്യന്‍.
ଏସିଡି: അമ്ലസംബന്ധി അമ്ലതയുള്ള
ଏସିଡିୟ_: അമ്ലതയുള്ള
ଏସୀୟ: ഏഷ്യന്‍.
ଏହି_ପ୍ରକାର: ഇതതരത്തിലുള്ള.
ଏହି_ସମୟ: വറ്ത്തമാനകാലത്തുള്ള വറ്ത്തമാനസമയത്തുള്ള ഇപ്പൊഴുള്ള ഇന്നത്തെ വറ്ത്തമാനമായ.
ଐଚ୍ଛିକ: ഇച്ഛയനുസരിച്ചുള്ള തിരഞെടുക്കാനുള്ള ആഗ്രഹന്മനുസരിച്ചുള്ള തിതമനുസരിച്ചുള്ള അഭിലാഷം_അനുസരിച്ചുള്ള ഇച്ഛിത ഉദ്ദിഷ്ടമായ താ‍ത്പര്യമുള്ള തിതകരമായ.
ଐତିହାସିକ: ഐതിഹാസികമായി. ചരിത്ര_സംബന്ധമായ.
ଐଶ୍ବରିକ: ഈശ്വരനെ_സംബന്ധിക്കുന്ന ദേവിയെ_സംബന്ധിക്കുന്ന പരമേശ്വരിയെ_സംബന്ധിക്കുന്ന.
ଐଶ୍ବରୀୟ: ഈശ്വരനെ_സംബന്ധിക്കുന്ന ദേവിയെ_സംബന്ധിക്കുന്ന പരമേശ്വരിയെ_സംബന്ധിക്കുന്ന.
ଐଶ୍ୱର୍ଯ୍ୟଶାଳୀ: ധനികനായ പണക്കാരനായ
ଓଜନିଆ: ഭാരിച്ച കനത്ത തൂക്കമുള്ള മഹത്ത്വമുള്ള ശ്രേഷ്ഠമായ ഗംഭീരമായ ഉല്ക്ര്ഷ്ടമായ പ്രൌഢമായ ഉത്തമമായ വിശിഷ്ഠമായ സ്തുത്യറ്ഹമായ മികച്ച മഹിമയുള്ള.
ଓଜନ୍‌ଦାର୍: ഭാരിച്ച കനത്ത തൂക്കമുള്ള
ଓଡିଆ: ഒറിയ
ଓଦା: നനവുള്ള ഈറനായ ആറ്‍ദ്രമായ കുതിറ്‍ന്ന ഈറ്‍പ്പമുള്ള
ଓପଡା: തുള ദ്വാരം.
ଓମାନୀ: ഒമാനി.
ଓଲଟା: വിപരീതമ്മയ്. വിപരീതം.
ଓସାରିଆ: വീതിയുള്ള
ଔଦ୍ୟୋଗିକ: ഔദ്യോഗികമായ.
ଔପଚାରିକ_: ഔപചാരികമായി ഉപചാരപൂര്വ്വമുള്ള ആചാരപരമായ ഔദ്യോഗപരമായ.
ଔଷଧୀୟ|: ചികിത്സാ_സംബന്ധമായ. ഔഷധങള്_സംബന്ധിച്ച.
କଂସାରି: മൂശാരിയുടെ.
କକାପୁଅ_ଭାଇ: അച്ഛന്റെ_ഇളയ_സഹോദരനെ_സംബന്ധിക്കുന്ന.
କକାଶ୍ବଶୁର: അച്ഛന്റെ_അനിയനെ_സംബന്ധിക്കുന്ന.
କଙ୍କାଳଭଳି: അസ്ഥി_പഞരം_പോലെ എല്ലും_തോലും_മാത്രമാവുക.
କଙ୍କାଳିଆ: അസ്ഥി_പഞരം_പോലെ എല്ലും_തോലും_മാത്രമാവുക.
କଚ୍ଚା: പ്രായോഗികജ്ഞാനമില്ലാത്ത അഭ്യാസജ്ഞാനമില്ലാത്ത പ്രാവറ്ത്തികജ്ഞാനമില്ലാത്ത ക്രിയാത്മകജ്ഞാനമില്ലാത്ത അനുഭവസിദ്ധന്മല്ലാത്ത പക്വതയില്ലാത്ത.
କଞ୍ଚା: പച്ചയായ പാകമല്ലാത്ത പച്ചയായ.
କଞ୍ଜୁସ: പിശുക്കന്‍ ലുബ്ധന്‍ ലോഭന്‍ കൃപണന്‍
କଞ୍ଜୁସ୍: പിശുക്കനായ ക്ര്പണനായ.‌
କଟା: മുറിഞ്ഞ
କଟୁ: കൈപ്പേറിയ ചവര്‍പ്പുള്ള
କଟୂ: വിരിദ്ധമായ അസന്തുഷ്ടമായ.
କଟୂଭାଷୀ: കഠിന_വാക്കു_പറയുന്ന അപ്രിയം_പറയുന്ന.
କଟ୍ଟରପନ୍ଥୀ|: മത_കാര്യങളില്_വിട്ടുവീഴ്ചയില്ലാത്ത.
କଠିନ: ആഴമേറിയ. ബുദ്ധിമുട്ടുള്ള_. പ്രയാസമുള്ള ഗൂഢമായ ഉറപ്പുള്ള ദൃഢമായ കഠോരം ദ്രിഢം ക്ലേശകരമായ. ഒന്നായത്. കഠിനമായ.
କଠୋର: ദ്രോഹിയായ കരുണയില്ലാത്ത ഉപദ്രവിക്കുന്ന അചഞ്ചലമായ മാറാത്ത നിശ്ചലമായ. കര്‍ക്കശമായ ദൃഢചിത്തനായ കഠോരം ദ്രിഢം ക്ലേശകരമായ. കര്ക്കശ_സ്വഭാവമുള്ള.
କଠୋରହୃଦୟ: കഠിനഹ്രിദയനായ കഠോരഹ്രിദയനായ ദയ_ഇല്ലാത്ത.
କଡା: കര്‍ക്കശമായ ദൃഢചിത്തനായ
କଡା|: കര്ക്കശ_സ്വഭാവമുള്ള.
କଣା: ഒറ്റക്കണ്ണുള്ള.
କଣାଯୁକ୍ତ: തുളയുള്ളത് ഓട്ടയുള്ളത്.
କଣ୍ଟକଯୁକ୍ତ: മുള്ളുകളുള്ള.
କଣ୍ଟକହୀନ: മുള്ളില്ലാത്ത.
କଣ୍ଟକିତ: മുള്ളുകളുള്ള.
କଣ୍ଠରୁଦ୍ଧ: വാക്കുകള്_തടയപ്പെട്ട.
କଥନୀୟ: പറയത്തക്ക പറയാന്‍_കൊള്ളാവുന്ന. വര്‍ണ്ണിക്കാവുന്നത്.
କଥାକୁହା: സംസാരിക്കുന്ന. വ്യക്തമാക്കുന്ന.
କଥ୍ୟ: പറയത്തക്ക പറയാന്‍_കൊള്ളാവുന്ന.
କଦାଚାରୀ: ദുശ്ചരിത്രം.
କନିଷ୍ଠ: ചെറുത്. അപ്രധാനമായപങ്കു_വഹിക്കുന്ന_അനുജന്‍.
କନିଷ୍ଠ|: ഇളയ പ്രായം_കുറഞ്ഞ.
କନ୍ଦରାବାସୀ: ഗുഹാവാസി.
କନ୍ନଡ: ക്ന്നഡ കന്നഡ കന്നടത്തിലെ
କପଟପୂର୍ଣ୍ଣ: ചതി_നിറഞ്ഞ.
କପଟମୟ: ചതി_നിറഞ്ഞ.
କପଟହୀନ: കാപഠ്യമില്ലാത്ത.
କପଟିଆ: കപടമായ.
କପଟୀ: ചതിയനായ വഞ്ചകനായ. കപടമായ.
କପୋଳ_କଳ୍ପିତ: സങ്കല്പ_സ്ര്‌ഷ്ടിയായ.
କବଚଧାରୀ|: കവചധാരി.
କବିତ୍ବପୂର୍ଣ୍ଣ: കാവ്യാത്മകമായ.
କମ: ചെറിയ. കുറയുക.
କମ_ପାଠୁ: അല്പം_വിദ്യയുള്ള.
କମ_ଶିକ୍ଷିତ: അല്പം_വിദ്യയുള്ള.
କମନୀୟ: സൌന്ദര്യമുള്ള സുമുഖമുള്ള ചേലുള്ള ചന്തമുള്ള
କମବୟସ୍କ: വയസ്സില്ലാത്ത.
କମଯୋର: ലോലമായ സുകുമാരമായ കോമളമായ
କମ୍: കുറച്ചു.
କମ୍|: ലേശം_മാത്രം.
କମ୍ପୁଟର_ସମ୍ବନ୍ଧୀ: കമ്പ്യൂട്റ്ററിന്റെ
କମ୍ପ୍ୟୁଟରୀକୃତ: കമ്പ്യൂട്ടറ്വത്കരിച്ച കമ്പ്യൂട്ടറ്വത്ക്രിതമായ. കമ്പ്യൂട്ടറ്വത്കരിച്ച കമ്പ്യൂട്ടറ്വത്ക്രിതമായ.
କମ୍ବୋଡିୟାଈ: കമ്പോടിയയുടെ കമ്പൂചിയയുടെ
କମ୍ୟୁନିଷ୍ଟ: സമത്വവാദിയായ.
କମ୍‌ଦାମ: വിലക്കുറവു
କରଜଦାର: കടക്കാരന്.
କରମୁକ୍ତ|: നികുതി_വിമുക്തരാക്കല്.
କରଯୁକ୍ତ: കരം_ചുമത്താവുന്ന.
କରାହୋଇନଥିବା: ചെയ്യാത്തത്.
କରୁଣାକର: ദയാലുവായ ക്രിപാലുവായ കാരുണികനായ മഹാമനസ്കനായ
କରୁଣାବାନ: ദയാലുവായ ക്രിപാലുവായ കാരുണികനായ മഹാമനസ്കനായ
କରୁଣାହୀନ: ദ്രോഹിയായ കരുണയില്ലാത്ത ഉപദ്രവിക്കുന്ന
କର୍କଶ: കര്ക്കശ_സ്വഭാവമുള്ള.
କର୍କଶା: കര്‍ക്കസയായ.
କର୍ଣ୍ଣଭେଦୀ: കര്‍ണഭേദകമായ. മ്ര്‌ദുവായ നേറ്മ്മയുള്ള‌ കനം_കുറഞ്ഞ ആറ്ദ്രമായ സൌമ്യതയുള്ള.
କର୍ତ୍ତବ୍ୟବାଦୀ: കര്തവ്യവാദി.
କର୍ତ୍ତା: പ്രവര്‍ത്തിക്കുന്നവന്‍.
କର୍ଦ୍ଦମାକ୍ତ: വ്രിത്തികെട്ട വ്രിത്തി_ഇല്ലാത്ത.
କର୍ମଠ: പരിശ്രമിക്കുക പ്രയത്നിക്കുക അധ്വാനിക്കുക കഠിനയത്നം_ചെയ്യുക
କର୍ମନିଷ୍ଠ: കര്‍ത്തവ്യ_ബോധമുള്ള
କର୍ମବାଦୀ: കറ്മ്മവാദി.
କର୍ମଶୀଳ: പരിശ്രമിക്കുക പ്രയത്നിക്കുക അധ്വാനിക്കുക കഠിനയത്നം_ചെയ്യുക
କର୍ମହୀନ: പണിയെടുക്കാത്ത.
କର୍ଷିତ: ക്ര്‌ഷിക്ക്_ഉപയുക്തമായ ക്ര്‌ഷിക്ക്_യോഗ്യമായ ക്ര്‌ഷി_ചെയ്യാന്‍_കൊള്ളാവുന്ന.
କଲମ୍ବିୟାନ୍: കൊളംബിയയുടെ.
କଲାକାମ: ഉത്പന്നമായ ജനിച്ച പരിസമാപ്തമായ.
କଲିକତି: കല്‍കത്തയെ_സംബന്ധിക്കുന്ന.
କଲିକତିଆ: കല്‍കത്തയെ_സംബന്ധിക്കുന്ന.
କଲ୍ୟାଣକାରୀ: നന്മ_നല്കുന്ന
କଲ୍ୟାଣପ୍ରଦ: നന്മ_നല്കുന്ന
କଲ୍ୟାଣମୟ_: നന്മ_നല്കുന്ന
କଳଙ୍କିତ: കളങ്ങ്കപ്പെട്ട.
କଳହକାରୀ: കലഹപ്രിയമുള്ള.
କଳହପ୍ରିୟ: കലഹപ്രിയമുള്ള.
କଳା: കറുത്ത കറുപ്പ്.
କଳା_ରସିକ: കലാസ്നേഹി.
କଳାତ୍ମକ: കലാത്മകമായ
କଳାପୂର୍ଣ୍ଣ: കലാത്മകമായ
କଳାପ୍ରେମୀ: കലാസ്നേഹി.
କଳାମୁହାଁ: കളങ്ങ്കപ്പെട്ട.
କଳାମୟ: കലാത്മകമായ
କଳାହୀନ: പ്രവ്ര്ത്തിയിലെ_കൌശലമില്ലായ്മ.
କଳିହା: കലഹപ്രിയമുള്ള.
କଳିହୁଡା: കലഹപ്രിയമുള്ള.
କଳିହୁଡି: കര്‍ക്കസയായ.
କଳୁଷିତ: കളങ്ങ്കപ്പെട്ട.
କଳେହୀ: കര്‍ക്കസയായ.
କଳୋଚିତ: സമയോചിതമായ സന്ദര്‍ഭത്തിനു_ചേര്‍ന്ന സമകാലീനമായ.
କଳ୍ପନାତୀତ: സങ്കല്പ്പിക്കാവുന്നതിനപ്പുറം.
କଳ୍ପିତ: കാല്പനീകമായ സാങ്കല്‍പ്പീകമായ വാസ്തവമല്ലാത്ത സങ്കല്പത്തിലുള്ള യാഥാറ്ത്ഥ്യമല്ലാത്ത സത്യ്മല്ലാത്ത ഭാവനയിലുള്ള കല്പിതമായ ഭാവനം_ചെയ്ത അനനുക്ര്‌തമായ മിഥ്യയായ അയഥാറ്ത്ഥമായ മായികമായ.
କଷା: ചവര്‍പ്പുള്ള.
କଷାଳିଆ: ചവര്‍പ്പുള്ള.
କଷ୍ଟକର: ദു
କଷ୍ଟଗ୍ରସ୍ତ: കഷ്ട്ടത്തിലായ.
କଷ୍ଟଦାୟକ: ദു ദു
କଷ୍ଟଦାୟୀ: ദു
କଷ୍ଟପୂର୍ଣ୍ନ: ദു
କଷ୍ଟପ୍ରଦ: ദു
କଷ୍ଟଭରା: ദു
କସରତୀ: വ്യായമത്തിന്റെ വ്യായമം_സംബന്ധിച്ച കസറ്ത്തിന്റെ ശാരീരികഭ്യാസത്തിന്റെ.
କହିବା_ଯୋଗ୍ୟ: പറയത്തക്ക പറയാന്‍_കൊള്ളാവുന്ന.
କାଙ୍ଗାଳ: പാവപെട്ട ദരിദ്രനായ നിര്‍ദ്ധനനായ പാപപരായ അഗതിയായ
କାଜାଖ: കസാക്കിസ്ഥാനിയന്‍ കസാക്കിയന്‍.
କାଟ୍ୟ_: വെട്ടാവുന്നത് മുറിക്കാവുന്നത്.
କାଠର: വിറകിന്റെ തടിയുടെ.
କାତର: ഇളകിമറിഞ്ഞ തകിടം_മറിഞ്ഞ.
କାତାରୀ: ഖത്തറി.
କାଦୁଆ: വ്രിത്തികെട്ട വ്രിത്തി_ഇല്ലാത്ത. ചതുപ്പായ. മാലിന്യമുള്‍ള ചേറുള്‍ള.
କାନଫଟା: കര്‍ണഭേദകമായ.
କାନାଡା: കാനഡയുടെ.
କାନାଡିଆନ୍_: കാനഡയുടെ.
କାନି_ଆଙ୍ଗୁଳି_: ചെറുവിരല്
କାନ୍ତିମାନ: തേജസ്സാര്ന്ന തിളങുന്ന.
କାନ୍ଦକାନ୍ଦ: കരയുവാന്‍_പോകുന്ന.
କାନ୍ଦୁରା: കരയുവാന്‍_പോകുന്ന.
କାବୁଲୀ: കാബൂളിനെ_സംബന്ധിക്കുന്നത്.
କାବ୍ୟ_ରସିକ: കാവ്യ_പ്രേമി.
କାବ୍ୟପ୍ରେମୀ: കാവ്യ_പ്രേമി.
କାବ୍ୟାତ୍ମକ: കാവ്യാത്മകമായ.
କାମକାର୍ଯ୍ୟହୀନ: ജോലിയില്‍_ശരിയായി_ഏര്‍പ്പെടാത്ത.
କାମଚଳା: സാധാരണ.
କାମଚୋର: മടിയനായ.
କାମନା_ପୂର୍ଣ୍ଣ_: ത്ര്പ്തിയുള്ള മനസ്സാലെയുള്ള.‌
କାମନାହୀନ: അതീന്ദ്രിയമായ.
କାମବତୀ: കാമാസക്തയായ
କାମଲୋଲୁପ|: കാമിയായ കാമ_വികാരമുള്ള ക്രീഡാസക്തിയുള്ള.
କାମହୀନ: അതീന്ദ്രിയമായ.
କାମିକା: ജോലിത്തിരക്കുള്ള ഉദ്യോഗമുള്ള പരിശ്രമിയായ കര്‍മ്മനിരതയായ വ്യവസായ_നിരതയായ തൊഴില്‍_നിരതയായ.
କାମୀ: കാമിയായ കാമ_വികാരമുള്ള ക്രീഡാസക്തിയുള്ള.
କାମୁକ: കാമിയായ കാമ_വികാരമുള്ള ക്രീഡാസക്തിയുള്ള. നീച_വികാരങളുള്ള കാമാദ്ദീപകമായ.
କାମୁକତାପୂର୍ଣ୍ଣ: അശ്ലീലം.
କାମ୍ପି: പിശുക്കന്‍ ലുബ്ധന്‍ ലോഭന്‍ കൃപണന്‍
କାରକ: ചെയ്യുന്ന പ്രവറ്ത്തിക്കുന്ന സാധിക്കുന്ന പണ്ണുന്ന ആക്കുന്ന ഉണ്ടാക്കുന്ന പയറ്റുന്ന നിറ്വ്വഹിക്കുന്ന നിറവേറ്റുന്ന പ്രയോഗിക്കുന്ന വ്യപരിക്കുന്ന.
କାରାଗାର_ସମ୍ବନ୍ଧୀ|: പോലീസിന്റെ_കീഴിലുള്ള.
କାରୁଣିକ: ദയാലുവായ ക്രിപാലുവായ കാരുണികനായ മഹാമനസ്കനായ
କାର୍ଯ୍ୟତତ୍ପର: സ്ഥിരമായി_പരിശ്രമിക്കുന്ന
କାର୍ଯ୍ୟଶୂନ୍ୟ: ജോലിയില്‍_ശരിയായി_ഏര്‍പ്പെടാത്ത.
କାର୍ଯ୍ୟାଳୟ_ବିଷୟକ: ഓഫീസിനെ_സംബന്ധിക്കുന്ന.
କାର୍ୟାନ୍ବିତ: നടപ്പാക്കല്.
କାଲ: ബധിരരായ മൂകരായ ഊമയായ
କାଳଜୟୀ: അമരന്‍ മൃത്യുഞ്ഞയന്‍ ചിരഞ്ഞീവി അമര്‍ത്യന്‍
କାଳାତୀତ: എന്നും_നിലനില്ക്കുന്ന. അമരന്‍ മൃത്യുഞ്ഞയന്‍ ചിരഞ്ഞീവി അമര്‍ത്യന്‍ സമയം_കഴിഞ്ഞു_പോയ കാലാവധി_കഴിഞ്ഞ.
କାଳାନୁଯାୟୀ: സ്മയോചിതമായ സന്ദര്‍ഭത്തിനു_ചേര്‍ന്ന സമകലീനമായ.
କାଳ୍ପନିକ: കാല്പനീകമായ സാങ്കല്‍പ്പീകമായ വാസ്തവമല്ലാത്ത സങ്കല്പത്തിലുള്ള യാഥാറ്ത്ഥ്യമല്ലാത്ത സത്യ്മല്ലാത്ത ഭാവനയിലുള്ള കല്പിതമായ ഭാവനം_ചെയ്ത അനനുക്ര്‌തമായ മിഥ്യയായ അയഥാറ്ത്ഥമായ മായികമായ.
କାଶ୍ମିରୀ: കാശ്മീരിലെ കാശ്മീരി
କାଶ୍ମୀରୀ|: കശ്മീരി.
କାଷ୍ଠୀୟ|: വിറകിന്റെ തടിയുടെ.
କିଂକର୍ତ୍ତବ୍ୟବିମୂଢ: പ്രശ്നത്തില്_അകപ്പെടുക ഇതികര്ത്തവ്യതാമൂഢത_പിടിപ്പെട്ട.
କିଛି: കുറച്ചു.
କିଣା: വാങ്ങിയ.
କିପ୍ରକାର: എങ്ങനത്തെ.
କିସମିସଯୁକ୍ତ: കിശ്മിശുള്ള.
କିସମିସିଆ: കിശ്മിശിന്റെ.
କୀଟ_ଭକ୍ଷକ: കീടഭക്ഷി.
କୀଟନାଶକ: കീട_നാശിനി.
କୀଟଭୋଜୀ|: കീടഭക്ഷി.
କୀର୍ତ୍ତିବନ୍ତ: കീര്ത്തിമാന്.
କୀର୍ତ୍ତିମାନ: കീര്ത്തിമാന്.
କୀର୍ତ୍ତିଶାଳୀ: കീര്ത്തിമാന്.
କୁଆଁରୀ|: അവിവാഹിത. കുമാരി.
କୁଆପଥରସମ: ആലിപ്പഴം.
କୁଏତୀ: കുവൈറ്റിയന്‍.
କୁକର୍ମା: ദുഷ്കര്‍മ്മം_ചെയുന്നവന്‍.
କୁଖ୍ୟାତ: കുപ്രസിദ്ധി ദുഷ്കീര്‍ത്തി അപഖ്യാതി
କୁଗଠିତ: വിരൂപമായ.
କୁଞ୍ଚା: ചുരുങ്ങുക.
କୁଞ୍ଚିତ: ചുരുണ്ട. വളഞ്ഞ വക്രതയുള്ള ചുറ്റിക്കുന്ന
କୁଞ୍ଚୁକୁଞ୍ଚିଆ|: ചുരുണ്ട.
କୁଟ: പ്രയാസമുള്ള ഗൂഢമായ
କୁଟତାପୂର୍ଣ୍ଣ: പ്രയാസമുള്ള ഗൂഢമായ
କୁଟିଳ: ചതി_നിറഞ്ഞ. കുടിലമായ കള്ളത്തരത്തിലുള്ള.
କୁଟିଳତାହୀନ: കാപട്യമില്ലാത്ത നിഷ്കളങ്കരായ ശാന്തസ്വഭാവമുള്ള
କୁଟୁମ୍ବହୀନ: കുടുംബം_ഇല്ലാത്ത.
କୁତ୍ସାକାରୀ: തെറ്റായ_കുറ്റാരോപണം അപകീര്‍ത്തിപ്പെടുത്തല്‍.
କୁତ୍ସିତ: വെറുക്കപ്പെട്ട നിന്ദിക്കപ്പെട്ട.
କୁନିପିଲା: ചെറിയ.
କୁପଥ୍ୟ: ആരോഗ്യത്തിനു_ഹാനികരമായ ആരോഗ്യത്തിനു_ഹാനികരമായ
କୁପାଚ୍ୟ: വേവാത്തത്.
କୁପାତ୍ର: അയോഗ്യനായ കൊള്ളരുതാത്ത.
କୁପିତ: ദു
କୁଭାଷୀ: കഠിന_വാക്കു_പറയുന്ന അപ്രിയം_പറയുന്ന.
କୁମାର: അവിവാഹിത്ന്.
କୁମାରୀ: അവിവാഹിത. കുമാരി.
କୁମାର୍ଗୀ: ദുശ്ചരിത്രം.
କୁମ୍ଭୀର_କାନ୍ଦଣା|: പ്രകടനപരമായ കപടമായ ക്രിത്രിമമായ.
କୁରୂପୀ: വിരൂപനായ വിലക്ഷണമായ ഭംഗിയില്ലാത്ത വികൃതമായ
କୁଲଷଣ|: ദുശ്ചരിത്രം.
କୁଳଟା: പരപുരുഷനുമായി_ലൈംഗികബന്ധം_പുലര്ത്തുന്നവള്.
କୁଳୀନ: ഉന്നതകുലജാതനായ.
କୁଶଳୀ: പ്രാവീണ്യമുള്ള നിപുണതയുള്ള സാമറ്ത്ഥ്യമുള്ള മിടുക്കമുള്ള നൈപുണ്യമുള്ള പ്രായോഗികയോഗ്യതയുള്ള ചാതുര്യമുള്ള കുശലതയുള്ള വിരുതുള്ള വിചക്ഷണതയുള്ള പാടവമുള്ള തഴക്കമുള്ള പ്രാപ്തിയുള്ള.
କୁସୁମ_କାଠ: പിശുക്കന്‍ ലുബ്ധന്‍ ലോഭന്‍ കൃപണന്‍
କୁସୁମରହିତ: പുഷ്പങളില്ലാത്ത പൂക്കാത്ത പൂക്കലില്ലാത്ത പുഷ്പ്പിക്കാത്ത.
କୁସୁମିତ: വിടര്‍ന്ന വികസിച്ച.
କୁସ୍ବଭାବୀ: ദുസ്വഭാവിയ്യായ ചീത്ത_സ്വഭാവമുള്ള
କୃତ_: രചിക്കപ്പെട്ട എഴുതപ്പെട്ട.
କୃତକର୍ମ_: ഉത്പന്നമായ ജനിച്ച പരിസമാപ്തമായ.
କୃତକୃତ୍ୟ: ക്ര്താര്ഥന്.
କୃତଘ୍ନ: നന്ദികെട്ട ഉപകാരസ്മരണയില്ലാത്ത.
କୃତଜ୍ଞ: നന്ദിയുള്ള ഉപകാര_സ്മരണയുള്ള. ക്ര്താര്ഥന്.
କୃତାର୍ଥ: ക്ര്താര്ഥന്.
କୃତିମ: പ്രകടനപരമായ കപടമായ ക്ര്‌ത്രിമമായ.
କୃପଣ: പിശുക്കനായ ക്ര്പണനായ.‌ പിശുക്കന്‍ ലുബ്ധന്‍ ലോഭന്‍ കൃപണന്‍
କୃପାଳୁ: ദയാലുവായ ക്രിപാലുവായ കാരുണികനായ മഹാമനസ്കനായ
କୃଶୋଦର: മെലിഞ്ഞ
କୃଷିଯୋଗ୍ୟ: ഉഴാനുള്ള.
କୃଷ୍ଣ: കറുപ്പ്.
କେତେକ: അനേകം ഒന്നിലധികമായ പല വളരെയേറേ അസംഖ്യം.
କେନିୟା_ସମ୍ବନ୍ଧୀ: കെനിയന്.
କେନିୟାନ୍: കെനിയന്.
କେନ୍ଦ୍ରଶାସିତ: കേന്ദ്രഭരണ കേന്ദ്രം_ഭരിക്കുന്ന.
କେନ୍ଦ୍ରୀୟ: കേന്ദ്രത്തിന്റെ_.
କେବଳ: മാത്രം ഒറ്റയ്ക്ക് പൂര്ണ്ണമായ.
କେମିତି: എങ്ങനത്തെ.
କେଶର: കുംകുമ_നിറമുള്ള.
କେଶହୀନ|: കഷണ്ടിയുള്ള കഷണ്ടി_രോഗമുള്ള. മൊട്ട.
କୋଙ୍କଣୀ: കൊങ്കിണി കൊങ്കിണി കൊങ്കിണി
କୋଙ୍କନୀ: കൊങ്കിണി കൊങ്കിണി
କୋଟି: ഒരു_കോടി 10000000
କୋଟିପତି: കോടിപതി.
କୋଡିଏ: ഇരുപതാം
କୋପିତ: ദ്വേഷ്യമുള്ള.
କୋମଳ: കോമളം സുകുമാരം. മൃദുവായ മൃദുലമായ പേലവമായ ലോലമായ കോമളമായ സുകുമാരമായ
କୋମଳ_: സൌമ്യനായ.
କୋମଳଚିତ୍ତ|: കോമള_ഹ്രിദയം.
କୋମଳମନସ୍କ: സംവേദനശീലമുള്ള (എളുപ്പം_അനുഭൂതികള്_ഉള്കൊള്ളുന്ന്)
କୋମଳହୃଦୟ: കോമള_ഹ്രിദയം.
କୋମଳାଙ୍ଗନା: കോമളാങ്കിനി കോമളാങ്കീ സുന്ദരിയായ_സ്ത്രീ.
କୋମଳାଙ୍ଗୀ: കോമളാങ്കിനി കോമളാങ്കീ സുന്ദരിയായ_സ്ത്രീ.
କୋମୋରିଆନ୍: കോമൊരോസീയ
କୋମୋରୋଜୀ: കോമൊരോസീയ
କୋରିୟାଈ: കൊറിയയിലെ
କୋଷୀୟ: ശരീര_കോശത്തിന്റെ.
କୌତୁକପୂର୍ଣ୍ଣ: തമാശക്കാരന്‍.
କୌମାର୍ଯ୍ୟଯୁକ୍ତ|: കുമാരാവസ്ഥ കന്യകാത്വം.
କ୍ରନ୍ଦନରତ: കരയുന്ന നിലവിളിക്കുന്ന കേഴുന്ന തേങ്ങുന്ന.
କ୍ରମରହିତ: ക്രമമല്ലാത്ത.
କ୍ରମହୀନ: ക്രമമല്ലാത്ത.
କ୍ରମାଗତ: ഭങ്കം_വരാത്ത. തുടറ്ച്ചായായുള്ള സ്ഥിരമായ ഇടവിടാതെയുള്ള ആവറ്ത്തിച്ചുള്ള.
କ୍ରମାନୁସାରୀ: ക്രമത്തിലുള്ള.
କ୍ରମିକ: ക്രമത്തിലുള്ള.
କ୍ରିଓଲ୍: മിശ്രഭാഷയുടെ.
କ୍ରିୟାଶୀଳ|: ഏര്പ്പെട്ടിരിക്കുന്ന.
କ୍ରିୟୋଲ୍: മിശ്രഭാഷയുടെ.
କ୍ରୀତ: വാങ്ങിയ.
କ୍ରୁଦ୍ଧ: ദ്വേഷ്യമുള്ള.
କ୍ରୁର: ദ്രോഹിയായ കരുണയില്ലാത്ത ഉപദ്രവിക്കുന്ന
କ୍ରୁର|: സദാചാരമില്ലാത്ത മറ്റുള്ളവരേ_ഉപദ്രവിക്ക്ല്.
କ୍ରୋଏଶିଆଈ: ക്രോഏശിയക്കാരന്‍. ക്രോഏശിയായിലുള്ള
କ୍ରୋଏଶିୟାଈ: ക്രോഏശിയക്കാരന്‍. ക്രോഏശിയായിലുള്ള
କ୍ରୋଧହୀନ: ക്രോധമില്ലാത്ത്.
କ୍ରୋଧିତ: ദ്വേഷ്യമുള്ള.
କ୍ରୋଧୀ: ക്രോധമുള്ള.
କ୍ରୋଧୀ_ବ୍ୟକ୍ତି: ദ്വേഷ്യമുള്ള.
କ୍ଲାନ୍ତ: ക്ഷീണിച്ച.
କ୍ଲାନ୍ତିହୀନ: ക്ഷീണിക്കാത്ത മടുക്കാത്ത.
କ୍ଷଣଭଙ୍ଗୁର|: ക്ഷണികമായ നൈമിഷികമായ.
କ୍ଷଣସ୍ଥାୟୀ: നശിക്കുന്ന.
କ୍ଷଣିକ: ക്ഷണികമായ നൈമിഷികമായ.
କ୍ଷତାକ୍ତ_: മുറിവേറ്റ ക്ഷതമേറ്റ.
କ୍ଷତିକର: ദോഷം_ചെയ്യുന്ന നാശം_ചെയ്യുന്ന.
କ୍ଷତିକାରକ: ദോഷം_ചെയ്യുന്ന നാശം_ചെയ്യുന്ന.
କ୍ଷତିହୀନ|: നസിക്കാതെ.
କ୍ଷମଣୀୟ: ക്ഷമിക്കപ്പെടാവുന്ന മാപ്പാക്കാവുന്ന.
କ୍ଷମତା_ହୀନ: സാമര്ഥ്യം_ഇല്ലാത്ത.
କ୍ଷମତାପ୍ରାପ୍ତ: വൈദഗ്ദ്ധ്യം സാമര്ഥ്യം യോഗ്യത
କ୍ଷମତାବାନ: വൈദഗ്ദ്ധ്യം സാമര്ഥ്യം യോഗ്യത
କ୍ଷମତାଶାଳୀ: വൈദഗ്ദ്ധ്യം സാമര്ഥ്യം യോഗ്യത
କ୍ଷମା_ପ୍ରାର୍ଥି: ക്ഷമ_യാചിക്കുന്ന.
କ୍ଷମା_ଭିକ୍ଷୁ: ക്ഷമ_യാചിക്കുന്ന.
କ୍ଷମାକର୍ତ୍ତା: ക്ഷമിക്കുന്നവന്.
କ୍ଷମାଦାତା: ക്ഷമിക്കുന്നവന്.
କ୍ଷମାଯୋଗ୍ୟ: ക്ഷമിക്കപ്പെടാവുന്ന മാപ്പാക്കാവുന്ന.
କ୍ଷମାଶୂନ୍ୟ: ക്ഷമിക്കാന്_പറ്റാത്തത്.
କ୍ଷମାହୀନ|: ക്ഷമിക്കാന്_പറ്റാത്തത്.
କ୍ଷମ୍ୟ_: ക്ഷമിക്കപ്പെടാവുന്ന മാപ്പാക്കാവുന്ന.
କ୍ଷିପ୍ର: വേഗതയുള്ള.
କ୍ଷୀଣ: നേര്‍മയുള്ള
କ୍ଷୀଣକଟୀ: ശോഷിചച_വയറുള്ള_സ്ത്രി.
କ୍ଷୁଦ୍ର|: സൂക്ഷ്മമായ.
କ୍ଷୁଧାତୁର: വിശന്നിരുന്ന ബുഭുക്ഷയുള്ള വയറു_കാലിയായ
କ୍ଷୁଧିତ: വിശന്നിരുന്ന ബുഭുക്ഷയുള്ള വയറു_കാലിയായ
କ୍ଷୁବ୍ଧ: ശാന്തമല്ലാത്ത. ദ്വേഷ്യമുള്ള.
କ୍ଷେପକ_: കൂട്ടിചേര്ത്ത
କ୍ଷେପଣ_: വിക്ഷേപിക്കുന്ന
କ୍ୟାଥୋଲିକ: കാത്തോലിക്കകാരന്‍.
କ୍ୟୁବା_: ക്യൂബയിലെ.
ଖଗୋଳୀୟ: ജ്യോതിശാസ്ത്രപരമായ.
ଖଟା: പുളിയുള്ള അംളരസമുള്ള
ଖଡ୍ଗଧାରୀ: വാള്‍പ്രയോഗ_വിദ്ഗ്ധന്‍.
ଖଣ୍ଡନୀୟ: തകര്‍ക്കാവുന്ന ഖണ്ടിക്കാവുന്ന. വെട്ടാവുന്നത് മുറിക്കാവുന്നത്.
ଖଣ୍ଡାଧାରୀ: വാള്‍പ്രയോഗ_വിദ്ഗ്ധന്‍.
ଖଣ୍ଡିତ: കഷണമായത്. മുറിഞ്ഞ
ଖନନ_କରାଯାଇଥିବା: കുഴിച്ച ഖനനം_ചെയ്ത കുഴിയാക്കിയ.
ଖନା: കൊഞ്ചി_പ്പറയുന്ന
ଖନିତ: കുഴിച്ച കുഴികുത്തിയ. കുഴിച്ച ഖനനം_ചെയ്ത കുഴിയാക്കിയ.
ଖପର_ଛାତ: ഓടിട്ട ഓടു_മേഞ്ഞ.
ଖରାପ: ചീത്ത_ആശയം ചീത്ത_ലക്ഷ്യം ദ്രോഹബുദ്ധി. അനുചിതമായ അയുക്‌തമായ ശരിയല്ലാത്ത ഔചിത്യമില്ല്ലാത്ത അരുതാത്ത ബസാറിനോട്_ബന്ധപ്പെട്ട തരം_താണ്. അശ്ലീലം. മോശമായ ചീത്തയായ. ചീത്ത ചീഞ്ഞഅഴുകിയ അളിഞ്ഞ ജീര്‍ണ്ണിച്ച അളിഞ്ഞ.
ଖରାପଚେହେରା: വിരൂപനായ വിലക്ഷണമായ ഭംഗിയില്ലാത്ത വികൃതമായ
ଖରାପଲେଖା: ചീതയായി_എഴുതിയത്.
ଖରାରେ_ଶୁଖାଯାଇଥିବା: സൂര്യനെ_സംബന്ധിച്ച.
ଖରିଦା: വാങ്ങിയ.
ଖଳ: ദുഷ്ട ദുഷിച്ച ചീത്ത നീച
ଖସଡା: വഴുക്കലുള്ള.
ଖାଇବା: ഭക്ഷണയോഗ്യമായ ഭക്ഷണ_പദാര്‍ഥം.
ଖାଇବାବାଲା: തിന്നുന്ന ഭക്ഷിക്കുന്ന കഴിക്കുന്ന ഭോജിക്കുന്ന ആഹരിക്കുന്ന.
ଖାଣ୍ଟି: ശുദ്ധമായ ഒന്നാംതരമായ ശുദ്ധമായതു.
ଖାତାଦାର: നിക്ഷേപകന്
ଖାଦହୀନ: ശുദ്ധമായതു.
ଖାଦ୍ୟ: ഭക്ഷണയോഗ്യമായ ഭക്ഷണ_പദാര്‍ഥം.
ଖାଦ୍ୟମଗାଳି: ഭക്ഷണാര്‍ഥിയായ
ଖାରଜ: സ്വീകരിക്കാത്ത. നിരസിക്കപ്പെട്ട റദ്ദാക്ക്പ്പെട്ട. ബഹിഷ്ക്കരിക്കപ്പെട്ട.
ଖାଲଢିପ: പരുപരുപ്പുള്ള ഉയര്‍ന്നതും_താണതുമായ തുല്യമല്ലാത്ത പൊങിറ്യതും_താണതുമായ കുണ്ടും_കുഴിയുമായ യോജിക്കാത്ത ചേര്‍ച്ചയില്ലാത്ത.
ଖାଲି: മാത്രം ഒറ്റയ്ക്ക് പൂര്ണ്ണമായ. ഒഴിഞ്ഞ ശൂന്യമായ കാലിയായ ഒഴിവുള്ള പ്രയോജനമില്ലാത്ത ശൂന്യമായ.
ଖାଲିପାଦ: നഗ്നപാദം
ଖାସ୍: അസാമാന്യമായ സാധാരണമല്ലാത്ത.
ଖିଲାଣଯୁକ୍ତ: കമാനയുക്തമായ
ଖୁଡୁତାଶୁର: അച്ഛന്റെ_അനിയനെ_സംബന്ധിക്കുന്ന.
ଖୁନି: കൊലപാതകികള്.
ଖୁବ୍: വളരേയധികം.
ଖୁବ୍‌: വളരേ.
ଖୁସି: ആനന്ദം_നിറഞ്ഞ സന്തോഷം_പ്രകടിപ്പിക്കുന്ന.
ଖୁସିବାସି: സന്തോഷത്തോടെ സസുഖത്തോടെ ആഹ്ലാദപൂര്‍വ്വം
ଖୋଦନକାରୀ: തുളയുള്‍ള.
ଖୋଦିତ: കുഴിച്ച കുഴികുത്തിയ.
ଖୋଲା: തുറന്ന മൂടി_നീക്കിയ അടപ്പു_മാറ്റിയ പരസ്യമായ. സ്വ്തന്ത്റനായ തുറന്ന തുറന്ന പരസ്യമാക്കിയ ആരംഭിച്ച വെളിപ്പെടുത്തിയ.
ଖୋଳାଯାଇଥିବା: കുഴിച്ച ഖനനം_ചെയ്ത കുഴിയാക്കിയ.
ଖୋସାମତିଆ: മുഖസ്തുതിക്കാരന്‍ വ്യാജ_പ്രശംസക്കാരന്‍ മുഖസ്തുതി_പറയുന്ന വ്യാജപ്രശംസ_പറയുന്ന.
ଖ୍ରୀଷ୍ଟିୟାନ୍|: യേശുവിനെ_സംബന്ധിക്കുന്നതു് ഈശോമിശിഹ യേശു_ക്രിസ്തു മരിച്ചവനെ_ജീവിപ്പിക്കുന്നവന്‍.
ଖ୍ୟାତ: പ്രസിദ്ധയായ കേള്‍വിപ്പെട്ട പേരുകേട്ട യശസ്വിയായ പ്രഖ്യാതമായ അറിയപ്പെട്ട വിഖ്യാതിയായ
ଗଗନଭେଦୀ: ആകാശത്തെ_ഭെദിക്കുന്ന.
ଗଚ୍ଛିତ: ഒരാവശ്യത്തിന്‍_വെച്ചിട്ടുള്ള.
ଗଜା: മുളച്ച.
ଗଡିପଡିଥିବା: തകര്‍ത്ത നിലത്തു_വീണ.
ଗଢା: നിര്‍മ്മാണം രൂപം ആക്രിതി_കൊടുക്കല്‍.
ଗଣନୀୟ: എണ്ണപ്പെടാവുന്ന കണക്കാക്കത്തക്ക അംഗീകരിക്കപ്പെടേണ്ട്.
ଗଣମାନ୍ୟ: ബഹുമാനിക്കപ്പെട്ട ആദരിക്കപ്പെട്ട.
ଗଣ୍ୟ_: എണ്ണപ്പെടാവുന്ന കണക്കാക്കത്തക്ക അംഗീകരിക്കപ്പെടേണ്ട്.
ଗତ: കഴിഞ്ഞുപോയ.
ଗତିପୂର୍ଣ୍ଣ: ചലനാത്മകമായ പുരോഗമനപരമായ ക്രിയാത്മകമായ.
ଗତିବାନ୍: ചലനാത്മകമായ പുരോഗമനപരമായ ക്രിയാത്മകമായ.
ଗତିମାନ|: ഒഴുക്ന്ന ഒഴുക്കിന്റെ_ഗതി തുടര്‍ച്ചയായ_ഗതി ശക്തിയേറിയ_പാച്ചില്‍ നീരൊഴുക്കു് തുടര്‍ച്ചയായ_ഗതി നിരന്തരമായി_പ്രവഹിക്കുന്ന.
ଗତିଶୀଳ: ഒഴുക്ന്ന ഒഴുക്കിന്റെ_ഗതി തുടര്‍ച്ചയായ_ഗതി ശക്തിയേറിയ_പാച്ചില്‍ നീരൊഴുക്കു് തുടര്‍ച്ചയായ_ഗതി നിരന്തരമായി_പ്രവഹിക്കുന്ന. ചലനാത്മകമായ പുരോഗമനപരമായ ക്രിയാത്മകമായ.
ଗତିହୀନ: ചലനമില്ലാത്ത ചലിക്കാത്ത ഗതിരോധമുള്ള. സ്ഥിരമായ.
ଗତିହୀନ_: സ്ഥാവരങള്.
ଗତିହୀନ_ଜମିଥିବା: പ്രവഹിക്കാത്ത ശാന്ത_മായ നില്‍ക്കുന്ന സ്ഥിരമായ ഗതിഹീനമായ.
ଗନ୍ଧଯୁକ୍ତ: മണമുള്ള.
ଗନ୍ଧହୀନ: മണമില്ലാത്ത.
ଗନ୍ଧିଆ: മുഷിഞ്ഞ ശുചിയല്ലാത്ത അഴുക്കായ മലിനപ്പെട്ട വൃത്തിഹീനമായ അശ്ലീലം.
ଗବେଷିତ: ഗവേഷണപരമായ
ଗଭୀର: ആഴമുള്ള താഴ്ചയുള്ള
ଗମନୀୟ: പോകത്തക്ക.
ଗମ୍ଭୀର: ഗൌരവമുള്ള പതറാത്ത സുദൃഢമായ സുസ്ഥിരമായ പ്രയാസമുള്ള ഗൂഢമായ
ଗମ୍ଭୀର|: ചിന്തിക്കേണ്ടതായ.
ଗମ୍ୟ: പോകത്തക്ക.
ଗରମ: ചൂടു ഉഷ്ണം ഉതേജിപ്പിക്കുക ജ്വലിപ്പിക്കുക. ചൂടുള്ള ചൂടേകുന്ന ചൂട്പകരുന്ന.
ଗରମ|: നല്ല_ചൂടുള്ള.
ଗରମାଗରମ: പുതിയതായ പുത്തനായ
ଗରହାଜିର: അസന്നിഹിതനായ ഇല്ലാത്ത ഹാജരില്ലാത്ത വരത്ത
ଗରିମାହୀନ|: മഹത്വമില്ലാത്ത.
ଗରିଷ୍ଠ: വേവാത്തത്.
ଗରୀବ: പാവപെട്ട ദരിദ്രനായ നിര്‍ദ്ധനനായ പാപപരായ അഗതിയായ
ଗର୍ବୀ: ഉദ്ധതനായ അഹങ്കാരി_ആയ അഹന്തയുള്ള ഞാന്‍_വമ്പനാണെന്ന_ഭാവം അഹമ്മതിഉള്ള അകനിന്ദയുള്ള അഹമ്മമതയുള്ള കെര്രുവുള്ള ഞാനെന്ന_ഭാവമുള്ള. അഹങ്കാരിയായ അഹന്തയുള്ള അഹമ്മതിയുള്ള പൊങ്ങച്ചക്കാരിയായ
ଗର୍ଭଜ: ഗര്‍ഭത്തില്‍_നിന്നു_ജനിക്കുന്നത്.
ଗର୍ଭବତୀ: ഗര്ഭവതി ഗര്ഭിണി.
ଗର୍ଭିଣୀ: ഗര്ഭവതി ഗര്ഭിണി.
ଗର୍ହିତ: ചീത്ത
ଗହନ: ആഴമേറിയ.
ଗହନ_: സാന്ദ്രമായ ഉറപ്പുള്ള മേഘമുള്ള.
ଗାଁଉଲି: ഗ്രാമീണ. ഗ്രാമീണമായ ഗ്രാമത്തെ_സംബന്ധിക്കുന്ന.
ଗାଇବାବ୍ୟକ୍ତି: പാടുന്ന_ആള്‍ ആലപിക്കുന്ന_ആള്‍ ഗായകന്‍ പാട്ടുകാരന്‍ ഗായനന്‍.
ଗାଢ: അടുത്ത.
ଗାନ୍ଧିବାଦୀ: ഗാന്ധിവാദി. ഗാന്ധിവാദി.
ଗାବାନିଜ୍: ഗാബായന്.
ଗାମ୍ବିୟାନ୍: ഗാംബിയന്
ଗାମ୍ବିୟାସମ୍ବନ୍ଧୀ: ഗാംബിയന്
ଗାରିମାପୂର୍ଣ୍ଣ\: മഹത്വപൂര്ണ്ണമായ.
ଗାରିମାଯୁକ୍ତ: മഹത്വപൂര്ണ്ണമായ.
ଗାୟକ: പാടുന്ന_ആള്‍ ആലപിക്കുന്ന_ആള്‍ ഗായകന്‍ പാട്ടുകാരന്‍ ഗായനന്‍.
ଗିରଫ: തടവിലാക്കിയ ബന്ധനത്തിലാക്കിയ കാരഗ്രഹത്തിലായ തടങ്കലിലായ.
ଗୁଜବ_ଜନିତ: കേട്ടു_കേള്‍വി.
ଗୁଜୁରାଟୀ|: ഗുജറാത്തിന്റെ.
ଗୁଜୁରାତୀ: ഗുജറാത്തിലെ ഗുജറാത്തി
ଗୁଞ୍ଜରିତ: വണ്ടുകളുടെ_മുരള്‍ച്ച_നിറഞ്ഞ. മുഴങ്ങിയ.
ଗୁଢ: പ്രയാസമുള്ള ഗൂഢമായ
ଗୁଣକାରୀ: ലാഭദായകം ഗുണകരം ഉപയോഗപ്രദം.
ଗୁଣବତ୍ତାଯୁକ୍ତ: ഗുണമേന്മയുള്ള
ଗୁଣବତ୍ତାରହିତ: ഗുണമില്ലാത്തത്.
ଗୁଣବନ୍ତ: സദ്ഗുണമുള്ള
ଗୁଣବାନ୍: സദ്ഗുണമുള്ള
ଗୁଣଯୁକ୍ତ: ഗുണമേന്മയുള്ള
ଗୁଣଶାଳୀ: സദ്ഗുണമുള്ള
ଗୁଣାନ୍ବିତ: ഗുണമേന്മയുള്ള
ଗୁଣୀ: സദ്ഗുണമുള്ള
ଗୁପ୍ତ: മൂടിയ ഒളിച്ച. ഗ്രഹിക്കപ്പെട്ട മറയ്ക്കപ്പെട്ട് ഒളിയ്ക്കപ്പെട്ട്.
ଗୁରୁତ୍ବପୂର୍ଣ୍ଣ: അസാമാന്യമായ സാധാരണമല്ലാത്ത. മഹത്ത്വമുള്ള ശ്രേഷ്ഠമായ ഗംഭീരമായ ഉല്ക്ര്ഷ്ടമായ പ്രൌഢമായ ഉത്തമമായ വിശിഷ്ഠമായ സ്തുത്യറ്ഹമായ മികച്ച മഹിമയുള്ള.
ଗୁହାନିବାସୀ: ഗുഹാവാസി.
ଗୁହାବାସୀ: ഗുഹാവാസി.
ଗୁହାରିଆ|: ആവലാദി.
ଗୂଢ|: രഹസ്യപൂര്ണ്ണം.
ଗୃହପାଳିତ: വളര്‍ത്തപ്പെടുന്ന
ଗୃହବିହୀନ: വീടില്ലാത്തവര്.
ଗୃହଯୁକ୍ତ: താമസ_യോഗ്യമായ വീടുള്ളത്
ଗୃହହୀନ: വീടില്ലാത്തവര്.
ଗୃହୀତ: സ്വന്തമായി_തിരഞ്ഞെടുത്ത.
ଗେୟ: പാടാന്‍_പറ്റിയ ആലാപനയോഗ്യമായ.
ଗୋଇନ୍ଦାଗିରି|: രഹസ്യാന്വേഷണം കുറ്റാന്വേഷണം.
ଗୋଟିଏ: ഒരു ഒന്ന് 1.
ଗୋଟିଏ_ମାତ୍ର: ഒരേയൊരു.
ଗୋପନୀୟ: ഒളിക്കേണ്ടതായിട്ടുള്ള.
ଗୋପ୍ୟ: ഒളിക്കേണ്ടതായിട്ടുള്ള.
ଗୋରା: വെളുത്ത വെളുത്ത_നിറമുള്ള.
ଗୋରା-ନାଲିଚିଆ: തേജസ്വിയായ
ଗୋଲ: ഗോളാകൃതി വൃത്താകൃതി
ଗୋଲାମ: സ്വാതന്ത്ര്യമില്ലാത്ത അടിമയായ.
ଗୋଳମାଳିଆ: പ്രയാസമുള്ള കുഴപ്പം_പിടിച്ച വിഷമമുള്ള ആയാസമുള്ള.
ଗୌଣ: പ്രമുഖനലാത്ത.
ଗୌରବପୂର୍ଣ୍ଣ: മഹത്വപൂര്ണ്ണമായ.
ଗୌରବମୟ: മഹത്വപൂര്ണ്ണമായ.
ଗୌରବଯୁକ୍ତ: മഹത്വപൂര്ണ്ണമായ.
ଗୌରବଶାଳୀ: മഹത്വപൂര്ണ്ണമായ.
ଗୌରବହୀନ: മഹത്വമില്ലാത്ത.
ଗୌରବାନ୍ବିତ: ബഹുമാനിക്കപ്പെട്ട ആദരിക്കപ്പെട്ട. മഹത്വപൂര്ണ്ണമായ.
ଗ୍ରହଣୀୟ: സ്വീകാര്യമായ.
ଗ୍ରାମବାସୀ: ഗ്രാമീണ.
ଗ୍ରାମୀଣ|: ഗ്രാമീണ. ഗ്രാമീണമായ ഗ്രാമത്തെ_സംബന്ധിക്കുന്ന.
ଗ୍ରାମ୍ୟ: ഗ്രാമീണ. ഗ്രാമീണമായ ഗ്രാമത്തെ_സംബന്ധിക്കുന്ന.
ଗ୍ରାହ୍ୟ: സ്വീകാര്യമായ. സ്വീകാര്യമായ.
ଗ୍ରୀକ: യുനാനി
ଗ୍ରୀନଲ୍ୟାଣ୍ଡ: ഗ്രീന്‍ലാന്‍ഡിന്റെ.
ଗ୍ରୀନଲ୍ୟାଣ୍ଡ_: ഗ്രീന്‍ലാന്‍ഡിനെ_കുറിച്ചുള്ള.
ଗ୍ରୀଷ୍ମ_କାଳୀନ|: ഗ്രീഷ്മ_കാലത്തെ.
ଘଞ୍ଚ: സാന്ദ്രമായ ഉറപ്പുള്ള മേഘമുള്ള.
ଘଟନୀୟ: കുറഞ്ഞ.
ଘଟିତ: സംഭവിച്ച ഉണ്ടായ രചിക്കപ്പെട്ട കഴിഞ്ഞു_പോയ കടന്നു_പോയ.
ଘଟିତବ୍ୟ: കുറഞ്ഞ.
ଘଟିଯାଇଥିବା: സംഭവിച്ച ഉണ്ടായ രചിക്കപ്പെട്ട കഴിഞ്ഞു_പോയ കടന്നു_പോയ.
ଘନ: ഇടതൂര്‍ന്ന്.
ଘନତମସାମୟ: ഇരുട്ട്_നിറഞ്ഞ.
ଘନିଷ୍ଠ: അടുത്ത.
ଘରନଥିବା: വാസമില്ലാത്ത നശിച്ചു_പോയ ഉപേക്ഷിച്ച അന്യമായ.
ଘରହୀନ: വാസമില്ലാത്ത നശിച്ചു_പോയ ഉപേക്ഷിച്ച അന്യമായ.
ଘରୁଆ: വളര്‍ത്തപ്പെടുന്ന
ଘାତକ|: ജീവനൊടുക്കുന്ന.
ଘାନା: ഘാനിയന്
ଘୁଙ୍ଗା: മൂകന്‍
ଘୁଞ୍ଚାଯାଇଥିବା: മാറ്റിവെച്ച.
ଘୃଣାକରିବାଲୋକ: അവജ്ഞയുള്ള നിന്ദയുള്ള ജുഗുപ്സയുള്ള.
ଘୃଣାସ୍ପଦ_: വെറുക്കപ്പെട്ട നിന്ദിക്കപ്പെട്ട.
ଘୃଣିତ: വെറുക്കപ്പെട്ട നിന്ദിക്കപ്പെട്ട.
ଘୃଣ୍ୟ: വെറുക്കപ്പെട്ട നിന്ദിക്കപ്പെട്ട.
ଘେରା: ചുറ്റപ്പെട്ട ചുറ്റിയ.
ଘୋର: ദാരുണമായ.
ଘୋଳିବା_ଯୋଗ୍ୟ: കടയുവാനുള്ള.
ଘୋଷକ: വിളംബരം_ചെയ്യുന്ന ഉദ്ഘോഷിക്കുന്ന ഘോഷിക്കുന്ന പ്രസ്താവിക്കുന്ന പ്രഖ്യാപിക്കുന്ന.
ଘୋଷଣାକାରୀ: വിളംബരം_ചെയ്യുന്ന ഉദ്ഘോഷിക്കുന്ന ഘോഷിക്കുന്ന പ്രസ്താവിക്കുന്ന പ്രഖ്യാപിക്കുന്ന.
ଘୋଷାପାଠ: ആവര്‍ത്തിച്ച.
ଘୋସଖୋର: കൈക്കൂലിക്കാരന്‍.
ଚଉଡା: വീതിയുള്ള
ଚଉବନ: അന്പത്തി_നാല്
ଚଉବନତମ: അന്പത്തിനാലാമത്തെ
ଚଉରାନବେତମ: തൊണ്ണൂറ്റി_നാല്
ଚଉରାଶୀତମ: എണ്പത്തിനാലാമത്തെ
ଚଉସ୍ତରିତମ: എഴുപത്തി_നാലാം
ଚକଚକିଆ: നേരിയ_പാഡ_പോലെയുള്ള_തൊലി.
ଚକମକ: തിളങ്ങുന്ന ശോഭയുള്ള തെളിമയുള്ള ശുദ്ധമായ സ്പഷ്ട്ടമായ.
ଚକାଚକ୍‌: തിളങ്ങുന്ന ശോഭയുള്ള പ്രഭയുള്ള പകിട്ടുള്ള കാന്തിയുള്ള സ്ഫുരിക്കുന്നപ്രകാശിക്കുന്ന
ଚକ୍ରବର୍ତ୍ତୀ: സമ്രാട്ട് ചക്രവര്ത്തി.
ଚକ୍ରାକାର: ഗോളാകൃതി വൃത്താകൃതി
ଚକ୍ଷୁଃପ୍ରୀତିକର: നയനാഭിരാമാ‍മായ നയനരമ്യമായ നേത്രാഭിരമാമായ.
ଚକ୍ଷୁହୀନ: അന്ധനായ കാഴ്ചയില്ലാത്ത കണ്ണില്ലാത്ത
ଚକ୍‌ଚକ୍‌: തിളങ്ങുന്ന ശോഭയുള്ള പ്രഭയുള്ള പകിട്ടുള്ള കാന്തിയുള്ള സ്ഫുരിക്കുന്നപ്രകാശിക്കുന്ന
ଚକ୍‌ମକିଆ: തിളങ്ങുന്ന ശോഭയുള്ള പ്രഭയുള്ള പകിട്ടുള്ള കാന്തിയുള്ള സ്ഫുരിക്കുന്നപ്രകാശിക്കുന്ന തിളങ്ങുന്ന മിന്നുന്ന പുറമ്പകിട്ടൂള്ള.
ଚଞ୍ଚଳ: ചഞ്ചലചിത്തനായ അസ്ഥിരനായ ശാന്തമല്ലാത്ത. ചഞ്ഞ്ചലിതമായ.
ଚଞ୍ଚଳିଆ|: സൂക്ഷ്മതയില്ലാത്ത വേണ്ടപോലെ_ആലോചിക്കാത്ത ദ്രുതഗതിയിലുള്ള.
ଚତୁଃଷଷ୍ଟିତମ: അരുപത്തി_നാലാമത്തെ.
ଚତୁର: നിപുണനായ സമര്‍ഥനായ മിടുക്കുള്ള ചാതുര്യമുള്ള
ଚତୁର୍ଗୁଣ: നാലുമടങ്ങ് നാലിരട്ടി
ଚତୁର୍ଥ: നാലാം
ଚତୁର୍ଦ୍ଦଶ: പതിനാലാം പതിനാലാമത്തെ
ଚନ୍ଦନନିର୍ମିତ: ചന്ദന_നിറ്മുള്ള ചന്ദനം_പോലെയുള്ള.
ଚପଳ: ചഞ്ചലചിത്തനായ അസ്ഥിരനായ
ଚମକଦାର: തിളങ്ങുന്ന ശോഭയുള്ള പ്രഭയുള്ള പകിട്ടുള്ള കാന്തിയുള്ള സ്ഫുരിക്കുന്നപ്രകാശിക്കുന്ന
ଚମକିତ: പ്രശോഭിക്കുന്ന തിളങ്ങുന്ന മിന്നുന്ന ശോഭിക്കുന്ന ജ്വലിക്കുന്ന സ്ഫുരിക്കുന്ന ദ്യോതിപ്പിക്കുന്ന മിനുങ്ങുന്ന ഉജ്ജ്വലിക്കുന്ന.
ଚମକିଲା: തിളങ്ങുന്ന ശോഭയുള്ള പ്രഭയുള്ള പകിട്ടുള്ള കാന്തിയുള്ള സ്ഫുരിക്കുന്നപ്രകാശിക്കുന്ന
ଚମକ୍‌ଦାର: തിളങ്ങുന്ന മിന്നുന്ന പുറമ്പകിട്ടൂള്ള.
ଚମତକୃତ|: വിസ്മയിച്ച പരിഭ്രമിച്ച അമ്പരന്ന.
ଚମତ୍କାରପୂର୍ଣ୍ଣ: വര്ണ്ണ_ശബളമായ.
ଚମତ୍କାରୀ: വര്ണ്ണ_ശബളമായ.
ଚମ୍ପଟ: ഓടിപ്പോയ പിടി_കൊടുക്കാതെരക്ഷപ്പെട്ട്_ഒളിച്ചു_നടക്കുന്ന.
ଚରିତ୍ରବତୀ: നല്ല_സ്വഭാവം_ഉള്ള.
ଚରିତ୍ରହୀନ: ദുശ്ചരിത്രം.
ଚରିତ୍ରହୀନା: പരപുരുഷനുമായി_ലൈംഗികബന്ധം_പുലര്ത്തുന്നവള്.
ଚର୍ଚ୍ଚିତ: ചര്ച്ച_ചെയ്യപ്പെട്ടത്.
ଚଳଚଞ୍ଚଳ: ചലനാത്മകമായ പുരോഗമനപരമായ ക്രിയാത്മകമായ.
ଚଳଚିତ୍ର_ସମ୍ବନ୍ଧୀୟ: സിനിമ
ଚଳନଶୀଳ: ചലിക്കുന്ന ചലിക്കാന്‍_സാധിക്കുന്ന ജീവനുള്ള.
ଚଳମାନ୍: ചലനാത്മകമായ പുരോഗമനപരമായ ക്രിയാത്മകമായ.
ଚାକ୍ଷୁଷ: കാണാവുന്ന.
ଚାଟୁକାର: മുഖസ്തുതിക്കാരന്‍ വ്യാജ_പ്രശംസക്കാരന്‍ മുഖസ്തുതി_പറയുന്ന വ്യാജപ്രശംസ_പറയുന്ന.
ଚାଡିୟାନ୍: ചാഡീയ.
ଚାଡ୍-ସମ୍ବନ୍ଧୀ: ചാഡീയ.
ଚାମଚା: മുഖസ്തുതിക്കാരന്‍ വ്യാജ_പ്രശംസക്കാരന്‍
ଚାମତ୍କାରୀକ|: വര്ണ്ണ_ശബളമായ.
ଚାରି: നാലാം നാല്‌ 4
ଚାରିଗୁଣ: നാലുമടങ്ങ് നാലിരട്ടി
ଚାରିତରଫା: നാലു_ഭാഗത്ത്_നിന്നും.
ଚାରିପଟିଆ: നാലു_ഭാഗത്ത്_നിന്നും.
ଚାରିପାଖିଆ: നാലു_ഭാഗത്ത്_നിന്നും.
ଚାରିଭାଗ: നാലുമടങ്ങ് നാലിരട്ടി
ଚାରିଶ୍‌ବିଶ୍‌: ചതിയനായ വഞ്ചകനായ.
ଚାରୁ: സൌന്ദര്യമുള്ള സുമുഖമുള്ള ചേലുള്ള ചന്തമുള്ള
ଚାଲାକ: നിപുണനായ സമര്‍ഥനായ മിടുക്കുള്ള ചാതുര്യമുള്ള ഇരുമുഖങ്ങളുള്ള
ଚାଲୁ: തുടരുന്ന ആവറ്ത്തിക്കുന്ന നടക്കുന്ന നിരന്തരമായ.
ଚାଳିତ_: നടത്തപ്പെടുന്ന പ്രവര്‍ത്തിക്കപ്പെറ്ടുന്ന.
ଚାଳିଶ|: നാല്‍പ്പത്.
ଚାଷଯୋଗ୍ୟ: ഉഴാനുള്ള.
ଚିକଚିକ: പ്രശോഭിക്കുന്ന തിളങ്ങുന്ന മിന്നുന്ന ശോഭിക്കുന്ന ജ്വലിക്കുന്ന സ്ഫുരിക്കുന്ന ദ്യോതിപ്പിക്കുന്ന മിനുങ്ങുന്ന ഉജ്ജ്വലിക്കുന്ന.
ଚିକିଟା: വഴുക്കലുള്ള.
ଚିକିତ୍ସାତୀତ: അസാദ്ധ്യമായത്.
ଚିକିତ୍ସାସେବା: ചികിത്സാ_സംബന്ധമായ.
ଚିକିତ୍ସିତ: ചികിത്സിക്കപ്പെട്ട ശുശ്രൂഷിക്കപ്പെട്ട.
ଚିକିତ୍ସ୍ୟ: ചികിത്സിക്കാവുന്നത്.
ଚିକ୍କଣ: മിനുസം മാര്‍ദ്ദവം മിനുമിനുപ്പ്
ଚିତ୍ରାଙ୍କିତ: ചിത്രാങ്കിതമായ ചിത്രത്തിലു്_അറ്റയാളപ്പെടുത്തിയ.
ଚିତ୍ରିତ: ചിത്രീകരിച്ച ചിത്രീകരിക്കപ്പെട്ട ചിത്രം_വരച്ച ചിത്രിതമായ. ചിത്രീകരിച്ച ചിത്രീകരിക്കപ്പെട്ട ചിത്രം_വരച്ച ചിത്രിതമായ.
ଚିନିଯୁକ୍ତ: മധുരമുള്ള.
ଚିନ୍ତନୀୟ: ചിന്തിക്കേണ്ടതായ.
ଚିନ୍ତାଗ୍ରସ୍ତ_: ചിന്തയോടു_കൂടിയ ഉത്കണ്ഠയുള്ള ചിന്താകുലനായ.
ଚିନ୍ତାଜନକ: ചിന്തിക്കേണ്ടതായ.
ଚିନ୍ତାମୁକ୍ତ: ചിന്താഹീനനായ.
ଚିନ୍ତାଯୁକ୍ତ: ചിന്തയോടു_കൂടിയ ഉത്കണ്ഠയുള്ള ചിന്താകുലനായ.
ଚିନ୍ତାରହିତ: ചിന്താഹീനനായ.
ଚିନ୍ତାହୀନ: ചിന്താഹീനനായ.
ଚିନ୍ତିତ: ചിന്തയോടു_കൂടിയ ഉത്കണ്ഠയുള്ള ചിന്താകുലനായ.
ଚିପୁଡା: നന്നായി_പിഴിഞ്ഞ.
ଚିରକାଳିକ: നീണ്ട_കാലത്തെ.
ଚିରକାଳୀନ: നീണ്ട_കാലത്തെ.
ଚିରଜୀବୀ: ചിരഞ്ജീവി.
ଚିରଞ୍ଜିବୀ: അമരന്‍ മൃത്യുഞ്ഞയന്‍ ചിരഞ്ഞീവി അമര്‍ത്യന്‍
ଚିରଞ୍ଜୀବୀ: ചിരഞ്ജീവി.
ଚିରସ୍ଥାୟୀ: എന്നും_നിലനില്ക്കുന്ന. ദഹനമില്ലായ്മ.
ଚିରହରିତ: നിത്യഹരിതം.
ଚିରହରିତ୍_: പച്ച_നിറഞ്ഞ സംര്‌ദ്ധമായ_.
ଚିରାୟୁ: ചിരഞ്ജീവി.
ଚିଲିୟାନ୍: ചിലി_രാജ്യത്തെ.
ଚିହ୍ନ_ହୋଇଥିବା: ആംഗ്യം_കാണിച്ച അടയാളം_കാണിച്ച ചൂണ്ടിക്കാണിച്ച.
ଚିହ୍ନିତ: ആംഗ്യം_കാണിച്ച അടയാളം_കാണിച്ച ചൂണ്ടിക്കാണിച്ച.
ଚିହ୍ନିବାଯୋଗ୍ୟ: പര്യവേക്ഷണത്തില്‍_നിന്ന്_കിട്ടുന്ന_വിശിഷ്ട്ട_ജ്ഞാനം.
ଚୀନୀ: ചൈനക്കാരന്റെ ചൈന_ഭാഷ
ଚୁପ: മൌനമായ.
ଚୁପ୍‌: ഉത്തരം_ഇല്ലാത്ത.
ଚୁରମାର: പൊടിഞ്ഞു_പോകുക.
ଚେକ: ചെക്ക് ചെക്ക്
ଚେତନ: ചേതനയോടു_കൂടിയ.
ଚେତନା_ରହିତ: ജഡം.
ଚେତନାଯୁକ୍ତ: ചേതനയോടു_കൂടിയ.
ଚେତନାରହିତ: ബോധമില്ലാത്ത.
ଚେତାଶୂନ୍ୟ: ബോധമില്ലാത്ത.
ଚେତାହୀନ: ബോധമില്ലാത്ത.
ଚେପଟା: പരന്ന.
ଚେରହୀନ|: വേരില്ലാത്ത അടിസ്ഥാനമില്ലാത്ത ആധാരമില്ലാത്ത മൂലമില്ലാത്ത മൂടില്ലാത്ത മാണമില്ലാത്ത ജടയില്ലാത്ത ശിഫയില്ലാത്ത.
ଚେରୁଆ_: വേരുള്ള
ଚୋପା: തൊലി_കളഞ്ഞ
ଚୋରା: അപഹരിക്കപ്പെട്ട്. അപഹരിക്കപ്പെട്ട്.
ଚ୍ୟୁତ: മാറ്റിയ നീക്കിയ മാറ്റം_ചെയ്ത.
ଛଅ_କୋଣିଆ: ആറു_കോണുകളുള്ള ആറു_വശ്ങ്ങളുള്ള.
ଛଅଷଠିତମ: അറുപത്തി_ആറാം
ଛଗୁଣ: ആറുമടങ്ങ്
ଛଡା: ഉച്ഛിഷ്ടമായ എച്ചിലായ ഫേലമായ ചണ്ടിയായ ശേഷിച്ച
ଛଡାଯାଇଥିବା: കളയുവാനായി_ഉപേക്ഷിച്ച.
ଛଦ୍ମମୟ_: ചതി_നിറഞ്ഞ.
ଛଦ୍ମହୀନ|: കാപഠ്യമില്ലാത്ത.
ଛପନତମ: അന്പത്തിയാറാമത്തെ
ଛମାସିଆ: അരകൊല്ലത്തെ.
ଛଳ_କପଟୀ: കപടമായ.
ଛଳନାପୂର୍ଣ୍ଣ: ചതി_നിറഞ്ഞ. വിശ്വാസവഞ്ചന_ചെയ്യുന്ന.
ଛଳନାମୟ: ചതി_നിറഞ്ഞ.
ଛଳନାହୀନ: സത്യസന്ധനായ നെറിയുള്ള വിശ്വസ്തനായ
ଛଳହୀନ: കാപട്യമില്ലാത്ത നിഷ്കളങ്കരായ ശാന്തസ്വഭാവമുള്ള
ଛସ୍ତରିତ: എഴുപത്തി_ആറാം
ଛାତ୍ରାବାସୀ: വിദ്യാര്‍ഥികളുടെ_പാര്‍പ്പിടത്തില്‍_നില്‍ക്കുന്ന്.
ଛିଟଦାର: ചെറിയ_ജലകണങള്‍_വെച്ചുണ്ടാക്കിയ_തുണി.
ଛିଡିଯାଇଥିବା: പ്രശ്നം_പരിഹരിച്ച സംശയ_നിവാരണം_കഴിഞ്ഞ കുരുക്കഴിഞ്ഞ പരിഹ്ര്‌തമായ.
ଛିଣ୍ଡିଯାଇଥିବା: പ്രശ്നം_പരിഹരിച്ച സംശയ_നിവാരണം_കഴിഞ്ഞ കുരുക്കഴിഞ്ഞ പരിഹ്ര്‌തമായ.
ଛିଦ୍ରଯୁକ୍ତ: തുളയുള്ളത് ഓട്ടയുള്ളത്.
ଛିଦ୍ରାନ୍ବେଷକ|: കുറ്റം_തിരക്കി_നടക്കുന്നയാള്.
ଛିଦ୍ରାନ୍ବେଷୀ: കുറ്റം_തിരക്കി_നടക്കുന്നയാള്.
ଛିନ୍ଛତରହୋଇ: ചിതറിയ പരന്നു_കിടക്കുന്ന നുറുക്കുകളായ.
ଛିନ୍ନ: മുറിഞ്ഞ
ଛେଉଁଣ୍ଡ: അനാഥ രക്ഷിതാവില്ലാത്ത രക്ഷയില്ലാത്ത ആശ്രയമില്ലാത്ത അഗതിയായ അഭയമില്ലാത്ത ഉടമയില്ലാത്ത.
ଛୋଟ: ചെറിയ ചെറിയ.
ଛୋଟ_ବଡ: അല്ലറ_ചില്ലറ
ଛୋଟକାଟିଆ: ചെറിയതും_വലിയതഉമായ.
ଛୋଟଛୋଟ|: ചെറിയ_ചെറിയ.
ଛୋଟପିଲା: ചെറിയ.
ଛୋଟମୋଟ: ചെറിയ
ଛୋଟାମୋଟା: ചെറിയതും_വലിയതഉമായ.
ଛୋଟିଆ: ചെറിയ ചെറിയതും_വലിയതഉമായ.
ଛୟାନବେତମ: തൊണ്ണൂറ്റി_ആറാമത്തെ
ଛୟାଶୀତମ: എണ്പത്തിയാറാം
ଜଂଗମ: ചലിക്കുന്ന ചലിക്കാന്‍_സാധിക്കുന്ന ജീവനുള്ള.
ଜଖମୀ: മുറിവേറ്റ ക്ഷതമേറ്റ.
ଜଗୁଆଳିବିହୀନ: ആസ്രയമില്ലാത്ത രക്ഷ്കനില്ലാത്ത.
ଜଘନ୍ୟ: വെറുക്കപ്പെട്ട നിന്ദിക്കപ്പെട്ട.
ଜଙ୍ଗଲୀ: വനത്തെ_സംബന്ധിക്കുന്ന. വന്യ കാടന്‍
ଜଙ୍ଘହୀନ: തുടയില്ലാത്ത
ଜଞ୍ଜାଳିଆ: പ്രയാസമുള്ള കുഴപ്പം_പിടിച്ച വിഷമമുള്ള ആയാസമുള്ള.
ଜଟିଳ: കുരുക്കുള്ള് കുഴപ്പത്തില്_പെട്ട. പ്രയാസമുള്ള ഗൂഢമായ
ଜଡ: ജഡം. അധികം_സംസാരിക്കാത്ത
ଜଡିତ_: സംബന്ധിക്കുന്ന കുറിച്ചുള്ള.
ଜଣା: അറിവുള്ള പേരു_കേട്ട.
ଜଣାଶୁଣା_: പരിചയമുള്ള.
ଜଣାଶୁଣା|: പ്രായോഗികന്ജ്ഞാനമുള്ള അനുഭവന്ജ്ഞാനം_ഉള്ള പരിചയസമ്പന്നത_ഉള്ള ഇടപഴക്കമുള്ള പ്രായോഗികജ്ഞാനം_ഉള്ള
ଜଣେ_ଅଧେ_: ഒന്നോ_രണ്ടോ
ଜଣେଅଧେ: ഒന്നോ_രണ്ടോ.
ଜଣେଦୁଇଜଣ: ഒന്നോ_രണ്ടോ.
ଜନଜାତୀୟ: ഗിരിവര്‍ഗ്ഗ_സംബന്ധിയായ.
ଜନନେନ୍ଦ୍ରୀୟ: ജനനേന്ദ്രിയം
ଜନଶୂନ୍ୟ: നിര്ജ്ജനം ഏകാന്തം.
ଜନୋପଯୋଗୀ: ജനങ്ല്ക്കുപകാരപ്രദമായത്.
ଜନ୍ମାନ୍ଧ: ജന്മാന്ധന്
ଜନ୍ମିତ: ഉല്പന്ന് ഉണ്ടായ ജനിച്ച.ഉത്ഭവിച്ച രൂപപ്പെട്ട ഉല്പാദിപ്പിച്ച. ഉത്പാദിപ്പിക്കുന്ന ഉത്ഭവിക്കുന്ന ഔല്പാദികമായ ഉല്പാദിക്കപ്പെട്ട് ഉല്പാദിത ഉല്പാദിപ്പിക്കപ്പെട്ട ഉല്പാദ്യ് സ്ര്‌ഷ്ടിപരമായ നിറ്മ്മാണാത്മകമായ രചനാത്മകമായ.
ଜବତ: കണ്ടുകെട്ട്പ്പെട്ട്.
ଜବାନ: യുവാവ്
ଜମା|: ഒന്നിച്ചു_ചേര്‍ന്ന ശേഖരിച്ച കൂട്ടിചേര്‍ത്ത.
ଜରାୟୁଜ: ഗര്‍ഭത്തില്‍_നിന്നു_ജനിക്കുന്നത്.
ଜରୁରୀ_: ആവശ്യമുള്ള പ്രധാനമായ തീര്‍ച്ചയായും_വേണ്ട്തായ കടപ്പാടുള്ള ഒഴിച്ച്കൂടാനാവാത്ത.
ଜର୍ଜର: ജീര്‍ണ്ണിച്ച.
ଜର୍ଜିୟା_ସମ୍ବନ୍ଧିତ: ജോറ്ജിയന്‍.
ଜର୍ଜିୟାନ୍: ജോറ്ജിയന്‍.
ଜର୍ମାନୀ: ജര്‍മ്മന്‍ ജര്‍മ്മനിയുടെ
ଜଳମୟ: വെള്ളമയം
ଜଳା: കത്തി_ദഹിച്ച.
ଜାଆଁଳା: ഇരട്ട.
ଜାଗତିକ: ഈ_ലോകത്തുള്ള ലൌഗികമായ.
ଜାଗ୍ରତ: ഉണര്ന്നിരിക്കുന്ന.
ଜାଜ୍ବଲ୍ୟମାନ: സ്വര്‍ണ്ണം_കൊണ്ടലങ്ങ്കരിച്ച കാന്തിപൂര്‍ണ്ണമായ ഉജ്ജ്വലമായ.
ଜାଣିବାର_ଇଚ୍ଛୁକ: ചോദ്യങള്ക്കുള്ള
ଜାତ: ഉല്പന്ന് ഉണ്ടായ ജനിച്ച.ഉത്ഭവിച്ച രൂപപ്പെട്ട ഉല്പാദിപ്പിച്ച.
ଜାତି\: ജാതീയമായ വര്‍ഗ്ഗീയമായ.
ଜାପାନୀ: ജപ്പാന്‍_ഭാഷയിലെ
ଜାଫରାନୀ: കുംകുമ_നിറമുള്ള.
ଜାଭା: ജാവയിലെ ജാവായുടെ
ଜାମାଇକା: ജമൈക്കയിലെ.
ଜାମାଇକାନ୍_: ജമൈക്കയിലെ.
ଜାରି: തുടരുന്ന ആവറ്ത്തിക്കുന്ന നടക്കുന്ന നിരന്തരമായ.
ଜାଲ: ക്രിത്രിമമായ.
ଜାଲି: ക്രിത്രിമമായ.
ଜିଜ୍ଞାସାଜନକ_: അസാമാന്യമായ അത്ഭുതകരമായ വിസ്മയകരമായ.
ଜିଜ୍ଞାସାହୀନ: ഉത്സാഹമില്ലാത്ത.
ଜିଜ୍ଞାସିତ: ചോദ്യങള്ക്കുള്ള
ଜିଜ୍ଞାସୁ: അറിയാനാഗ്രഹമുള്ള ജിജ്ഞാസു.
ଜିତ_: ജയിക്കത്തക്ക.
ଜିଦଖୋର|: വാശിക്കാരനായ.
ଜିମ୍ବାୱେ_ବାସୀ: സിംബ്ബാവെവിയന്.
ଜିହ୍ବାମୂଳୀୟ: നാക്കിന്റെ_ചുവട്
ଜୀବନଦାୟୀ: മരണം_ഇല്ലാതാക്കുന്നവന്‍ ജീവന്‍_നല്‍കുന്നവന്‍ സഞീവനി.
ଜୀବନହାରୀ: മരിക്കുവാന്‍_ഉതകുന്ന.
ଜୀବନହୀନ: ജീവനില്ലാത്ത.
ଜୀବିତ: ഉല്പന്ന് ഉണ്ടായ ജനിച്ച.ഉത്ഭവിച്ച രൂപപ്പെട്ട ഉല്പാദിപ്പിച്ച. ജീവനുള്ള ശ്വാസോച്ഛ്വാസമുള്ള
ଜୀର୍ଣ୍ଣ: ജീര്‍ണ്ണിച്ച.
ଜୁଆଡି: ചൂതുകളിക്കുന്ന
ଜୁଗୁପ୍ସୁ: അവജ്ഞയുള്ള നിന്ദയുള്ള ജുഗുപ്സയുള്ള.
ଜୁଡୁବୁଡୁ: കുതിര്‍ന്ന
ଜୋତିର୍ମୟ: പ്രകാശപൂര്‍ണ്ണമായ പ്രകാശമാനമായ.
ଜୋର୍ଡାନ: ജോറ്ദാന്‍ ജോറ്ദാനി.
ଜୋର୍ଡାନ_ସମ୍ବନ୍ଧିତ: ജോറ്ദാന്‍ ജോറ്ദാനി.
ଜ୍ଞନଯୁକ୍ତ: അറിവുള്ള ബോധപൂര്‍ണ്ണമായ.
ଜ୍ଞାତ: മനസ്സിലാക്കാവുന്ന ധരിക്കാവുന്ന. അറിവുള്ള പേരു_കേട്ട.
ଜ୍ଞାନପୂର୍ଣ୍ଣ: അറിവുള്ള ബോധപൂര്‍ണ്ണമായ.
ଜ୍ଞାନଶୂନ୍ୟ: ബോധമില്ലാത്ത.
ଜ୍ଞାନାତୀତ: ജയിക്കാന്_പറ്റാത്ത.
ଜ୍ଞାନୀ: അറിവുള്ള ബോധപൂര്‍ണ്ണമായ. വിദ്വാന്‍മാരായിട്ടുളള പാണ്ഡിത്യമുള്ള അറിവുള്ള
ଜ୍ଞାପିତ: പറഞ്ഞ
ଜ୍ଞେୟ: മനസ്സിലാക്കാവുന്ന ധരിക്കാവുന്ന.
ଝଗଡା_କରୁଥିବା: കലഹപ്രിയമുള്ള.
ଝଗଡାଳୁ: കലഹപ്രിയമുള്ള.
ଝଞ୍ଜଟିଆ: പ്രയാസമുള്ള കുഴപ്പം_പിടിച്ച വിഷമമുള്ള ആയാസമുള്ള.
ଝାପସା: മങ്ങലുള്ള വ്യ്ക്‌തമല്ലാത്ത അസ്പഷ്ടമായ അവ്യക്‌തമായ
ଝାମ୍ପୁରା: അഴിഞ്ഞു_ചിതറിയ.
ଝାଳରେ_ଭିଜିଥିବା: വിയര്ത്തു_കുളിച്ച.
ଝାଳୁଆ: വിയര്ത്തു_കുളിച്ച.
ଝିଲିମିଲି: നേരിയ_പാഡ_പോലെയുള്ള_തൊലി.
ଟାଇପ୍_କରାଯାଇଥିବା: ടയിപ്പ്_ചെയ്ത.
ଟାଇଲ_ଛପର: ഓടിട്ട ഓടു_മേഞ്ഞ.
ଟାଣୁଆ: ഉറപ്പുള്ള ബലമുള്ള
ଟେକନିକହୀନ: സാങ്കേതികമല്ലാത്ത.
ଟେକନିକ୍: സാങ്കേതിക.
ଟ୍ରେଣ୍ଡ_: ശിക്ഷണം_ചെയ്യപ്പെട്ട.
ଟ୍ୟୁନିସିଆନ୍: ട്യൂനിസിയന്.
ଠକ: വിശ്വാസവഞ്ചന_ചെയ്യുന്ന.
ଠାଉକା: തട്ടിപ്പറിക്കുന്ന.
ଠାଉରିଆ: തട്ടിപ്പറിക്കുന്ന.
ଠିକ: യുക്തമായ ഉചിതമായ ഒത്ത തക്ക സത്യം നിപത്തി നേര് നേറ്റി
ଠିକ_: സാന്മാര്‍ഗ്ഗികത സാന്മാര്‍ഗ്ഗികാചരണം.
ଠିକରୂପେ: ക്രമപ്പെടുത്തപ്പെട്ട നിശ്ച്ചിതമായ വ്യവസ്ഥപ്പെടുത്തിയ.
ଠିକ୍: വിധിപ്രകാരമുള്ള. വാസ്തവികമായ യദാര്ഥമായ.
ଠିକ୍_ଠାକ୍: നല്ല.
ଡଚ: ഡച്. ഡച്ചിന്റെ
ଡରହୀନ: പേടിയില്ലാത്ത.
ଡରୁଆ: ഭീരുത്വമുള്ള ഭയശീലമുള്ള ആണത്തമില്ലാത്ത നെഞ്ഞുരപ്പില്ലാത്ത
ଡାଳଯୁକ୍ତ_: ശാഖകളുള്ള.
ଡିମ୍ବଜ: മുട്ടയിടുന്ന.
ଡିଷ୍ଟିଲ୍ଡ_ୱାଟର: വാറ്റിയ
ଡୁପ୍ଲିକେଟ୍: ഒരേപോലത്തെ ഡ്യൂപ്ലികേറ്റ്.
ଡେଙ୍ଗା_: നിക്രിഷ്ഠമല്ലാത്ത ദുഷ്ട്ടനല്ലാത്ത
ଡେଣାହୀନ: ചിറകൊടിഞ്ഞ
ଡେନମାର୍କୀୟ: ഡേനിഷിന്റെ ഡെന്മാര്‍ക്കി_ഭാഷ
ଡେନିଶ: ഡേനിഷിന്റെ ഡെന്മാര്‍ക്കി_ഭാഷ
ଡୌଉଲ_ଡାଉଲ: ആകാരവടിവുള്ള.
ଢଙ୍କା: മൂടിയ നിറഞ്ഞ.
ଢିଲା: അലസനായ മടിയനായ ആലസ്യമുള്ള അയഞ്ഞ. അഴിഞ്ഞ. മുറുക്കമില്ലാത്ത.
ଢେଉଯୁକ୍ତ: തിരയടിക്കുന്ന ഇളകുന്ന.
ତଉଲା: തൂക്കിയ
ତଟକା: പുതിയതായ പുത്തനായ
ତଟବାସୀ: തീരത്ത്_വസിക്കുന്ന.
ତତଲା: ചൂടുള്ള
ତତ୍ପର: തത്പരമായ ആഭിമുഖ്യമുള്ള പ്രതിപത്തിയുള്ള ശുഷ്കാന്തിയുള്ള വാഞ്ജയുള്ള താല്‍പര്യമുള്ള ഉത്സാഹമുള്ള സന്നദ്ധതയുള്ള
ତଥ୍ୟପୂର୍ଣ୍ଣ: സത്യാവസ്ഥയിലുള്ള് യാഥാര്‍ത്ഥ്യപൂര്‍ണ്ണമായ.
ତଥ୍ୟାତ୍ମକ: സത്യാവസ്ഥയിലുള്ള് യാഥാര്‍ത്ഥ്യപൂര്‍ണ്ണമായ.
ତନୁଧାରୀ: ശരീരമുള്ള
ତନୁପତଳା: മെലിഞ്ഞ
ତନ୍ଦ୍ରାଳୁ: ക്ഷീണിതനായ ക്ഷീണിച്ച തളറ്ന്ന മടുത്ത വാടിയ ചുണകെട്ട.
ତନ୍ବୀ: കോമളാങ്കിനി കോമളാങ്കീ സുന്ദരിയായ_സ്ത്രീ.
ତନ୍ମୟ: മുഴുകിയ.
ତମସାମୟ: ഇരുട്ട്_നിറഞ്ഞ.
ତରଙ୍ଗାୟିତ: തിരയടിക്കുന്ന ഇളകുന്ന.
ତରଙ୍ଗିତ: തിരയടിക്കുന്ന ഇളകുന്ന.
ତରତରିଆ: സൂക്ഷ്മതയില്ലാത്ത വേണ്ടപോലെ_ആലോചിക്കാത്ത ദ്രുതഗതിയിലുള്ള.
ତରଳ: ഉരുകിയ. മുറുക്കമില്ലാത്ത അയഞ്ഞ അഴിഞ്ഞ.
ତରୁଣ: യുവാവ്
ତର୍କଗମ୍ୟ: അവിരുദ്ധമായ.
ତର୍କପୂର୍ଣ୍ଣ: യുക്തി_നിറഞ്ഞ.
ତର୍କଯୁକ୍ତ: യുക്തി_നിറഞ്ഞ.
ତର୍କରହିତ: തര്ക്കമില്ലാത്ത.
ତର୍କସଙ୍ଗତ: അവിരുദ്ധമായ. യുക്തി_നിറഞ്ഞ.
ତର୍କହୀନ: തര്ക്കമില്ലാത്ത.
ତର୍କାତୀତ: തര്ക്കത്തിന്നതീതമായ.
ତଲ୍ଲୀନ: മുഴുകിയ.
ତଳ: പല_നിലകളുള്ള. താഴെയുള്ള അടിയിലുള്ള കീഴെയുള്ള.
ତାଇବାନୀ: തായ്‌വാനിന്റെ
ତାଜା: പുതിയ പുത്തന്‍ പുതിയതായ പുത്തനായ പുതിയ പുത്തനായ
ତାଜିକିସ୍ତାନୀ: തസികിസ്താനി.
ତାଞ୍ଜାନିଆନ୍: ടാന്സാനിയന്.
ତାପନାଶକ: ഊഷ്മാവ്മാറ്റുന്ന ചൂട്_മാറ്റുന്ന.
ତାପହର: ഊഷ്മാവ്മാറ്റുന്ന ചൂട്_മാറ്റുന്ന.
ତାମିଲ: തമിഴിന്റെ തമിഴ് തമിഴ്
ତାରକିତ: നക്ഷത്രങ്ങളോടു_കൂടിയ.
ତାରାବିହୀନ: നക്ഷത്ര_വിഹീനമായ.
ତାରାଭରା: നക്ഷത്രങ്ങളോടു_കൂടിയ.
ତାରାଯୁକ୍ତ: നക്ഷത്രങ്ങളോടു_കൂടിയ.
ତାରାହୀନ|: നക്ഷത്ര_വിഹീനമായ.
ତାର୍କିକ_: തര്‍ക്കിക്കുന്ന വാദിക്കുന്ന.
ତିଅଡ: മൂന്നു_തവണ_ഉഴുത.
ତିଆରି: നിര്‍മ്മാണം രൂപം ആക്രിതി_കൊടുക്കല്‍.
ତିକ୍ତ: കൈപ്പേറിയ ചവര്‍പ്പുള്ള
ତିତିକ୍ଷୁ: ക്ഷമിക്കുന്നവന്.
ତିନିଅଧେ: മൂന്നര
ତିନିଓଡ: മൂന്നു_തവണ_ഉഴുത.
ତିନିଗୁଣ: മൂന്നു_മടങ്ങ്
ତିନିଗୋଡିଆ: മുക്കാലി.
ତିନିଜଣ: മൂവരും.
ତିନିତରଫା: മൂന്ന്_ഭാഗത്ത്_നിന്നും.
ତିନିପଟିଆ: മൂന്ന്_ഭാഗത്ത്_നിന്നും.
ତିବ୍ବତୀ: തിബത്തുകാരന്റെ തിബത്തിലെ തിബത്തിലെ_ഭാഷ
ତିରସ୍କରଣୀୟ: തിരസ്ക്കരണീയ അപമാന്യമായ അപമാനജനകമായ
ତିରସ୍କୃତ: ഉപേക്ഷിക്കപ്പെട്ട തിരസ്ക്കരിക്കപ്പെട്ട
ତୀକ୍ଷଣ: മൂര്‍ച്ചുള്ള മുനയുള്ള
ତୀକ୍ଷ୍ଣ: സൂക്ഷ്മ_ഗ്രാഹിത്വം.
ତୀକ୍ଷ୍ଣ୍: മ്ര്‌ദുവായ നേറ്മ്മയുള്ള‌ കനം_കുറഞ്ഞ ആറ്ദ്രമായ സൌമ്യതയുള്ള.
ତୀବ୍ର: സൂക്ഷ്മ_ഗ്രാഹിത്വം. വേഗതയുള്ള ചുണയുള്ള തീക്ഷ്ണമായ.
ତୀବ୍ର|: പ്രബലമായി.
ତୁଙ୍ଗ: ഉയര്‍ന്ന പൊക്കമുള്ള
ତୁଚ୍ଛ: പ്രാധാന്യമില്ലാത്ത.
ତୁରନ୍ତ: താമസം_വിനാ താമസം_കൂടാതെ വിളംബിക്കാതെ അമാന്തിക്കാതെ.
ତୁରୁତୁରିଆ: സൂക്ഷ്മതയില്ലാത്ത വേണ്ടപോലെ_ആലോചിക്കാത്ത ദ്രുതഗതിയിലുള്ള.
ତୁର୍କମେନିସ୍ତାନୀ: തുര്‍ക്കമേനിസ്താനിന്റെ.
ତୁର୍କୀ: തുര്‍ക്കി_ഭാഷയിലെ
ତୁଲ: തുല്യമായ സമമായ സമാനമായ
ତୁଲ୍ୟ: താരതമ്യപ്പെടുത്താന്‍_യോഗ്യം. തുല്യമായ സമമായ സമാനമായ സമമായ തുല്യമൂല്യമായ.
ତୁଳନୀୟ: താരതമ്യപ്പെടുത്താന്‍_യോഗ്യം.
ତୁଷ୍ଟ: ത്ര്പ്തനായ്.
ତୃଣଚର: പുല്ലു_തിന്നുന്ന_മ്രിഗങ്ങള്‍
ତୃଣଜୀବୀ_: പുല്ല്_തിന്നുന്ന
ତୃଣଭୋଜୀ: പുല്ല്_തിന്നുന്ന പുല്ലു_തിന്നുന്ന_മ്രിഗങ്ങള്‍
ତୃଣମୟ: പുല്ലോ_വൈക്കോലോ_കൊണ്ടുണ്ടാക്കിയ.
ତୃପ୍ତ: ത്ര്പ്തനായ്.
ତୃଷିତ: ദാഹമുള്ള തൊണ്ടവരള്‍ച്ചയുള്ള
ତେଜ: സൂക്ഷ്മ_ഗ്രാഹിത്വം. പ്രബലമായി. വേഗതയുള്ള ചുണയുള്ള തീക്ഷ്ണമായ.
ତେଜପୂର୍ଣ: സ്വര്‍ണ്ണം_കൊണ്ടലങ്ങ്കരിച്ച കാന്തിപൂര്‍ണ്ണമായ ഉജ്ജ്വലമായ.
ତେଜପୂର୍ଣ୍ଣ: പ്രകാശപൂര്‍ണ്ണമായ പ്രകാശമാനമായ.
ତେଜବନ୍ତ: കാന്തിമത്തായ.
ତେଜବାନ: കാന്തിമത്തായ.
ତେଜସ୍ବୀ: കാന്തിമത്തായ.
ତେଜହୀନ: തേജസ്സില്ലാത്ത ചുണയില്ലാത്ത ശോഭയില്ലാത്ത.
ତେଜିୟାନ: ചുറുചുറുക്കുള്ള ഉന്‍മേഷമുള്ള ചൊടിയുള്ള ഉത്സാഹമുള്ള ഊറ്‍ജ്ജസ്വലതയുള്ള പ്രസരിപ്പുള്ള ഓജസ്സുള്ള ചുണയുള്ള മിടുക്കുള്ള
ତେଜୋମଣ୍ଡିତ: സ്വര്‍ണ്ണം_കൊണ്ടലങ്ങ്കരിച്ച കാന്തിപൂര്‍ണ്ണമായ ഉജ്ജ്വലമായ.
ତେଢା: പ്രയാസമുള്ള ഗൂഢമായ വളഞ്ഞ വക്രതയുള്ള ചുറ്റിക്കുന്ന
ତେଢା_ମେଢା: വളഞ്ഞ വക്രതയുള്ള ചുറ്റിക്കുന്ന
ତେପନ: അന്പത്തി_മൂന്ന്
ତେପନତମ: അന്പത്തി_മൂന്നാം
ତେଲଗୁ: തെലുംഗ് തെലുംഗ് തെലുംഗ്
ତେଲୁଗୁ: തെലുംഗ് തെലുംഗ് തെലുംഗ്
ତେଷଠି: അറുപത്തി_മൂന്ന്
ତେଷଠିତମ: അറുപത്തി_മൂന്നാം
ତେସ୍ତରିତମ: എഴുപത്തി_മൂന്നാം
ତେୟାଅଶୀତମ: എണ്പത്തി_മൂന്നാം
ତେୟାନବେତମ: തൊണ്ണൂറ്റി_മൂന്നാം
ତୋଫାନୀ|: കൊടുംകാറ്റിനോടു_ബന്ധപ്പെട്ട.
ତୋଷକ: ത്രിപ്തിപ്പെടുത്തുന്നയാള്‍.
ତୋଷଣୀୟ: സന്തോഷിപ്പിക്കുന്ന ത്രിപ്തിപ്പെടുത്തുന്ന. ത്രിപ്തി_അല്ലെങ്കില്‍_സന്തോഷം_നല്‍കുന്നത്.
ତୋଷିତ: ത്ര്പ്തനായ്.
ତୋଷ୍ୟ: സന്തോഷിപ്പിക്കുന്ന ത്രിപ്തിപ്പെടുത്തുന്ന. ത്രിപ്തി_അല്ലെങ്കില്‍_സന്തോഷം_നല്‍കുന്നത്.
ତ୍ବରିତ: വേഗതയുള്ള. വേഗതയുള്ള.
ତ୍ରସିତ|: പീടിപ്പിക്കപ്പെട്ട.
ତ୍ରସ୍ତ: പേടിച്ച.
ତ୍ରୟୋଦଶ: പതിമൂന്നാം പതിമൂന്നാമത്തെ
ତ୍ୟଜନୀୟ: ഉപേക്ഷിക്കപ്പെടേണ്ടതായ ഉപേക്ഷിക്കത്തക്ക ചീത്തയായ വര്‍ജ്ജിക്കത്തക്കതായ.
ତ୍ୟଜ୍ୟ: ഉപേക്ഷിക്കപ്പെടേണ്ടതായ ഉപേക്ഷിക്കത്തക്ക ചീത്തയായ വര്‍ജ്ജിക്കത്തക്കതായ.
ତ୍ୟାଜ୍ୟ: ഭാര്യയേയോ_ഭര്‍ത്താവിനേയോ_ഉപേക്ഷിച്ച.
ତ୍ୱରିତକର୍ମା: തത്പരമായ ആഭിമുഖ്യമുള്ള പ്രതിപത്തിയുള്ള ശുഷ്കാന്തിയുള്ള വാഞ്ജയുള്ള താല്‍പര്യമുള്ള ഉത്സാഹമുള്ള സന്നദ്ധതയുള്ള
ଥକିଲା: ക്ഷീണിച്ച.
ଥଟାରି: മൂശാരിയുടെ.
ଥଟ୍ଟାଳିଆ: നര്‍മ്മബോധമുള്ള രസികത്വമുള്ള പരിഹാസത്തിനു_അര്‍ഹനായ നിന്ദായോഗ്യമായ.
ଥଣ୍ଡା: തണുത്ത. തണുത്ത ശീതളമായ കുളിരുള്ള കുളിറ്‍മയുള്ള തണുത്ത. തണുപ്പേകുന്ന കുളിരേകുന്ന.
ଥଣ୍ଡା_ମିଜାଜ୍: ഗൌരവമുള്ള പതറാത്ത സുദൃഢമായ സുസ്ഥിരമായ
ଥାଈ: ഥായുടെ ഥായ് ഥായ്
ଥାଈବାସୀ: ഥായ്
ଥୁଣ୍ଟା: ശോഷിക്കുന്ന കൊഴിയുന്ന ക്ഷയിക്കുന്ന ശുഷ്കിക്കുന്ന. ശുഷ്കിച്ച ശോഷിച്ച ക്ഷയിച്ച ചടച്ച ഉണങ്ങിയ.
ଦକ୍ଷିଣ: തെക്കേദിക്കിനെ_സംബന്ധിക്കുന്ന.
ଦକ୍ଷିଣ_ଆଫ୍ରିକା_ସମ୍ବନ୍ଧୀୟ: ദക്ഷിണാഫ്രിക്കന്.
ଦକ୍ଷିଣ_ଆଫ୍ରିକୀୟ: ദക്ഷിണാഫ്രിക്കന്.
ଦକ୍ଷିଣ_ଆମେରିକୀୟ_: ദക്ഷിണ_അമേരിക്ക.
ଦକ୍ଷିଣ_କୋରିଆ: ദക്ഷിണ_കൊറിയന്‍.
ଦକ୍ଷିଣୀ: തെക്കേദിക്കിനെ_സംബന്ധിക്കുന്ന.
ଦକ୍ଷିଣୀୟ: തെക്കേദിക്കിനെ_സംബന്ധിക്കുന്ന.
ଦଗାବାଜ: ക്രിത്രിമം_ചെയ്യുന്ന.
ଦନ୍ତହୀନ|: പല്ലില്ലാത്ത.
ଦନ୍ଥରା: മൂര്‍ച്ചയില്ലാതാക്കപെട്ട മുനയില്ലാതായ
ଦମଦାର: ശക്തിയുള്ള ബലമുള്ള ദ്രിഢമായ
ଦମିତ_: നിയന്ത്രിക്കപ്പെട്ട.
ଦରକାରୀ_: പ്രയോഗിച്ച ഉപയോഗിച്ച.
ଦରଗଢା: ശരിയായ_രൂപമില്ലാത്ത വിക്ര്‌ത്കമായ മോശമായ.
ଦରପାଚିଲା: പകുതി_പഴുത്ത.
ଦରବୃଦ୍ଧି: വളര്ന്നുകൊണ്ടിരിക്കുന്ന
ଦରମରା: പകുതി_മരിച്ച.
ଦରମଲା: പകുതി_മരിച്ച.
ଦରମୁକୁଳିତ|: വിടരാത്ത.
ଦରିଦ୍ର: പാവപെട്ട ദരിദ്രനായ നിര്‍ദ്ധനനായ പാപപരായ അഗതിയായ
ଦର୍ପୀ: അഹങ്കാരിയായ അഹന്തയുള്ള അഹമ്മതിയുള്ള പൊങ്ങച്ചക്കാരിയായ
ଦର୍ଶନୀୟ: കാണാന്_കഴിയുന്ന.
ଦଳବଦଳକାରୀ: കാലുമാറല്‍.
ଦଳିଚକଟି_ହୋଇଥିବା: കേടു_വന്ന നാശം_പറ്റിയ അയോഗ്യമായ കൊള്ളാത്ത ചീഞ്ഞ അഴുകിയ.
ଦଳିତ: ചവിട്ടിമെതിക്കപ്പെട്ട.
ଦଳୀୟ: സംഘത്തിന്റെ
ଦଶ: പത്ത് ദശം ദശകം 10 പത്താം
ଦଶ_ଲକ୍ଷ: പത്ത്_ലക്ഷം മില്ല്യണ്‍ 100000.
ଦଶ_ହଜାର: പതിനായിരം പത്ത്_ആയിരം.
ଦଶଗୁଣ: പത്തുമടങ്ങ്
ଦସ୍ତଖତହୋଇଥିବା: ഒപ്പുവെച്ച്ത്.
ଦସ୍ତାନିର୍ମିତ: നാകത്തിന്റെ_നിറമുള്ള.
ଦସ୍ତାବିଜ_ସମ୍ବନ୍ଧୀୟ: പ്രമാണം_സംബന്ധിച്ച.
ଦାଗୀ: കളങ്ങ്കപ്പെട്ട.
ଦାଢହୀନ: മൂര്‍ച്ചയില്ലാതാക്കപെട്ട മുനയില്ലാതായ
ଦାଢିଆ: താടിയുള്ള.
ଦାଢୁଆ: സൂക്ഷ്മ_ഗ്രാഹിത്വം.
ଦାତା: ഉദാരമതിയായ ദാനശീലനായ
ଦାଦାଶୁର: അച്ഛന്റെ_അനിയനെ_സംബന്ധിക്കുന്ന.
ଦାନବୀର: ഉദാരമതിയായ ദാനശീലനായ വളരെ_ദാനശീലനായ.
ଦାନଶୀଳ: ഉദാരമതിയായ ദാനശീലനായ
ଦାନୀ: ഉദാരമതിയായ ദാനശീലനായ
ଦାନ୍ତହୀନ: പല്ലില്ലാത്ത.
ଦାନ୍ତୁଡି: പല്ലു_പൊങിയ.
ଦାମିକା: വിലയേറിയ വിലമതിക്കാനാവാത്ത വിലപിടിച്ച
ଦାମୀ: വില_പിടിച്ച വിലപിടിപ്പുള്ള വിലയേറിയ മൂല്യമേറിയ
ଦାମ୍ଭିକ: അഹങ്കാരിയായ അഹന്തയുള്ള അഹമ്മതിയുള്ള പൊങ്ങച്ചക്കാരിയായ
ଦାରୁଣ: ദാരുണമായ.
ଦାହ: കത്തി_ദഹിച്ച.
ଦାୟ: കൊടുക്കാവുന്നത് കൊടുക്കാനുളള്‍ത്.
ଦାୟୀ|: ഉത്തരവാദിത്വമുള്ള ഉത്തരവാദപ്പെട്ട
ଦିଗଭ୍ରମ: വഴി_തെറ്റിപ്പോകുന്ന
ଦିଗହୀନ: വഴി_തെറ്റിപ്പോകുന്ന
ଦିଗ୍ଗଜ|: വലിയ.
ଦିଗ୍‌ବିଜୟୀ: ലോകം_ജയിച്ചവന്‍.
ଦିତରଫା: ഇരുവശത്തും_ചേരുന്ന.
ଦିପଟିଆ: ഇരുവശത്തും_ചേരുന്ന.
ଦିପହରିଆ: ഉച്ച മദ്ധ്യാഹ്ന.
ଦିପାଖିଆ: ഇരുവശത്തും_ചേരുന്ന.
ଦିବଙ୍ଗତ: മരിച്ച അന്തരിച്ച സമാധിയായ മഹാനിദ്രയിലായ നിര്യാതനായ
ଦୀନ: പാവപെട്ട ദരിദ്രനായ നിര്‍ദ്ധനനായ പാപപരായ അഗതിയായ
ଦୀନହୀନ: പാവപെട്ട ദരിദ്രനായ നിര്‍ദ്ധനനായ പാപപരായ അഗതിയായ
ଦୀର୍ଘ: നീണ്ട നീളമുള്ള ദീറ്ഘ നീളമുള്ള നീണ്ട നെടിയ.
ଦୀର୍ଘକାଳିକ: നീണ്ട_കാലത്തെ.
ଦୀର୍ଘକାଳୀନ: നീണ്ട_കാലത്തെ.
ଦୀର୍ଘସ୍ଥାୟୀ: സ്ഥിരമായ ശാശ്വതമായ സ്ഥായിയായ അനശ്വരമായ
ଦୀର୍ଘାୟୁ: ചിരഞ്ജീവി.
ଦୁଃଖକର: ദു
ଦୁଃଖକାରକ: ദു
ଦୁଃଖଦ: ദു ദു
ଦୁଃଖଦାୟକ: ദു ദു
ଦୁଃଖଦାୟୀ_: ദു
ଦୁଃଖପୂର୍ଣ୍ଣ: ദു വ്യഥാപൂര്‍വം അനുശോചനപൂര്‍ണ്ണം. ദു
ଦୁଃଖପ୍ରଦ: ദു
ଦୁଃଖଭରା: ദു
ଦୁଃଖମୟ: ദു
ଦୁଃଖମୟ_ସ୍ଥିତି: കഷ്ട്ടത്തിലായ.
ଦୁଃଖିତ: ദു
ଦୁଃଖୀ: ദു
ଦୁଃଶୀଳ: ദുസ്വഭാവിയ്യായ ചീത്ത_സ്വഭാവമുള്ള
ଦୁଃସହ: അസഹ്യമായ.
ଦୁଃସାହାସିକ: സാഹസിക സാഹസികമായ ധീരമായ.
ଦୁଇଧାଡିଆ: രണ്ടിഴയുള്ള.
ଦୁଇନଳିଆ|: ഇരട്ട_കുഴല്.
ଦୁଇପଟିଆ: രണ്ടു_പക്ഷമുള്ള രണ്ടു_വശമുള്ള.
ଦୁଇବର୍ଷିଆ: ദ്വി_വര്‍ഷി രണ്ടു_വര്‍ഷം_നില്‍ക്കുന്നത്.
ଦୁଇହାତିଆ: രണ്ടുകയ്യുള്ള.
ଦୁଖାତ୍ମକ: ദു
ଦୁଖାନ୍ତ_: ദു
ଦୁନିର୍ବାର: ദുര്നിവാര്യമായ.
ଦୁରାଗ୍ରହୀ|: ദുരാഗ്രഹി.
ଦୁରାଚାରୀ: ദുശ്ചരിത്രം.
ଦୁରାତ୍ମା: ദുഷ്ട്ടാത്മാവു.
ଦୁରାଶୟ: ചീത്ത_ആശയം ചീത്ത_ലക്ഷ്യം ദ്രോഹബുദ്ധി.
ଦୁରୂହ: ബുദ്ധിമുട്ടുള്ള_. ദുരൂഹതയുള്ള. കഠിനമായ.
ଦୁର୍ଗନ୍ଧ: ചീഞ്ഞു_പോയ.
ଦୁର୍ଗନ୍ଧପୂର୍ଣ୍ଣ: ദുര്‍ഗന്ധപൂര്‍ണ്ണമായ.
ଦୁର୍ଗନ୍ଧମୟ: ദുര്‍ഗന്ധപൂര്‍ണ്ണമായ.
ଦୁର୍ଗମ: ബുദ്ധിമുട്ടുള്ള_.
ଦୁର୍ଗମ୍ୟ: ബുദ്ധിമുട്ടുള്ള_. ദുര്ഗ്ഗമമായ
ଦୁର୍ଗୁଣୀ: ദുര്ഗുണ്ങളുള്ള
ଦୁର୍ଜନ: ദുഷ്ട ദുഷിച്ച ചീത്ത നീച
ଦୁର୍ଜେୟ: അജയ്യ്ന് തോല്പ്പിക്കാന_്വയ്യാത്ത.
ଦୁର୍ଦଶାଗ୍ରସ୍ତ: ദുര്ദശ_പിടിപ്പെട്ട.
ଦୁର୍ଦ୍ଦର୍ଷ: ഭയാനകമായ ഭീകരമായ ഉഗ്രമായ ഞെട്ടിക്കുന്ന ഭീതിജനകമായ ഭയാവഹമായ രുദ്രമായ
ଦୁର୍ନାମ: കുപ്രസിദ്ധി ദുഷ്കീര്‍ത്തി അപഖ്യാതി
ଦୁର୍ବଳ: ലോലമായ സുകുമാരമായ കോമളമായ
ଦୁର୍ବୋଧ୍ୟ: ദുരൂഹതയുള്ള.
ଦୁର୍ବ୍ୟବହାରକାରୀ: ദുര്വ്യവഹാരികള്.
ଦୁର୍ବ୍ୟବହାରୀ|: ദുര്വ്യവഹാരികള്.
ଦୁର୍ଭାଗା: ദുര്ഭാഗ്യശാലി.
ଦୁର୍ଭାଗ୍ୟଶାଳୀ: ദുര്ഭാഗ്യശാലി.
ଦୁର୍ଭେଦ୍ୟ: ഭേദിക്കാന്‍_പറ്റാത്തത് തുളക്കുവാന്‍_പറ്റാത്തത് അവിഭാജ്യം.
ଦୁର୍ଲଙ୍ଘ୍ୟ: ഇരിപ്പിടമില്ലാത്ത.
ଦୁର୍ଲଭ: ദുര്ലഭമായ.
ଦୁଶ୍ଚରିତ୍ର: ദുശ്ചരിത്രം.
ଦୁଶ୍ଚରିତ୍ର|: നീച_വികാരങളുള്ള കാമാദ്ദീപകമായ.
ଦୁଷ୍କର: ഇരിപ്പിടമില്ലാത്ത.
ଦୁଷ୍କର୍ମା: ദുഷ്കര്‍മ്മം_ചെയുന്നവന്‍.
ଦୁଷ୍ଟ: ദുഷ്ട ദുഷിച്ച ചീത്ത നീച കുസൃതിയായ വികൃതിയായ അളിഞ്ഞ.
ଦୁଷ୍ଟ|: കപടമായ.
ଦୁଷ୍ଟମତି.ପାପମତି: ദുഷ്ട്ടാത്മാവു.
ଦୁଷ୍ଟାତ୍ମା: ദുഷ്ട്ടാത്മാവു.
ଦୁଷ୍ପ୍ରାପ୍ୟ: ദുര്ലഭമായ.
ଦୁସାଧ୍ୟ: അസാദ്ധ്യമായത്.
ଦୁସ୍ତର: അസീമമായ ചെന്നെത്താന്_പറ്റാത്ത.
ଦୂର: അകലേയുള്ള ദൂരത്തുള്ള.
ଦୂରଦର୍ଶୀ: മുന്‍പ്_സംഭവിച്ച മുന്‍പത്തെ.
ଦୂରବର୍ତ୍ତୀ: ദൂരെയുള്ള അകലെയുള്ള.അപാറ്ണ്ണമായ വിപ്രക്ര്‌ഷ്ടമായ പര വിദൂരമായ ബഹുദൂരെയുള്ള.
ଦୂରବର୍ତ୍ତୀ|: അകലേയുള്ള ദൂരത്തുള്ള.
ଦୂରୀକୃତ: പുറത്താക്കപ്പെട്ട.
ଦୂଷିତ: അപവിത്രമായ അശുദ്ധമായ. മുഷിഞ്ഞ ശുചിയല്ലാത്ത അഴുക്കായ മലിനപ്പെട്ട വൃത്തിഹീനമായ
ଦୃଢ: അടുത്ത. സ്ഥിരമായ. ദ്രിഢമായ. അചഞ്ചലമായ മാറാത്ത നിശ്ചലമായ. ഉറപ്പുള്ള ബലമുള്ള
ଦୃଢମତପୂର୍ଣ୍ଣ: ദ്രിഢമായ.
ଦୃଢମତବାଦୀ: ദ്രിഢമായ.
ଦୃଢମତହୀନ|: ദ്രിഢാഭിപ്രായമില്ലാത്ത.
ଦୃଶ୍ୟ: കാണാവുന്ന. കാണാന്_കഴിയുന്ന.
ଦୃଶ୍ୟମାନ: കാണാവുന്ന.
ଦୃଷ୍ଟିଗୋଚର: കാണാവുന്ന.
ଦୃଷ୍ଟିବାନ: ദ്ര്‌ഷ്ട്ടിയുള്ള കാഴ്ച്ചയുള്ള.
ଦୃଷ୍ଟିଯୁକ୍ତ: ദ്ര്‌ഷ്ട്ടിയുള്ള കാഴ്ച്ചയുള്ള.
ଦୃଷ୍ଟିହୀନ: അന്ധനായ കാഴ്ചയില്ലാത്ത കണ്ണില്ലാത്ത
ଦେଖାଯାଉଥିବା: കാണാവുന്ന.
ଦେଖାସୁନ୍ଦର: പ്രകടനപരമായ കപടമായ ക്രിത്രിമമായ. പ്രകടനപരമായ കപടമായ ക്ര്‌ത്രിമമായ.
ଦେଖିବା_ଭଳି: കാണാന്_കഴിയുന്ന.
ଦେଖିବା_ଯୋଗ୍ୟ: കാണാന്_കഴിയുന്ന.
ଦେଢ|: ഒന്നര
ଦେଦୀପ୍ୟମାନ: സ്വര്‍ണ്ണം_കൊണ്ടലങ്ങ്കരിച്ച കാന്തിപൂര്‍ണ്ണമായ ഉജ്ജ്വലമായ.
ଦେବାଳିଆ: പാപ്പരായ.
ଦେଶଜ: പ്രാദേശിക പ്രദേശികമായ സ്വദേശിയമായ ദേശിയതദ്ദേശീയമായ.
ଦେଶଦ୍ରୋହୀ: ദേശ_ദ്രോഹി.
ଦେଶଭକ୍ତ: ദേശഭക്തന്‍.
ଦେଶୀ: പ്രാദേശിക പ്രദേശികമായ സ്വദേശിയമായ ദേശിയതദ്ദേശീയമായ.
ଦେହଧାରୀ: ശരീരമുള്ള
ଦେହୀ_: ശരീരമുള്ള
ଦେୟ: കൊടുക്കാവുന്നത് കൊടുക്കാനുളള്‍ത്.
ଦେୱାନୀ: ദിവാന്‍_സ്ഥാനം.
ଦୈବବାଦୀ: എല്ലാം_ഭാഗ്യത്തിനധീനമെന്നു_വിശ്വസിക്കുന്ന.
ଦୈବୀ: ഈശ്വരനെ_സംബന്ധിക്കുന്ന ദേവിയെ_സംബന്ധിക്കുന്ന പരമേശ്വരിയെ_സംബന്ധിക്കുന്ന.
ଦୋନଳି: ഇരട്ട_കുഴല്.
ଦୋମୁହାଁ: ഇരു_വായുള്ള. രണ്ടു_വിധം_സംസാരിക്കുന്ന.
ଦୋଷକାରୀ: ആരോപിക്കപ്പെട്ടയാള്‍.
ଦୋଷଯୁକ୍ତ: ആരോപിക്കപ്പെട്ടയാള്‍.
ଦୋଷାରୋପିତ: കുറ്റം_ആരോപിക്കപ്പെട്ട
ଦୋଷାଶ୍ରିତ: ആരോപിക്കപ്പെട്ടയാള്‍.
ଦୋଷୀ: അപരാധിയായ നിയമലംഘകനായ കുറ്റവാളിയായ പാപിയായ തെറ്റുകാരനായ കുറ്റം_ആരോപിക്കപ്പെട്ട അടിച്ചേല്പ്പിച്ച ആരോപിക്കപ്പെട്ടയാള്‍.
ଦୋଷୀରୋପିତ|: അടിച്ചേല്പ്പിച്ച
ଦ୍ବାବିଂଶ: ഇരുപത്തി_രണ്ട്.
ଦ୍ବାବିଂଶତମ: ഇരുപത്തി_രണ്ടാമത്തെ.
ଦ୍ବିଦଳ|: രണ്ടിതളുകളുള്ള ദ്വിദലീയ.
ଦ୍ବିଧାଗ୍ରସ୍ତ: പ്രശ്നത്തില്_അകപ്പെടുക ഇതികര്ത്തവ്യതാമൂഢത_പിടിപ്പെട്ട.
ଦ୍ବିଧାଜନକ: ഇതികര്‍ത്തവ്യതാമൂഢത_ഉണ്ടാക്കുന്ന ഇതികര്‍തവ്യതാമൂഢത_ജനിപ്പിക്കുന്ന.
ଦ୍ବିଧାହୀନ: അവിശ്വാസമില്ലാത്ത.
ଦ୍ବିପ୍ରହରିଆ: ഉച്ച മദ്ധ്യാഹ്ന.
ଦ୍ବିଫାଳବିଶିଷ୍ଟ: രണ്ടിതളുകളുള്ള ദ്വിദലീയ.
ଦ୍ବିବର୍ଷି: ദ്വി_വര്‍ഷി രണ്ടു_വര്‍ഷം_നില്‍ക്കുന്നത്.
ଦ୍ବୀପୀୟ: ദ്വീപ്
ଦ୍ବେଷପୂର୍ଣ୍ଣ_: അസൂയ_നിറഞ്ഞ.
ଦ୍ବେଷହୀନ: അസൂയ_ഇല്ലാതിരിക്കുക.
ଦ୍ରବିତ: ഉരുകിയ. ദയ_നിറഞ്ഞ.
ଦ୍ରବୀଭୂତ: ഉരുകിയ. ദയ_നിറഞ്ഞ.
ଦ୍ରୁତ: വേഗതയുള്ള ചുണയുള്ള തീക്ഷ്ണമായ. വേഗതയുള്ള. വേഗതയുള്ള.
ଦ୍ୟୁତିମାନ: തേജസ്സാര്ന്ന തിളങുന്ന. തിളങ്ങുന്ന ശോഭയുള്ള പ്രഭയുള്ള പകിട്ടുള്ള കാന്തിയുള്ള സ്ഫുരിക്കുന്നപ്രകാശിക്കുന്ന
ଦ୍ୱାଦଶତମ: പന്ത്ര്ണ്ടാമത്തെ പന്ത്രണ്ടാം
ଦ୍ୱିତୀୟ: രണ്ടാം ദ്വിതീയ
ଦୟନୀୟ|: ദയനീയമായ.
ଦୟାବାନ: ദയാലുവായ ക്രിപാലുവായ കാരുണികനായ മഹാമനസ്കനായ ദയാലുവായ ക്രിപാലുവായ കാരുണികനായ മഹാമനസ്കനായ
ଦୟାର୍ଦ୍ର: ദയ_നിറഞ്ഞ.
ଦୟାଳୁ: ദയാലുവായ ക്രിപാലുവായ കാരുണികനായ മഹാമനസ്കനായ
ଦୟାଶୀଳ: ദയാലുവായ ക്രിപാലുവായ കാരുണികനായ മഹാമനസ്കനായ
ଦୟାହୀନ: ദ്രോഹിയായ കരുണയില്ലാത്ത ഉപദ്രവിക്കുന്ന
ଧଡିଆ: മെലിഞ്ഞ
ଧନଦାତା_: പണം_കൊടുക്കുന്നവന്.
ଧନବନ୍ତ: ധനികനായ പണക്കാരനായ
ଧନବାନ: ധനികനായ പണക്കാരനായ
ଧନହୀନ: പാവപെട്ട ദരിദ്രനായ നിര്‍ദ്ധനനായ പാപപരായ അഗതിയായ
ଧନାଢ୍ୟ: ധനികനായ പണക്കാരനായ
ଧନୀ: സമര്‍ത്ഥനായ. ധനികനായ പണക്കാരനായ
ଧନ୍ୟ: സാറ്ത്ഥകമായ ഉപയോഗമുള്ള ഫലമുള്ള ഗുണമുള്ള ഉപയുക്തിയുള്ള പ്രയോജനമുള്ള ഉപകാരമുള്ള.
ଧବଳ: വെളുത്തത്.
ଧରାଶାୟୀ: തകര്‍ത്ത നിലത്തു_വീണ. ഭൂമിയില്‍_വീണ_.
ଧର୍ମଘଟକାରୀ: സമരം_ചെയ്യുന്ന പണിമുടക്കുന്ന.
ଧର୍ମନିଷ୍ଠ: ധാര്‍മ്മികനായ മതഭക്തിയുള്ള സദാചാരതത്പരനായ ധര്‍മ്മനിഷ്ഠനായ ധര്‍മ്മബോധമുള്ള നീതിബോധമുള്ള
ଧର୍ମପରାୟଣ: ധാര്‍മ്മികനായ മതഭക്തിയുള്ള സദാചാരതത്പരനായ ധര്‍മ്മനിഷ്ഠനായ ധര്‍മ്മബോധമുള്ള നീതിബോധമുള്ള
ଧର୍ମଭୀରୁ: മത_വിരുദ്ധമായി_പ്രവര്‍ത്തിക്കാന്‍_ഭയപ്പെടുന്നവന്‍.
ଧର୍ମମତାନୁସାରୀ|: മതാനുയായി.
ଧର୍ମମତାବଲମ୍ବୀ: മതാനുയായി.
ଧର୍ମହୀନ: ധര്‍മ്മബോധമില്ലാത്ത ധര്‍മ്മവിരുദ്ധിയായ
ଧର୍ମାତ୍ମା: ധാര്‍മ്മികനായ മതഭക്തിയുള്ള സദാചാരതത്പരനായ ധര്‍മ്മനിഷ്ഠനായ ധര്‍മ്മബോധമുള്ള നീതിബോധമുള്ള
ଧର୍ମାନ୍ଧ: മതഭ്രാന്തുള്ള
ଧର୍ମାବଲମ୍ବୀ: മതാനുയായി.
ଧର୍ମାର୍ଥ: മതപരമായ
ଧଳା: വെളുത്തത്.
ଧାତବୀୟ_: ലോഹപരമായ ആന്തരികമായ
ଧାରଯୁକ୍ତ: വക്കുള്ള
ଧାରହୀନ: മൂര്‍ച്ചയില്ലാതാക്കപെട്ട മുനയില്ലാതായ
ଧାରାବାହିକ: തുടറ്ച്ചായായുള്ള സ്ഥിരമായ ഇടവിടാതെയുള്ള ആവറ്ത്തിച്ചുള്ള.
ଧାରୁଆ: മൂര്‍ച്ചുള്ള മുനയുള്ള
ଧାର୍ମିକ: സത്യസന്ധനായ നെറിയുള്ള വിശ്വസ്തനായ ധാര്‍മ്മികനായ മതഭക്തിയുള്ള സദാചാരതത്പരനായ ധര്‍മ്മനിഷ്ഠനായ ധര്‍മ്മബോധമുള്ള നീതിബോധമുള്ള
ଧୀମା: മന്ദം സാവധാനം അകലെ_കാണുന്ന വിവേകമുള്ള പണ്ഡിതാന്‍.
ଧୀମାନ୍‌: ബുദ്ധിമാന്‍ ധാരണാശക്‌തിയുള്ള വിവേകമുള്ള
ଧୀର: മന്ദം സാവധാനം അകലെ_കാണുന്ന വിവേകമുള്ള പണ്ഡിതാന്‍. ധൈര്യശാലി നിര്‍ഭയനായ ചങ്കൂറ്റമുള്ള ഉള്‍ക്കരുത്തുള്ള മടിയുള്ള അലസതയുള്ള.
ଧୁଳିଧୂସରିତ: പൊടിപടലമായ
ଧୂମାଳ: മങ്ങലുള്ള വ്യ്ക്‌തമല്ലാത്ത അസ്പഷ്ടമായ അവ്യക്‌തമായ
ଧୂର୍ତ୍ତ: ഇരുമുഖങ്ങളുള്ള ക്രിത്രിമം_ചെയ്യുന്ന.
ଧୂଳିଧୁସରିତ_: പൊടിപിടിച്ച
ଧୂଳିଧୂସର: പൊടിപിടിച്ച
ଧୂଳିମୟ: പൊടിപടലമായ
ଧୂଳିସାତ: ഭൂമിയോട്_സമാനമായി.
ଧୂସର: മങ്ങലുള്ള വ്യ്ക്‌തമല്ലാത്ത അസ്പഷ്ടമായ അവ്യക്‌തമായ
ଧୂସର_: പൊടിപടലമായ
ଧୂସରିତ: പൊടിപടലമായ
ଧୃଷ୍ଟ: നിയന്ത്രണമില്ലാത്ത തോന്ന്യാസമുള്ള ധിക്കാരപരമായ.
ଧୈର୍ଯ୍ୟବାନ୍‌: ധൈര്യശാലി നിര്‍ഭയനായ ചങ്കൂറ്റമുള്ള ഉള്‍ക്കരുത്തുള്ള
ଧୈର୍ଯ୍ୟଶୀଳ: ധൈര്യശാലി നിര്‍ഭയനായ ചങ്കൂറ്റമുള്ള ഉള്‍ക്കരുത്തുള്ള
ଧୈର୍ଯ୍ୟହୀନ: ചഞ്ചലചിത്തനായ അസ്ഥിരനായ
ଧୈର୍ଯ୍ୟହୀନ|: ധൈര്യമില്ലാത്ത_അവസ്ഥ.
ଧୋକାବାଜ୍‌: ചതിയനായ വഞ്ചകനായ.
ଧ୍ବଂସ: മരിച്ച നശിച്ച നശിപ്പിക്കപ്പെട്ട.
ଧ୍ବଂସନୀୟ: നശിക്കുന്ന ധ്വംസിക്കാവുന്ന ഇല്ലാതാകവുന്ന അസ്ഥിരമായ ശാസ്വതമല്ലാത്ത.
ଧ୍ୟାନହୀନ|: ശ്രദ്ധയില്ലാത്ത.
ଧ୍ୟାନାକର୍ଷଣ: ശ്രദ്ധിക്ക്ത്തക്കതായ.
ନ: ഒന്‍പത് 9
ନଅ: ഒന്‍പത് 9
ନଇଁଥିବା: മുന്നോട്ടു_കുനിഞ്ഞ.
ନକଲି: പ്രകടനപരമായ കപടമായ ക്ര്‌ത്രിമമായ. ക്രിത്രിമമായ.
ନକାରାତ୍ମକ: നിഷേധാത്മകമായി.
ନଗଣ୍ୟ: പ്രാധാന്യമില്ലാത്ത. ഉപേക്ഷിക്കത്തക്ക അവഹേളിക്കത്തക്ക.
ନଗର_ନିବାସୀ: പട്ടണവാസി നഗരവാസി.
ନଗର_ବାସୀ: പട്ടണവാസി നഗരവാസി.
ନଗରୀକୃତ: നഗരവത്കരിക്കപെട്ട പരിഷ്കരിക്കപ്പെട്ട വികസിതമായ.
ନଗୁଣ: ഒന്‍പതുമടങ്ങ്
ନଗ୍ନ: നഗ്നനായ വിവസ്ത്രനായ ദിഗംബരനായ അനംബരനായ
ନଡକା: എല്ലും_തോലാകുക.
ନଡନଡିଆ: എല്ലും_തോലാകുക.
ନଣ୍ଡା: കഷണ്ടിയുള്ള കഷണ്ടി_രോഗമുള്ള. മൊട്ട.
ନଦା: ഭാരപ്പെട്ട് ചുമക്കപ്പെട്ട് വഹിക്കപ്പെട്ട് എടുക്കപ്പെട്ട് പൊക്കപ്പെട്ട്.
ନବ: പുതിയ പുത്തനായ നവീനതമായ നൂതനമായ ഒന്‍പത് 9
ନବ_ପ୍ରଶିକ୍ଷିତ: പുതുതായി_പഠിച്ച അപക്വമായ ശിക്ഷണം_ചെയ്യപ്പെട്ട സിദ്ധിക്കപ്പെടാത്ത അഭ്യസിക്കാത്ത.
ନବ_ଶିକ୍ଷିତ: പുതുതായി_പഠിച്ച അപക്വമായ ശിക്ഷണം_ചെയ്യപ്പെട്ട സിദ്ധിക്കപ്പെടാത്ത അഭ്യസിക്കാത്ത.
ନବଜାତ: ഇപ്പോള്‍_ജനിച്ച.
ନବତିତମ: തൊണ്ണൂറാമത്തെ
ନବମ: ഒന്‍പതാം
ନବୀକରଣଯୋଗ୍ୟ: ആധുനികവല്ക്കരണം.
ନବୀଣ: പുതുതായി_പഠിച്ച അപക്വമായ ശിക്ഷണം_ചെയ്യപ്പെട്ട സിദ്ധിക്കപ്പെടാത്ത അഭ്യസിക്കാത്ത.
ନବୀନ: ആധുനികം. പുതിയ പുത്തനായ നവീനതമായ നൂതനമായ
ନବୀନତମ: പുതിയ പുതുമ_നിറഞ്ഞ നവമായ ആധുനികമായ പുതുതായ അഭിനവ പുതുമയുള്ള.
ନମନୀୟ: വലിച്ചു_നീട്ടാവുന്ന. അടിച്ചു_പരത്താവുന്ന.
ନମନୀୟ_: വളയുന്ന വഴങ്ങുന്ന.
ନମିତ: കുനിയിക്കപ്പെട്ടവന്‍. മുന്നോട്ടു_കുനിഞ്ഞ.
ନମ୍ର: വിനീതമായ_പെരുമാറ്റമുള്ള. മുന്നോട്ടു_കുനിഞ്ഞ.
ନରଭକ୍ଷକ: നരഭോജിയായ മനുക്ഷ്യനെ_ഭക്ഷിക്കുന്ന.
ନରଭକ୍ଷୀ: നരഭോജിയായ മനുക്ഷ്യനെ_ഭക്ഷിക്കുന്ന.
ନରମ: മൃദുവായ മൃദുലമായ പേലവമായ ലോലമായ കോമളമായ സുകുമാരമായ
ନରୱେଜିଆନ୍_: നോര്‍വെയുടെ. നോര്‍വീജിയന്‍.
ନଶ୍ବର: നശിക്കുന്ന.
ନଷ୍ଟ: മരിച്ച നശിച്ച നശിപ്പിക്കപ്പെട്ട.
ନାଇଜିରିଆ_ସମ୍ବନ୍ଧୀୟ: നൈജീരിയന്.
ନାଇଜିରିଆନ୍: നൈജീരിയന്.
ନାଚାର: നിസ്സഹായനായ നിര്ബന്ധിതനായ
ନାନା: അനേകം ഒന്നിലധികമായ പല വളരെയേറേ അസംഖ്യം.
ନାପସନ୍ଦ: ഇഷ്ട്ടപ്പെടാത്ത വെറുപ്പുണ്ടാക്കുന്ന.
ନାମଂଜୁର: സമ്മതമില്ലാത്ത. സ്വീകരിക്കാത്ത.
ନାମଜାଦା: പ്രസിദ്ധയായ കേള്‍വിപ്പെട്ട പേരുകേട്ട യശസ്വിയായ പ്രഖ്യാതമായ അറിയപ്പെട്ട വിഖ്യാതിയായ
ନାମଞ୍ଜୁର: നിരാകരിച്ച സമ്മതിക്കാത്ത് സമ്മതമില്ലാത്ത സമ്മതം_ലഭിക്കാത്ത സമ്മതംകിട്ടാത്ത.
ନାମୀ: ബഹുമാനിക്കപ്പെട്ട ആദരിക്കപ്പെട്ട. പ്രസിദ്ധയായ കേള്‍വിപ്പെട്ട പേരുകേട്ട യശസ്വിയായ പ്രഖ്യാതമായ അറിയപ്പെട്ട വിഖ്യാതിയായ
ନାମ୍ବିୟା_ସମ୍ବନ୍ଧୀୟ: നമീബിയന്
ନାମ୍ବିୟାନ୍: നമീബിയന്
ନାରାଜ: ദു
ନାରୀଯୋଗ୍ୟ: സ്ത്രീക്കു_ചേര്ന്നതായ.
ନାୟହୀନ: ന്യായമില്ലായ്മ അനീതി ന്യായവിരിദ്ധമായ_പെരുമാറ്റം അക്രമം അന്യായം_ചെയ്യുന്ന ദുരാചാരിയായ.
ନିଂଦ୍ୟ: നിന്ദിക്കപ്പെടാവുന്നത്.
ନିଃଶଙ୍କ: ആശങ്കയില്ലാത്ത ഭയമില്ലാത്ത ശങ്കയില്ലാത്ത ചിന്തയില്ലാത്ത കൂസലില്ലാത്ത.
ନିଃଶୁଳ୍କ: പണമില്ലാതെ.
ନିଃସଙ୍ଗ: ഏകാന്തമായ തനിയേ_ഉള്ള ഒറ്റയായ അനാഥമായ
ନିଃସହାୟ: നിസ്സഹായ സഹായമില്ലാത്ത ആശ്രയമില്ലാത്ത നിരാലംബ അശരണ കെല്പില്ലാത്ത നിറ്ധനനായ.
ନିଃସାର: നിസ്സാരമായ കഴ്മ്പില്ലാത്ത. നിസ്സാരമായ കാര്യമില്ലാത്ത.
ନିଃସ୍ବାର୍ଥ: സ്വാര്ഥഹീനനായ നിസ്വാര്ഥിയായ.
ନିଆରା: ഉപമയില്ലാത്ത അതുല്യമായ.
ନିକଟ: അടുത്തു_വന്ന അടുത്തെത്തിയ.
ନିକଟତମ: ഏറ്റവും_അടുത്തുള്ള സമീപത്തുള്ള തൊട്ടടുത്തുള്ള.
ନିକଟବର୍ତ୍ତୀ|: അടുത്തു_വന്ന അടുത്തെത്തിയ.
ନିକମା: പണിയെടുക്കാത്ത.
ନିକୃଷ୍ଟ: ബസാറിനോട്_ബന്ധപ്പെട്ട തരം_താണ്.
ନିକୃଷ୍ଟତମ: നീചമായ ഹീനമായ.
ନିଖୁଣ: വിക്രുതമല്ലാത്ത.
ନିଚ: താഴെയുള്ള അടിയിലുള്ള കീഴെയുള്ള.
ନିଜକର୍ତ୍ତୃକ: സ്വതന്ത്ര്മായ നിയന്ത്രണമില്ലാത്ത.
ନିଜପାଇଁ: സ്വന്തം_ഇഷ്ട്ടാനുസരണം.
ନିଜର: അവനവന്റെ സ്വന്തമായ തന്റെ തന്റേതായ. വ്യക്തിപരമായ സ്വകാര്യ്മായ തനതായ സ്വയംക്ര്‌തമായ സ്വീയമായ സ്വകീയമായ തന്റ്റേതായ സ്വന്തമായ രഹസ്യമായ വൈക്ത്യമായ അനന്യമായ.
ନିଜସ୍ବ: അടിസ്ഥാനപരമായ മൌലീക യഥാറ്ത്ഥമായ തനതായ അക്ര്‌ത്രിമമായ.
ନିଡର: പേടിയില്ലാത്ത.
ନିତ୍ୟ: എന്നും_നിലനില്ക്കുന്ന.
ନିଦ୍ରାଗତ: നിദ്രാനിമഗ്നനായ_‍ ഉറങ്ങിയ.
ନିଦ୍ରାମଗ୍ନ: നിദ്രാനിമഗ്നനായ_‍ ഉറങ്ങിയ.
ନିଦ୍ରାଳୁ: ക്ഷീണിതനായ ക്ഷീണിച്ച തളറ്ന്ന മടുത്ത വാടിയ ചുണകെട്ട.
ନିଦ୍ରାହୀନ: നിദ്രയില്ലാത്ത നിദ്രാവിഹീനന്‍
ନିଦ୍ରିତ: നിദ്രാനിമഗ്നനായ_‍ ഉറങ്ങിയ.
ନିନ୍ଦନୀୟ: നിന്ദിക്കപ്പെടാവുന്നത്.
ନିନ୍ଦାକାରୀ: തെറ്റായ_കുറ്റാരോപണം അപകീര്‍ത്തിപ്പെടുത്തല്‍.
ନିନ୍ଦାତ୍ମକ: നിന്ദാത്മകമായ
ନିନ୍ଦୁକ: നിന്ദിക്കുന്ന. തെറ്റായ_കുറ്റാരോപണം അപകീര്‍ത്തിപ്പെടുത്തല്‍.
ନିବଦ୍ଧ: ബന്ധിക്കപ്പെട്ട.
ନିବାହୀ: തലപ്പത്തിരിക്കുന്ന.
ନିବେଦକ: അപേക്ഷകന്.
ନିଭୃତ: നിര്ജ്ജനം ഏകാന്തം.
ନିମଗ୍ନ: മുഴുകിയ.
ନିମନ୍ତ୍ରଣକାରୀ: ക്ഷണിക്കുന്ന.
ନିମ୍ନ: കുറഞ്ഞ ചെറിയതായ. താഴെയുള്ള അടിയിലുള്ള കീഴെയുള്ള.
ନିମ୍ନ_ବଂଶୀୟ: താഴ്ന്ന.
ନିଯୁକ୍ତ: നിയുക്തനാക്കിയ.
ନିଯୋଜ୍ୟ: നിയമിക്കാവുന്ന ഏറ്പ്പെടുത്താവുന്ന
ନିରକ୍ଷର: വിദ്യാഭാസമില്ലാത്ത പഠിപ്പില്ലാത്ത
ନିରଙ୍କୁଶ: സ്വേച്ഛാധിപതിയായ അനിയന്ത്രിതനായ നിരങ്കുശനായ കടിഞ്ഞാണില്ലാത്ത.
ନିରପେକ୍ଷ: താല്പര്യ_മില്ലായ്മ നിഷ്പക്ഷത.
ନିରପେକ୍ଷିତ: ആഗ്രഹിക്കാത്ത അപേക്ഷിക്കാത്ത മറ്റൊന്നിനെ_ആശ്രയിക്കാത്ത.
ନିରର୍ଥକ: ഉപയോഗശൂന്യ്മായ.
ନିରାକାର: ക്ലിപ്തരൂപമില്ലാത്ത.
ନିରାଧାର: ആശ്രയമില്ലാത്ത അടിസ്ഥാനമില്ലാത്ത.
ନିରାପଦ: സുരക്ഷിതമായ സംരക്ഷിതമായ സുരക്ഷിതമായ.
ନିରାଭିମାନୀ: അഹങ്കാരമില്ലാത്ത വിനയമുള്ള ഗര്‍വ്വില്ലാത്ത.
ନିରାଶ: പ്രതീക്ഷ_ഇല്ലാത്ത ആശ_നഷ്ട്ടപ്പെട്ട ആശയറ്റ.
ନିରାଶ_: നിരാശയുള്ള.
ନିରାଶାଜନକ: നിരാശാജനകമായ.
ନିରାଶାବାଦୀ: നിരാശവാദി.
ନିରାଶ୍ରିତ: ദരിദ്രനായ.
ନିରାଶ୍ରୟ: ദരിദ്രനായ.
ନିରୁତ୍ତର: ഉത്തരം_ഇല്ലാത്ത.
ନିରୁତ୍ସାହୀ: അനുത്സാഹികളായ.
ନିରୁତ୍ସୁକ: ഉത്സാഹമില്ലാത്ത.
ନିରୁଦ୍ଧ: അടഞ്ഞുപ്പോയ
ନିରୁଦ୍ବିଘ୍ନ_: ശാന്തമായ നിശ്ചേഷ്ട്ടമായ അടക്കമുള്ള.
ନିରୁପାୟ: സന്ദേഹമില്ലാതെ ധാരണയോടെ ഉപായത്തോടെ നിശ്ചയത്തോടെ ധൈര്യത്തോടെ ഉറ്പ്പോടെ തീറ്ച്ചയോടെ.
ନିରୂତ୍ସାହ: നിരുത്സാഹകന്‍ പ്രവര്‍ത്തിക്കാത്തവന്‍.
ନିରୋଗକର: ആരോഗ്യപ്രദമായ.
ନିରୋପରାଧ: നല്ല.
ନିର୍ଗତ: പുറത്താക്കപ്പെട്ട.
ନିର୍ଗନ୍ଧ: മണമില്ലാത്ത.
ନିର୍ଜନ: നിര്ജ്ജനം ഏകാന്തം.
ନିର୍ଜୀବ: ജീവനില്ലാത്ത.
ନିର୍ଦ୍ଦିଷ୍ଟ: വിധിപ്രകാരമുള്ള.
ନିର୍ଦ୍ଦେଶିତ: ആജ്ഞാപിക്കപ്പെട്ട നിറ്‌ദ്ദേശിക്കപ്പെട്ട കല്പിക്കപെട്ട ഏല്‍പ്പിക്കപ്പെട്ട.
ନିର୍ଦ୍ଦେଶିତ_: നിര്‍ദേശിച്ച.
ନିର୍ଦ୍ଦୋଷ: നല്ല.
ନିର୍ଦ୍ଦୟ: ദ്രോഹിയായ കരുണയില്ലാത്ത ഉപദ്രവിക്കുന്ന വിശ്വാസവഞ്ചന_ചെയ്യുന്ന. വികാരമില്ലാത്ത.
ନିର୍ଦ୍ଧାରିତ: വിധിപ്രകാരമുള്ള. നിയോഗിക്കപ്പെട്ട ചുമതലപ്പെടുത്തിയ.
ନିର୍ଧନ: പാവപെട്ട ദരിദ്രനായ നിര്‍ദ്ധനനായ പാപപരായ അഗതിയായ
ନିର୍ବଚନ: മൌനമായ.
ନିର୍ବାକ: മൌനമായ. മൂകന്‍
ନିର୍ବାଚନୀୟ: തെരഞ്ഞെടുപ്പ്.
ନିର୍ବାଚିତହୋଇଥିବା|: വേര്പ്പെടുത്തുക.
ନିର୍ବାଦ: വിഘ്നം_ഇല്ലാത്ത്.
ନିର୍ବାସିତ: ബഹിഷ്ക്കരിക്കപ്പെട്ട.
ନିର୍ବିକାର: നിര്‍വികാരനാണ്‍.
ନିର୍ବିଘ୍ନ: വിഘ്നം_ഇല്ലാത്ത്.
ନିର୍ଭରଶୀଳ: ആശ്രയിക്കപ്പെട്ട.
ନିର୍ଭୀକ: പേടിയില്ലാത്ത. രക്ഷിക്കുന്ന.
ନିର୍ଭୟ: പേടിയില്ലാത്ത.
ନିର୍ମମ: വികാരമില്ലാത്ത.
ନିର୍ମଳ: നിര്‍മ്മലമായ വിമലമായ പവിത്രമായ് ശുദ്ധമായ
ନିର୍ମଳୀକୃତ: പരിഷ്ക്കരിച്ച ശുദ്ധീകരിച്ച സ്ഫുടം_ചെയ്ത.
ନିର୍ମାଣ: നിര്‍മ്മാണം രൂപം ആക്രിതി_കൊടുക്കല്‍.
ନିର୍ମିତ: രചിക്കപ്പെട്ട എഴുതപ്പെട്ട.
ନିର୍ମୂଳି: വേരില്ലാത്ത അടിസ്ഥാനമില്ലാത്ത ആധാരമില്ലാത്ത മൂലമില്ലാത്ത മൂടില്ലാത്ത മാണമില്ലാത്ത ജടയില്ലാത്ത ശിഫയില്ലാത്ത.
ନିର୍ଲଜ: നാണ്മില്ലാത്ത.
ନିର୍ଲିପ୍ତ: ആസക്തനല്ലാത്ത.
ନିଲମ୍ବିତ: ജോലിയില്‍_നിന്നു_മാറ്റി_നിര്‍ത്തിയ.
ନିଶଂକ: പേടിയില്ലാത്ത.
ନିଶାଖୋର: ലഹരിക്കടിമയായവന്.
ନିଶାବାଜ|: ലഹരിക്കടിമയായവന്.
ନିଶାହୀନ: മത്ത്_പിടിച്ചിട്ടില്ലാത്ത ബോധമുള്ള ഉന്മത്തനല്ലാത്ത മദ്യപിക്കാത്ത.
ନିଶୁଆ: മീശയുള്ള.
ନିଶ୍ଚଳ: സ്ഥിരമായ.
ନିଶ୍ଚିତ: അനിവാര്യം. ചിന്താഹീനനായ. അനിവാര്യമായ. വിധിപ്രകാരമുള്ള.
ନିଶ୍ଚେତକ: വേദന_സംഹാരി.
ନିଷିଦ୍ଧ: നിഷേധിക്കപ്പെട്ടത് നിരോധിക്കപ്പെട്ട തടയപ്പെട്ട.
ନିଷ୍କଣ୍ଟକ: വിഘ്നം_ഇല്ലാത്ത്.
ନିଷ୍କପଟ: സത്യസന്ധനായ നെറിയുള്ള വിശ്വസ്തനായ കാപട്യമില്ലാത്ത നിഷ്കളങ്കരായ ശാന്തസ്വഭാവമുള്ള
ନିଷ୍କର୍ମା: അംഗവൈകല്ല്യമുള്ള.
ନିଷ୍କାମ: ആഗ്രഹമില്ലാത്തവന്. അതീന്ദ്രിയമായ.
ନିଷ୍କାସିତ: പുറത്താക്കപ്പെട്ട.
ନିଷ୍ଠାହୀନ: വിശ്വസ്തത_ഇല്ലാത്ത.
ନିଷ୍ଠୁର: ദ്രോഹിയായ കരുണയില്ലാത്ത ഉപദ്രവിക്കുന്ന
ନିଷ୍ପକ୍ଷ: താല്പര്യ_മില്ലായ്മ നിഷ്പക്ഷത.
ନିଷ୍ପତ୍ତି_ହୋଇଥିବା: പ്രശ്നം_പരിഹരിച്ച സംശയ_നിവാരണം_കഴിഞ്ഞ കുരുക്കഴിഞ്ഞ പരിഹ്ര്‌തമായ.
ନିଷ୍ପଳ: അസഫലമായ.
ନିଷ୍ପୃହ_: ആഗ്രഹമില്ലാത്തവന്.
ନିଷ୍ପ୍ରାଣ: ജീവനില്ലാത്ത.
ନିସ୍ତେଜ_: തേജസ്സില്ലാത്ത ചുണയില്ലാത്ത ശോഭയില്ലാത്ത.
ନିସ୍ପୃହ: ആഗ്രഹമില്ലാത്തവന്. ആഗ്രഹമില്ലായ്മ
ନିହିତ: ഗ്രസിക്കപ്പെട്ട.
ନିୟତି_ଅଧୀନ: മുന്പേ_നിശ്ചയിച്ച.
ନିୟନ୍ତ୍ରକ: നിയന്ത്രിക്കുന്ന.
ନିୟମ_ପାଳକ: നിയമം_പാലിക്കുന്ന സ്വയമേ_പാലിക്കുന്ന__അച്ചടക്കം.
ନିୟମବିରୁଦ୍ଧ: നിയമ_വിരുദ്ധമായ നിഷിദ്ധമായ.
ନିୟମୀ: നിയമം_പാലിക്കുന്ന സ്വയമേ_പാലിക്കുന്ന__അച്ചടക്കം.
ନିୟୁତ: പത്ത്_ലക്ഷം മില്ല്യണ്‍ 100000.
ନିୟୁନ: കുറച്ചു.
ନିୟୋଜିତ: യോജിച്ച അനുയോജ്യമായ ചേറ്ന്ന യുക്തമായ പൊരുത്തമുള്ള ഉചിതമായ ഹിതകരമായ ഇണങ്ങിയ അനുസ്ര്തമായ അനുഗുണമായ.
ନିୟୋଜିତ|: നിയുക്തനാക്കിയ.
ନୀଚ: ബസാറിനോട്_ബന്ധപ്പെട്ട തരം_താണ്.
ନୀଚ_କୁଳୀନ: താഴ്ന്ന_കുലത്തിലേ.
ନୀଚ_ବଂଶୀୟ|: താഴ്ന്ന_കുലത്തിലേ.
ନୀଚା: കുറഞ്ഞ ചെറിയതായ.
ନୀତିଜ୍ଞ: നീതിജ്ഞന്‍ നിയമജ്ഞന്‍.
ନୀତିପୂର୍ଣ୍ଣ: സാന്മാര്‍ഗ്ഗികത സാന്മാര്‍ഗ്ഗികാചരണം.
ନୀତିବିରୋଧ: ഉചിതമല്ലാത്ത അനീതിപൂര്‍ണ്ണമായ തെറ്റായ നീതിക്കു_വിരുദ്ധമായി.
ନୀରସ: അരുചികരമായ ഇഷ്ട്ടപ്പെടാത്ത. സ്വാദില്ലാത്ത. രസഹീനമായത്. നിസ്സാരമായ കഴ്മ്പില്ലാത്ത.
ନୀରୋଗ: ആരോഗ്യപൂര്‍ണ്ണമായ ആരോഗ്യകരമായ
ନୂଆ: ആധുനികം. പുതിയ പുത്തനായ നവീനതമായ നൂതനമായ
ନୂଆଶିଖାଳି: പുതുതായി_പഠിച്ച അപക്വമായ ശിക്ഷണം_ചെയ്യപ്പെട്ട സിദ്ധിക്കപ്പെടാത്ത അഭ്യസിക്കാത്ത.
ନୂତନ: ആധുനികം. പുതിയ പുത്തനായ നവീനതമായ നൂതനമായ
ନୃଶଂସ: സദാചാരമില്ലാത്ത മറ്റുള്ളവരേ_ഉപദ്രവിക്ക്ല്. ദ്രോഹിയായ കരുണയില്ലാത്ത ഉപദ്രവിക്കുന്ന
ନୃଶଂସ|: ഹിംസകന്.
ନେତାହୀନ_: നാഥനില്ലാത്ത
ନେତ୍ରବିମୋହନ: നയനാഭിരാമാ‍മായ നയനരമ്യമായ നേത്രാഭിരമാമായ.
ନେତ୍ରହୀନ: അന്ധനായ കാഴ്ചയില്ലാത്ത കണ്ണില്ലാത്ത
ନେପାଳୀ: നേപ്പാളിക്കാരി നേപ്പാളിയിലുള്‍ള്‍
ନୈତିକ: സാന്മാര്‍ഗ്ഗികത സാന്മാര്‍ഗ്ഗികാചരണം.
ନୈତିକତାପୂର୍ଣ୍ଣ: സാന്മാര്‍ഗ്ഗികത സാന്മാര്‍ഗ്ഗികാചരണം.
ନୈତିକହୀନ: ഉചിതമല്ലാത്ത അനീതിപൂര്‍ണ്ണമായ തെറ്റായ നീതിക്കു_വിരുദ്ധമായി.
ନୈସର୍ଗିକ: സ്വാഭാവികമായ ഭൌതികമായ നൈസര്‍ഗ്ഗികമായ സ്വാഭാവികമായ.
ନ୍ୟାୟ_ବିଷୟକ: ന്യായ_സൂചകമായ.
ନ୍ୟାୟକର୍ତ୍ତା: ന്യായാധിപന്‍ ന്യായി ന്യായമുള്ള വിശ്വസ്ഥതയുള്ള നിഷ്പക്ഷനായ പക്ഷപാതമില്ലാത്ത.
ନ୍ୟାୟକାରୀ: ന്യായാധിപന്‍ ന്യായി ന്യായമുള്ള വിശ്വസ്ഥതയുള്ള നിഷ്പക്ഷനായ പക്ഷപാതമില്ലാത്ത.
ନ୍ୟାୟଚିତ: ന്യായ_പൂറ്ണ്ണമായ ന്യായോചിതമായ.
ନ୍ୟାୟପୂର୍ଣ୍ଣ: ന്യായ_പൂറ്ണ്ണമായ ന്യായോചിതമായ.
ନ୍ୟାୟସଙ୍ଗତ: ന്യായ_പൂറ്ണ്ണമായ ന്യായോചിതമായ.
ନ୍ୟାୟହୀନ: അന്യായപൂര്‍ണ്ണമായ.
ନ୍ୟାୟିକ|: ന്യായ_സൂചകമായ.
ନ୍ୟାୟୀ: ന്യായാധിപന്‍ ന്യായി ന്യായമുള്ള വിശ്വസ്ഥതയുള്ള നിഷ്പക്ഷനായ പക്ഷപാതമില്ലാത്ത.
ନ୍ୟୁଜିଲ୍ୟାଣ୍ଡୀୟ: ന്യൂസിലാന്റിയന് ന്യൂസിലാന്റിയ.
ନ୍ୟୂନ: ചെറിയ.
ନ୍ୟୂନତମ|: ഏറ്റവും_കുറഞ്ഞ.
ନୟନାଭିରାମ: നയനാഭിരാമാ‍മായ നയനരമ്യമായ നേത്രാഭിരമാമായ.
ପଇଁଚାଳିଶତମ: നാല്‍പ്പത്തി_അഞ്ഞ്ചാമത്തെ.
ପଇଠ_|: അടച്ചുതീര്ന്ന.
ପକ୍କା: പ്രാവീണ്യമുള്ള നിപുണതയുള്ള സാമറ്ത്ഥ്യമുള്ള മിടുക്കമുള്ള നൈപുണ്യമുള്ള പ്രായോഗികയോഗ്യതയുള്ള ചാതുര്യമുള്ള കുശലതയുള്ള വിരുതുള്ള വിചക്ഷണതയുള്ള പാടവമുള്ള തഴക്കമുള്ള പ്രാപ്തിയുള്ള. ദ്ര്ഢമായ പാകമായ. ഉറപ്പുള്ള ബലമുള്ള
ପକ୍ଷଧର: പക്ഷം_പിടിക്കുന്നവന്‍ സമര്‍ഥിക്കുന്നവന്‍.വാദിക്കുന്നവന്‍.
ପକ୍ଷପାତରହିତ: താല്പര്യ_മില്ലായ്മ നിഷ്പക്ഷത.
ପକ୍ଷପାତି: പക്ഷം_പിടിക്കുന്നവന്‍ സമര്‍ഥിക്കുന്നവന്‍.വാദിക്കുന്നവന്‍.
ପକ୍ଷହୀନ: ചിറകൊടിഞ്ഞ
ପଙ୍କହୀନ: ചെളിയില്ലാത്ത പങ്കിലമല്ലാത്ത
ପଙ୍କିଳ: വ്രിത്തികെട്ട വ്രിത്തി_ഇല്ലാത്ത. മാലിന്യമുള്‍ള ചേറുള്‍ള.
ପଙ୍କୁଆ: മാലിന്യമുള്‍ള ചേറുള്‍ള. പൊടി_നിറഞ്ഞ മണ്ണു_നിറഞ്ഞ
ପଙ୍ଗୁ: മുടന്തനായ. മുടന്തന്‍ ഞൊണ്ടി അങ്ഗ_വൈകല്യമുള്ള.
ପଚା: ചീഞ്ഞഅഴുകിയ അളിഞ്ഞ ജീര്‍ണ്ണിച്ച കേടുവന്ന വളിച്ച.
ପଛ: കഴിഞ്ഞ താമസിച്ച പിന്നിലത്തെ.
ପଛୁଆ: പിന്നോക്കം_നില്‍ക്കുന്ന. നല്ല_സ്വഭാവമുള്ള.
ପଞ୍ଚକୋଣ: പഞ്ച_കോണം.
ପଞ୍ଚକୋଣୀୟ: പഞ്ച_കോണം.
ପଞ୍ଚତାରକା: പഞ്ച_നക്ഷത്ര.
ପଞ୍ଚଦଶ: പതിനഞ്ചാം പതിനഞ്ചാമത്തെ
ପଞ୍ଚନବତିତମ: തൊണ്ണൂറ്റി_അഞ്ചാമത്തെ.
ପଞ୍ଚପଞ୍ଚାଶତ୍: അന്പത്തി_അഞ്ചാമത്തെ
ପଞ୍ଚବାର୍ଷିକ: പഞ്ച_വത്സര അഞ്ചാം_വറ്ഷം_തോറും_ഉള്ള.
ପଞ୍ଚମ: അഞ്ചാമത്തെ അഞ്ചാം
ପଞ୍ଚଷଷ୍ଟିତମ: അറുപത്തി_അഞ്ചാം
ପଞ୍ଚସପ୍ତତିତମ: അന്പത്തി_അഞ്ചാം
ପଞ୍ଚାଶୀତିତମ: അന്പതാമത്തെ
ପଞ୍ଜାବୀ: പഞ്ചാബി പഞ്ചാപിലെ
ପଞ୍ଜିକରଣ: രജിസ്റ്റര്‍_ചെയ്തത്.
ପଞ୍ଜିକୃତ: രജിസ്റ്റര്‍_ചെയ്തത്.
ପଟୁ: പ്രാവീണ്യമുള്ള നിപുണതയുള്ള സാമറ്ത്ഥ്യമുള്ള മിടുക്കമുള്ള നൈപുണ്യമുള്ള പ്രായോഗികയോഗ്യതയുള്ള ചാതുര്യമുള്ള കുശലതയുള്ള വിരുതുള്ള വിചക്ഷണതയുള്ള പാടവമുള്ള തഴക്കമുള്ള പ്രാപ്തിയുള്ള.
ପଠନରତ: പഠിപ്പില്_ശ്രദ്ധിക്കുന്ന അദ്ധ്യാപനം
ପଠନୀୟ: വായിക്കുവാന്_പറ്റിയ വായനായോഗ്യമായ
ପଠିତ: പഠിപ്പിച്ച
ପଠ୍ୟ: വായിക്കുവാന്_പറ്റിയ വായനായോഗ്യമായ
ପଡିଆ: ക്ര്‌ഷിയില്ലാത്ത ക്ര്‌ഷിപ്പണി_നടക്കാത്ത.
ପଢାଲିଖା: അഭ്യസ്‌തവിദ്യനായ വിദ്യാഭ്യാസമുള്ള
ପଢୁଆ: അഭ്യസ്‌തവിദ്യനായ വിദ്യാഭ്യാസമുള്ള പഠിപ്പില്_ശ്രദ്ധിക്കുന്ന അദ്ധ്യാപനം
ପଣ୍ଡିତ: വിദ്വാന്‍മാരായിട്ടുളള പാണ്ഡിത്യമുള്ള അറിവുള്ള
ପଣ୍ୟ: വില്പ്പനചരക്ക്.
ପତନଶୀଳ: അധോഗതിശീലമുള്ള നശിച്ച്_ശീലമുള്ള.
ପତନୋନ୍ମୁଖ: അധോഗതിശീലമുള്ള നശിച്ച്_ശീലമുള്ള.
ପତଳା: മെലിഞ്ഞ മുറുക്കമില്ലാത്ത അയഞ്ഞ അഴിഞ്ഞ. നേര്‍മയുള്ള
ପତିତ: താഴേക്കു_പോകുന്നവന്‍.
ପତ୍ରଝଡା: ഇലകളില്ലാത്ത.
ପତ୍ରଝରା|: ഇലകളില്ലാത്ത.
ପତ୍ରବହୁଳ: ഇലയുള്ള.
ପତ୍ରବିହୀନ: ഇലകളില്ലാത്ത.
ପତ୍ରଭରା: ഇലയുള്ള.
ପଥଭ୍ରଷ୍ଟ_: വഴി_തെറ്റിയ ലക്ഷ്യമില്ലാതെ_അലയുന്ന അമ്പരമ്മു_പോകുന്ന.
ପଥର_ନିର୍ମିତ: കല്ലു_കൊണ്ടുണ്ടാക്കിയ.
ପଥରହୃଦୟ: കഠിനഹ്രിദയനായ കഠോരഹ്രിദയനായ ദയ_ഇല്ലാത്ത.
ପଥହୁଡା: വഴി_തെറ്റിയ ലക്ഷ്യമില്ലാതെ_അലയുന്ന അമ്പരമ്മു_പോകുന്ന.
ପଥୁରିଆ|: കല്ലു_നിറഞ്ഞ.
ପଦଚାରୀ: കാല്നടയായി.
ପଦଚ୍ୟୁତ: ജോലിയില്‍_നിന്നു_മാറ്റി_നിര്‍ത്തിയ.
ପଦଦଳିତ: ചവിട്ടിമെതിക്കപ്പെട്ട. ചവിട്ടി_അരച്ച.
ପଦସ୍ଥ: നിയമിതനായ
ପଦାତିକ: കാല്നടയായി.
ପଦୋନ୍ନତି: അഭിവ്ര്ദ്ധിപ്രദമായ ഐശ്വര്യപ്രദമായ സംര്‌ദ്ധിപ്രദമായ.
ପବିତ୍ର: നിര്‍മ്മലമായ വിമലമായ പവിത്രമായ് ശുദ്ധമായ പൂജിച്ച നിവേദിച്ച.
ପରଜାତୀୟ: വിഭിന്ന_ജാതിയിപ്പെട്ട.
ପରଦେଶୀ: വിദേശി അന്യദേശക്കാരന്‍ വൈദേശികന്‍ അന്യന്‍ അന്യദിക്കുകാരന്‍ കുടിയേറ്രക്കാരന്‍.
ପରବର୍ତୀ_: വരാന്_പോകുന്ന ഭാവിയിലുള്ള വരാനിരിക്കുന്ന.
ପରମ୍ପରାଗତ: പരമ്പരാസിദ്ധമായ.
ପରମ୍ପରାବାଦୀ: പാരമ്പര്യമായിട്ടുള്ള.
ପରର: മറ്രുള്ളവരുടെ അന്യരുടെ അന്യമായ വേറെ_ആയ വൈദേശികമായ വിദേശിയായ തറ്റേതല്ലാത്ത പുറമേയുള്ള മറ്രൊന്നായ മറ്രേതായ ഇതരമായ സ്വന്തമല്ലാത്ത അപര.
ପରଲୋକଗତ: മരിച്ച അന്തരിച്ച സമാധിയായ മഹാനിദ്രയിലായ നിര്യാതനായ
ପରଲୋକବାସୀ: മരിച്ച അന്തരിച്ച സമാധിയായ മഹാനിദ്രയിലായ നിര്യാതനായ
ପରହିତୈଷୀ: പരോപകാരി അന്യനു_നന്മ_ചെയ്യുന്നയാള്‍ അന്യനു_ഉപകാരം_ചെയ്യുന്നവന്‍ ഔദാര്യം_ചെയ്യുന്നയാള്‍ മഹാമനസ്ക്കനായ_ആള്‍.
ପରାକ୍ରମୀ: വീരന്‍ ധൈര്യശാലി നിര്‍ഭയന്‍
ପରାଜିତ: പരാജിതനായ.
ପରାଧୀନ: സ്വാതന്ത്ര്യമില്ലാത്ത അടിമയായ.
ପରାବଲମ୍ବିନୀ: പരാവലംബിനി പരാശ്രയതോടെ_ജീവിക്കുന്നവള്‍.
ପରାବଲମ୍ବୀ: പരാശ്രയി.
ପରାଶ୍ରିତ: പരാശ്രയി.
ପରାଶ୍ରୟୀ: പരാശ്രയി.
ପରାସ୍ତ: പരാജിതനായ.
ପରିକଳ୍ପିତ: യോജിച്ച അനുയോജ്യമായ ചേറ്ന്ന യുക്തമായ പൊരുത്തമുള്ള ഉചിതമായ ഹിതകരമായ ഇണങ്ങിയ അനുസ്ര്തമായ അനുഗുണമായ.
ପରିଚିତ: പരിചയമുള്ള.
ପରିଜ୍ଞାତ: പേരു_കേട്ട.
ପରିଣତ: മാറ്റം_വരുത്തിയ മാറിയ.
ପରିଣୀତ: വിവാഹിതന്‍ കല്യാണം_കഴിഞ്ഞവന്‍.
ପରିତୁଷ୍ଟ: ത്ര്പ്തനായ്.
ପରିତୃପ୍ତ: പൂര്‍ണ്ണമായും_ത്രിപ്തമായ.
ପରିତ୍ୟଜ୍ୟ: ഉപേക്ഷിക്കപ്പെടേണ്ടതായ ഉപേക്ഷിക്കത്തക്ക ചീത്തയായ വര്‍ജ്ജിക്കത്തക്കതായ.
ପରିପୂରିତ_: പരിപൂര്ണ്ണന്.
ପରିପୂର୍ଣ୍ଣ: പരിപൂര്ണ്ണന്.
ପରିବର୍ତିତ: മാറ്റം_വരുത്തിയ മാറിയ.
ପରିବର୍ତ୍ତନଶୀଳ: മാറുന്ന.
ପରିବର୍ତ୍ତନୀୟ: മാറുന്ന.
ପରିବର୍ଦ୍ଧିତ: കൂട്ടിചേര്‍ത്ത കൂട്ടിചേര്‍ത്ത
ପରିବହନକାରୀ: സാധനങ്ങ്ള്‍_കൊണ്ട്പോകുന്ന.
ପରିବାରହୀନ: കുടുംബം_ഇല്ലാത്ത.
ପରିବାହୀ: പ്രവാഹകന്‍.
ପରିବେଶ_ସମ୍ବନ୍ଧିତ: പരിസ്ഥിതി_സംബന്ധമായ പാരിസ്ഥിതികമായ.
ପରିବ୍ୟାପକ: പരന്ന വ്യാപിച്ചിരിക്കുന്ന.
ପରିବ୍ୟାପ୍ତ: പരന്ന വ്യാപിച്ചിരിക്കുന്ന.
ପରିମାର୍ଜିତ: പരിഷ്ക്കരിച്ച ശുദ്ധീകരിച്ച സ്ഫുടം_ചെയ്ത.
ପରିଶୁଦ୍ଧ: ശുദ്ധമാക്കിയ.
ପରିଶୋଧିତ: ശുദ്ധമാക്കിയ. പൂറ്ത്തിയാക്കപെട്ട തീറ്ന്ന അനുഭവിക്കപ്പെട്ട.
ପରିଶ୍ରମୀ: ജോലിത്തിരക്കുള്ള ഉദ്യോഗമുള്ള പരിശ്രമിയായ കര്‍മ്മനിരതയായ വ്യവസായ_നിരതയായ തൊഴില്‍_നിരതയായ. പരിശ്രമിക്കുക പ്രയത്നിക്കുക അധ്വാനിക്കുക കഠിനയത്നം_ചെയ്യുക
ପରିଶ୍ରାନ୍ତ: ക്ഷീണിച്ച.
ପରିଷ୍କୃତ: പരിഷ്ക്കരിച്ച ശുദ്ധീകരിച്ച സ്ഫുടം_ചെയ്ത.
ପରିସୀମିତ: അതിരുള്ള.
ପରିସ୍ଫୁଟ_: പൂക്കുന്ന പുഷ്പ്പിക്കുന്ന.
ପରିହାସପୂର୍ଣ୍ଣ: പരിഹാസത്തിനു_അര്‍ഹനായ നിന്ദായോഗ്യമായ.
ପରୀକ୍ଷିତ: പരീക്ഷിക്കപ്പെട്ട
ପରୋପକାରୀ: പരോപകാരി അന്യനു_നന്മ_ചെയ്യുന്നയാള്‍ അന്യനു_ഉപകാരം_ചെയ്യുന്നവന്‍ ഔദാര്യം_ചെയ്യുന്നയാള്‍ മഹാമനസ്ക്കനായ_ആള്‍.
ପର୍ଦ୍ଦାହୀନ: മുഖപടം മുഖാവരണം മൂടുപടം.
ପର୍ବତୀୟ: പര്‍വ്തപ്രദേശം.
ପର୍ଯୁସିତ: പഴകിയ
ପର୍ଯ୍ୟଟନପ୍ରିୟ: അലഞ്ഞു_തിരിയുന്ന.
ପର୍ଯ୍ୟାପ୍ତ: തികയുന്നത്.
ପର୍ଯ୍ୟାବରଣ_ସମ୍ବନ୍ଧିତ: പരിസ്ഥിതി_സംബന്ധമായ പാരിസ്ഥിതികമായ.
ପର୍ସିୟାନ: ഇറാനി പേര്‍ശ്യന്‍ ഇറാനിന്റെ
ପଳାତକ: സൈന്യം_ഉപേക്ഷിച്ച.
ପଳାୟନକାରୀ: നാടുവിട്ട
ପଳାୟନଶୀଳ: അഭയാര്‍ത്ഥിയായി_ഓടിപോകുന്നവന്‍ ഭീരു.
ପଳାୟମାନ: ഓടിപ്പോയ പിടി_കൊടുക്കാതെരക്ഷപ്പെട്ട്_ഒളിച്ചു_നടക്കുന്ന.
ପଳାୟିତ: ഓടിപ്പോയ പിടി_കൊടുക്കാതെരക്ഷപ്പെട്ട്_ഒളിച്ചു_നടക്കുന്ന.
ପଶମ: കമ്പിളി.
ପଶ୍ଚଗାମୀ: പിന്തിരിപ്പന്‍.
ପଶ୍ଚଦେଶ: കഴിഞ്ഞ താമസിച്ച പിന്നിലത്തെ.
ପଶ୍ଚାତଗାମୀ: വഴുതി_മാറിയ
ପଶ୍ଚାତାପୀ: പശ്ചാത്തപിക്കുന്നവന്‍
ପଶ୍ଚାତ୍ଭାଗ: കഴിഞ്ഞ താമസിച്ച പിന്നിലത്തെ.
ପସନ୍ଦିଆ: മനസ്സിനിണങ്ങിയ പ്രിയപെട്ട ഇഷ്ടപെട്ട
ପାଇବାଲୋକ: ലഭിക്കുന്നവന്‍.
ପାକଲା: പഴുത്ത പാകംവന്ന
ପାଗଳ: വീതി
ପାଚିଲା: പഴുത്ത പാകംവന്ന പഴുത്ത്_ചീഞ്ഞ.
ପାଚେଲା: പഴുത്ത പാകംവന്ന
ପାଜି: ദുഷ്ട ദുഷിച്ച ചീത്ത നീച
ପାଞ୍ଚ: അഞ്ച് 5
ପାଞ୍ଚ_ପା: ഒന്നേകാല്‍
ପାଠ୍ୟ: വായിക്കുവാന്_പറ്റിയ വായനായോഗ്യമായ
ପାଣିଆ: മുറുക്കമില്ലാത്ത അയഞ്ഞ അഴിഞ്ഞ.
ପାଣ୍ଡିତ୍ୟପୂର୍ଣ୍ଣ: പാണ്ഡിത്യമുള്ള.
ପାତଳ: മെലിഞ്ഞ
ପାଦଚଲା: നടക്കാന്തുടങ്ങിയ
ପାଦଚାରୀ|: കാല്നടയായി.
ପାଦଦଳିତ: ചവിട്ടി_അരച്ച.
ପାଦରହିତ: പാദമില്ലാത്ത.
ପାଦହୀନ: പാദങ്ങളില്ലാത്ത പാദമില്ലാത്ത.
ପାନୀୟ: കുടിക്കുവാനുള്ള.
ପାପବୁଦ୍ଧି|: ദുഷ്ട്ടാത്മാവു.
ପାପିଷ୍ଠ: മഹാപാപി.
ପାବନ: പൂജിച്ച നിവേദിച്ച.
ପାମର: അവിവേകിയായ ജളനായ ഭോഷനായ മൂഢനായ മന്ദതയുള്ള ജളത്വമുള്ള
ପାରମ୍ପରିକ: പരമ്പരാസിദ്ധമായ.
ପାରାଗୁଏନ୍: പരാഗ്വേയിലെ.
ପାରିତ: പാസ്സാകുക.
ପାରିବାରିକ: കുടുംബപരമായ
ପାର୍ବତୀୟ: പര്‍വതത്തിലുള്ള പര്‍വതത്തില്‍_വസിക്കുന്ന.
ପାଲିସ: മിനുസം മാര്‍ദ്ദവം മിനുമിനുപ്പ്
ପାଳିତ: വളര്‍ത്തപ്പെടുന്ന
ପାଳିତପୋଷିତ: പോഷിപ്പിക്കപ്പെട്ട വളര്‍ത്തപ്പെട്ട.
ପାଷାଣ_ନିର୍ମିତ: കല്ലു_കൊണ്ടുണ്ടാക്കിയ.
ପାଷାଣହୃଦୟ: കഠിനഹ്രിദയനായ കഠോരഹ്രിദയനായ ദയ_ഇല്ലാത്ത.
ପାଷାଣ୍ଡ: കപടമായ.
ପାସ: വിജയിച്ച ജയിച്ച്ച സഫലമായ.
ପାସ|: പാസ്സാകുക.
ପାହାଡି: പര്‍വതത്തിലുള്ള പര്‍വതത്തില്‍_വസിക്കുന്ന.
ପାହାଡୀ: പര്‍വ്തപ്രദേശം.
ପିଙ୍ଗଳା: അടുത്തുള്ള.
ପିଙ୍ଗଳା_ନାଡି: അടുത്തുള്ള.
ପିଚ୍ଛିଳ: വഴുക്കലുള്ള.
ପିଠି_ବୁଦ୍ଧି_: മലര്‍ന്നു_കിടക്കുക.
ପିଣ୍ଡଜ|: ഗര്‍ഭത്തില്‍_നിന്നു_ജനിക്കുന്നത്.
ପିତା: കൈപ്പേറിയ ചവര്‍പ്പുള്ള
ପିତାହୀନ: പിതാവില്ലാത്ത താതന്‍_ഇല്ലാത്ത.
ପିତୃବିହୀନ: പിതാവില്ലാത്ത താതന്‍_ഇല്ലാത്ത.
ପିତୃହୀନ: പിതാവില്ലാത്ത താതന്‍_ഇല്ലാത്ത.
ପିତ୍ତ: കൈപ്പേറിയ ചവര്‍പ്പുള്ള
ପିତ୍ତଜନିତ: പിത്ത_സംബന്ധി_ആയ.
ପିତ୍ତଳ|: പിച്ചള_കൊണ്ടുള്ള.
ପିପାସିତ: ദാഹമുള്ള തൊണ്ടവരള്‍ച്ചയുള്ള
ପିପାସୁ: ദാഹമുള്ള തൊണ്ടവരള്‍ച്ചയുള്ള
ପିଲାଳିଆ: കുട്ടികളുടെ_പോലുള്ള.
ପିୟମ୍ବଦ_: ഇഷ്ട്ടം_സംസാരിക്കുന്ന പ്രിയം_വദമായി_സംസാരിക്കുന്ന.
ପୀଡାଦାୟକ|: ദു
ପୀଡିତ: പീടിപ്പിക്കപ്പെട്ട. ദു
ପୀତ: മഞ്ഞയായ പാണ്‌ഡുരമായ പീതവറ്‍ണ്ണമായ പിംഗലവര്‍ണ്ണമായ
ପୁଣ୍ୟ_: പൂജിച്ച നിവേദിച്ച.
ପୁନରୁକ୍ତ: ആവര്‍ത്തനം വീണ്ടുമുള്‍ള_പറച്ചില്‍.
ପୁନର୍ନିଯୁକ୍ତି: പഴയസ്ഥിതിയില്‍_ത്തന്നെ
ପୁରଦିଆ: നിറച്ച.
ପୁରସ୍କାରଘୋଷିତ: സമ്മാന സമ്മാനത്തിന്റെ സമ്മാനത്തിന്റേതായ.
ପୁରାତନ: പഴയ പുരാതനമായ.
ପୁରୁଣା: പഴയ പുരാതനമായ. പുരാതനം പണ്ടേയുള്ള പൂര്‍വ്വ_കാലത്തെ
ପୁରୁଣା|: കഴിഞ്ഞുപോയ.
ପୁରୋଗାମୀ: മുന്പേ_നടക്കുന്ന മുന്പനായ ശ്രേഷ്ഠനായ. പുരോഗമന_വാദി.
ପୁରୋଗାମୀ|: മുന്നേറുന്ന പുരോഗമനോന്മുഖമായ.
ପୁର୍ତ୍ତଗାଲୀୟ: പോര്‍ത്തുഗലിന്റെ. പോര്‍തുഗലിന്റെ.
ପୁଲକିତ: ആനന്ദം_നിറഞ്ഞ സന്തോഷം_പ്രകടിപ്പിക്കുന്ന.
ପୁଷ୍ଟ_: പോഷിപ്പിക്കപ്പെട്ട വളര്‍ത്തപ്പെട്ട.
ପୁଷ୍ଟିକର: പുഷ്ടികരമായ
ପୁଷ୍ଟିକାରକ: പുഷ്ടികരമായ
ପୁଷ୍ଟିପ୍ରଦ: പുഷ്ടികരമായ
ପୁଷ୍ପବନ୍ତ: പൂക്കളുള്ള പൂവുകളുള്ള.
ପୁଷ୍ପଯୁକ୍ତ: വിടര്‍ന്ന വികസിച്ച.
ପୁଷ୍ପରହିତ: പുഷ്പങളില്ലാത്ത പൂക്കാത്ത പൂക്കലില്ലാത്ത പുഷ്പ്പിക്കാത്ത.
ପୁଷ୍ପହୀନ: പുഷ്പങളില്ലാത്ത പൂക്കാത്ത പൂക്കലില്ലാത്ത പുഷ്പ്പിക്കാത്ത.
ପୁଷ୍ପିତ: വിടര്‍ന്ന വികസിച്ച. പൂക്കുന്ന പുഷ്പ്പിക്കുന്ന.
ପୁସ୍ତକୀୟ: പുസ്തകത്തിലെ.
ପୂଜେଇଥିବା: പഴുത്ത്_ചീഞ്ഞ.
ପୂତିଗନ୍ଧମୟ: ദുര്‍ഗന്ധപൂര്‍ണ്ണമായ.
ପୂରା: ദ്ര്ഢമായ പാകമായ. ആകെ മുഴുവനും ഒട്ടാകെ ആകപ്പാടെ പൂര്‍ണ്ണമായ
ପୂରିଲା: ആകാരവടിവുള്ള.
ପୂରିଲାପୂରିଲା: ആകാരവടിവുള്ള.
ପୂର୍ଣ୍ଣ: അവസാനിക്കുക. പരിപൂര്ണ്ണന്. നിറഞ്ഞു_കവിഞ്ഞ
ପୂର୍ଣ୍ଣାୟୁ: പൂര്‍ണ്ണ്_ആയുസ്സുള്ള.
ପୂର୍ବ: ആദ്യത്തെ. കഴിഞ്ഞുപോയ.
ପୂର୍ବ_ପରିଚିତ: അറിയാവുന്ന.
ପୂର୍ବକଥିତ: മുന്‍പ്_ഉച്ചരിച്ച
ପୂର୍ବକାଳର: പഴയ പുരാതനമായ. പുരാതനം പണ്ടേയുള്ള പൂര്‍വ്വ_കാലത്തെ
ପୂର୍ବକାଳର|: പശ്ഴയ_കാലത്തെ.
ପୂର୍ବକାଳୀନ: പഴയ പുരാതനമായ. പുരാതനം പണ്ടേയുള്ള പൂര്‍വ്വ_കാലത്തെ
ପୂର୍ବଦିନର: പുരാതനം പണ്ടേയുള്ള പൂര്‍വ്വ_കാലത്തെ
ପୂର୍ବପ୍ରସ୍ତୁତ: റെഡീമേഡ്.
ପୂର୍ବୋକ୍ତ: മേല്പറഞ്ഞ മുമ്പേ_പറയപ്പെട്ട മുന്‍പ്_ഉച്ചരിച്ച
ପୃଥକ: വ്യത്യസ്ഥമായ ഭിന്നമായ
ପୃଥକଚର: വേറിട്ട.
ପୃଥକଯୋଗ୍ୟ: വേറെ_ആക്കാവുന്നത് കഷ്ണമാക്കാവുന്നത്.
ପୃଥିବୀବ୍ୟାପୀ: ലോകം_മുഴുവനും
ପୃଥିବୀସାରା: ലോകം_മുഴുവനും
ପୃଷ୍ଠାଙ୍କିତ: ഒപ്പിട്ടത്
ପେଟ: വിരക്ത്തിയുള്ള_.
ପେଟଭରି: വയറ്_നിറയേ.
ପେଟୁ: അധികം_ഭക്ഷിക്കുന്ന വേഗം_വേഗം_ഭക്ഷിക്കുന്ന ഭക്ഷണപ്രിയനായ വയറനായ കൊതിയനായ.
ପେଟେଇଚାଲିବା: ഇഴയുന്ന പതുക്കെ_നടക്കുന്ന.
ପେଣ୍ଟ୍_କରାଯାଇଥିବା: നിറം_കൊടുത്ത.
ପୈତୃକ|: പിന്തുടര്‍ച്ചയായി_ലഭിച്ച.
ପୋଖରୀଆ: ചളി.
ପୋଡା: കത്തി_ദഹിച്ച.
ପୋଲା: പൊള്ളയായ ശൂന്യമായ
ପୋଲାଣ୍ଡିୟ: പോളണ്ടിനെ_സംബന്ധിക്കുന്നത്.
ପୋଲିଶ: പോളിഷ്
ପୋଷକ: വര്ദ്ധിപ്പിക്കുന്ന.
ପୌଷ୍ଟିକ: പുഷ്ടികരമായ
ପ୍ରକଟିତ: വ്യക്തമാക്കപ്പെട്ട സ്പഷ്ട്ടമായ.
ପ୍ରକାଶ_ଯୋଗ୍ୟ_: രഹസ്യസ്വഭാവമല്ലാത്ത രഹസ്യമല്ലാത്ത.
ପ୍ରକାଶ୍ୟ: രഹസ്യസ്വഭാവമല്ലാത്ത രഹസ്യമല്ലാത്ത.
ପ୍ରକୃତ: വാസ്തവികമായ യദാര്ഥമായ.
ପ୍ରକୃଷ୍ଟ_: ഉത്തമമായ.
ପ୍ରକ୍ଷେପିତ: വിക്ഷേപിച്ച
ପ୍ରଖର: സൂക്ഷ്മ_ഗ്രാഹിത്വം.
ପ୍ରଖ୍ୟାତ: പ്രസിദ്ധയായ കേള്‍വിപ്പെട്ട പേരുകേട്ട യശസ്വിയായ പ്രഖ്യാതമായ അറിയപ്പെട്ട വിഖ്യാതിയായ
ପ୍ରଗତ: പുരോഗതിയുള്ള ഉയര്‍ച്ചയുള്ള ഉന്നതിയുള്ള.
ପ୍ରଗତିକର୍ତ୍ତା: പുരോഗമന_വാദി.
ପ୍ରଗତିଶୀଳ: മുന്നേറുന്ന.
ପ୍ରଗତୀଶୀଳ: പുരോഗമന_വാദി.
ପ୍ରଗଳ୍ଭ: വചാലന്‍ അതി_ഭാഷി.
ପ୍ରଗାଢ: അടുത്ത.
ପ୍ରଚଣ୍ଡ: പ്രബലമായി. ഭയാനകമായ ഭീകരമായ ഉഗ്രമായ ഞെട്ടിക്കുന്ന ഭീതിജനകമായ ഭയാവഹമായ രുദ്രമായ
ପ୍ରଚାରିତ: പ്രചരിക്കപ്പെട്ട പ്രചരിച്ച വ്യാപിച്ച പ്രസിദ്ദമാക്കിയ പരസ്യമാക്കിയ കൊട്ടിഘോഷിച്ച വിളംബരം_ചെയ്ത അവഘോഷിച്ച.
ପ୍ରଚୁର: വളരേയധികം.
ପ୍ରଚ୍ଛନ୍ନ: മറയ്ക്കപ്പെട്ട് ഒളിയ്ക്കപ്പെട്ട്.
ପ୍ରଜ୍ଞାବାନ୍: കുശാഗ്രബുദ്ധിമാനായ.
ପ୍ରତାରକ: വിശ്വാസവഞ്ചന_ചെയ്യുന്ന.
ପ୍ରତିକୂଳ: വിപരീതമായ പ്രതികൂലമായ.
ପ୍ରତିକୂଳ|: വിപരീതം.
ପ୍ରତିଗାମୀ: പിന്തിരിപ്പന്‍.
ପ୍ରତିପକ୍ଷ: പ്രതിപക്ഷത്തിലുള്ള എതിറ്പക്ഷത്തിലുള്ള.
ପ୍ରତିପକ୍ଷୀୟ: പ്രതിപക്ഷത്തിലുള്ള എതിറ്പക്ഷത്തിലുള്ള.
ପ୍ରତିପାଦନ_ଯୋଗ୍ୟ: പ്രതിപാതിച്ചിട്ടുള്ളത്
ପ୍ରତିପାଦନୀୟ: പ്രതിപാതിച്ചിട്ടുള്ളത്
ପ୍ରତିପାଦିତ: പ്രതിപാദിച്ചിട്ടുള്ള വിവരിച്ചിട്ടുള്ള പ്രസ്താവിച്ചിട്ടുള്ള സ്ഥാപിച്ചിട്ടുള്ള വിസ്തരിച്ചിട്ടുള്ള വിശകലനം_ചെയ്തിട്ടുള്ള.
ପ୍ରତିପାଦ୍ୟ: പ്രതിപാതിച്ചിട്ടുള്ളത്
ପ୍ରତିଭାବାନ: പ്രതിഭാശാലി കഴിവുള്ള ബുദ്ധിയുള്ള.
ପ୍ରତିଭାବିହୀନ: കഴിവില്ലായ്മ ബുദ്ധിയില്ലായ്മ.
ପ୍ରତିଭାଶାଳୀ: പ്രതിഭാശാലി കഴിവുള്ള ബുദ്ധിയുള്ള.
ପ୍ରତିଭାସମ୍ପନ୍ନ: പ്രതിഭാശാലി കഴിവുള്ള ബുദ്ധിയുള്ള.
ପ୍ରତିଭାହୀନ: കഴിവില്ലായ്മ ബുദ്ധിയില്ലായ്മ.
ପ୍ରତିରୂପ: ത്ത്സ്വരൂപമായ പ്ര്തിരൂപമായ പകറ്പ്പായ സാദ്ര്ശ്മായ പ്തിച്ഛായയുള്ള്.‌ തനിപ്പകര്‍പ്പ്.
ପ୍ରତିରୋପିତ: മാറ്റി_വച്ച പറിച്ചു_നടപ്പെട്ട ഇടം_മാറ്റിയ.
ପ୍ରତିଶୋଧ_ପରାୟଣ: പ്രതികാരം_ചെയ്യുന്ന.
ପ୍ରତିଶୋଧହୀନ: പ്രതികാരം_ചെയ്യാത്ത.
ପ୍ରତିଶ୍ରୁତିବଦ୍ଧ: വാക്ക്_കൊടുത്തിട്ടുള്ള
ପ୍ରତିଷ୍ଠାହୀନ: അപമാനിക്കപ്പെട്ട അനാദരിക്കപ്പെട്ട.
ପ୍ରତିଷ୍ଠିତ: ബഹുമാനിക്കപ്പെട്ട ആദരിക്കപ്പെട്ട.
ପ୍ରତିସ୍ବାକ୍ଷରିତ: തെളിയിക്കപ്പെട്ട വ്യക്തമാക്കപ്പെട്ട പ്രകാശിപ്പിച്ച.
ପ୍ରତୀକ୍ଷିତ: അപേക്ഷിക്കുന്നവന് പ്രതീക്ഷിച്ച കാത്തിരിന്ന. പ്രതീക്ഷിച്ചിരിന്ന കാത്തിരിന്ന
ପ୍ରତ୍ୟକ୍ଷଦର୍ଶୀ: ദ്രിക്സാക്ഷി.
ପ୍ରତ୍ୟାଶିତ: പ്രതീക്ഷയുള്ള ആശയുള്ള. അപേക്ഷിക്കുന്നവന്
ପ୍ରତ୍ୟାଶୀ: അപേക്ഷിക്കുന്നവന്
ପ୍ରଥମ: പ്രഥമ ഒന്നാമത്തെ ആദ്യത്തെ
ପ୍ରଥମୋକ୍ତ: മേല്പറഞ്ഞ മുമ്പേ_പറയപ്പെട്ട
ପ୍ରଦର୍ଶନୀୟ: പ്രദറ്ശനീയമായ പ്രദറ്ശിപ്പിക്കാന്‍_യോഗ്യ്മാ‍യ പരസ്യപ്പെടുത്താന്‍_യോഗ്യ്മായ.
ପ୍ରଦୀପ୍ତ: തേജസ്സാര്ന്ന തിളങുന്ന.
ପ୍ରଦୂଷିତ|: മലിനീകരിച്ചത്.
ପ୍ରଧାନ: പ്രമുഖന്‍. പ്രാഥ്മികമായ മുഖയമായ പ്രധാനമായ പ്രധാന മുഖ്യ.
ପ୍ରଫୁଲ୍ଲ: ആനന്ദം_നിറഞ്ഞ സന്തോഷം_പ്രകടിപ്പിക്കുന്ന.
ପ୍ରଫୁଲ୍ଲିତ: ആനന്ദം_നിറഞ്ഞ സന്തോഷം_പ്രകടിപ്പിക്കുന്ന.
ପ୍ରବନ୍ଧିତ: ക്രമപ്പെടുത്തപ്പെട്ട നിശ്ച്ചിതമായ വ്യവസ്ഥപ്പെടുത്തിയ.
ପ୍ରବଳ: പ്രബലമായി.
ପ୍ରବାସୀ: കുടിയേറി_പാര്ക്കുന്നവന്.
ପ୍ରବାହମାନ: ഒഴുക്ന്ന ഒഴുക്കിന്റെ_ഗതി തുടര്‍ച്ചയായ_ഗതി ശക്തിയേറിയ_പാച്ചില്‍ നീരൊഴുക്കു് തുടര്‍ച്ചയായ_ഗതി നിരന്തരമായി_പ്രവഹിക്കുന്ന.
ପ୍ରବାହଶୀଳ: ഒഴുക്ന്ന ഒഴുക്കിന്റെ_ഗതി തുടര്‍ച്ചയായ_ഗതി ശക്തിയേറിയ_പാച്ചില്‍ നീരൊഴുക്കു് തുടര്‍ച്ചയായ_ഗതി നിരന്തരമായി_പ്രവഹിക്കുന്ന.
ପ୍ରବାହହୀନ: പ്രവഹിക്കാത്ത ശാന്ത_മായ നില്‍ക്കുന്ന സ്ഥിരമായ ഗതിഹീനമായ.
ପ୍ରବାହିତ: ഒഴുക്ന്ന ഒഴുക്കിന്റെ_ഗതി തുടര്‍ച്ചയായ_ഗതി ശക്തിയേറിയ_പാച്ചില്‍ നീരൊഴുക്കു് തുടര്‍ച്ചയായ_ഗതി നിരന്തരമായി_പ്രവഹിക്കുന്ന.
ପ୍ରବିଣ: പ്രാവീണ്യമുള്ള നിപുണതയുള്ള സാമറ്ത്ഥ്യമുള്ള മിടുക്കമുള്ള നൈപുണ്യമുള്ള പ്രായോഗികയോഗ്യതയുള്ള ചാതുര്യമുള്ള കുശലതയുള്ള വിരുതുള്ള വിചക്ഷണതയുള്ള പാടവമുള്ള തഴക്കമുള്ള പ്രാപ്തിയുള്ള.
ପ୍ରବିଷ୍ଟ: പ്രവേശിച്ച ഏര്പ്പെട്ട.
ପ୍ରବେଶ: പ്രവേശനം കടക്കല്‍.
ପ୍ରବେଶନୀୟ: പ്രവേശനം കടക്കല്‍.
ପ୍ରବେଶ୍ୟ: പ്രവേശനം കടക്കല്‍.
ପ୍ରଭାବଶାଳୀ: സ്വാധീനശ്ക്തിയുള്ള. സാമറ്ത്ഥ്യമുള്ള കീഴടക്കുന്ന നിപുണതയുള്ള വൈദഗദ്ധ്യമുള്ള പ്രാപ്തിയുള്ള യോഗ്യതയുള്ള പ്രവറ്ത്തനക്ഷമമായ ചാതുര്യമുള്ള.
ପ୍ରଭାବଶୂନ୍ୟ: അസമറ്ത്ഥനായ നിഷ്ഫലനായ അപ്രാപ്ത്നായ.
ପ୍ରଭାବହୀନ: അസമറ്ത്ഥനായ നിഷ്ഫലനായ അപ്രാപ്ത്നായ. നിഷ്ഫലമായ ഫലശ്യൂന്യമായ നിഷ്പ്രയോജനമായ വ്യ്ര്ത്ഥ്മായ.
ପ୍ରଭୂତ: ആഴമേറിയ.
ପ୍ରମାଣବିହୀନ: തെളിയിക്കപ്പെടാത്ത.
ପ୍ରମାଣରହିତ: തെളിയിക്കപ്പെടത്ത.
ପ୍ରମାଣଶୂନ୍ୟ: തെളിയിക്കപ്പെടത്ത. തെളിയിക്കപ്പെടാത്ത.
ପ୍ରମୁଖ: പ്രമുഖന്‍. പ്രാഥ്മികമായ മുഖയമായ പ്രധാനമായ
ପ୍ରମୋଦିତ: ആനന്ദം_നിറഞ്ഞ സന്തോഷം_പ്രകടിപ്പിക്കുന്ന.
ପ୍ରଯତ୍ନବାନ: തത്പരമായ ആഭിമുഖ്യമുള്ള പ്രതിപത്തിയുള്ള ശുഷ്കാന്തിയുള്ള വാഞ്ജയുള്ള താല്‍പര്യമുള്ള ഉത്സാഹമുള്ള സന്നദ്ധതയുള്ള
ପ୍ରଯତ୍ନଶୀଳ_: പരിശ്രമിക്കുന്ന പ്രയത്നിക്കുന്ന.
ପ୍ରଯତ୍ନହୀନ|: പ്രയത്നശീലമില്ലാത്ത പ്രയത്നിക്കാത്ത സംയമനമില്ലാത്ത അലസനായ മടിയനായ.
ପ୍ରଳାପୀ: വ്യര്ഥ_ഭാഷണം_ചെയ്യുന്ന.
ପ୍ରଶଂସକ|: പ്രശംസകന്.
ପ୍ରଶଂସନୀୟ: പ്രശംസനീയം
ପ୍ରଶଂସିତ: പ്രശംസിക്കപ്പെട്ട
ପ୍ରଶଂସ୍ୟ: പ്രശംസനീയം
ପ୍ରଶମକ: വേദന_ഇല്ലാതാക്കുന്ന ശമിപ്പിക്കുന്ന.
ପ୍ରଶମିତ_କାରୀ: വേദന_ഇല്ലാതാക്കുന്ന ശമിപ്പിക്കുന്ന.
ପ୍ରଶାନ୍ତ: ശാന്തമായ നിശ്ചേഷ്ട്ടമായ അടക്കമുള്ള. വളരേ_ശാന്തമായ_മനസ്സുള്ള.
ପ୍ରଶାସନିକ: അച്ചടക്ക_സംബന്ധിയായ നിഷ്കര്‍ഷണ_സംബന്ധിയായ അനുനയ_സംബന്ധിയായ.
ପ୍ରଶିକ୍ଷିତ: ശിക്ഷണം_ചെയ്യപ്പെട്ട.
ପ୍ରଶ୍ନକର୍ତ୍ତା: ചോദ്യം_ചെയ്യുന്ന ഉത്തരം_അന്വേഷിക്കുന്ന.
ପ୍ରଶ୍ନାତ୍ମକ: ചോദ്യത്തിന്റെ ചോദ്യത്തിന്റെ_ധ്വനിയുള്ള.
ପ୍ରଶ୍ନାର୍ଥକ: ചോദ്യത്തിന്റെ ചോദ്യത്തിന്റെ_ധ്വനിയുള്ള.
ପ୍ରସଙ୍ଗହୀନ|: സാന്ദര്ഭികമല്ലാത്ത അപ്രസക്തമായ.
ପ୍ରସନ୍ନ: ആനന്ദം_നിറഞ്ഞ സന്തോഷം_പ്രകടിപ്പിക്കുന്ന.
ପ୍ରସନ୍ନଚିତ୍ତ: വിനോദപ്രിയനായ ആനന്ദം_പൂണ്ടവന്‍
ପ୍ରସନ୍ନମନା: വിനോദപ്രിയനായ ആനന്ദം_പൂണ്ടവന്‍
ପ୍ରସନ୍ନମୁଖ|: ചിരിച്ച_മുഖം.
ପ୍ରସିଦ୍ଧ: പ്രസിദ്ധയായ കേള്‍വിപ്പെട്ട പേരുകേട്ട യശസ്വിയായ പ്രഖ്യാതമായ അറിയപ്പെട്ട വിഖ്യാതിയായ
ପ୍ରସୁତ: ഉല്പന്ന് ഉണ്ടായ ജനിച്ച.ഉത്ഭവിച്ച രൂപപ്പെട്ട ഉല്പാദിപ്പിച്ച. ഉത്പാദിപ്പിക്കുന്ന ഉത്ഭവിക്കുന്ന ഔല്പാദികമായ ഉല്പാദിക്കപ്പെട്ട് ഉല്പാദിത ഉല്പാദിപ്പിക്കപ്പെട്ട ഉല്പാദ്യ് സ്ര്‌ഷ്ടിപരമായ നിറ്മ്മാണാത്മകമായ രചനാത്മകമായ.
ପ୍ରସ୍ତୁତ: തത്പരമായ ആഭിമുഖ്യമുള്ള പ്രതിപത്തിയുള്ള ശുഷ്കാന്തിയുള്ള വാഞ്ജയുള്ള താല്‍പര്യമുള്ള ഉത്സാഹമുള്ള സന്നദ്ധതയുള്ള
ପ୍ରାକୃତ: സ്വാഭാവികമായ.
ପ୍ରାକୃତିକ: സ്വാഭാവികമായ ഭൌതികമായ നൈസര്‍ഗ്ഗികമായ സ്വാഭാവികമായ.
ପ୍ରାଚୀନ: പഴയ പുരാതനമായ. പുരാതനം പണ്ടേയുള്ള പൂര്‍വ്വ_കാലത്തെ
ପ୍ରାଜ୍ଞ: ബുദ്ധിമാന്‍ ധാരണാശക്‌തിയുള്ള വിവേകമുള്ള
ପ୍ରାଣଘାତକ: ജീവനൊടുക്കുന്ന.
ପ୍ରାଣଘାତୀ: ജീവനൊടുക്കുന്ന.
ପ୍ରାଣାନ୍ତକ: ജീവനൊടുക്കുന്ന.
ପ୍ରାଥମିକ: മുമ്പുള്ള പ്രാരംഭികമായ ആദ്യമായ.
ପ୍ରାପକ: ലഭിക്കുന്നവന്‍.
ପ୍ରାପ୍ତ: ലഭിച്ച നേടിയ സ്വീകരിക്കപ്പെട്ട. കിട്ടിയ നേടിയ.
ପ୍ରାପ୍ତକର୍ତ୍ତା: ലഭിക്കുന്നവന്‍.
ପ୍ରାପ୍ୟ: നേടിയെടുക്കേണ്ട നേടേണ്ട ലഭിക്കേണ്ട കിട്ടേണ്ട കൈവരേണ്ട.
ପ୍ରାମାଣ୍ୟ: യഥാറ്ത്ഥ_ജ്ഞാനം_അനുസരിച്ചുള്ള ശാസ്ത്രം_അനുസരിച്ചുള്ള തെളിയിച്ചിട്ടുള്ള. തെളിയിക്കേണ്ട സ്ഥാപിക്കേണ്ട.
ପ୍ରାରବ୍ଧବାଦୀ: എല്ലാം_ഭാഗ്യത്തിനധീനമെന്നു_വിശ്വസിക്കുന്ന.
ପ୍ରାରବ୍ଧାଧୀନ: മുന്പേ_നിശ്ചയിച്ച.
ପ୍ରାରମ୍ଭିକ: മുമ്പുള്ള പ്രാരംഭികമായ ആദ്യമായ. ആരംഭിച്ച തുടക്കമിട്ട പ്രാരംഭിച്ച സമാരംഭിച്ച.
ପ୍ରାର୍ଥନାକର୍ତ୍ତା|: അപേക്ഷകന്.
ପ୍ରାର୍ଥୀ: അപേക്ഷകന്.
ପ୍ରାୟୋଜିତ_: പ്രയോചകര്
ପ୍ରିୟ: മനസ്സിനിണങ്ങിയ പ്രിയപെട്ട ഇഷ്ടപെട്ട
ପ୍ରିୟବାଦୀ: ഇഷ്ട്ടം_സംസാരിക്കുന്ന പ്രിയം_വദമായി_സംസാരിക്കുന്ന.
ପ୍ରୀତିକର: പ്രിയപെട്ട ഇഷ്ടപെട്ട
ପ୍ରେମଯୁକ୍ତ: പ്രേമാസക്തനായ.
ପ୍ରେମାଶକ୍ତ: പ്രേമാസക്തനായ.
ପ୍ରେମୀ: പ്രിയപ്പെട്ട പ്രിയം_ചെയ്യുന്ന ഇഷ്ടമുള്ള അഭിമതമായ പ്രീതികരമായ.
ପ୍ରେରଣାତ୍ମକ: പ്രേരണാദായകം പ്രേരണാത്മകത പ്രേരണാസ്വാദ്യകത ഉത്സാഹിപ്പിക്കിക പ്രവര്‍ത്തിക്കാനായി_പറഞു_വിടുക .
ପ୍ରେରଣାଦାୟକ: പ്രേരണാദായകം പ്രേരണാത്മകത പ്രേരണാസ്വാദ്യകത ഉത്സാഹിപ്പിക്കിക പ്രവര്‍ത്തിക്കാനായി_പറഞു_വിടുക .
ପ୍ରେରଣାସ୍ପଦ|: പ്രേരണാദായകം പ്രേരണാത്മകത പ്രേരണാസ്വാദ്യകത ഉത്സാഹിപ്പിക്കിക പ്രവര്‍ത്തിക്കാനായി_പറഞു_വിടുക .
ପ୍ରୟାସଶୀଳ: പരിശ്രമിക്കുന്ന പ്രയത്നിക്കുന്ന.
ପ୍ରୟାସୀ: പരിശ്രമിക്കുന്ന പ്രയത്നിക്കുന്ന.
ପ୍ରୟୋଜନାର୍ଥୀ|: ഉദ്ദേശയം_.
ଫାଲତୁ: ഉപയോഗശൂന്യ്മായ. അനാവശ്യമായ.
ଫିଟ: ഫിറ്റ്
ଫିନଲେଣ୍ଡୀ: ഫിന്‍ലൈംടിയുടെ
ଫିନଲେଣ୍ଡୀୟ: ഫിന്‍ലൈംടിയുടെ
ଫିନଲ୍ୟାଣ୍ଡୀ: ഫിന്‍ലൈംടിലെ
ଫିଲିପିନୀ: ഫിലിപ്പീന്സിന്റെ
ଫିଲ୍ମୀ: സിനിമ
ଫୁଟା: പുഴുങ്ങിയ.
ଫୁର୍ତ୍ତି: ചുറുചുറുക്കുള്ള ഉന്‍മേഷമുള്ള ചൊടിയുള്ള ഉത്സാഹമുള്ള ഊറ്‍ജ്ജസ്വലതയുള്ള പ്രസരിപ്പുള്ള ഓജസ്സുള്ള ചുണയുള്ള മിടുക്കുള്ള
ଫୁର୍ତ୍ତିପୂର୍ଣ୍ଣ: ചുറുചുറുക്കുള്ള ഉന്‍മേഷമുള്ള ചൊടിയുള്ള ഉത്സാഹമുള്ള ഊറ്‍ജ്ജസ്വലതയുള്ള പ്രസരിപ്പുള്ള ഓജസ്സുള്ള ചുണയുള്ള മിടുക്കുള്ള
ଫୁର୍ତ୍ତିଯୁକ୍ତ: ചുറുചുറുക്കുള്ള ഉന്‍മേഷമുള്ള ചൊടിയുള്ള ഉത്സാഹമുള്ള ഊറ്‍ജ്ജസ്വലതയുള്ള പ്രസരിപ്പുള്ള ഓജസ്സുള്ള ചുണയുള്ള മിടുക്കുള്ള
ଫୁଲପକା: ചിത്രത്തയ്യലുകള്ളുള്ള പൂക്കളുള്ള.
ଫୁଲହୀନ: പുഷ്പങളില്ലാത്ത പൂക്കാത്ത പൂക്കലില്ലാത്ത പുഷ്പ്പിക്കാത്ത.
ଫେଣହୀନ: നുരയും_പതയും_ഇല്ലാത്ത.
ଫେରାର: ഓടിപ്പോയ പിടി_കൊടുക്കാതെരക്ഷപ്പെട്ട്_ഒളിച്ചു_നടക്കുന്ന.
ଫେରିବା: മടക്കയാത്രക്കുള്ള
ଫେଲ: തോറ്റുപോയ തോറ്റ പരാജയപ്പെട്ട വിഫലമായ അപജയപ്പെട്ട.
ଫୌଜଦାରୀ: സേനാനായകന്റെ_സ്ഥാനം.
ଫ୍ରାନସୀୟ: ഫ്രെഞ്ച് ഫ്രെഞ്ച്
ବଂଶଗତ: പിന്തുടര്‍ച്ചയായി_ലഭിച്ച.
ବଂଶାନୁକ୍ରମିକ: പിന്തുടര്‍ച്ചയായി_ലഭിച്ച.
ବକବାସ: അസംബന്ധം.
ବକବାସୀ|: വ്ര്ധാഭാഷണം നിരര്‍ദധകഭാഷണം്‌ അധികം_സംസാരിക്കുന്ന.
ବକେୟା: മിച്ചം_വന്ന മിച്ചം_നില്‍ക്കുന്ന.
ବକ୍ର: ബുദ്ധിമുട്ടുള്ള_.
ବକ୍ରହୀନ: നേരേ
ବଙ୍କା: വളഞ്ഞ വക്രതയുള്ള ചുറ്റിക്കുന്ന വളവും_തിരിവും_ഉള്ള_.
ବଙ୍ଗାଳୀ: ബംഗാളി ബംഗാളി
ବଚନବଦ୍ଧ: വാക്ക്_കൊടുത്തിട്ടുള്ള
ବଛାଯାଇଥିବା: വേര്പ്പെടുത്തുക.
ବଜାର: ബസാറിനോട്_ബന്ധപ്പെട്ട തരം_താണ അസഭ്യമായ.
ବଜାରୀ: ബസാറിനോട്_ബന്ധപ്പെട്ട തരം_താണ്.
ବଞ୍ଚିତ: എടുത്തു_കളയപ്പെട്ട രഹിതമായ ചതിക്കപ്പെട്ട വഞ്ചിക്കപ്പെട്ട.
ବଡ: മഹാനായ ശ്രേഷ്ഠനായ ഉന്നതനായ വിശിഷ്ടനായ വലിയ വലുതായ വലിപ്പമുള്ള വന്‍ വമ്പിച്ച ബഹു വിപുലമായ പെരുത്ത വിശാലമായ വിസ്ത്ര്തമായ വ്യാപകമായ പരന്ന വണ്ണമുള്ള. വലിയ
ବଡଖିଆ: അധികം_ഭക്ഷിക്കുന്ന വേഗം_വേഗം_ഭക്ഷിക്കുന്ന ഭക്ഷണപ്രിയനായ വയറനായ കൊതിയനായ.
ବଢିଆ: നല്ല നന്മയുള്ള വലിയ ഉത്തമമായ ഗുണമുള്ള മെച്ചപ്പെട്ട വൈശിഷ്ട്യമുള്ള സദ്ഗുണമുള്ള ഗുണകരമായ ശുദ്ധമായ ഉതകുന്ന കൊള്ളാവുന്ന. ശുദ്ധമായ ഒന്നാംതരമായ
ବଣୁଆ: വന്യ കാടന്‍
ବଣୁଆ_|: വനത്തെ_സംബന്ധിക്കുന്ന.
ବଦ: ചീത്ത
ବଦନାମ: കുപ്രസിദ്ധി ദുഷ്കീര്‍ത്തി അപഖ്യാതി
ବଦନାମୀ: ദുസ്വഭാവിയ്യായ ചീത്ത_സ്വഭാവമുള്ള
ବଦମାସ: ദുസ്വഭാവിയ്യായ ചീത്ത_സ്വഭാവമുള്ള തെമ്മാടി പോക്കിരി താന്തോന്നി ആഭാസന്‍ നെറികെട്ടവന്‍ കുസൃതിയായ വികൃതിയായ
ବଦଳୁଥିବା_: മാറുന്ന.
ବଦହଜମୀ: വേവാത്തത്.
ବଦ୍ଧ: ബന്ധിക്കപ്പെട്ട.
ବଧିର: ബധിരരായ മൂകരായ ഊമയായ
ବନସ୍ପତିହୀନ: സാസ്യങ്ങളില്ലാത്ത.
ବନୀୟ: വനത്തെ_സംബന്ധിക്കുന്ന.
ବନ୍ଦ: അടഞ്ഞുപ്പോയ
ବନ୍ଦିତ: അഭിനന്ദിക്കപ്പെട്ട.
ବନ୍ଦୀ|: പോലീസ്_കസ്റ്റഡിയിലുള്ള
ବନ୍ଦୀକୃତ: ബന്ദി_ആക്കപ്പെട്ട.
ବନ୍ଧକବିହୀନ: അടക്കാത്ത.
ବନ୍ଧକରହିତ: അടക്കാത്ത.
ବନ୍ଧନମୁକ୍ତ: സ്വ്തന്ത്റനായ
ବନ୍ଧନହୀନ: സ്വ്തന്ത്റനായ
ବନ୍ଧୁହୀନ: കൂട്ടുകാരില്ലാത്ത.
ବନ୍ୟ: വനത്തെ_സംബന്ധിക്കുന്ന. വന്യ കാടന്‍
ବପିତ: വിതയ്ക്കാവുന്ന വിതയ്ക്കാന്_പറ്റിയ നടാവുന്ന പാകവുന്ന. വിതച്ച വിതയ്ക്കപ്പെട്ട വിത്തു_പാകിയ വിത്തു_നട്ട
ବମ୍ବେଇଆ: മുംബൈയിലുള്ള ബോംബേയിലുള്ള. മുബൈയുടെ മുംബൈ‌-
ବମ୍ବେଇବାଲା: മുംബൈയിലുള്ള ബോംബേയിലുള്ള. മുബൈയുടെ മുംബൈ‌-
ବରଖାସ୍ତ: ജോലിയില്‍_നിന്നു_മാറ്റി_നിര്‍ത്തിയ.
ବରଫ_ପଡିଥିବା: ഐസ്സുള്ള.
ବରଫମୟ: മഞ്ഞുമൂടിയ.
ବରଫାଚ୍ଛାଦିତ: മഞ്ഞുമൂടിയ.
ବରଫାବୃତ୍ତ: മഞ്ഞുമൂടിയ.
ବରମୁଡା: ബറ്മൂഡിയന്‍.
ବରମୁଡା_ସମ୍ବନ୍ଧିତ: ബറ്മൂഡിയന്‍.
ବରିଷ୍ଠ: വയസ്സായ. ഏറ്റവും_പ്രായം_കൂടിയത്.
ବରିଷ୍ଠ_: പ്രമുഖന്‍.
ବର୍ଜିତ: നിഷേധിക്കപ്പെട്ടത് നിരോധിക്കപ്പെട്ട തടയപ്പെട്ട. കളയുവാനായി_ഉപേക്ഷിച്ച.
ବର୍ଜ୍ୟ: ഉപേക്ഷിക്കപ്പെടേണ്ടതായ ഉപേക്ഷിക്കത്തക്ക ചീത്തയായ വര്‍ജ്ജിക്കത്തക്കതായ.
ବର୍ଣ୍ଣନାତୀତ_: പറയുവാന്_പറ്റാത്തത്.
ବର୍ଣ୍ଣନୀୟ: വര്‍ണ്ണിക്കാവുന്നത്.
ବର୍ଣ୍ଣା: നിറമുള്ള വറ്ണ്ണമുള്ള
ବର୍ଣ୍ଣୀୟ: നിറമുള്ള വറ്ണ്ണമുള്ള
ବର୍ଣ୍ୟ: വര്‍ണ്ണിക്കാവുന്നത്.
ବର୍ତ୍ତମାନ: വറ്ത്തമാനകാലത്തുള്ള വറ്ത്തമാനസമയത്തുള്ള ഇപ്പൊഴുള്ള ഇന്നത്തെ വറ്ത്തമാനമായ. ആധുനികം.
ବର୍ତ୍ତମାନ_କାଳୀନ: നിലവിലുള്ള്_കാലത്തെ
ବର୍ତ୍ତୁଳ: ഗോളാകൃതി വൃത്താകൃതി
ବର୍ଦ୍ଧକ: വര്ദ്ധിപ്പിക്കുന്ന.
ବର୍ବର: സദാചാരമില്ലാത്ത മറ്റുള്ളവരേ_ഉപദ്രവിക്ക്ല്. ഹിംസകന്.
ବର୍ମା: ബ്ര്‍മ്മയുടെ മ്യാന്മറിന്റെ
ବର୍ମୀ: ബ്ര്‍മ്മക്കാരെ മ്യാന്മര്‍കാരെ ബ്ര്‍മ്മ_ഭാഷ മ്യാന്മര്‍_ഭാഷ
ବର୍ଷା: ശക്തിയായ_മഴ.
ବର୍ଷିଆ: വാര്‍ഷികം.
ବର୍ଷିକିୟା: ഒരു_വര്‍ഷം_നീണ്ടു_നില്‍ക്കുന്ന_ചെടി.
ବର୍ହିମୁଖୀ_: ബാഹ്യ_വിഷയങളില്‍_കുടുങിയ.
ବଳକା: കളയുവാനായി_ഉപേക്ഷിച്ച.
ବଳବନ୍ତ: ശക്തിയുള്ള ബലമുള്ള ദ്രിഢമായ
ବଳବାନ: വീരന്‍ ധൈര്യശാലി നിര്‍ഭയന്‍
ବଳିଷ୍ଠ: ശക്തിയുള്ള ബലമുള്ള ദ്രിഢമായ
ବଶହୀନ: ഒഴിവാക്കാന്_ആവാത്ത വശത്താക്ക്പ്പെടാനാവാത്ത.
ବଶୀକରଣ: വശീകരിക്കല്‍
ବସତିବିହୀନ: വാസമില്ലാത്ത നശിച്ചു_പോയ ഉപേക്ഷിച്ച അന്യമായ.
ବସୀକର: വശീകരിക്കല്‍
ବସ୍ତ୍ରଧାରୀ: വസ്ത്രധാരി
ବସ୍ତ୍ରହୀନ: നഗ്നനായ വിവസ്ത്രനായ ദിഗംബരനായ അനംബരനായ
ବହନକାରୀ: സാധനങ്ങ്ള്‍_കൊണ്ട്പോകുന്ന.
ବହିଯାଉଥିବା: ഒഴുക്ന്ന ഒഴുക്കിന്റെ_ഗതി തുടര്‍ച്ചയായ_ഗതി ശക്തിയേറിയ_പാച്ചില്‍ നീരൊഴുക്കു് തുടര്‍ച്ചയായ_ഗതി നിരന്തരമായി_പ്രവഹിക്കുന്ന.
ବହିଷ୍କୃତ: പുറത്താക്കപ്പെട്ട. ബഹിഷ്ക്കരിക്കപ്പെട്ട. ബഹിഷ്ക്കരിക്കപ്പെട്ട.
ବହୁଖର୍ଚ୍ଚୀ: ധൂര്ത്തടിക്കുന്നവന്.
ବହୁଗୁଣିତ: ഗുണിച്ച.
ବହୁଚର୍ଚ୍ଚିତ: വളരെ_ചറ്ച്ചചെയ്യപ്പെട്ട വളരെ_വിചിന്തനം_ചെയ്യപ്പെട്ട.
ବହୁତ: വളരേയധികം. വളരേ.
ବହୁତ_ଅଧିକ: വളരേയധികം.
ବହୁତ_ଦୂର: ദൂരെയുള്ള അകലെയുള്ള.അപാറ്ണ്ണമായ വിപ്രക്ര്‌ഷ്ടമായ പര വിദൂരമായ ബഹുദൂരെയുള്ള.
ବହୁତ_ପିତା_ବା_କଷା: വളരെ_കൈപ്പുള്ള അത്യധികം_കൈപ്പേറിയ അപ്രിയമായ.
ବହୁତ_ବଡ: വളരെ_വലിയ ബ്ര്ഹത്തായ.‌
ବହୁତକଳା: ഭയങ്ങ്കരമായി_കറുത്ത.
ବହୁଦର୍ଶୀ: കുശാഗ്രബുദ്ധിമാനായ.
ବହୁଦେଶୀୟ: അന്താരാഷ്ട്രീയമായ.
ବହୁଧର୍ମୀୟ: നാനജാതി_മതങ്ങളുള്ള.
ବହୁଧାର୍ମିକ: നാനജാതി_മതങ്ങളുള്ള.
ବହୁବର୍ଷୀୟ|: അനേകം_വര്ഷം_ജീവിക്കുന്ന.
ବହୁମୂଲ୍ୟ: വിലയേറിയ വിലമതിക്കാനാവാത്ത വിലപിടിച്ച മഹത്വപൂര്ണ്ണമായ.
ବହୁରାଷ୍ଟ୍ରୀୟ_: അന്താരാഷ്ട്രീയമായ.
ବହୁସଂଖ୍ୟକ: വളരേ_അധികം.
ବହ୍ବକ୍ଷର: അനേകാക്ഷരമുള്ള
ବାଂଲାଦେଶ_ସମ୍ବନ୍ଧିତ: ബംഗ്ലാദേശിലുള്ള ബംഗ്ലാദേശിയന്‍.
ବାଂଲାଦେଶୀ: ബംഗ്ലാദേശിലുള്ള ബംഗ്ലാദേശിയന്‍.
ବାଆଷଠି: അറുപത്തി_രണ്ട്.
ବାଇଶ: ഇരുപത്തി_രണ്ട്.
ବାଇଶି: ഇരുപത്തി_രണ്ട്.
ବାଇଶିତମ: ഇരുപത്തി_രണ്ടാമത്തെ.
ବାଉଁଆ: ഇടങ്കൈ_കൂടുതലായി_ഉപയോഗിക്കുന്ന
ବାଉଁଶ_ନିର୍ମିତ: മുള_കൊണ്ടുള്ള മുളയാലുള്ള.
ବାଉଁଶର: മുള_കൊണ്ടുള്ള മുളയാലുള്ള.
ବାଉନ: അന്പത്തി_രണ്ട്.
ବାଉନତମ: അന്പത്തി_രണ്ടാം
ବାକରୁଦ୍ଧ|: വാക്കുകള്_തടയപ്പെട്ട.
ବାକି: മുഴുവനാകാത്ത.
ବାକିଥିବା_: മിച്ചം_വന്ന മിച്ചം_നില്‍ക്കുന്ന.
ବାକ୍ଶକ୍ତି_ରହିତ: അധികം_സംസാരിക്കാത്ത
ବାକ୍ହୀନ: മൌനമായ.
ବାଗଦତ୍ତା: വാഗ്ദാനം_ചെയ്യപ്പെട്ട വാക്കു_കൊടുക്കപ്പെട്ട വാക്കു_കൊടുത്ത കരാറ്_ചെയ്ത.
ବାଙ୍ଗାଲୋରୀ: ബംഗളൂരിന്റെ.
ବାଚକ: പറയുന്ന വിവരിക്കുന്ന.
ବାଚାଳ_: വചാലന്‍ അതി_ഭാഷി.
ବାଜେକଥା: അസംബന്ധം.
ବାଞ୍ଛିତ: ഇച്ഛിച്ച് ആഗ്രഹിച്ച താല്പര്യപ്പെട്ട.
ବାଟହୁଡା: വഴി_തെറ്റിയ ലക്ഷ്യമില്ലാതെ_അലയുന്ന അമ്പരമ്മു_പോകുന്ന.
ବାଡହୀନ_: സൂക്ഷിക്കാത്ത
ବାତିଲ: നിരസിക്കപ്പെട്ട റദ്ദാക്ക്പ്പെട്ട.
ବାତୁଳ: വചാലന്‍ അതി_ഭാഷി.
ବାତୁଳାମୀହୀନ: ശ്രദ്ധയുള്ള.
ବାତୁଳି: വചാലന്‍ അതി_ഭാഷി.
ବାଧକ: ഇന്സുലേറ്റര് തടയ്ല്.
ବାଧାଗ୍ରସ୍ତ: അടഞ്ഞുപ്പോയ
ବାଧାହୀନ: സ്വേച്ഛാധിപതിയായ അനിയന്ത്രിതനായ നിരങ്കുശനായ കടിഞ്ഞാണില്ലാത്ത. വിഘ്നം_ഇല്ലാത്ത്.
ବାଧ୍ୟ: നിസ്സഹായനായ നിര്ബന്ധിതനായ
ବାଧ୍ୟତାମୂଳକ: ആവശ്യമുള്ള പ്രധാനമായ തീര്‍ച്ചയായും_വേണ്ട്തായ കടപ്പാടുള്ള ഒഴിച്ച്കൂടാനാവാത്ത.
ବାମ: വിപരീതമായ പ്രതികൂലമായ.
ବାରମାସୀ: നിത്യഹരിതം പന്ത്രണ്ടു_മാസം_മുഴുവനും_നീണ്ടു_നില്ലക്കുന്ന.
ବାର୍ତ୍ତାବହ: സന്ദേശം_വഹിക്കുന്ന_.
ବାର୍ଷିକ: വാര്‍ഷികം.
ବାଳସୁଲଭ: കുട്ടികള്ക്ക്_ചേര്ന്ന
ବାଳହୀନ: കഷണ്ടിയുള്ള കഷണ്ടി_രോഗമുള്ള. മൊട്ട.
ବାଳୋଚିତ: കുട്ടികള്ക്ക്_ചേര്ന്ന
ବାଳୋପଯୋଗୀ: കുട്ടികള്ക്ക്_ഉപയോഗമുള്ള_.
ବାଷଠି_୬୨: അറുപത്തി_രണ്ട്.
ବାଷଠିତମ: അറുപത്തിമൂന്നാം
ବାସନାହୀନ: അതീന്ദ്രിയമായ.
ବାସଯୁକ୍ତ: മണമുള്ള.
ବାସହୀନ: വാസമില്ലാത്ത നശിച്ചു_പോയ ഉപേക്ഷിച്ച അന്യമായ. വീടില്ലാത്തവര്.
ବାସହୀନ|: മണമില്ലാത്ത.
ବାସି: പഴകിയ കേടുവന്ന വളിച്ച.
ବାସ୍ତବିକ: വാസ്തവികമായ യദാര്ഥമായ.
ବାସ୍ତରିତମ: എഴുപത്തി_രണ്ടാം
ବାସ୍ନାଯୁକ୍ତ|: മണമുള്ള.
ବାହାଦୂର: വീരന്‍ ധൈര്യശാലി നിര്‍ഭയന്‍
ବାହାର: ബാഹ്യമായ പുറമേയുള്ള.
ବାହାରିନ: ബഹറിന്‍.
ବାହାରିନ_ସମ୍ବନ୍ଧିତ: ബഹറിന്‍.
ବାହିକା: വാഹിനി.
ବାହୀ: വാഹിനി.
ବାହେଲ୍‌: പഴയസ്ഥിതിയില്‍_ത്തന്നെ
ବାହ୍ୟ: പ്രകടനപരമായ കപടമായ ക്ര്‌ത്രിമമായ.
ବାହ୍ୟ|: ബാഹ്യമായ പുറമേയുള്ള.
ବାୟବ: ആകാ‍ശ ആകാശസ്ഥമായ വായു_ചരമായ വായു_മണ്ഡല_സംബന്ദിയായ.
ବାୟବୀୟ: ആകാ‍ശ ആകാശസ്ഥമായ വായു_ചരമായ വായു_മണ്ഡല_സംബന്ദിയായ.
ବିକଟ: ഭയാനകമായ ഭീകരമായ ഉഗ്രമായ ഞെട്ടിക്കുന്ന ഭീതിജനകമായ ഭയാവഹമായ രുദ്രമായ
ବିକଳ: ചഞ്ഞ്ചലിതമായ.
ବିକଳ_: അസ്വസ്ഥമായ.
ବିକଳାଙ୍ଗ: അംഗവിഹീന വികലാംഗ അംഗഭംഗ അംഗവൈകല്യമുള്ള കോട്ടം_വന്ന ശരീരക്ഷ്തം_വന്ന.
ବିକଳ୍ପହୀନ: സന്ദേഹമില്ലാതെ ധാരണയോടെ ഉപായത്തോടെ നിശ്ചയത്തോടെ ധൈര്യത്തോടെ ഉറ്പ്പോടെ തീറ്ച്ചയോടെ.
ବିକଶିତ: പൂക്കുന്ന പുഷ്പ്പിക്കുന്ന. വികസിതമായ.
ବିକାରଗ୍ରସ୍ତ|: മോശമായ ചീത്തയായ.
ବିକାରହୀନ: നിര്‍വികാരനാണ്‍.
ବିକାଶଶୀଳ: മുന്നേറുന്ന.
ବିକୀର୍ଣ୍ଣ|: ചിതറിയ പരന്നു_കിടക്കുന്ന നുറുക്കുകളായ.
ବିକୃତ: മോശമായ ചീത്തയായ.
ବିକ୍ରମୀ: വിക്രമമുള്ള ബലമുള്ള ശൂരതയുള്ള.
ବିକ୍ରି_ସରିଥିବା: വിറ്റഴിഞ്ഞ.
ବିକ୍ରୟ_ଯୋଗ୍ୟ: വില്പ്പനചരക്ക്.
ବିକ୍ଷିପ୍ତଭାବେ: ചിതറിയ പരന്നു_കിടക്കുന്ന നുറുക്കുകളായ.
ବିକ୍ଷେଣ: പ്രാവീണ്യമുള്ള നിപുണതയുള്ള സാമറ്ത്ഥ്യമുള്ള മിടുക്കമുള്ള നൈപുണ്യമുള്ള പ്രായോഗികയോഗ്യതയുള്ള ചാതുര്യമുള്ള കുശലതയുള്ള വിരുതുള്ള വിചക്ഷണതയുള്ള പാടവമുള്ള തഴക്കമുള്ള പ്രാപ്തിയുള്ള.
ବିଖଣ୍ଡିତ: മുറിക്കുന്ന
ବିଖଣ୍ଡିତ|: കഷണമായത്.
ବିଖ୍ୟାତ: പ്രസിദ്ധയായ കേള്‍വിപ്പെട്ട പേരുകേട്ട യശസ്വിയായ പ്രഖ്യാതമായ അറിയപ്പെട്ട വിഖ്യാതിയായ
ବିଗତ: കഴിഞ്ഞുപോയ.
ବିଚଳିତ: മാറിയ ഇളക്കപ്പെട്ട അസ്ഥിരമായ ചഞ്ചലമായ പരിഭ്രമിച്ച.
ବିଚଳିତ.ଅସ୍ଥିର: ശാന്തമല്ലാത്ത.
ବିଚାରଣୀୟ: ചിന്തനീയമായ ചര്‍ച്ചാവിഷയമാകാന്‍_പറ്റിയ സന്ദിഗ്ദ്ധമായ പരിശോധിക്കപ്പെടേണ്ടതായ.
ବିଚାରପୂର୍ଣ୍ଣ: ചിന്തയോറ്ടു_കൂടിയ
ବିଚାରଯୋଗ୍ୟ: ചിന്തനീയമായ ചര്‍ച്ചാവിഷയമാകാന്‍_പറ്റിയ സന്ദിഗ്ദ്ധമായ പരിശോധിക്കപ്പെടേണ്ടതായ.
ବିଚାରଶୂନ୍ୟ: ശ്രദ്ധയില്ലാത്ത.
ବିଚାରହୀନ: ശ്രദ്ധയില്ലാത്ത.
ବିଚାରାତ୍ମକ: ചിന്തയോറ്ടു_കൂടിയ
ବିଚାରିତ: വിചാരിക്കപ്പെട്ട ചര്‍ച്ച_ചെയ്യപ്പെട്ട.
ବିଚାର୍ୟ: ചിന്തനീയമായ ചര്‍ച്ചാവിഷയമാകാന്‍_പറ്റിയ സന്ദിഗ്ദ്ധമായ പരിശോധിക്കപ്പെടേണ്ടതായ.
ବିଚିତ୍ର: അസാമാന്യമായ അത്ഭുതകരമായ വിസ്മയകരമായ. പ്രത്യേകതയുള്ള അപൂര്വമായ.വ്യത്യാസമായ.
ବିଚ୍ୟୁତ: മാറിയ ഇളക്കപ്പെട്ട അസ്ഥിരമായ ചഞ്ചലമായ പരിഭ്രമിച്ച.
ବିଜନ: നിര്ജ്ജനം ഏകാന്തം.
ବିଜାତୀୟ: വിഭിന്ന_ജാതിയിപ്പെട്ട.
ବିଜିତ: ജയിക്കത്തക്ക.
ବିଜେତା: ജേതാവ് വിജയി
ବିଜ୍ଞ: വിദ്വാന്‍മാരായിട്ടുളള പാണ്ഡിത്യമുള്ള അറിവുള്ള അഭ്യസ്‌തവിദ്യനായ വിദ്യാഭ്യാസമുള്ള കുശാഗ്രബുദ്ധിമാനായ.
ବିଜ୍ଞାନ_ବିରୁଦ୍ଧ: അശാസ്ത്രീയം.
ବିଜ୍ଞାନ_ସଙ୍ଗତ: ശാസ്ത്രത്തിനനുസ്രിതമായ_.
ବିଜ୍ଞାନାନୁକୂଳ|: ശാസ്ത്രത്തിനനുസ്രിതമായ_.
ବିଜୟୀ: ജേതാവ് വിജയി
ବିତାଡିତ: ബഹിഷ്ക്കരിക്കപ്പെട്ട.
ବିତି_ଯାଇଥିବା: കഴിഞ്ഞുപോയ.
ବିତ୍ତହୀନ: പാവപെട്ട ദരിദ്രനായ നിര്‍ദ്ധനനായ പാപപരായ അഗതിയായ
ବିତ୍ତୀୟ: സാമ്പത്തിക_സ്ഥിതി.
ବିଦାରକ|: കീറുന്ന തകരുന്ന.
ବିଦାରିତ: തുള ദ്വാരം.
ବିଦିତ: അറിവുള്ള
ବିଦେଶୀ: വിദേശി അന്യദേശക്കാരന്‍ വൈദേശികന്‍ അന്യന്‍ അന്യദിക്കുകാരന്‍ കുടിയേറ്രക്കാരന്‍.
ବିଦେହ: ദേഹമില്ലാത്ത.
ବିଦ୍ଧ: തുളഞ്ഞു_കയ്രിയ
ବିଦ୍ବତ୍ତାପୂର୍ଣ୍ଣ: പാണ്ഡിത്യമുള്ള.
ବିଦ୍ରୂପାତ୍ମକ: പരിഹാസത്തിനു_അര്‍ഹനായ നിന്ദായോഗ്യമായ.
ବିଦ୍ୟମାନ: ഹാജരുള്ള സന്നിഹിതമായ വന്ന ഉള്ള സമകാലീന വറ്ത്തമാനകാല ഇപ്പോഴുള്ള നിലവിലുള്ള.
ବିଦ୍ୟାଳୟ: വിദ്യാലയത്തിലെ
ବିଦ୍ୟୁତ_ଚମକିତ: മിന്നല്‍_രൂപിയായ
ବିଦ୍ୱାନ୍‌: വിദ്വാന്‍മാരായിട്ടുളള പാണ്ഡിത്യമുള്ള അറിവുള്ള
ବିଧର୍ମୀ: ധര്‍മ്മബോധമില്ലാത്ത ധര്‍മ്മവിരുദ്ധിയായ
ବିଧିବଶ: മുന്പേ_നിശ്ചയിച്ച.
ବିଧିବିରୁଦ୍ଧ: നിയമ_വിരുദ്ധമായ നിഷിദ്ധമായ.
ବିନମ୍ର: വിനീതമായ_പെരുമാറ്റമുള്ള.
ବିନା_ପଇସାରେ: പണമില്ലാതെ.
ବିନାଶକ: നശിക്കുന്ന ധ്വംസിക്കാവുന്ന ഇല്ലാതാകവുന്ന അസ്ഥിരമായ ശാസ്വതമല്ലാത്ത.
ବିନାଶଶୀଳ: നശിക്കുന്ന ധ്വംസിക്കാവുന്ന ഇല്ലാതാകവുന്ന അസ്ഥിരമായ ശാസ്വതമല്ലാത്ത.
ବିନାଶୀ: നശിക്കുന്ന ധ്വംസിക്കാവുന്ന ഇല്ലാതാകവുന്ന അസ്ഥിരമായ ശാസ്വതമല്ലാത്ത.
ବିନାଶୀ|: നശിക്കുന്ന.
ବିନୀତ: വിനീതമായ_പെരുമാറ്റമുള്ള.
ବିନୋଦିତ: സന്തോഷമുള്ള്വരാകുക.
ବିନୋଦିତ|: ആനന്ദം_നിറഞ്ഞ സന്തോഷം_പ്രകടിപ്പിക്കുന്ന.
ବିନ୍ଦୁଯୁକ୍ତ: ചെറിയ_പൊട്ടുകളുള്ള
ବିନୟଯୁକ୍ତ|: വിനീതമായ_പെരുമാറ്റമുള്ള.
ବିନୟଶୀଳ: വിനീതമായ_പെരുമാറ്റമുള്ള.
ବିନୟୀ: വിനീതമായ_പെരുമാറ്റമുള്ള.
ବିପକ୍ଷ: പ്രതിപക്ഷത്തിലുള്ള എതിറ്പക്ഷത്തിലുള്ള. വിരോധമുള്ള എതിര്‍പ്പുള്ള പ്രതിപക്ഷ_കക്ഷിയില്‍പ്പെട്ട.
ବିପକ୍ଷୀୟ: പ്രതിപക്ഷത്തിലുള്ള എതിറ്പക്ഷത്തിലുള്ള.
ବିପତ୍ତିଗ୍ରସ୍ତ: സംകടം_പിടിപ്പെട്ട
ବିପଦଗ୍ରସ୍ତ: സംകടം_പിടിപ്പെട്ട വിഷമത്തില്പെട്ട വിഷമതയില്‍പെട്ട ദുറ്ഘടസ്ഥിതിയിലായ ദുഃഖപൂറ്ണ്ണനായ.
ବିପଦପୂର୍ଣ୍ଣ: അപകടകരമായ.
ବିପଦାକ୍ରାନ୍ତ: വിഷമത്തില്പെട്ട വിഷമതയില്‍പെട്ട ദുറ്ഘടസ്ഥിതിയിലായ ദുഃഖപൂറ്ണ്ണനായ.
ବିପଦାପନ୍ନ: വിഷമത്തില്പെട്ട വിഷമതയില്‍പെട്ട ദുറ്ഘടസ്ഥിതിയിലായ ദുഃഖപൂറ്ണ്ണനായ.
ବିପନ୍ନ|: കഷ്ട്ടത്തിലായ.
ବିପରୀତ: വിപരീതമ്മയ്. വിപരീതമായ പ്രതികൂലമായ. വിപരീതം.
ବିପୁଳ: വളരേയധികം. ഭാരിച്ച.
ବିଫଳ: അസഫലമായ.
ବିବରଣାତ୍ମକ: വിസദീകരിക്കാവുന്ന
ବିବଶ: നിസ്സഹായനായ നിര്ബന്ധിതനായ
ବିବସନ: നഗ്നനായ വിവസ്ത്രനായ ദിഗംബരനായ അനംബരനായ
ବିବସ୍ତ୍ର: നഗ്നനായ വിവസ്ത്രനായ ദിഗംബരനായ അനംബരനായ
ବିବାଦସ୍ପଦ: തര്‍ക്കിക്കപ്പെടാവുന്ന വിവാദത്തിനു_കാരണമാകാവുന്ന.
ବିବାଦୀ_: തര്‍ക്കിക്കപ്പെടാവുന്ന വിവാദത്തിനു_കാരണമാകാവുന്ന.
ବିବାହଯୋଗ୍ୟ: വിവാഹപ്രായമായ വിവാഹം_ചെയ്യപ്പെടതക്ക.
ବିବାହିତ_ବ୍ୟକ୍ତି: വിവാഹിതന്‍ കല്യാണം_കഴിഞ്ഞവന്‍.
ବିବିଧ: അനേകം ഒന്നിലധികമായ പല വളരെയേറേ അസംഖ്യം.
ବିବେକବାନ୍: വിവേചനശക്തിയുള്ള തിരിച്ചറിവുള്ള ശരിയായ_ജ്ഞാനമുള്ള.
ବିବେକଶୀଳ: വിവേചനശക്തിയുള്ള തിരിച്ചറിവുള്ള ശരിയായ_ജ്ഞാനമുള്ള.
ବିବେକହୀନ: അവിവേകി.
ବିବେକୀ: വിവേചനശക്തിയുള്ള തിരിച്ചറിവുള്ള ശരിയായ_ജ്ഞാനമുള്ള.
ବିଭକ୍ତ: വേര്തിരിക്കുക.
ବିଭାଗୀୟ: വകുപ്പനുസരിച്ചുള്ള
ବିଭାଜିତ: വേര്തിരിക്കുക.
ବିଭିନ୍ନ: വ്യത്യസ്ഥമായ ഭിന്നമായ
ବିଭୂଷିତ: അലങ്കരിച്ച ആഭരണമണിഞ്ഞ അലങ്ക്ര്തമായ.
ବିଭୂଷିତ_: അലംകരിക്കപ്പെട്ട ഒരുക്കപ്പെട്ട.
ବିମର୍ଶିତ_: വിചാരിക്കപ്പെട്ട ചര്‍ച്ച_ചെയ്യപ്പെട്ട.
ବିମଳ: നിര്‍മ്മലമായ വിമലമായ പവിത്രമായ് ശുദ്ധമായ
ବିରକ୍ତ: മടുപ്പ് മുഷിച്ചില്.
ବିରକ୍ତିକର: മനസ്സ്_മുഷിഞ്ഞ മനസ്സ്_മടുത്ത.
ବିରଚିତ: രചിക്കപ്പെട്ട എഴുതപ്പെട്ട.
ବିରାଟ: ഭാരിച്ച.
ବିରୁଦ୍ଧ: വിപരീതമ്മയ്. വിപരീതമായ പ്രതികൂലമായ.
ବିରୁଦ୍ଧାର୍ଥୀ_: വിപരീതമായ
ବିରୁପାକ୍ଷ: വിരൂപമായ_കണ്ണുകളുള്ള.
ବିରୋଧକାରୀ: വിരോധമുള്ള എതിര്‍പ്പുള്ള പ്രതിപക്ഷ_കക്ഷിയില്‍പ്പെട്ട.
ବିରୋଧହୀନ: തിരിചചടിയില്ലാത്ത.
ବିରୋଧିତ: എതിര്‍ക്കപ്പെട്ട് തടയ്പ്പെട്ട്.
ବିରୋଧୀ: വിരോധമുള്ള എതിര്‍പ്പുള്ള പ്രതിപക്ഷ_കക്ഷിയില്‍പ്പെട്ട.
ବିଲକ୍ଷଣ: അസാമാന്യമായ അത്ഭുതകരമായ വിസ്മയകരമായ. പ്രത്യേകതയുള്ള അപൂര്വമായ.വ്യത്യാസമായ.
ବିଲୁପ୍ତ: വംശനാശം_സംഭവിച്ചത്.
ବିଲୋକିତ: അവലോകനം_ചെയ്യപ്പെട്ട.
ବିଳମ୍ବିତ_: താമസിച്ച.
ବିଳାସବ୍ୟସନହୀନ_: ദു
ବିଳାସୀ: സ്ത്രീ_ലംബടനായ വിലാസപ്രിയനായ ഭോഗപ്രിയനായ.
ବିଶାଳ: ഭാരിച്ച.
ବିଶାଳକାୟ: ഭീമകായനായ വളരേ_വലിയ.
ବିଶାଳହୃଦୟ: ഉദാരമതിയായ വിശാലഹ്രിദയനായ .
ବିଶିଷ୍ଟ: വിശേഷതയുള്ള ശ്രേഷ്ഠമായ നിശ്ചിതമായ.
ବିଶୁଦ୍ଧ: ശുദ്ധമായ ഒന്നാംതരമായ നിര്‍മ്മലമായ വിമലമായ പവിത്രമായ് ശുദ്ധമായ
ବିଶୁଦ୍ଧ_: ശുദ്ധമായതു.
ବିଶୁଦ୍ଧ|: കൂടി_ചേരാത്ത.
ବିଶୃଙ୍ଖଳିତ: ക്രമമല്ലാത്ത.
ବିଶେଷ: അസാമാന്യമായ സാധാരണമല്ലാത്ത. വിശേഷവും
ବିଶୋଧିତ: ശുദ്ധമാക്കിയ.
ବିଶ୍ବ_ଜୟୀ: ലോകം_ജയിച്ചവന്‍.
ବିଶ୍ବ_ବିଜେତା: ലോകം_ജയിച്ചവന്‍.
ବିଶ୍ବ_ବିଜୟୀ: ലോകം_ജയിച്ചവന്‍.
ବିଶ୍ବବ୍ୟାପୀ: ലോകം_മുഴുവനും
ବିଶ୍ବସ୍ତ: വിശ്വസിക്കാവുന്ന വിശ്വസനീയമായ വിശ്വസ്തനായ വിശ്വസാമുള്ള വിശ്വസ്ത വിശ്വാസിയായ.
ବିଶ୍ବାସ_କଲାବାଲା_: വിശ്വാസമുള്ള.
ବିଶ୍ବାସଘାତୀ: വിശ്വാസവഞ്ചന_ചെയ്യുന്ന.
ବିଶ୍ବାସୀ: വിശ്വസിക്കാവുന്ന വിശ്വസനീയമായ വിശ്വസ്തനായ വിശ്വസാമുള്ള വിശ്വസ്ത വിശ്വാസിയായ. വിശ്വാസമുള്ള.
ବିଶ୍ବୀୟ: ഈശ്വരന്_സ്രിഷ്ട്ടിച്ച_സമ്പൂര്ണ്ണ_വസ്തുക്കളുടേയും_സമൂഹത്തെ_സംബന്ധിക്കുന്നത്.
ବିଶ୍ରାନ୍ତ: ക്ഷീണിച്ച.
ବିଷମୟ: വിഷമുള്ള വിഷം_കലര്‍ന്ന വിഷം_നിറഞ്ഞ.
ବିଷଯୁକ୍ତ: വിഷമുള്ള വിഷം_കലര്‍ന്ന വിഷം_നിറഞ്ഞ.
ବିଷରହିତ: വിഷരഹിതമായ.
ବିଷର୍ଣ୍ଣ|: ദു
ବିଷହୀନ: വിഷരഹിതമായ.
ବିଷାକ୍ତ: വിഷമുള്ള വിഷം_കലര്‍ന്ന വിഷം_നിറഞ്ഞ. വിഷതുല്യമായ.
ବିଷାଦଗ୍ରସ୍ତ: ദു
ବିଷୟକ: സംബന്ധമായ സംബന്ധിക്കുന്ന.
ବିସ୍ତାରଯୁକ୍ତ: വിസ്താരമുള്ള.
ବିସ୍ତାରହୀନ: ഇടുങ്ങിയ വീതി_കുറഞ്ഞ കുടുസ്സായ
ବିସ୍ତାରିତ: വിസ്തരിച്ച
ବିସ୍ତୀର୍ଣ୍ଣ: പരന്ന വ്യാപിച്ചിരിക്കുന്ന. വീതിയുള്ള
ବିସ୍ତୃତ: പരന്ന വ്യാപിച്ചിരിക്കുന്ന. വിസ്തരിച്ച
ବିସ୍ଥାପିତ: സ്ഥാനത്തു_നിന്നു_നീക്കിയ സ്ഥലത്തു_നിന്നു_അകറ്റപ്പെട്ട.
ବିସ୍ଫୋଟକ: സ്പോടകാത്മകമായ
ବିସ୍ଫୋଟକାରୀ: സ്പോടകാത്മകമായ
ବିସ୍ଫୋରଣ: സ്പോടകാത്മകമായ
ବିସ୍ଫୋରଣକାରୀ: സ്പോടകാത്മകമായ
ବିସ୍ମୃତ: മറന്നു_പോയ.
ବିସ୍ମୟକାରକ.କୌତୁହଳଜନକ: അസാമാന്യമായ അത്ഭുതകരമായ വിസ്മയകരമായ.
ବିସ୍ମୟକାରୀ: അസാമാന്യമായ അത്ഭുതകരമായ വിസ്മയകരമായ.
ବିସ୍ମୟଜନକ: അസാമാന്യമായ അത്ഭുതകരമായ വിസ്മയകരമായ.
ବିହାରୀ: ബീഹാറിലെ
ବିହ୍ବଳ|: ഊടും_പാവും_പോലെ_കോര്ക്കപ്പെട്ട.
ବୀପରିତାର୍ଥୀ: വിപരീതമായ
ବୀଭତ୍ସ: വെറുക്കപ്പെട്ട നിന്ദിക്കപ്പെട്ട.
ବୀର: വീരന്‍ ധൈര്യശാലി നിര്‍ഭയന്‍
ବୀରତ୍ବପୂର୍ଣ୍ଣ: ധൈര്യപൂറ്വ്വം ധീരതയോടെ ധൈര്യത്തോടെ വീര്യത്തോടെ തന്റേടത്തോടെ മനക്കരുത്തോടെ.
ବୁଢା: വയസ്സായ.
ବୁଢୀ: വയസ്സായ_സ്ത്രീ വ്ര്ദ്ധ_സ്ത്രീ.‌
ବୁଣା: വിതച്ച
ବୁଣା_ହୋଇନଥିବା: വിതക്കാത്ത
ବୁଣାଜମି: ഉഴുത.
ବୁଣାଳି: വിതയ്ക്കുന്ന വിത്തു_പാകുന്ന വിത്തു_നടുന്ന.
ବୁଣିବା_ଯୋଗ୍ୟ: വിതയ്ക്കാവുന്ന വിതയ്ക്കാന്_പറ്റിയ നടാവുന്ന പാകവുന്ന.
ବୁଦ୍ଧିଆ: അറിവുള്ള ബോധപൂര്‍ണ്ണമായ.
ବୁଦ୍ଧିଜୀବି: ബുദ്ധി_ജീവി.
ବୁଦ୍ଧିବାଦୀ: നിരീശ്വരവാദി.
ବୁଦ୍ଧିମାନ: അറിവുള്ള ബോധപൂര്‍ണ്ണമായ. നിപുണനായ സമര്‍ഥനായ മിടുക്കുള്ള ചാതുര്യമുള്ള
ବୁଦ୍ଧିମାନ୍‌: ബുദ്ധിമാന്‍ ധാരണാശക്‌തിയുള്ള വിവേകമുള്ള
ବୁରୁଣ୍ଡି: ബുറുണ്ടീയ.
ବୁରୁଣ୍ଡିୟାନ୍: ബുറുണ്ടീയ.
ବୁଲଗେରି: ബുള്ഗേരിയയുടെ
ବୁଲାଟିଆ: അലഞ്ഞു_തിരിയുന്ന.
ବୁଲାଣି: വളവും_തിരിവും_ഉള്ള_.
ବୁଲାପ୍ରିୟ: അലഞ്ഞു_തിരിയുന്ന.
ବୃକ୍ଷହୀନ: സാസ്യങ്ങളില്ലാത്ത.
ବୃତ୍ତାକାର: ഗോളാകൃതി വൃത്താകൃതി
ବୃଦ୍ଧ: വയസ്സായ.
ବୃଦ୍ଧା: വയസ്സായ_സ്ത്രീ വ്ര്ദ്ധ_സ്ത്രീ.‌
ବୃଦ୍ଧିକାରୀ: വര്ദ്ധിപ്പിക്കുന്ന.
ବୃଷ୍ଟି: ശക്തിയായ_മഴ.
ବୃହତ: ഭാരിച്ച.
ବୃହତ|: വളരെ_വലിയ ബ്ര്ഹത്തായ.‌
ବେକାର: പണിയെടുക്കാത്ത. ഉപയോഗശൂന്യ്മായ. അകാരണമായ
ବେଠିକ: അനുചിതമായ അയുക്‌തമായ ശരിയല്ലാത്ത ഔചിത്യമില്ല്ലാത്ത അരുതാത്ത
ବେଢଙ୍ଗ: വിരൂപമായ.
ବେତନପ୍ରାପ୍ତ: ശംബളം_പറ്റി_ജോലി__ചെയ്യുന്ന.
ବେତନଭୋଗୀ: ശംബളം_പറ്റി_ജോലി__ചെയ്യുന്ന.
ବେଦମ: സാമര്ഥ്യം_ഇല്ലാത്ത.
ବେନିନୀ: ബെനീനിയ.
ବେନିନୀଜ୍: ബെനീനിയ.
ବେପରୁଆ: കൂസലില്ലാത്ത.
ବେପରୱା: കൂസലില്ലാത്ത.
ବେପାରୀ: വീടില്ലാത്തവര്.
ବେମାର: രോഗി രോഗാതുരന്‍ രോഗബാധിതന്‍
ବେରସ: രസഹീനമായത്.
ବେଲରସୀ: ബേല്രസ്സിന്റെ. ബേല്രസ്സിന്റെ_.
ବେଲରସୀୟ: ബേല്രസ്സിന്റെ.
ବେଲ୍ଜିୟମୀ: ബെല്‍ജിയക്കാരുടെ. ബെല്‍ജിയം.
ବେଲ୍ଜିୟମୀୟ: ബെല്‍ജിയക്കാരുടെ.
ବେଶି: കുറേ_കൂടി_ഭേദമായ കൂടുതല്_മെച്ചപ്പെട്ടതായ.
ବେଶିଙ୍ଗା_: കൊമ്പില്ലാത്തതായ.
ବେଶ୍ୟାଗାମୀ: വേശ്യയെ_പ്രാപിക്കുന്ന.
ବେଶ୍ୟାସକ୍ତ: വേശ്യയെ_പ്രാപിക്കുന്ന.
ବେଷ୍ଟିତ: ചുറ്റപ്പെട്ട ചുറ്റിയ.
ବେସାହାରା: അനാഥന്
ବେସୁମାରୀ: അസംഖ്യം.
ବେହିଆ: നാണ്മില്ലാത്ത.
ବେହୋସ୍: ബോധമില്ലാത്ത.
ବୈକଳ୍ପିକ: ഇച്ഛയനുസരിച്ചുള്ള തിരഞെടുക്കാനുള്ള ആഗ്രഹന്മനുസരിച്ചുള്ള തിതമനുസരിച്ചുള്ള അഭിലാഷം_അനുസരിച്ചുള്ള ഇച്ഛിത ഉദ്ദിഷ്ടമായ താ‍ത്പര്യമുള്ള തിതകരമായ.
ବୈଜ୍ଞାନିକ_: ശാസ്ത്രപരമായ.
ବୈତନିକ: ശംബളം_പറ്റി_ജോലി__ചെയ്യുന്ന.
ବୈଦ୍ୟୁତିକ: വൈദ്യുതിയുടെ.
ବୈରପୂର୍ଣ୍ଣ: ശത്രു_ഭാവത്തോടു_കൂടി വൈരാഗ്യപൂര്‍വ്വം_.
ବୈଷୟିକ: സാങ്കേതിക.
ବୈୟକ୍ତିକ: വ്യക്തിപരമായ സ്വകാര്യ്മായ തനതായ സ്വയംക്ര്‌തമായ സ്വീയമായ സ്വകീയമായ തന്റ്റേതായ സ്വന്തമായ രഹസ്യമായ വൈക്ത്യമായ അനന്യമായ.
ବୋଟ୍_ସ୍ବାନା: ബോസ്വാനീയ
ବୋଧଗମ୍ୟ: മനസ്സിലാക്കാവുന്ന ധരിക്കാവുന്ന. മനസ്സിലാക്കാവുന്ന ധരിക്കാവുന്ന. സ്പഷ്ടമായ വ്യക്തമായ സ്ഫുടമായ
ବୋଧାତୀତ: ജയിക്കാന്_പറ്റാത്ത.
ବୋଧିତ: പറഞ്ഞ
ବୋଧ୍ୟ: മനസ്സിലാക്കാവുന്ന ധരിക്കാവുന്ന.
ବୋସନିଆଈ: ബോസ്നിയായിലെ ബോസിനായിലുള്ള
ବୋସନିୟାଈ: ബോസ്നിയായിലെ ബോസിനായിലുള്ള
ବୌଦ୍ଧ: ബുദ്ധമതത്തെ_സംബന്ധിക്കുന്ന.
ବୌଦ୍ଧ_ଧର୍ମାବଲମ୍ବୀ: ബുദ്ധനെ_സംബന്ധിച്ച.
ବୌଦ୍ଧ|: ബുദ്ധനെ_സംബന്ധിച്ച.
ବୌଦ୍ଧିକ: ബുദ്ധിപരമായ.
ବ୍ରହ୍ମାଣ୍ଡୀୟ: ഈശ്വരന്_സ്രിഷ്ട്ടിച്ച_സമ്പൂര്ണ്ണ_വസ്തുക്കളുടേയും_സമൂഹത്തെ_സംബന്ധിക്കുന്നത്.
ବ୍ରାଜିଲିୟାନ୍_: ബ്രസീലിലെ.
ବ୍ରିଟିଶ: ബ്രിട്ടീഷ് ബ്രിട്ടനിലെ
ବ୍ୟକ୍ତ: വ്യക്തമാക്കപ്പെട്ട സ്പഷ്ട്ടമായ.
ବ୍ୟକ୍ତିଗତ: വ്യക്തിപരമായ സ്വകാര്യ്മായ തനതായ സ്വയംക്ര്‌തമായ സ്വീയമായ സ്വകീയമായ തന്റ്റേതായ സ്വന്തമായ രഹസ്യമായ വൈക്ത്യമായ അനന്യമായ.
ବ୍ୟଗ୍ର: തത്പരമായ ആഭിമുഖ്യമുള്ള പ്രതിപത്തിയുള്ള ശുഷ്കാന്തിയുള്ള വാഞ്ജയുള്ള താല്‍പര്യമുള്ള ഉത്സാഹമുള്ള സന്നദ്ധതയുള്ള
ବ୍ୟଙ୍ଗାତ୍ମକ: പരിഹാസപൂര്‍വം
ବ୍ୟବସ୍ଥାହୀନ: ക്രമപ്പെടുത്തപ്പെടാത്ത വ്യവസ്ഥയില്ലാത്ത മര്യാദയില്ലാത്ത.
ବ୍ୟବସ୍ଥିତ: ക്രമപ്പെടുത്തപ്പെട്ട നിശ്ച്ചിതമായ വ്യവസ്ഥപ്പെടുത്തിയ.
ବ୍ୟବହାର_ଅକୁଶଳ: വ്യവഹാരസംബന്ധമല്ലാത്ത തൊഴില്_സംബന്ധമല്ലാത്ത.
ବ୍ୟବହାର_କୁଶଳ_: പെരുമാറുന്നതില്‍_സമര്‍ഥനായ.
ବ୍ୟବହାରିକ: ഉപയോഗമുള്ള ഗുണമുള്ള പ്രയോജനകരമായ പ്രയോജനപ്രദമായ ഉപയോഗയോഗ്യമായ യൌഗികമായ പ്രയുക്തമായ കൊള്ളാവുന്ന പറ്റിയ.
ବ୍ୟବହାର୍ଯ୍ୟ: ഉപയോഗമുള്ള ഗുണമുള്ള പ്രയോജനകരമായ പ്രയോജനപ്രദമായ ഉപയോഗയോഗ്യമായ യൌഗികമായ പ്രയുക്തമായ കൊള്ളാവുന്ന പറ്റിയ.
ବ୍ୟବହୃତ: പ്രയോഗിച്ച ഉപയോഗിച്ച.
ବ୍ୟଭିଚାରିଣୀ: പരപുരുഷനുമായി_ലൈംഗികബന്ധം_പുലര്ത്തുന്നവള്.
ବ୍ୟଭିଚାରୀ: നീച_വികാരങളുള്ള കാമാദ്ദീപകമായ.
ବ୍ୟର୍ଥ: ഉപയോഗശൂന്യ്മായ.
ବ୍ୟସ୍ତ: തിരക്കുള്ള
ବ୍ୟାକୁଳ: ഇളകിമറിഞ്ഞ തകിടം_മറിഞ്ഞ.
ବ୍ୟାକୁଳତାହୀନ_: ഉത്കണ്ഠയില്ലാത്ത
ବ୍ୟାପକ: പരന്ന വ്യാപിച്ചിരിക്കുന്ന.
ବ୍ୟୟଶୀଳ: നന്നായി_ചിലവു_ചെയ്യുന്ന ദുര്‍വ്യയം_ചെയ്യുന്ന.
ବ୍ୟୟୀ: നന്നായി_ചിലവു_ചെയ്യുന്ന ദുര്‍വ്യയം_ചെയ്യുന്ന.
ବୟସ୍କ: പ്രായ_പൂര്ത്തിയായ.
ବୟାଅଶୀତମ: എണ്ണപത്തി_രണ്ടാം
ବୟାନବେ: തൊണ്ണൂറ്റി_രണ്ട്.
ବୟାନବେତମ: തൊണ്ണൂറ്റി_രണ്ട്
ବୟୋଜ୍ୟେଷ୍ଠ_: വയസ്സായ.
ଭକ୍ଷ: ഭക്ഷണയോഗ്യമായ ഭക്ഷണ_പദാര്‍ഥം.
ଭକ୍ଷକ: ഭക്ഷിക്കുന്നവന്‍ തിന്നുന്നവന്‍ ഉണ്ണുന്നവന്‍ ഭുജിക്കുന്നവന്‍ തീന്‍_കഴിക്കുന്നവന്‍ അകത്താക്കുന്നവന്‍ വാരി_വിഴുങുക. തിന്നുന്ന ഭക്ഷിക്കുന്ന കഴിക്കുന്ന ഭോജിക്കുന്ന ആഹരിക്കുന്ന.
ଭକ୍ଷୀ: ഭക്ഷിക്കുന്നവന്‍ തിന്നുന്നവന്‍ ഉണ്ണുന്നവന്‍ ഭുജിക്കുന്നവന്‍ തീന്‍_കഴിക്കുന്നവന്‍ അകത്താക്കുന്നവന്‍ വാരി_വിഴുങുക.
ଭଗ୍ନ: കഷണമായത്. മുറിക്കുന്ന
ଭଗ୍ନପୃଷ୍ଠ: പൊട്ടിയ_മുതുകെല്ല്.
ଭଙ୍ଗା: തകര്‍ത്ത നിലത്തു_വീണ. കഷണമായത്. മുറിക്കുന്ന
ଭଙ୍ଗୁର: നശിക്കുന്ന.
ଭଙ୍ଗୁରଶୀଳ: ഉടയ്ക്കാവുന്ന.
ଭଞ୍ଜନଶୀଳ_: ഉടയ്ക്കാവുന്ന.
ଭଦ୍ର: ഉത്തമനായ സര്‍വ്വശ്റേഷ്ടനായ അതിവിശിഷ്ടനായ ഉല്‍കൃഷ്ടനായ അതുല്യനായ അദ്വിതീനായ മികവുള്ളവനായ സജ്ജനം കുലീനനായ മാന്യനായ മര്യാദയുള്ള.
ଭବିତବ୍ୟ: വരാന്‍_പോകുന്ന ഭാവികാലത്തെ_സംബന്ധിച്ച.
ଭବିଷ୍ୟ_କାଳୀନ: വരാന്‍_പോകുന്ന ഭാവികാലത്തെ_സംബന്ധിച്ച.
ଭମଣପ୍ରିୟ: അലഞ്ഞു_തിരിയുന്ന.
ଭରପୂର: പരിപൂര്ണ്ണന്. പൂര്‍ണ്ണമായ നിറഞ്ഞു_കവിഞ്ഞ
ଭରା: പരിപൂര്ണ്ണന്.
ଭର୍ତ୍ତି: നിറഞ്ഞു_കവിഞ്ഞ
ଭର୍ସିତ: ഉപേക്ഷിക്കപ്പെട്ട തിരസ്ക്കരിക്കപ്പെട്ട
ଭଲ: നല്ല നന്മയുള്ള വലിയ ഉത്തമമായ ഗുണമുള്ള മെച്ചപ്പെട്ട വൈശിഷ്ട്യമുള്ള സദ്ഗുണമുള്ള ഗുണകരമായ ശുദ്ധമായ ഉതകുന്ന കൊള്ളാവുന്ന. സജ്ജനം കുലീനനായ മാന്യനായ മര്യാദയുള്ള. ശുദ്ധമായതു. സ്വാദിഷ്ട്ടമായ. നല്ല.
ଭଲ_: ഗുണമേന്മയുള്ള
ଭଳି: ഒരു_പോലെയുള്ള സമാനരൂപിയായ
ଭାଗ୍ୟବାଦୀ: എല്ലാം_ഭാഗ്യത്തിനധീനമെന്നു_വിശ്വസിക്കുന്ന.
ଭାଗ୍ୟବାନ_: സൌഭാഗ്യമുള്ള ഭാഗ്യമുള്ള.
ଭାଗ୍ୟଶାଳୀ: സൌഭാഗ്യമുള്ള ഭാഗ്യമുള്ള.
ଭାଗ୍ୟହୀନ: ദുര്ഭാഗ്യശാലി.
ଭାବ_ପ୍ରବଣ|: മ്രിദുല_വികാരങള്ക്ക്_അടിമപ്പെടുന്ന.
ଭାବନାତ୍ମକ: ഭാവനാത്മകമായ.
ଭାବନାପୂର୍ଣ୍ଣ: ഭാവനാത്മകമായ.
ଭାବନାହୀନ: ഭാവരഹിത്മായ വികാരരഹിതമായ.
ଭାବପୂର୍ଣ୍ଣ: ഭാവനാത്മകമായ.
ଭାବହୀନ: ഭാവരഹിത്മായ വികാരരഹിതമായ. നിരപ്പായ മിനുസമായ.
ଭାବାତ୍ମକ: ഭാവനാത്മകമായ.
ଭାବାବିଷ୍ଟ: ഊടും_പാവും_പോലെ_കോര്ക്കപ്പെട്ട.
ଭାବୁକ: മ്രിദുല_വികാരങള്ക്ക്_അടിമപ്പെടുന്ന.
ଭାରହୀନ: ആകുലതയില്ലാത്ത.
ଭାରି: ഭാരിച്ച കനത്ത തൂക്കമുള്ള
ଭାରୀ: മഹത്ത്വമുള്ള ശ്രേഷ്ഠമായ ഗംഭീരമായ ഉല്ക്ര്ഷ്ടമായ പ്രൌഢമായ ഉത്തമമായ വിശിഷ്ഠമായ സ്തുത്യറ്ഹമായ മികച്ച മഹിമയുള്ള.
ଭାଷାନ୍ତରକାରୀ: വിവവ്ര്ത്തകന്‍.
ଭାଷାନ୍ତରଣୀୟ: തര്‍ജ്ജിമചെയ്യാവുന്ന.
ଭାଷାନ୍ତରିତ: ഭാഷാന്തരം_ചെയ്യപ്പെട്ട തര്‍ജ്ജിമ_ചെയ്യപ്പെട്ട വിവര്‍ത്തനം_ചെയ്യപ്പെട്ട ഭാഷാന്തരം_ചെയ്യപ്പെട്ട.
ଭାସମାନ: പൊങ്ങികിടക്കുന്ന പൊന്തി_കിടക്കുന്ന.
ଭାସୁଥିବା: പൊങ്ങികിടക്കുന്ന പൊന്തി_കിടക്കുന്ന.
ଭିଏତନାମୀ: വിയത്നാമിന്റെ.
ଭିଜା: നനവുള്ള ഈറനായ ആറ്‍ദ്രമായ കുതിറ്‍ന്ന ഈറ്‍പ്പമുള്ള കുതിര്‍ന്ന
ଭିତରର: ആന്തരികമായ.
ଭିତରିଆ_ପ୍ରାଣୀ: ഉള്ളില്_വസിക്കുന്ന.
ଭିତ୍ତିହୀନ: ആശ്രയമില്ലാത്ത അടിസ്ഥാനമില്ലാത്ത.
ଭିନ୍ନ: മറ്റൊന്ന് രണ്ടാമത് അതല്ലാത്തത്.
ଭିନ୍ନଜାତୀୟ: വിഭിന്ന_ജാതിയിപ്പെട്ട.
ଭୀମକାୟ: ഭീമകായനായ വളരേ_വലിയ.
ଭୀରୁ: ഭീരുത്വമുള്ള ഭയശീലമുള്ള ആണത്തമില്ലാത്ത നെഞ്ഞുരപ്പില്ലാത്ത
ଭୀଷଣ: ഭയാനകമായ ഭീകരമായ ഉഗ്രമായ ഞെട്ടിക്കുന്ന ഭീതിജനകമായ ഭയാവഹമായ രുദ്രമായ ദാരുണമായ.
ଭୁକ୍ତଭୋଗୀ: വിഷയാസക്തനായ സുഖാന്വേഷിയായ അനുഭവസ്ഥന്‍ ദു
ଭୁତଭରା: ഭൂതത്തെ_സംബന്ധിക്കുന്ന.
ଭୁଲ: നുണ കള്ളം അസത്യം
ଭୁଲିହୋଇଯାଇଥିବା|: മറന്നു_പോയ.
ଭୁଷୁଡିପଡିଥିବା: തകര്‍ത്ത നിലത്തു_വീണ.
ଭୂଟାନୀ: ഭൂട്ടാന്‍കാരുടെ ഭൂട്ടാനിലെ_ഭാഷയിലുള്ള
ଭୂତ: കഴിഞ്ഞുപോയ.
ଭୂତ_ବିଷୟକ|: ഭൂതത്തെ_സംബന്ധിക്കുന്ന.
ଭୂତକାଳର: പശ്ഴയ_കാലത്തെ.
ଭୂମଣ୍ଡଳୀୟ: ഭൂപ്രദേശത്തിന്റെ വിശ്വത്തിന്റെ.
ଭୂମିସାତ: ഭൂമിയോട്_സമാനമായി.
ଭୂଲୁଣ୍ଠିତ: ഭൂമിയില്‍_വീണ_.
ଭୂଷିତ: അലങ്കരിച്ച ആഭരണമണിഞ്ഞ അലങ്ക്ര്തമായ. വേഷമിട്ട.
ଭେଦକ: വേര്‍തിരിക്കുന്ന. വേര്‍തിരിക്കുന്ന.
ଭେଦକାରୀ: വേര്‍തിരിക്കുന്ന. വേര്‍തിരിക്കുന്ന. ഭേദിച്ച.
ଭେଦନୀୟ: തുളയ്ക്കാവുന്ന മുറിവേല്‍പ്പിക്കാവുന്ന നിരീക്ഷിക്കാവുന്ന.
ଭେଦିତ: വേര്തിരിക്കുക. ഭേദിച്ച.
ଭେଦୀ: തുളയ്ക്കാവുന്ന മുറിവേല്‍പ്പിക്കാവുന്ന നിരീക്ഷിക്കാവുന്ന. വേര്‍തിരിക്കുന്ന.
ଭେଦ୍ୟ: തുളയ്ക്കാവുന്ന മുറിവേല്‍പ്പിക്കാവുന്ന നിരീക്ഷിക്കാവുന്ന.
ଭେନେଜୁଏଲାନ୍: വെനിസ്വേലേയനായ വെനിസ്വേലേയന്
ଭେନେଜୁଏଲାବାସୀ: വെനിസ്വേലേയനായ വെനിസ്വേലേയന്
ଭୋକିଲା: വിശന്നിരുന്ന ബുഭുക്ഷയുള്ള വയറു_കാലിയായ
ଭୋକିଲା|: പട്ടിണിയായ.
ଭୋଗଲିପ୍ସୁ: സ്ത്രീ_ലംബടനായ വിലാസപ്രിയനായ ഭോഗപ്രിയനായ.
ଭୋଗୀ: വിഷയാസക്തനായ സുഖാന്വേഷിയായ അനുഭവസ്ഥന്‍ ദു
ଭୋଜକ: തിന്നുന്ന ഭക്ഷിക്കുന്ന കഴിക്കുന്ന ഭോജിക്കുന്ന ആഹരിക്കുന്ന.
ଭୋଜନକର୍ତ୍ତା: തിന്നുന്ന ഭക്ഷിക്കുന്ന കഴിക്കുന്ന ഭോജിക്കുന്ന ആഹരിക്കുന്ന.
ଭୋଜନକାରୀ: തിന്നുന്ന ഭക്ഷിക്കുന്ന കഴിക്കുന്ന ഭോജിക്കുന്ന ആഹരിക്കുന്ന.
ଭୋଜ୍ୟ: ഭക്ഷണയോഗ്യമായ ഭക്ഷണ_പദാര്‍ഥം.
ଭୌତିକ: ജഡം.
ଭ୍ରମରହିତ: സന്ദേഹത്തിലകപ്പെടാത്ത ഭ്രമത്തില്‍_പെടാത്ത.
ଭ୍ରଷ୍ଟ: ദുശ്ചരിത്രം.
ଭ୍ରଷ୍ଟାଚାରୀ: ദുശ്ചരിത്രം.
ଭ୍ରାନ୍ତରୋପିତ: തെറ്റിദ്ധരിച്ച
ଭ୍ରାନ୍ତିଶୂନ୍ୟ: സന്ദേഹത്തിലകപ്പെടാത്ത ഭ്രമത്തില്‍_പെടാത്ത.
ଭୟଂକର: അപകടകരമായ.
ଭୟଗ୍ରସ୍ତ: ഭയവിഹ്വലനായ.
ଭୟଙ୍କର: ഭയാനകമായ ഭീകരമായ ഉഗ്രമായ ഞെട്ടിക്കുന്ന ഭീതിജനകമായ ഭയാവഹമായ രുദ്രമായ ദാരുണമായ.
ଭୟପୂର୍ଣ୍ଣ: ഭയപൂര്ണ്ണമായ.
ଭୟଭୀତ: ഭയവിഹ്വലനായ.
ଭୟଯୁକ୍ତ: ഭയവിഹ്വലനായ.
ଭୟଶୂନ୍ୟ: രക്ഷിക്കുന്ന.
ଭୟାକୁଳ: പേടിച്ച.
ଭୟାକ୍ରାନ୍ତ: പേടിച്ച.
ଭୟାନକ: ഭയാനകമായ ഭീകരമായ ഉഗ്രമായ ഞെട്ടിക്കുന്ന ഭീതിജനകമായ ഭയാവഹമായ രുദ്രമായ
ଭୟାନ୍ବିତ: ഭയവിഹ്വലനായ.
ମଂଜୁଳ: ആകര്‍ഷിക്കുന്ന ആകര്‍ഷകമായ ആകര്‍ഷണീയമായ വശ്യ മാസ്മരശക്‌തിയുള്ള മാദകമായ ചേതോഹാരിയായ ആനന്ദിപ്പിക്കുന്ന വശീകൃതമായ
ମଇଳା: മുഷിഞ്ഞ ശുചിയല്ലാത്ത അഴുക്കായ മലിനപ്പെട്ട വൃത്തിഹീനമായ
ମଉଜପ୍ରିୟ: ഉന്മാദമുള്ള ഭ്രാന്തുള്ള ഉന്മത്തനായ കിറുക്കുള്ള വട്ടുള്ള.
ମକ୍ଷୀଚୋଷ୍: പിശുക്കനായ ക്ര്പണനായ.‌
ମଗ୍ନ: മുഴുകിയ.
ମଙ୍ଗଯୁକ୍ତ: വക്കുള്ള
ମଙ୍ଗଳକାରକ: നന്മ_നല്കുന്ന
ମଙ୍ଗଳକାରୀ: നന്മ_നല്കുന്ന
ମଙ୍ଗଳଦାୟକ: നന്മ_നല്കുന്ന
ମଙ୍ଗଳପ୍ରଦ: നന്മ_നല്കുന്ന
ମଙ୍ଗୋଲ: മംഗോളിയന്‍.
ମଙ୍ଗୋଲିଆନ: മംഗോളിയന്‍.
ମଙ୍ଗୋଲିୟାନ୍: മംഗോളിയന്‍.
ମଜବୁତିଆ: ഉറപ്പുള്ള ബലമുള്ള
ମଜାଦାର: രസകരമായ തമാശക്കാരന്‍.
ମଜାଳିଆ: നര്‍മ്മബോധമുള്ള രസികത്വമുള്ള തമാശക്കാരന്‍.
ମଝି: മധ്യ_ഭാഗത്ത്.
ମଞ୍ଚୋପଯୋଗୀ: അവതരണയോഗ്യമായത്.
ମଞ୍ଜରିତ: വിടര്‍ന്ന വികസിച്ച.
ମଞ୍ଜିଆ: വിത്തുള്ള ധാന്യമുള്ള കായുള്ള ബീജമുള്ള.
ମଞ୍ଜିଯୁକ୍ତ: വിത്തുള്ള ധാന്യമുള്ള കായുള്ള ബീജമുള്ള.
ମଞ୍ଜୁର: അങ്കീകരിച്ച സ്വീകരിച്ച.
ମଞ୍ଜୁରୀପ୍ରାପ୍ତ: അങ്ഗീകാര_യോഗ്യമായ.
ମଣିପୁରୀ: മണിപ്പൂരിലെ മണിപ്പൂരി
ମଣିଷଖିଆ_: നരഭോജിയായ_രാക്ഷസന്
ମଣ୍ଡଳାକାର: ഗോളാകൃതി വൃത്താകൃതി
ମଣ୍ଡଳୀୟ: വിഭജിച്ച.
ମଣ୍ଡିତ: അലങ്കരിച്ച ആഭരണമണിഞ്ഞ അലങ്ക്ര്തമായ.
ମତାନ୍ଧ: മത_കാര്യങളില്_വിട്ടുവീഴ്ചയില്ലാത്ത.
ମଦମତ୍ତ: ലഹരി_പിടിച്ച.
ମଦୋନ୍ମତ୍ତ: ലഹരി_പിടിച്ച.
ମଧୁର: സ്വാദിഷ്ട്ടമായ. മധുര_സ്വരമുള്ള. മധുരമുള്ള മധുരിമയുള്ള മാധുര്യമുള്ള ഇനിപ്പുള്ള മധുരമുള്‍ള.
ମଧ୍ୟ: മധ്യ_ഭാഗത്ത്.
ମଧ୍ୟକାଳୀନ: മധ്യകാല.
ମଧ୍ୟବର୍ତ୍ତୀ: മധ്യ_ഭാഗത്ത്.
ମଧ୍ୟବୟସ୍କ|: മദ്ധ്യ_വയസ്ക്കനായ.
ମଧ୍ୟମ: ഇടത്തരത്തിലുള്ള ഇടത്തരമായ മധ്യമമായ.
ମଧ୍ୟଯୁଗୀୟ: മധ്യകാല.
ମନଗଢା: സങ്കല്പ_സ്ര്‌ഷ്ടിയായ.
ମନପସନ୍ଦ: മനസ്സിനിണങ്ങിയ പ്രിയപെട്ട ഇഷ്ടപെട്ട
ମନମୁଖୀ: തന്നിഷ്ടം_പോലെ സ്വന്തം_ഇഷ്ടമനുസരിച്ച് സ്വതാത്പര്യം_അനുസരിച്ച്.
ମନମୋହକ: ആകര്‍ഷിക്കുന്ന ആകര്‍ഷകമായ ആകര്‍ഷണീയമായ വശ്യ മാസ്മരശക്‌തിയുള്ള മാദകമായ ചേതോഹാരിയായ ആനന്ദിപ്പിക്കുന്ന വശീകൃതമായ
ମନା_କରାଯାଇଥିବା: നിഷേധിക്കപ്പെട്ടത് നിരോധിക്കപ്പെട്ട തടയപ്പെട്ട.
ମନୁମୋଦିତ: സ്വീകരിച്ച സ്വീകരിക്കപ്പെട്ട അനുമതി_കിട്ടിയ അനുമതി_പ്രദാനം_ചെയ്ത.
ମନୋଜ୍ଞ: സൌന്ദര്യമുള്ള സുമുഖമുള്ള ചേലുള്ള ചന്തമുള്ള
ମନୋବାଞ୍ଛିତ: ഇച്ഛിച്ച് ആഗ്രഹിച്ച താല്പര്യപ്പെട്ട.
ମନୋରଞ୍ଜକ: രസകരമായ വിനോദപ്രദമായ.
ମନୋରଞ୍ଜନପୂର୍ଣ୍ଣ: രസകരമായ വിനോദപ്രദമായ.
ମନୋରମ: ആകര്‍ഷിക്കുന്ന ആകര്‍ഷകമായ ആകര്‍ഷണീയമായ വശ്യ മാസ്മരശക്‌തിയുള്ള മാദകമായ ചേതോഹാരിയായ ആനന്ദിപ്പിക്കുന്ന വശീകൃതമായ
ମନୋହର: സൌന്ദര്യമുള്ള സുമുഖമുള്ള ചേലുള്ള ചന്തമുള്ള ആകര്‍ഷിക്കുന്ന ആകര്‍ഷകമായ ആകര്‍ഷണീയമായ വശ്യ മാസ്മരശക്‌തിയുള്ള മാദകമായ ചേതോഹാരിയായ ആനന്ദിപ്പിക്കുന്ന വശീകൃതമായ
ମନ୍ତବ୍ୟ_: സ്വീകാര്യമായ
ମନ୍ଥନ_ଯୋଗ୍ୟ: കടയുവാനുള്ള.
ମନ୍ଥର: മന്ദം സാവധാനം അകലെ_കാണുന്ന വിവേകമുള്ള പണ്ഡിതാന്‍.
ମନ୍ଦ: മന്ദം സാവധാനം അകലെ_കാണുന്ന വിവേകമുള്ള പണ്ഡിതാന്‍. മടിയുള്ള അലസതയുള്ള. ബസാറിനോട്_ബന്ധപ്പെട്ട തരം_താണ്.
ମପା: തൂക്കിയ
ମରକ୍କାନ୍: മോസ്കോവിയന്
ମରକ୍କୋ_ସମ୍ବନ୍ଧୀ: മോസ്കോവിയന്
ମରାଠି: മറാഠിയിലെ മഹാരാഷ്ട്രയിലെ മറാഠി മറാഠി
ମରାଠୀ: മറാഠി_മാത്ര്ഭാഷയായ
ମରିଶିଆନ: മൌറീഷ്യസ്യന്_.
ମରିସସ_ସମ୍ବନ୍ଧୀ: മൌറീഷ്യസ്യന്_.
ମରୁଭୂମିସ୍ଥିତ: മ്രുഭൂമിയ.
ମରୁଭୂମୀୟ: മ്രുഭൂമിയ.
ମରୁସ୍ଥଳୀୟ: മ്രുഭൂമിയ.
ମଲୟାଲମ: മലയാള
ମଲୟାଲୀ: മലയാളിയായ മലയാള
ମଳିନ: മുഷിഞ്ഞ
ମସଗୁଲ: മുഴുകിയ.
ମସଲାଦାର: മസാലയുള്ള.
ମସୃଣ_: ലോലമായ
ମସ୍ତିଷ୍କୀୟ: തലച്ചോറിനെ_സംബന്ധിക്കുന്ന.
ମହଙ୍ଗା: വിലയേറിയ വിലപിടിച്ച. വില_പിടിച്ച വിലപിടിപ്പുള്ള വിലയേറിയ മൂല്യമേറിയ
ମହଜୁଦ: ഒരാവശ്യത്തിന്‍_വെച്ചിട്ടുള്ള.
ମହତାକାଂକ୍ଷୀ: ഔന്നത്ത്യത്തിനുള്ള_അഭിലാഷം വലുതാകാനുള്ള_ആഗ്രഹം.
ମହତ୍ତ୍ବପୂର୍ଣ୍ଣ: മഹത്വപൂര്ണ്ണമായ.
ମହତ୍ବହୀନ: മഹത്വമില്ലാത്ത.
ମହଲା: പല_നിലകളുള്ള.
ମହା: വലിയ ശ്രേഷ്ഠമായ.
ମହାକାଶୀୟ: ജ്യോതിശാസ്ത്രപരമായ.
ମହାକାୟ: ഭീമകായനായ വളരേ_വലിയ.
ମହାଦ୍ବୀପୀୟ: ഭൂഖണ്ഡ.
ମହାନ: മഹാനായ ശ്രേഷ്ഠനായ ഉന്നതനായ വിശിഷ്ടനായ
ମହାନଗରୀୟ: മഹാനഗരങളെ_സംബന്ധിച്ച.
ମହାପାପୀ: മഹാപാപി.
ମହାବିଦ୍ୟାଳୟୀୟ_: കലാലയത്തിലെ.
ମହାରାଷ୍ଟ୍ରୀ: മറാഠിയിലെ മഹാരാഷ്ട്രയിലെ
ମହାର୍ଗ୍ୟ: വിലയേറിയ വിലമതിക്കാനാവാത്ത വിലപിടിച്ച
ମାଂସଳ: നല്ലവണ്ണം_മാംസമുള്ള തടിച്ച.
ମାଂସଳ|: കഴമ്പുള്ള.
ମାଆହୀନ: അമ്മയില്ലാത്ത മാത്ര്ഹീനന്‍.‌
ମାଇଁଶାଶୁ: അമ്മാവന്റെ_മകന്‍.
ମାଉସୀପୁଅ: മാതൃസഹോദരിയെ_സംബന്ധിക്കുന്ന.
ମାଗୁଣିଆ: വളരെ_താഴ്മയോടെ_യാചിക്കുക.
ମାଗୁଥିବା_ବ୍ୟକ୍ତି_: വളരെ_താഴ്മയോടെ_യാചിക്കുക.
ମାଟିଆ: പൊടി_നിറഞ്ഞ മണ്ണു_നിറഞ്ഞ
ମାଡାଗାସ୍କାର_ସମ୍ବନ୍ଧୀ: മഡഗാസ്കറിയന്
ମାଡାଗାସ୍କାରୀ: മഡഗാസ്കറിയന്
ମାଡିଥିବା: ആരോഹണം_ചെയ്യപ്പെട്ട
ମାତାବିହୀନ: അമ്മയില്ലാത്ത മാത്ര്ഹീനന്‍.‌
ମାତାଲ: ലഹരി_പിടിച്ച.
ମାତାହୀନ: അമ്മയില്ലാത്ത മാത്ര്ഹീനന്‍.‌
ମାତୃବିହୀନ: അമ്മയില്ലാത്ത മാത്ര്ഹീനന്‍.‌
ମାତୃହୀନ: അമ്മയില്ലാത്ത മാത്ര്ഹീനന്‍.‌
ମାତ୍ର: മാത്രം ഒറ്റയ്ക്ക് പൂര്ണ്ണമായ.
ମାତ୍ର_ଗୋଟିଏ: ഒരേയൊരു.
ମାଦକ: ലഹരിയുണ്ടാക്കുന്ന ലഹരി_ബാധിച്ച.
ମାଦ୍ରାସୀ: മദ്രാസി.
ମାନନୀୟ: ബഹുമാനിക്കപ്പെട്ട ആദരിക്കപ്പെട്ട.
ମାନନୀୟା: ആദരിക്കപ്പെട്ട.
ମାନବ_କୃତ: മനുഷ്യ_നിര്മ്മിതം.
ମାନବ_ଚାଳିତ: മനുഷ്യചലിതമായ.
ମାନବ_ନିର୍ମିତ: മനുഷ്യ_നിര്മ്മിതം.
ମାନବ_ରଚିତ|: മനുഷ്യ_നിര്മ്മിതം.
ମାନବଭକ୍ଷକ: നരഭോജിയായ മനുക്ഷ്യനെ_ഭക്ഷിക്കുന്ന.
ମାନବିକ: മനുഷ്യ_സംബന്ധിയായ മാനുഷികമായ.
ମାନବୀକୃତ: മനുഷ്യത്വമാരോപിക്കപ്പെട്ട.
ମାନବୀୟ: മനുഷ്യ_സംബന്ധിയായ മാനുഷികമായ.
ମାନବୋଚିତ: മനുഷ്യോചിതമായ.
ମାନସିକ: ബുദ്ധിപരമായ.
ମାନସିକ_: മനസ്സിനെ_സംബന്ധിക്കുന്ന.
ମାନହାନି_: നിന്ദിക്കപ്പെട്ട അധിക്ഷേപിക്കപ്പെട്ട.
ମାନିବା: വിശ്വസിക്കുന്ന സമ്മതിക്കുന്ന അംഗീകരിക്കുന്ന.
ମାନ୍ଦା: കുറയുക.
ମାନ୍ୟ: അങ്ഗീകാര_യോഗ്യമായ. ബഹുമാനിക്കപ്പെട്ട ആദരിക്കപ്പെട്ട.
ମାନ୍ୟା: ആദരിക്കപ്പെട്ട.
ମାପନୀୟ: അളക്കാവുന്ന
ମାପଯୋଗ୍ୟ: അളക്കാവുന്ന അളക്കുവാന്‍_പറ്റുന്നത്.
ମାମୁଲି: പ്രാധാന്യമില്ലാത്ത. സാധാരണ.
ମାରକ: കൊല്ലുന്നവന്‍ നശിപ്പിക്കുന്നവന്‍.
ମାରବାଡୀ: മാര്‍വാടി മാര്‍വാടി
ମାର୍ମିକ: ഭാവനാത്മകമായ.
ମାଲିକବିହୀନ: അവകാശികളില്ലാത്ത അനാഥനായ.
ମାଲୁମ୍: അറിവുള്ള
ମାଲେସିଆନ୍: മലേഷ്യന്‍.
ମାଳଦ୍ବୀପୀୟ: മാലദ്വീപിയന്‍
ମାଳୟାଳୀ: മലയാളികളുടെ
ମାହାଳିଆଖିଆ: പണിയെടുക്കാതെ_ജീവിക്കുന്ന.
ମାୟାରହିତ_: ആസക്തനല്ലാത്ത.
ମାୟାଶୂନ୍ୟ: ആസക്തനല്ലാത്ത.
ମାୟାହୀନ: ആസക്തനല്ലാത്ത.
ମିଆଦୀ: ത്വണകളായുള്ള ഗടുക്കളായുള്ള.
ମିଛ: നുണ കള്ളം അസത്യം
ମିଛୁଆ: നുണയന്‍ അസത്യം_പറയുന്നവന്‍ അസത്യം_പറയുന്നവന്‍ എതിര്‍_വാദം_ചെയ്യുന്നയാള്‍ കള്ളം_പറയുന്നയാള്‍.
ମିଜୋ: മീസൊ.
ମିଠା: മധുര_സ്വരമുള്ള. മധുരമുള്ള മധുരിമയുള്ള മാധുര്യമുള്ള ഇനിപ്പുള്ള മധുരമുള്‍ള.
ମିତବ୍ୟୟୀ: ചിലവു_ചുരുക്കുന്ന പാഴ്_ചിലവൊഴിവാക്കുന്ന.
ମିତଭାଷୀ|: അല്പം_സംസാരിക്കുന്നത്.
ମିତାହାରୀ: അല്പമായും_ക്രമീക്ര്‌തമായും_ആഹാരം_കഴിക്കുന്ന മിതമായി_ഭക്ഷിക്കുന്ന സ്വല്പം_ഭക്ഷിക്കുന്ന.
ମିତ୍ରତାପୂର୍ଣ୍ଣ: മിത്രത മിത്രോചിതമായ_.
ମିତ୍ରବାନ୍‌: കൂട്ടുകാരോടു_കൂടിയ.
ମିତ୍ରଭଳି: മിത്രത മിത്രോചിതമായ_.
ମିତ୍ରହୀନ: കൂട്ടുകാരില്ലാത്ത.
ମିତ୍ରୋଚିତ୍ତ: മിത്രത മിത്രോചിതമായ_.
ମିଥ୍ୟା: നുണ കള്ളം അസത്യം
ମିଥ୍ୟାବାଦୀ: നുണയന്‍ അസത്യം_പറയുന്നവന്‍ അസത്യം_പറയുന്നവന്‍ എതിര്‍_വാദം_ചെയ്യുന്നയാള്‍ കള്ളം_പറയുന്നയാള്‍.
ମିଥ୍ୟାରୋପିତ: തെറ്റിദ്ധരിച്ച
ମିଥ୍ୟାସାକ୍ଷୀ: ക്രിത്രിമമായ_രേഖയുണ്ടക്കുന്ന വ്യാജമായ_രേഖയുണ്ടാക്കുന്ന തെറ്റായ_രേഖയുണ്ടാക്കുന്ന.
ମିଲିୟନ: പത്ത്_ലക്ഷം മില്ല്യണ്‍ 100000.
ମିଳିତ: മിശ്രിതം. ചേര്ച്ചയുള്ള
ମିଳିଥିବା: കിട്ടിയ നേടിയ.
ମିଶନାରୀ: വൈദികന്‍.
ମିଶରୀୟ: ഈജിപ്ഷ്യന്‍.
ମିଶ୍ର: മിശ്രിതം.
ମିଶ୍ରଣ: മിശ്രിതം.
ମିଶ୍ରଣୀୟ: കലറ്ത്താന്‍_യോഗ്യമായ കൂട്ടിയോജിപ്പിക്കാന്‍_യോഗ്യമാ‍യ കൂട്ടിചേറ്ക്കാന്‍_യോഗ്യമായ.
ମିଶ୍ରିତ: മിശ്രിതം.
ମିଷ୍ଟ: മധുരമുള്ള മധുരിമയുള്ള മാധുര്യമുള്ള ഇനിപ്പുള്ള
ମୁକରିର: നിയുക്തനാക്കിയ.
ମୁକୁଳିତ: പൂക്കുന്ന പുഷ്പ്പിക്കുന്ന.
ମୁକ୍ତ: സ്വ്തന്ത്റനായ
ମୁଖ୍ୟ: പ്രമുഖന്‍. പ്രാഥ്മികമായ മുഖയമായ പ്രധാനമായ പ്രധാന മുഖ്യ.
ମୁଗ୍ଧ: ആസക്തനായ താല്പര്യമുള്ള വിശ്വാസമുള്ള അനുരാഗമുള്ള താത്പര്യമുള്ള ശുഷ്കാന്തിയുള്ള മോഹമുള്ള അനുരക്തനായ.
ମୁଠାବାଲା: മന്ത്രപ്രയോഗമുള്ള.
ମୁଠାଯୁକ୍ତ: മന്ത്രപ്രയോഗമുള്ള.
ମୁଣ୍ଡା: മൂര്‍ച്ചയില്ലാതാക്കപെട്ട മുനയില്ലാതായ
ମୁତାବିକ: യോജിക്കുന്ന അനുകൂലമായ ചേര്‍ച്ചയുള്ള പൊരുത്തമുള്ള ഐക്യമുള്ള കൂടികലരുന്ന സംയോജിക്കുന്ന.
ମୁର୍ଖ: അവിവേകിയായ ജളനായ ഭോഷനായ മൂഢനായ മന്ദതയുള്ള ജളത്വമുള്ള
ମୁଲତବୀ: സതംഭിച്ച.
ମୁଲାୟମ: മൃദുവായ മൃദുലമായ പേലവമായ ലോലമായ കോമളമായ സുകുമാരമായ
ମୁହଁଟାଣ: മുഖത്തടിച്ച_പോലെ.
ମୁହାଁମୁହିଁ: മുഖത്തടിച്ച_പോലെ.
ମୂକ: മൂകന്‍
ମୂକ_: അധികം_സംസാരിക്കാത്ത
ମୂର୍ଚ୍ଛିତ: ബോധമില്ലാത്ത.
ମୂର୍ତ୍ତିବନ୍ତ: മൂര്‍തീകരിച്ച.
ମୂର୍ତ୍ତିମାନ: ആകാരമുള്ള
ମୂର୍ଦ୍ଧନ୍ୟ: മഹാനായ ശ്രേഷ്ഠനായ ഉന്നതനായ വിശിഷ്ടനായ
ମୂଲ୍ୟବାନ: വിലയേറിയ വിലമതിക്കാനാവാത്ത വിലപിടിച്ച
ମୂଲ୍ୟାତୀତ: വിലയേറിയത്.
ମୂଳ: അടിസ്ഥാനപരമായ മൌലീക യഥാറ്ത്ഥമായ തനതായ അക്ര്‌ത്രിമമായ. സ്വദേശീയ തത്സ്ഥാനത്തുള്ള ജനിച്ച_സ്ഥലത്തുള്ള.
ମୂଳଦାର: വേരുള്ള
ମୂଳହୀନ: വേരില്ലാത്ത അടിസ്ഥാനമില്ലാത്ത ആധാരമില്ലാത്ത മൂലമില്ലാത്ത മൂടില്ലാത്ത മാണമില്ലാത്ത ജടയില്ലാത്ത ശിഫയില്ലാത്ത.
ମୂଳିୟ: വേരുള്ള
ମୃତ: മരിച്ച അന്തരിച്ച സമാധിയായ മഹാനിദ്രയിലായ നിര്യാതനായ
ମୃତ_: മരിച്ചുകൊണ്ടിരിക്കുന്ന
ମୃତ୍ୟୁକାରୀ: മരിക്കുവാന്‍_ഉതകുന്ന.
ମୃତ୍ୟୁଞ୍ଜୟ: അമരന്‍ മൃത്യുഞ്ഞയന്‍ ചിരഞ്ഞീവി അമര്‍ത്യന്‍
ମୃତ୍ୟୁଞ୍ଜୟୀ: അമരന്‍ മൃത്യുഞ്ഞയന്‍ ചിരഞ്ഞീവി അമര്‍ത്യന്‍
ମୃତ୍ୟୁଶୀଳ: നശിക്കുന്ന.
ମୃଦୁଳ: മൃദുവായ മൃദുലമായ പേലവമായ ലോലമായ കോമളമായ സുകുമാരമായ
ମୃଦୁଳ|: കോമളം സുകുമാരം.
ମେକ୍ସିକାନ୍_: മെക്സിക്കന്‍ മെക്സിക്കോവിന്റെ.
ମେକ୍ସିକୋ: മെക്സിക്കന്‍ മെക്സിക്കോവിന്റെ.
ମେଘହୀନ_: സ്വച്ഛമായ സ്പഷ്ട്ടമായ തെളിഞ്ഞ.
ମେଧାବୀ: ബുദ്ധിമാന്‍ ധാരണാശക്‌തിയുള്ള വിവേകമുള്ള
ମେଳାପି: സ്നേഹബുദ്ധിയായ ഇടപഴകുന്ന ആത്മാര്‍ത്ഥതയുള്ള.
ମେଳୁଆ_: സ്നേഹബുദ്ധിയായ ഇടപഴകുന്ന ആത്മാര്‍ത്ഥതയുള്ള.
ମୈତ୍ରୀପୂର୍ଣ୍ଣ: മിത്രത മിത്രോചിതമായ_.
ମୋଟା: തടിച്ച സ്ഥുലശരീരിയായ കട്ടിയുള്ള കനമുള്ള
ମୋଡ: വളവും_തിരിവും_ഉള്ള_.
ମୋଡହୀନ: നേരേ
ମୋଫତ୍‌|: പണമില്ലാതെ.
ମୋହିତ: ആസക്തനായ താല്പര്യമുള്ള വിശ്വാസമുള്ള അനുരാഗമുള്ള താത്പര്യമുള്ള ശുഷ്കാന്തിയുള്ള മോഹമുള്ള അനുരക്തനായ.
ମୌନ: മൌനമായ.
ମୌଳବାଦୀ: യാഥാസ്തികനായ നിയന്മത്തില്‍_നിന്നും_അണുപോലും_വ്യതിചലിക്കാതത് നിര്‍ബ്ന്ധ_ബുദ്ധിയായ.
ମୌଳିକ: അടിസ്ഥാനപരമായ മൌലീക യഥാറ്ത്ഥമായ തനതായ അക്ര്‌ത്രിമമായ.
ମୌଳିକହୀନ: അനുകരണം വേറെ_ഒന്നിനെ_മാത്രികയാക്കല്‍ അനുവ്ര്‌ത്തി അനുകരിക്കല്‍ അനുകര്‍മ്മം അനുഗതി അനുപ്രവേശം അനുഹരണം അന്യര്‍ചെയ്യുന്നതു_പോലെ_ചെയ്യല്‍.
ମୌସୁମୀ_ବାୟୁ: കാലാനുസ്രിതമായ
ମ୍ଳାନ_: വിഷണ്ണതയുള്ള മ്ലാനമായ.
ମ୍ୟାଚିଙ୍ଗ୍: ചേര്‍ച്ചയുള്ള.
ମ୍ୟାନମାରୀ: ബ്ര്‍മ്മക്കാരെ മ്യാന്മര്‍കാരെ ബ്ര്‍മ്മ_ഭാഷ മ്യാന്മര്‍_ഭാഷ
ଯକ୍ଷ୍ମା|: ക്ഷയ_രോഗമുള്ള.
ଯଥାଖର୍ଚ୍ଚୀ: ചിലവു_ചുരുക്കുന്ന പാഴ്_ചിലവൊഴിവാക്കുന്ന.
ଯଥାର୍ଥ: യുക്തമായ ഉചിതമായ ഒത്ത തക്ക വാസ്തവികമായ യദാര്ഥമായ. സത്യം നിപത്തി നേര് നേറ്റി
ଯଥେଚ୍ଛାଚାରୀ: സ്വേച്ഛാധിപതിയായ അനിയന്ത്രിതനായ നിരങ്കുശനായ കടിഞ്ഞാണില്ലാത്ത.
ଯଥେଷ୍ଟ|: തികയുന്നത്.
ଯଥୋଚିତ: യുക്തമായ ഉചിതമായ ഒത്ത തക്ക ഉചിതമായ.
ଯନ୍ତ୍ର_ଚାଳିତ: യന്ത്ര_ചാലിതം.
ଯନ୍ତ୍ର_ସଂଚାଳିତ: യന്ത്ര_ചാലിതം.
ଯମଜ|: ഇരട്ട.
ଯଶସ୍ବୀ: കീര്ത്തിമാന്.
ଯାଚିତ: ചോദിച്ച യാചിച്ച അഭ്യറ്ത്ഥിച്ച അപേക്ഷിച്ച അവകാശപ്പെട്ട ആവശ്യപ്പെട്ട.
ଯାନ_ଆରୋହୀ: വണ്ടിയില്_യാത്ര_ചെയ്യുന്ന.
ଯାନହୀନ|: വാഹനം_ഇല്ലാത്ത.
ଯାନାରୂଢ|: വണ്ടിയില്_യാത്ര_ചെയ്യുന്ന.
ଯାନ୍ତ୍ରିକ: യന്ത്ര_ചാലിതം.
ଯାଯାବର: അലഞ്ഞു_തിരിയുന്ന.
ଯିଏ-ସିଏ: ഇന്നതായ
ଯୀଶୁ_ବିଷୟକ: യേശുവിനെ_സംബന്ധിക്കുന്നതു് ഈശോമിശിഹ യേശു_ക്രിസ്തു മരിച്ചവനെ_ജീവിപ്പിക്കുന്നവന്‍.
ଯୁକ୍ତିପୂର୍ଣ୍ଣ: ചിന്തയോറ്ടു_കൂടിയ യുക്തി_നിറഞ്ഞ.
ଯୁକ୍ତିଯୁକ୍ତ: യുക്തി_നിറഞ്ഞ.
ଯୁକ୍ତିହୀନ: തര്ക്കമില്ലാത്ത.
ଯୁଝାର: പലായനം_ചെയ്യാത്ത.
ଯୁଦ୍ଧକାମୀ: യുദ്ധം_ഇഷ്ട്ടപ്പെടുന്നയാള്.
ଯୁଦ୍ଧପ୍ରିୟ: പലായനം_ചെയ്യാത്ത.
ଯୁଦ୍ଧାର୍ଥୀ|: യുദ്ധം_ഇഷ്ട്ടപ്പെടുന്നയാള്.
ଯୁଦ୍ଧେଚ୍ଛୁ: യുദ്ധം_ഇഷ്ട്ടപ്പെടുന്നയാള്.
ଯୁବକ|: പ്രായ_പൂര്ത്തിയായ.
ଯୁବା: യുവാവ്
ଯୁଯୁତ୍ସୁ: യുദ്ധം_ഇഷ്ട്ടപ്പെടുന്നയാള്.
ଯେକୌଣସି: ഇന്നതായ
ଯୋଗ୍ୟ: യോഗ്യനായ കാര്യശേഷിയുള്ള നിപുണനായ സമര്ത്ഥനായ ശക്തനായ വിദഗ്ദ്ധനായ ചുണയുള്ള ചെയ്തുതഴക്കമുള്ള ചതുരനായ ചുറുചുറുക്കുള്ള ജ്ഞാനമുള്ള കെല്‍പ്പുള്ള പാടവമുള്ള കൌശലമുള്ള കഴിവുള്ള
ଯୋଜନୀୟ: ചേറ്ച്ചയുള്ള യോജ്യമായ പൊരുത്തമുള്ള യുക്തതയുള്ള സംയോജിക്കുന്ന രഞ്ജകമായ രഞ്ജിതമായ.
ଯୋଜିତ: യോജിച്ച അനുയോജ്യമായ ചേറ്ന്ന യുക്തമായ പൊരുത്തമുള്ള ഉചിതമായ ഹിതകരമായ ഇണങ്ങിയ അനുസ്ര്തമായ അനുഗുണമായ.
ଯୋଜ୍ୟ: ചേറ്ച്ചയുള്ള യോജ്യമായ പൊരുത്തമുള്ള യുക്തതയുള്ള സംയോജിക്കുന്ന രഞ്ജകമായ രഞ്ജിതമായ.
ଯୌଗିକ: മിശ്രിതം.
ଯୌନ: ലൈങ്ഗിക
ରକ୍ତବର୍ଣ୍ଣ: ചുവന്ന്.
ରକ୍ତରଞ୍ଜିତ: രക്തരൂഷിതമായ
ରକ୍ତସମ୍ପର୍କୀୟ: ഉറ്റബന്ധത്തിലുള്ള അടുത്ത_ബന്ധത്തിലുള്ള.
ରକ୍ତସମ୍ବନ୍ଧୀୟ: കൊലയാളി കൊലപാതകി ഘാതകന്‍.
ରକ୍ତହୀନ: രക്തഹീനന്‍ രുധിരഹീനന്‍.
ରକ୍ତାଭ: ചുവന്ന്.
ରକ୍ଷକ: രക്ഷിക്കുന്നവന്‍ സംരക്ഷകന്‍ രക്ഷകന്‍ ഉദ്ധാരകന്‍ പരിപാലകന്‍.
ରକ୍ଷକରହିତ: ആസ്രയമില്ലാത്ത രക്ഷ്കനില്ലാത്ത.
ରକ୍ଷାକର୍ତ୍ତା: രക്ഷിക്കുന്നവന്‍ സംരക്ഷകന്‍ രക്ഷകന്‍ ഉദ്ധാരകന്‍ പരിപാലകന്‍.
ରକ୍ଷିତ: സുരക്ഷിതമായ.
ରକ୍ଷୀ|: രക്ഷിക്കുന്നവന്‍ സംരക്ഷകന്‍ രക്ഷകന്‍ ഉദ്ധാരകന്‍ പരിപാലകന്‍.
ରଙ୍କ: പിശുക്കന്‍ ലുബ്ധന്‍ ലോഭന്‍ കൃപണന്‍
ରଙ୍ଗ: നിറമുള്ള.
ରଙ୍ଗବେରଙ୍ଗ: നിറമുള്ള.
ରଙ୍ଗରଙ୍ଗିଆ: പല_നിറത്തിലുള്ള.
ରଙ୍ଗହୀନ: സാധാരണമായ
ରଙ୍ଗୀନ: നിറമുള്ള.
ରଚିତ: രചിക്കപ്പെട്ട എഴുതപ്പെട്ട.
ରଞ୍ଜିତ: നിറമായ വറ്ണ്ണമായ ചായമായ രഞ്ജിതമായ അനുരഞ്ജിതമായ.
ରଣକାମୀ: യുദ്ധം_ഇഷ്ട്ടപ്പെടുന്നയാള്.
ରଣେଚ୍ଛୁ: യുദ്ധം_ഇഷ്ട്ടപ്പെടുന്നയാള്.
ରଦ୍ଦ: നിരസിക്കപ്പെട്ട റദ്ദാക്ക്പ്പെട്ട.
ରନ୍ଧ୍ରଯୁକ୍ତ_: തുളയുള്ളത് ഓട്ടയുള്ളത്.
ରମଣୀୟ: സുന്ദരമായ മനോഹരമായ.
ରମ୍ୟ: സുന്ദരമായ മനോഹരമായ.
ରସଦାର: രസമുള്ള രുചിയുള്ള സ്വാദുള്ള.
ରସପୂର୍ଣ୍ଣ_: രസമുള്ള രുചിയുള്ള സ്വാദുള്ള.
ରସହୀନ: അരുചികരമായ ഇഷ്ട്ടപ്പെടാത്ത. രസഹീനമായത്. നിസ്സാരമായ കാര്യമില്ലാത്ത.
ରସାତ୍ମକ: കാവ്യാത്മകമായ.
ରସାଳ: രസമുള്ള രുചിയുള്ള സ്വാദുള്ള.
ରସାୟନିକ: രസതന്ത്രപരമായ.
ରସୁଆଳ: രസമുള്ള രുചിയുള്ള സ്വാദുള്ള.
ରହସ୍ୟପୂର୍ଣ୍ଣ: രഹസ്യപൂര്ണ്ണം.
ରହସ୍ୟମୟ: രഹസ്യപൂര്ണ്ണം.
ରହସ୍ୟହୀନ: ഒളിവില്ലാത്ത.
ରହସ୍ୟାତ୍ମକ: രഹസ്യപൂര്ണ്ണം.
ରହି_ଯାଇଥିବା_: ഒടക്കിയ.
ରହିତ: നിരസിക്കപ്പെട്ട റദ്ദാക്ക്പ്പെട്ട.
ରାଗ-ମସଲା: എരിവും_മസാലകളും_ഉള്ള.
ରାଗୀ: ക്രോധമുള്ള.
ରାଗୁଆ: എരിവുള്ള തീക്ഷ്ണതയുള്ള.
ରାଜନୀତିକ_: രാഷ്ട്രീയമായ രാഷ്ട്ര_തന്ത്രപരമായ.
ରାଜନୈତିକ: രാഷ്ട്രീയമായ രാഷ്ട്ര_തന്ത്രപരമായ.
ରାଜପୁତର: രജപുത്രരുടെ.
ରାଜପୁତୀୟ: രജപുത്രരുടെ.
ରାଷ୍ଟ୍ରଦ୍ରୋହୀ|: ദേശ_ദ്രോഹി.
ରାସାୟନିକ: രസതന്ത്രപരമായ.
ରାସ୍ତା_ଭୁଲା: വഴി_തെറ്റിയ ലക്ഷ്യമില്ലാതെ_അലയുന്ന അമ്പരമ്മു_പോകുന്ന.
ରାସ୍ତା_ଭୁଲି_ଯାଇଥିବା: വഴി_തെറ്റിയ ലക്ഷ്യമില്ലാതെ_അലയുന്ന അമ്പരമ്മു_പോകുന്ന.
ରିକ୍ତ: ഒഴിഞ്ഞ ശൂന്യമായ കാലിയായ
ରିଜର୍ଭେସନ୍: കരുതല്.
ରିଟାୟାର୍ଡ୍: ജോലിയില്‍_നിന്ന്_വിരമിച്ച റിട്ടയറായ പെന്‍ഷന്‍_പറ്റിയ വിശ്രമയ_സമയം_പ്രാപിച്ച ഉദ്യോഗമൊഴിഞ്ഞ.
ରୁଆଣ୍ଡା_ସମ୍ବନ୍ଧୀୟ: റുവാണ്ടിയന്
ରୁଆଣ୍ଡାନ୍: റുവാണ്ടിയന്
ରୁଆଳି: നടുന്ന പാകുന്ന
ରୁକ୍ଷ: അപരിഷ്കൃതമായ മാന്യമല്ലാത്ത സംസ്കാരമില്ലാത്ത_പ്രാകൃതപ്പെരുമാറ്റമുള്ള വരണ്ട് ഉണങ്ങിയ ശുഷ്കമായ
ରୁଚିକର: മനസ്സിനിണങ്ങിയ രസകരമായ
ରୁଚିର: സൌന്ദര്യമുള്ള സുമുഖമുള്ള ചേലുള്ള ചന്തമുള്ള
ରୁଜୁ: ചുറ്റിക്കറങുന്ന അലഞ്ഞു_തിരിയുന്ന.
ରୁଢିଯୁକ୍ତ: ചൊല്ലുകളെ_സം‍ബന്ധിക്കുന്ന.
ରୁଦ୍ଧ: അടഞ്ഞുപ്പോയ
ରୁଧିରହୀନ: രക്തഹീനന്‍ രുധിരഹീനന്‍.
ରୁନ୍ଧିତ: അടഞ്ഞുപ്പോയ
ରୁଷ୍ଟ: ദു
ରୂଢ: അപരിഷ്കൃതമായ മാന്യമല്ലാത്ത സംസ്കാരമില്ലാത്ത_പ്രാകൃതപ്പെരുമാറ്റമുള്ള കര്‍ക്കശമായ ദൃഢചിത്തനായ
ରୂପବନ୍ତ: സൌന്ദര്യമുള്ള സുമുഖമുള്ള ചേലുള്ള ചന്തമുള്ള
ରୂପହୀନ: ക്ലിപ്തരൂപമില്ലാത്ത.
ରୂମାନିୟାଈ: രുമാനിയയുടെ. രുമാനിയയുടെ.
ରେକର୍ଡ: രജിസ്റ്റര്‍_ചെയ്തത്.
ରେଡିମେଡ୍: റെഡീമേഡ്.
ରୋଗଶୂନ୍ୟ: ആരോഗ്യപൂര്‍ണ്ണമായ ആരോഗ്യകരമായ
ରୋଗିଣା: രോഗി രോഗാതുരന്‍ രോഗബാധിതന്‍
ରୋଗୀ: രോഗി രോഗാതുരന്‍ രോഗബാധിതന്‍
ରୋଚକ: രസകരമായ സ്വാദിഷ്ട്ടമായ.
ରୋଜଗାରିଆ: സമ്പാദിക്കുന്ന.
ରୋପଣ_ଯୋଗ୍ୟ: നടാവുന്ന പാകാവുന്ന നടാന്_യോഗ്യമായ.
ରୋପଣକାରୀ: നടുന്ന പാകുന്ന
ରୋପଣୀୟ: നടാവുന്ന പാകാവുന്ന നടാന്_യോഗ്യമായ.
ରୋମାନିୟାଈ: രുമാനിയയുടെ.
ଲକ୍ଷତମ: ലക്ഷത്തിന്റെ
ଲକ୍ଷ୍ୟଚ୍ୟୁତ|: ലക്ഷ്യഹീനമായ.
ଲକ୍ଷ୍ୟଭେଦୀ: ഉന്നത്തില്_കൊള്ളിക്കുന്ന.
ଲକ୍ଷ୍ୟାନୁସାରୀ: ഉന്നത്തില്_കൊള്ളിക്കുന്ന.
ଲଗାମଶୂନ୍ୟ: കടിഞ്ഞാണില്ലാത്ത.
ଲଗାମହୀନ: കടിഞ്ഞാണില്ലാത്ത.
ଲଙ୍କାଯୁକ୍ତ|: എരിവുള്ള തീക്ഷ്ണതയുള്ള.
ଲଙ୍ଗଳା: നഗ്നനായ വിവസ്ത്രനായ ദിഗംബരനായ അനംബരനായ
ଲଜ୍ଜାକର: ലജ്ജാവഹമായ അപമാനകരമായ.
ଲଜ୍ଜାଜନକ: ലജ്ജാവഹമായ അപമാനകരമായ.
ଲଜ୍ଜାପ୍ରଦ: ലജ്ജാവഹമായ അപമാനകരമായ.
ଲଜ୍ଜାବାନ୍: ലജ്ജാശീലമുള്ള നാണമുള്ള
ଲଜ୍ଜାଳୁ: ലജ്ജാശീലമുള്ള നാണമുള്ള
ଲଜ୍ଜାଶୀଳ: ലജ്ജാശീലമുള്ള നാണമുള്ള
ଲଜ୍ଜାହୀନ: നാണ്മില്ലാത്ത.
ଲଣ୍ଡା: കഷണ്ടിയുള്ള കഷണ്ടി_രോഗമുള്ള.
ଲଦା: ഭാരപ്പെട്ട് ചുമക്കപ്പെട്ട് വഹിക്കപ്പെട്ട് എടുക്കപ്പെട്ട് പൊക്കപ്പെട്ട്.
ଲଦାହୋଇ|: ഭാരപ്പെട്ട് ചുമക്കപ്പെട്ട് വഹിക്കപ്പെട്ട് എടുക്കപ്പെട്ട് പൊക്കപ്പെട്ട്.
ଲଦିହୋଇ: ഭാരപ്പെട്ട് ചുമക്കപ്പെട്ട് വഹിക്കപ്പെട്ട് എടുക്കപ്പെട്ട് പൊക്കപ്പെട്ട്.
ଲଫଙ୍ଗା: തെമ്മാടി പോക്കിരി താന്തോന്നി ആഭാസന്‍ നെറികെട്ടവന്‍
ଲବ୍ଧ: ലഭിച്ച നേടിയ സ്വീകരിക്കപ്പെട്ട.
ଲଭ୍ୟ: നേടിയെടുക്കേണ്ട നേടേണ്ട ലഭിക്കേണ്ട കിട്ടേണ്ട കൈവരേണ്ട.
ଲମ୍ପଟ: കാമിയായ കാമ_വികാരമുള്ള ക്രീഡാസക്തിയുള്ള.
ଲମ୍ବା: നീണ്ട നീളമുള്ള
ଲଳିତ: ആകര്‍ഷിക്കുന്ന ആകര്‍ഷകമായ ആകര്‍ഷണീയമായ വശ്യ മാസ്മരശക്‌തിയുള്ള മാദകമായ ചേതോഹാരിയായ ആനന്ദിപ്പിക്കുന്ന വശീകൃതമായ
ଲହରିତ: തിരയടിക്കുന്ന ഇളകുന്ന.
ଲହୁ_ଲୁହାଣ: രക്തരൂഷിതമായ
ଲାଓ: ലാവൊയുടെ ലവോ.
ଲାଞ୍ଚଖୋର: കൈക്കൂലിക്കാരന്‍.
ଲାଞ୍ଛିତ: കളങ്ങ്കപ്പെട്ട.
ଲାଞ୍ଜହୀନ: വാലുമുറിഞ്ഞ.
ଲାତବିଆୟୀ: ലാത്വിയായിലെ ലാത്വിയായിലെ.
ଲାବଣ୍ୟମୟ: സൌന്ദര്യമുള്ള സുമുഖമുള്ള ചേലുള്ള ചന്തമുള്ള
ଲାଭକର_: ലാഭദായകം ഗുണകരം ഉപയോഗപ്രദം.
ଲାଭକାରକ: ലാഭദായകം ഗുണകരം ഉപയോഗപ്രദം.
ଲାଭଜନକ: ലാഭദായകം ഗുണകരം ഉപയോഗപ്രദം.
ଲାଭଦାୟକ: ലാഭദായകം ഗുണകരം ഉപയോഗപ്രദം.
ଲାଭପ୍ରଦ: ലാഭദായകം ഗുണകരം ഉപയോഗപ്രദം.
ଲାଭପ୍ରାପକ: ലാഭം_കൊയ്യുന്ന.
ଲାଭରହିତ: ലാഭഹീനമായ.
ଲାଭହୀନ: ലാഭഹീനമായ.
ଲାଭାନ୍ବିତ: ലാഭം_കൊയ്യുന്ന.
ଲାଲ: ചുവന്ന്.
ଲାଳସୀ: പ്രബലമായ_ആഗ്രഹം. അത്യാഗ്രഹമുള്ള അത്യാറ്‍ത്തിയുള്ള ലോഭമുള്ള ദുരാഗ്രഹമുള്ള അതിതൃഷ്ണയുള്ള അതിമോഹമുള്ള
ଲାଳାୟିତ: പ്രബലമായ_ആഗ്രഹം.
ଲାଳିତପାଳିତ: പോഷിപ്പിക്കപ്പെട്ട വളര്‍ത്തപ്പെട്ട.
ଲିକର|: രുചിയില്ലാത്ത.
ଲିଖିତ: എഴുതിയ.. ലേഖകന്‍_എഴുതിയ.
ଲିଙ୍ଗିୟ: ലൈങ്ഗിക
ଲିପିବଦ୍ଧ: എഴുതിയ..
ଲିପ୍‌ସୁ: അത്യാഗ്രഹമുള്ള അത്യാറ്‍ത്തിയുള്ള ലോഭമുള്ള ദുരാഗ്രഹമുള്ള അതിതൃഷ്ണയുള്ള അതിമോഹമുള്ള
ଲିବିୟାନ୍: ലിബിയന്.
ଲିବେରିୟା_ସମ୍ବନ୍ଧୀ: ലൈബീരിയന്.
ଲିବେରିୟାନ୍: ലൈബീരിയന്.
ଲୀନ: മുഴുകിയ.
ଲୁକାୟିତ: മറയ്ക്കപ്പെട്ട് ഒളിയ്ക്കപ്പെട്ട്.
ଲୁଚାଛପା: മൂടിയ ഒളിച്ച.
ଲୁଣ୍ଠିତ: അപഹരിക്കപ്പെട്ട്. അപഹരിക്കപ്പെട്ട്.
ଲୁପ୍ତ: വംശനാശം_സംഭവിച്ചത്.
ଲୁବ୍ଧ: ആകര്‍ഷിക്കപ്പെട്ട കൊതിയുള്ള അത്യാഗ്രഹമുള്ള.
ଲେଉଟା: മടക്കികൊണ്ടുവന്ന.
ଲେଖାଙ୍କିତ: ലേഖകന്‍_എഴുതിയ.
ଲେଙ୍ଗଡା: മുടന്തന്‍ ഞൊണ്ടി
ଲେବାନୀଜ୍: ലബനോനിയന്‍.
ଲେସ: കുറച്ചു.
ଲୋକ_ପ୍ରଚଳିତ: നിലവിലുള്ള പരമ്പരഗതമായ പ്രചാരത്തിലുള്ള പ്രചാരത്തിലിരിക്കുന്ന സറ്വ്വസാധരണമായ പൊതുവായ സാറ്വ്വജനീനമായ ലോകചാരാമായ പ്രചലിതമായ പ്രാബല്യത്തിലുള്ള സ്ഥാപിതമായ ഇപ്പോഴുള്ള നടപ്പിലുള്ള.
ଲୋକ_ପ୍ରଚଳିତ_କାହାଣୀ: കേള്വി_കേട്ട.
ଲୋକକଥା: കേള്വി_കേട്ട.
ଲୋକକାହାଣୀ: കേള്വി_കേട്ട.
ଲୋକହିତୈଷୀ: ജനങള്‍ക്കു്ഗുണം_ചെയ്യുന്നപ്രവ്ര്‌ത്തി ജനങള്‍ക്കു്_ഹിതമായതു്.
ଲୋକୋପକାରୀ: ജനങള്‍ക്കു്ഗുണം_ചെയ്യുന്നപ്രവ്ര്‌ത്തി ജനങള്‍ക്കു്_ഹിതമായതു്.
ଲୋକୋପଯୋଗୀ: ജനങ്ല്ക്കുപകാരപ്രദമായത്.
ଲୋକୋହିତକାରୀ: ജനങള്‍ക്കു്ഗുണം_ചെയ്യുന്നപ്രവ്ര്‌ത്തി ജനങള്‍ക്കു്_ഹിതമായതു്.
ଲୋଚାକୋଚା: ചുരുങ്ങുക.
ଲୋଭପୂର୍ଣ୍ଣ_: ആകര്‍ഷിക്കപ്പെട്ട കൊതിയുള്ള അത്യാഗ്രഹമുള്ള.
ଲୋଭଭରା: ആകര്‍ഷിക്കപ്പെട്ട കൊതിയുള്ള അത്യാഗ്രഹമുള്ള.
ଲୋଭିତ: ആകര്‍ഷിക്കപ്പെട്ട കൊതിയുള്ള അത്യാഗ്രഹമുള്ള.
ଲୋଭୀ: അത്യാഗ്രഹമുള്ള അത്യാറ്‍ത്തിയുള്ള ലോഭമുള്ള ദുരാഗ്രഹമുള്ള അതിതൃഷ്ണയുള്ള അതിമോഹമുള്ള
ଲୋଭୀ_: പിശുക്കനായ ക്ര്പണനായ.‌
ଲୋମଯୁକ୍ତ: രോമമുള്ള.
ଲୋମଶ: രോമമുള്ള.
ଲୋଲୁପୀ: അത്യാഗ്രഹമുള്ള അത്യാറ്‍ത്തിയുള്ള ലോഭമുള്ള ദുരാഗ്രഹമുള്ള അതിതൃഷ്ണയുള്ള അതിമോഹമുള്ള
ଲୋହିତ: ചുവന്ന്.
ଲୌକିକ: ഈ_ലോകത്തുള്ള ലൌഗികമായ.
ଲୌହ_: ഇരുമ്പുകൊണ്ടുള്ള.
ଶକ୍ତ: കര്‍ക്കശമായ ദൃഢചിത്തനായ കഠോരം ദ്രിഢം ക്ലേശകരമായ.
ଶକ୍ତିଶାଳୀ: ശക്തിയുള്ള ബലമുള്ള ദ്രിഢമായ
ଶକ୍ତିସମ୍ପନ୍ନ|: ശക്തിയുള്ള ബലമുള്ള ദ്രിഢമായ
ଶକ୍ତିହୀନ: സാമര്ഥ്യം_ഇല്ലാത്ത.
ଶଙ୍କାହୀନ: പേടിയില്ലാത്ത.
ଶଙ୍ଖ: ശങ്ഖിന്റെ.
ଶଙ୍ଖତିଆରି: ശങ്ഖിന്റേത്.
ଶଙ୍ଖନିର୍ମିତ: ശങ്ഖിന്റേത്.
ଶଠ: ദുഷ്ട ദുഷിച്ച ചീത്ത നീച ഇരുമുഖങ്ങളുള്ള ക്രിത്രിമം_ചെയ്യുന്ന.
ଶତକଡା_ପଚାଶ_ପ୍ରତିଶତ|: പകുതി.
ଶତ୍ରୁଘାତୀ: ശത്രുവിനെ_ജയിക്കുന്ന.
ଶତ୍ରୁଘ୍ନ: ശത്രുവിനെ_ജയിക്കുന്ന.
ଶତ୍ରୁଜିତ: ശത്രുവിനെ_ജയിക്കുന്ന.
ଶତ୍ରୁଜୟୀ: ശത്രുവിനെ_ജയിക്കുന്ന.
ଶତ୍ରୁତାପୂର୍ଣ୍ଣ: ശത്രു_ഭാവത്തോടു_കൂടി വൈരാഗ്യപൂര്‍വ്വം_.
ଶତ୍ରୁଦମନକାରୀ: ശത്രുവിനെ_ജയിക്കുന്ന.
ଶତ୍ରୁପୂର୍ଣ୍ଣ: ശത്രുപൂര്‍ണ്ണം വിരോധമുള്ള വൈരിയുള്ള.
ଶତ୍ରୁହୀନ: ശത്രുഹീനന്.
ଶରଣାଗତ|: ശരണം_പ്രപിച്ച ആശ്രയത്തില്_വന്ന.
ଶରୀରଧାରୀ: ശരീരമുള്ള
ଶରୀରହୀନ: ദേഹമില്ലാത്ത.
ଶରୀରୀ: ശരീരമുള്ള
ଶଲ୍ୟୋପଚାରିକ: ശസ്ത്രക്രിയാ_സംബന്ധമായ.
ଶସଯୁକ୍ତ: കാമ്പുള്ള.
ଶସ୍ତା: വിലക്കുറവു വിലകുറഞ്ഞ
ଶସ୍ତ୍ରଧାରୀ: ശസ്ത്ര_ധാരി.
ଶସ୍ତ୍ରବିହୀନ: നിരായുധനായ
ଶସ୍ତ୍ରହୀନ_: നിരായുധനായ
ଶସ୍ୟଜାତ: ധാന്യം_കൊണ്ടുള്ള.
ଶସ୍ୟଯୁକ୍ତ|: ധാന്യം_കൊണ്ടുള്ള.
ଶସ୍ୟହୀନ: സാസ്യങ്ങളില്ലാത്ത.
ଶହେ: നൂറാമത്തെ.
ଶହେ_ଏକ: നൂറ്റി_ഒന്ന്
ଶହେତମ: നൂറാമത്തെ.
ଶାଖାଯୁକ୍ତ: ശാഖകളുള്ള.
ଶାଣିତ: സൂക്ഷ്മ_ഗ്രാഹിത്വം.
ଶାନ୍ତ: പ്രവഹിക്കാത്ത ശാന്ത_മായ നില്‍ക്കുന്ന സ്ഥിരമായ ഗതിഹീനമായ. സൌമ്യമ്മായ സുശീലയായ. ഗൌരവമുള്ള പതറാത്ത സുദൃഢമായ സുസ്ഥിരമായ ധൈര്യശാലി നിര്‍ഭയനായ ചങ്കൂറ്റമുള്ള ഉള്‍ക്കരുത്തുള്ള ശാന്തമായ നിശ്ചേഷ്ട്ടമായ അടക്കമുള്ള. വളരേ_ശാന്തമായ_മനസ്സുള്ള. നിശ്ചലമായ
ଶାନ୍ତିକାରକ: വേദന_ഇല്ലാതാക്കുന്ന ശമിപ്പിക്കുന്ന.
ଶାବ୍ଦିକ|: വാക്കുകളെ_സംബന്ധിക്കുന്ന.
ଶାରିରୀକ_ଅକ୍ଷମ: അങ്ഗ_വൈകല്യമുള്ള.
ଶାଳିନ: ഉത്തമനായ സര്‍വ്വശ്റേഷ്ടനായ അതിവിശിഷ്ടനായ ഉല്‍കൃഷ്ടനായ അതുല്യനായ അദ്വിതീനായ മികവുള്ളവനായ
ଶାଶ୍ବତ: എന്നും_നിലനില്ക്കുന്ന.
ଶାସନାନ୍ତର୍ଗତ: നിയമം_പാലിക്കുന്ന.
ଶାୟିତ: നിദ്രാനിമഗ്നനായ_‍ ഉറങ്ങിയ.
ଶିକାରୀ: നായാ‍ട്ടുകാരനായ വേട്ടക്കാരനായ.
ଶିକ୍ଷିତ: അഭ്യസ്‌തവിദ്യനായ വിദ്യാഭ്യാസമുള്ള
ଶିଙ୍ଗଦାର: കൊമ്പുള്ള.
ଶିଙ୍ଗହୀନ: കൊമ്പില്ലാത്തതായ.
ଶିଷ୍ଟ: ഉത്തമനായ സര്‍വ്വശ്റേഷ്ടനായ അതിവിശിഷ്ടനായ ഉല്‍കൃഷ്ടനായ അതുല്യനായ അദ്വിതീനായ മികവുള്ളവനായ
ଶିଷ୍ଟାଚାରହୀନ: അപരിഷ്കൃതമായ മാന്യമല്ലാത്ത സംസ്കാരമില്ലാത്ത_പ്രാകൃതപ്പെരുമാറ്റമുള്ള
ଶୀଘ୍ର: വേഗതയുള്ള. വേഗതയുള്ള.
ଶୀତ: തണുപ്പേകുന്ന കുളിരേകുന്ന.
ଶୀତଳ: തണുത്ത ശീതളമായ കുളിരുള്ള കുളിറ്‍മയുള്ള തണുത്ത.
ଶୀତଳ|: തണുത്ത.
ଶୀର୍ଣ୍ଣ: നേര്‍മയുള്ള
ଶୀଳ: ഉത്തമനായ സര്‍വ്വശ്റേഷ്ടനായ അതിവിശിഷ്ടനായ ഉല്‍കൃഷ്ടനായ അതുല്യനായ അദ്വിതീനായ മികവുള്ളവനായ
ଶୁକୁଟା: മെലിഞ്ഞ
ଶୁକ୍ଳ: വെളുത്തത്.
ଶୁଖିଲା: രസഹീനമായത്. വരണ്ട് ഉണങ്ങിയ ശുഷ്കമായ
ଶୁଣା: കേട്ടിട്ടുള്ള.
ଶୁଣିଥିବା: കേട്ടിട്ടുള്ള. നന്നായി_കേട്ട് പൂറ്ണ്ണമായി_കേട്ട.
ଶୁଣିବାଯୋଗ୍ୟ: കേള്ക്കുവാന്_സാധിക്കുന്നത്.
ଶୁଦ୍ଧ: ശുദ്ധമായ ഒന്നാംതരമായ നിര്‍മ്മലമായ വിമലമായ പവിത്രമായ് ശുദ്ധമായ ശുദ്ധമായതു.
ଶୁନଶାନ|: നിര്ജ്ജനം ഏകാന്തം.
ଶୁଷ୍କ: രസഹീനമായത്. വരണ്ട് ഉണങ്ങിയ ശുഷ്കമായ
ଶୂନ୍ୟ: ഒഴിഞ്ഞ ശൂന്യമായ കാലിയായ
ଶୂର: വീരന്‍ ധൈര്യശാലി നിര്‍ഭയന്‍
ଶୂରବୀର: വീരന്‍ ധൈര്യശാലി നിര്‍ഭയന്‍
ଶୃଙ୍ଗୀ: കൊമ്പുള്ള.
ଶେଷ: അവസാനിക്കുക. അവസാനം. അവസാനത്തേതല്ലാത്ത
ଶେଷହୀନ_: അവസാനമില്ലാത്ത അന്തമില്ലാത്ത.
ଶୋକପୂର୍ଣ୍ଣ: ദു വ്യഥാപൂര്‍വം അനുശോചനപൂര്‍ണ്ണം.
ଶୋକହୀନ: ശോകരഹിതന്.
ଶୋକାଗ୍ରସ୍ତ: ദു വ്യഥാപൂര്‍വം അനുശോചനപൂര്‍ണ്ണം.
ଶୋଧିତ: ശുദ്ധമാക്കിയ.
ଶୋଭନୀୟ: മാന്യമായ.
ଶୋଷଣ_ଯୋଗ୍ୟ: വലിച്ചു_കുടിക്കാവുന്ന.
ଶୋଷଣୀୟ: വലിച്ചു_കുടിക്കാവുന്ന.
ଶୋଷିଲା: ദാഹമുള്ള തൊണ്ടവരള്‍ച്ചയുള്ള
ଶୋଷୀ: ദാഹമുള്ള തൊണ്ടവരള്‍ച്ചയുള്ള
ଶୋଷ୍ୟ: വലിച്ചു_കുടിക്കാവുന്ന.
ଶୋଷୟିତବ୍ୟ: വലിച്ചു_കുടിക്കാവുന്ന.
ଶ୍ବେତ: വെളുത്തത്.
ଶ୍ରବଣହୀନ: ബധിരരായ മൂകരായ ഊമയായ
ଶ୍ରବଣୀୟ: കേള്ക്കത്തക്ക. കേള്ക്കുവാന്_സാധിക്കുന്നത്.
ଶ୍ରବଣୀୟ|: കേള്ക്കത്തക്ക.
ଶ୍ରବ୍ୟ: കേള്ക്കത്തക്ക. കേള്ക്കുവാന്_സാധിക്കുന്നത്.
ଶ୍ରୁତ: കേട്ടിട്ടുള്ള.
ଶ୍ରେଷ୍ଠ: പ്രമുഖന്‍. മഹാനായ ശ്രേഷ്ഠനായ ഉന്നതനായ വിശിഷ്ടനായ
ଶ୍ରୋତବ୍ୟ: കേള്ക്കത്തക്ക.
ଶ୍ଳୀଳ: സഭ്യമായത്.
ଶ୍ୟାମ: കറുപ്പ്.
ଶ୍ୟାମଳସବୁଜ: പച്ച_നിറഞ്ഞ സംര്‌ദ്ധമായ_.
ଷଷ୍ଟିତମ: അറുപതാമത്തെ
ଷଷ୍ଠ: ആറാം ആ‍റാമത്തെ
ଷାଠିଏ: അറുപത്.
ଷାଣ୍ମାସିକ: അരകൊല്ലത്തെ.
ଷୋଡଶ: പതിനാറാം പതിനാറാമത്തെ
ଷୋହଳତମ: പതിനാറാം പതിനാറാമത്തെ
ସଂକଟନାଶକ: സംകട_മോചകന്.
ସଂକଟପୂର୍ଣ୍ଣ|: അപകടകരമായ.
ସଂକଟମୋଚକ: സംകട_മോചകന്.
ସଂକଟମୟ: അപകടകരമായ.
ସଂକଳିତ|: ശേഖരിക്കപ്പെട്ട സമ്പാദിക്കപ്പെട്ട കൂട്ടിവയ്ക്കപ്പെട്ട കൂമ്പാരം_കൂട്ടിവെച്ച.
ସଂକୁଚିତ: ചുരുങ്ങുക.
ସଂକ୍ରମିତ: പകറ്ന്ന സംക്രമിച്ച.
ସଂଖ୍ୟାଧିକ: വളരേ_അധികം.
ସଂଗୃହୀତ: ശേഖരിക്കപ്പെട്ട സമ്പാദിക്കപ്പെട്ട കൂട്ടിവയ്ക്കപ്പെട്ട കൂമ്പാരം_കൂട്ടിവെച്ച.
ସଂଗ୍ରହକର୍ତ୍ତା: സൂക്ഷിപ്പുകാരന്‍.
ସଂଗ୍ରହକାରୀ: സൂക്ഷിപ്പുകാരന്‍.
ସଂଘର୍ଷରତ: സംഘറ്ഷമുണ്ടാക്കുന്ന വഴക്കുണ്ടാക്കുന്ന കലഹമുണ്ടാക്കുന്ന വിപ്ലവമുണ്ടാക്കുന്ന.
ସଂଘର୍ଷଶୀଳ: സംഘറ്ഷശീലമുള്ള കലപ്രിയനായ വഴക്കാളിയായ വിപ്ലവകാരിയായ കുഴപ്പകാരനായ.
ସଂଘର୍ଷୀ: സംഘറ്ഷശീലമുള്ള കലപ്രിയനായ വഴക്കാളിയായ വിപ്ലവകാരിയായ കുഴപ്പകാരനായ.
ସଂଘୀୟ: സംഘത്തിന്റെ
ସଂଙ୍କୁଚିତ: ഇടുങ്ങിയ വീതി_കുറഞ്ഞ കുടുസ്സായ
ସଂଚାରିତ: നീക്കപ്പെട്ട.
ସଂଚାଳିତ: നിയന്ത്രിക്കപ്പെട്ട നിര്‍വഹിക്കപ്പെട്ട.
ସଂଚିତ: ഒരാവശ്യത്തിന്‍_വെച്ചിട്ടുള്ള. പ്രത്യേക_അവസരത്തില്‍_ധരിക്കുന്ന.
ସଂଜାତ: ഉല്പന്ന് ഉണ്ടായ ജനിച്ച.ഉത്ഭവിച്ച രൂപപ്പെട്ട ഉല്പാദിപ്പിച്ച.
ସଂଜିବନୀ_: മരണം_ഇല്ലാതാക്കുന്നവന്‍ ജീവന്‍_നല്‍കുന്നവന്‍ സഞീവനി.
ସଂଜ୍ଞାଯୁକ୍ତ: ചേതനയോടു_കൂടിയ.
ସଂଜ୍ଞାରହିତ: ബോധമില്ലാത്ത.
ସଂଜ୍ଞାଶୂନ୍ୟ: ബോധമില്ലാത്ത.
ସଂଜ୍ଞାହୀନ: ബോധമില്ലാത്ത.
ସଂତ୍ରସ୍ତ: പേടിച്ച.
ସଂପୂର୍ଣ୍ଣ: ആകെ മുഴുവനും ഒട്ടാകെ ആകപ്പാടെ പൂര്‍ണ്ണമായ
ସଂପ୍ରସାରିତ: പരന്ന വ്യാപിച്ചിരിക്കുന്ന.
ସଂବେଦନଶୀଳ: സംവേദനശീലമുള്ള (എളുപ്പം_അനുഭൂതികള്_ഉള്കൊള്ളുന്ന്)
ସଂଯମଶୀଳ: സംയമനം_പാലിക്കുന്ന
ସଂଯମୀ: സംയമനം_പാലിക്കുന്ന സംയമനം_പാലിക്കുന്ന മനോനിയന്ത്രണം_ഉള്ള ഇന്ദ്രിയ_നിഗ്രഹം_പാലിക്കുന്ന വിരക്തിയുള്ള ആത്മ_സംയമമുള്ള സംയാമമുള്ള.
ସଂଯୋଜକ: യോജിപ്പിക്കുന്ന
ସଂରକ୍ଷିତ: കരുതല്. സുരക്ഷിതമായ.
ସଂରଚିତ: രചിക്കപ്പെട്ട എഴുതപ്പെട്ട.
ସଂର୍କୀର୍ଣ୍ଣ: ഇടുങ്ങിയ വീതി_കുറഞ്ഞ കുടുസ്സായ
ସଂଲଗ୍ନ: ആഗിരണം_ചെയ്ത അനുബന്ധമായ.
ସଂଶୟହୀନ: അവിശ്വാസമില്ലാത്ത.
ସଂଶୟହୀନ_: ആശങ്കയില്ലാത്ത ഭയമില്ലാത്ത ശങ്കയില്ലാത്ത ചിന്തയില്ലാത്ത കൂസലില്ലാത്ത.
ସଂଶୟାତ୍ମକ: ഇതികര്‍ത്തവ്യതാമൂഢത_ഉണ്ടാക്കുന്ന ഇതികര്‍തവ്യതാമൂഢത_ജനിപ്പിക്കുന്ന.
ସଂସ୍କାରହୀନ: അപരിഷ്കൃതമായ മാന്യമല്ലാത്ത സംസ്കാരമില്ലാത്ത_പ്രാകൃതപ്പെരുമാറ്റമുള്ള
ସଂସ୍କାରୀ: സംസ്കാരമുള്ള സംസ്ക്ര്തിയുള്ള പക്വതയുള്ള.
ସଂସ୍କୃତ: സംസ്ക്രിതം
ସଂସ୍ଥାପିତ: സ്ഥാപിക്കപ്പെട്ട.
ସକର୍ମକ: ഏര്പ്പെട്ടിരിക്കുന്ന.
ସକ୍ରିୟ: ഏര്പ്പെട്ടിരിക്കുന്ന.
ସକ୍ଷମ: വൈദഗ്ദ്ധ്യം സാമര്ഥ്യം യോഗ്യത
ସଖାହୀନ: കൂട്ടുകാരില്ലാത്ത.
ସଘନ: സാന്ദ്രമായ ഉറപ്പുള്ള മേഘമുള്ള. ഇടതൂര്‍ന്ന്.
ସଙ୍କଟଗ୍ରସ୍ତ: സംകടം_പിടിപ്പെട്ട
ସଙ୍କଟପ୍ରଦ: സംകടപ്രദമായ.
ସଙ୍କଟାତ୍ମକ: സംകടപ്രദമായ.
ସଙ୍କଟାପନ୍ନ: വിഷമത്തില്പെട്ട വിഷമതയില്‍പെട്ട ദുറ്ഘടസ്ഥിതിയിലായ ദുഃഖപൂറ്ണ്ണനായ.
ସଙ୍ଗଠନହୀନ: ഐക്യം ഐഖ്യമത്യം അഖണ്ഡത ഏകത ഏകചിത്തത രജ്ഞിപ്പ് ഏകോപനം ഒരുമിപ്പ് ഏകമനസ്സ് ഏകീകരണം പൊരുത്തം ഇണക്കം ഏകീഭാവം സഹകരണം സ്വരുമ സ്വരുമിപ്പ്.
ସଙ୍ଗଠିତ: ഒരുമയോടെ അഖണ്ഡമായ അനന്യമായ ഏകീക്ര്‌തമായ ഒന്നായ സംഗതമായ പൊരുത്തപ്പെട്ട ഏക സംഘടിതമായ ഏകീഭവിച്ച ഏകചിത്തമായ യോജിച്ച ഏകകണ്ഡമായ. ചേര്ച്ചയുള്ള
ସଙ୍ଗତ: യുക്തമായ ഉചിതമായ ഒത്ത തക്ക
ସଚଳ: ചലിക്കുന്ന ചലിക്കാന്‍_സാധിക്കുന്ന ജീവനുള്ള.
ସଚେତ: ബോധമുള്ള കരുതലുള്ള ധാരണാശക്തിയുളള
ସଚ୍ଚରିତ୍ର: നല്ല_സ്വഭാവം_ഉള്ള.
ସଚ୍ଚା: സത്യസന്ധനായ നെറിയുള്ള വിശ്വസ്തനായ ശരിആയത്.
ସଚ୍ଚୋଟ: സത്യസന്ധനായ നെറിയുള്ള വിശ്വസ്തനായ
ସଚ୍ଛିଦ୍ର: തുളയുള്ളത് ഓട്ടയുള്ളത്.
ସଜ: പുതിയ പുത്തന്‍
ସଜଡା: കെട്ടു_കുടുങ്ങാത്ത.
ସଜାଗ: ബോധമുള്ള കരുതലുള്ള ധാരണാശക്തിയുളള
ସଜୀବ: ജീവനുള്ള ശ്വാസോച്ഛ്വാസമുള്ള പച്ചയായ സജീവമായ ഹരിതാഭമായ ചൈതന്യത്തോടെ.
ସଜ୍ଜନ: സജ്ജനം കുലീനനായ മാന്യനായ മര്യാദയുള്ള.
ସଜ୍ଜିତ: ക്രമപ്പെടുത്തപ്പെട്ട നിശ്ച്ചിതമായ വ്യവസ്ഥപ്പെടുത്തിയ. വേഷമിട്ട. തയ്യാറാക്കിയ ഒരുക്കിയ സജ്ജമാക്കിയ പൂറ്ത്തിയാക്കിയ.
ସଜ୍ଜିତ_: അലങ്കരിച്ച ആഭരണമണിഞ്ഞ അലങ്ക്ര്തമായ.
ସଞ୍ଚିତ: പ്രത്യേക_അവസരത്തില്‍_ധരിക്കുന്ന.
ସଢା: ചീഞ്ഞഅഴുകിയ അളിഞ്ഞ ജീര്‍ണ്ണിച്ച
ସତ: സത്യം നിപത്തി നേര് നേറ്റി
ସତର: പതിനേഴ്.
ସତର୍କ: ബോധമുള്ള കരുതലുള്ള ധാരണാശക്തിയുളള
ସତଷଠି: അറുപത്തി_ഏഴ്
ସତଷଠିତମ: അറുപത്ത്തി_എട്ടാം
ସତସ୍ତରି: എഴുപത്തി_ഏഴ്
ସତାଅଶୀ: എണ്പത്തിയേഴ്
ସତାଅଶୀତମ: എണ്പത്ത്യേഴാമത്തെ
ସତାନବେ: തൊണ്ണൂറ്റി_ഏഴ്
ସତାନବେତମ: തൊണ്ണൂറ്റി_ഏഴാമത്തെ
ସତାବନତମ: അന്പത്തിയേഴാമത്തെ
ସତୁରି: എഴുപത്.
ସତେଜ_: പച്ചയാര്‍ന്ന.
ସତ୍ତାଧାରୀ|: അധികാരത്തിലേറിയ
ସତ୍ତାରୂଢ: അധികാരത്തിലേറിയ
ସତ୍ତ୍ବହୀନ: അനധിക്രിതമായ അനധിക്രിതമായി
ସତ୍ୟ: വാസ്തവികമായ യദാര്ഥമായ. സത്യം നിപത്തി നേര് നേറ്റി
ସତ୍ୟତା_ଅନୁମୋଦିତ: തെളിയിക്കപ്പെട്ട വ്യക്തമാക്കപ്പെട്ട പ്രകാശിപ്പിച്ച.
ସତ୍ୟବଦୀ: സത്യസന്ധനായ നെറിയുള്ള വിശ്വസ്തനായ
ସତ୍ୟବାଦିନୀ: സത്യവാദിനി സത്യഭാഷിണി.
ସତ୍ୟବାଦୀ: സത്യസന്ധനായ നേരുപറയുന്ന
ସତ୍ୟବାନ୍: സത്യസന്ധനായ നേരുപറയുന്ന
ସତ୍ୟଭାଷିଣୀ: സത്യവാദിനി സത്യഭാഷിണി.
ସତ୍ୟାଗ୍ରହୀ: സത്യാഗ്രഹം_ചെയ്യുന്ന.
ସତ୍‌କର୍ମା: പുണ്യകര്മ്മങള്_ചെയ്യുന്നവന്.
ସତ୍‌କର୍ମୀ: പുണ്യകര്മ്മങള്_ചെയ്യുന്നവന്.
ସଦବ୍ୟବହାରୀ|: സന്മാര്ഗ്ഗപൂര്ണ്ണമായ_പെരുമാറ്റമുള്ള്.
ସଦାଚାରିଣୀ: നല്ല_സ്വഭാവം_ഉള്ള.
ସଦାନନ୍ଦ: വിനോദപ്രിയനായ ആനന്ദം_പൂണ്ടവന്‍
ସଦୃଶ: ത്ത്സ്വരൂപമായ പ്ര്തിരൂപമായ പകറ്പ്പായ സാദ്ര്ശ്മായ പ്തിച്ഛായയുള്ള്.‌ യോജിക്കുന്ന അനുകൂലമായ ചേര്‍ച്ചയുള്ള പൊരുത്തമുള്ള ഐക്യമുള്ള കൂടികലരുന്ന സംയോജിക്കുന്ന. തുല്യമായ സമമായ സമാനമായ ഒരു_പോലെയുള്ള സമാനരൂപിയായ
ସଦୃଶ୍ୟ|: സമമായ തുല്യമൂല്യമായ.
ସଦ୍ଗୁଣୀ: സദ്ഗുണമുള്ള
ସଦ୍ୟଜାତ|: ഇപ്പോള്‍_ജനിച്ച.
ସନାତନ: എന്നും_നിലനില്ക്കുന്ന.
ସନ୍ତାନଜନିତ: സന്താന.
ସନ୍ତୁଷ୍ଟ: ത്ര്പ്തനായ്.
ସନ୍ତୁଷ୍ଟ|: സന്തോഷമുള്ള_.
ସନ୍ତୋଷକାରୀ: ത്രിപ്തിപ്പെടുത്തുന്നയാള്‍.
ସନ୍ଦିଗ୍ଧ: സംശയം.
ସନ୍ଦେହହୀନ: അവിശ്വാസമില്ലാത്ത.
ସନ୍ଦେହହୀନ_: സംശയാസ്പദമല്ലാത്ത സുനിശ്ചിതാവസ്ഥയിലുള്ള്.
ସନ୍ଦେହାସ୍ପଦ|: സംശയം.
ସନ୍ନିବିଷ୍ଟ_: ഗ്രസിക്കപ്പെട്ട.
ସପକ୍ଷ: യോജിക്കുന്ന അനുകൂലമായ ചേര്‍ച്ചയുള്ള പൊരുത്തമുള്ള ഐക്യമുള്ള കൂടികലരുന്ന സംയോജിക്കുന്ന.
ସପୁଷ୍ପକ: പൂവു_കാരണം_പ്രസിദ്ധമായിരിക്കുന്ന_ചെടി.
ସପ୍ତତିତମ: എഴുപതാം
ସପ୍ତଦଶ: പതിനേഴാം പതിനേഴാമത്തെ
ସପ୍ତମ: ഏഴാം ഏഴാമത്തെ
ସଫଳ: സഫലമായ വിജയകരമായ. സാറ്ത്ഥകമായ ഉപയോഗമുള്ള ഫലമുള്ള ഗുണമുള്ള ഉപയുക്തിയുള്ള പ്രയോജനമുള്ള ഉപകാരമുള്ള.
ସଫା: വെളുത്ത വെളുത്ത_നിറമുള്ള. മരിച്ച നശിച്ച നശിപ്പിക്കപ്പെട്ട. വെളുത്തത്. സ്പഷ്ടമായ ശരിയായ നിര്‍മ്മലമായ വിമലമായ പവിത്രമായ് ശുദ്ധമായ തിളങ്ങുന്ന ശോഭയുള്ള തെളിമയുള്ള ശുദ്ധമായ സ്പഷ്ട്ടമായ. സ്പഷ്ടമായ വ്യക്തമായ സ്ഫുടമായ
ସଫାସୁତରା: നിര്‍മ്മലമായ വിമലമായ പവിത്രമായ് ശുദ്ധമായ
ସବାକ: സംസാരിക്കുന്ന.
ସବୁ: ആകെ മുഴുവനും ഒട്ടാകെ ആകപ്പാടെ
ସବୁଜ: പച്ച_നിറഞ്ഞ സംര്‌ദ്ധമായ_. പച്ചയാര്‍ന്ന. പച്ചയായ സജീവമായ ഹരിതാഭമായ ചൈതന്യത്തോടെ.
ସବୁଠାରୁ_ନୂଆ: പുതിയ പുതുമ_നിറഞ്ഞ നവമായ ആധുനികമായ പുതുതായ അഭിനവ പുതുമയുള്ള.
ସବୁଠୁ_ଭଲ: ഉത്തമമായ.
ସଭ୍ୟ: ഉത്തമനായ സര്‍വ്വശ്റേഷ്ടനായ അതിവിശിഷ്ടനായ ഉല്‍കൃഷ്ടനായ അതുല്യനായ അദ്വിതീനായ മികവുള്ളവനായ
ସମ: തുല്യമായ സമമായ സമാനമായ നിരപ്പായ മിനുസമായ.
ସମ_ସାମୟିକ: നിലവിലുള്ള്_കാലത്തെ
ସମକକ୍ଷ: സമമായ തുല്യമൂല്യമായ.
ସମତଳ: സമതലമായ നിരപ്പായ
ସମତଳିଆ: യുദ്ധക്കളത്തിന്റെ പോറ്ക്കളത്തിന്റെ.
ସମତୁଲ: സമമായ തുല്യമൂല്യമായ.
ସମତୁଲ୍ୟ: തുല്യമായ സമമായ സമാനമായ
ସମନ୍ଧୀୟ: സംബന്ധമായ സംബന്ധിക്കുന്ന.
ସମନ୍ବିତ: ചേര്ച്ചയുള്ള
ସମବର୍ଗୀୟ: സ്വജാതീയ ഒരേ_വറ്ഗ്ഗത്തില്‍_പെട്ട സജാതീയ.
ସମରୂପ: ത്ത്സ്വരൂപമായ പ്ര്തിരൂപമായ പകറ്പ്പായ സാദ്ര്ശ്മായ പ്തിച്ഛായയുള്ള്.‌ ഒരു_പോലെയുള്ള സമാനരൂപിയായ
ସମରୂପୀ: ഒരേപോലത്തെ ഡ്യൂപ്ലികേറ്റ്.
ସମର୍ଥ: യോഗ്യനായ കാര്യശേഷിയുള്ള നിപുണനായ സമര്ത്ഥനായ ശക്തനായ വിദഗ്ദ്ധനായ ചുണയുള്ള ചെയ്തുതഴക്കമുള്ള ചതുരനായ ചുറുചുറുക്കുള്ള ജ്ഞാനമുള്ള കെല്‍പ്പുള്ള പാടവമുള്ള കൌശലമുള്ള കഴിവുള്ള വൈദഗ്ദ്ധ്യം സാമര്ഥ്യം യോഗ്യത
ସମର୍ଥକ_: പക്ഷം_പിടിക്കുന്നവന്‍ സമര്‍ഥിക്കുന്നവന്‍.വാദിക്കുന്നവന്‍.
ସମର୍ଥିତ: തെളിയിക്കപ്പെട്ട വ്യക്തമാക്കപ്പെട്ട പ്രകാശിപ്പിച്ച.
ସମର୍ପିତ: അറ്പ്പിച്ച സമറ്പ്പിച്ച തറ്പ്പിച്ച
ସମସରିସା: തുല്യമായ സമമായ സമാനമായ
ସମସ୍ତ: ആകെ മുഴുവനും ഒട്ടാകെ ആകപ്പാടെ
ସମସ୍ୟାଯୁକ୍ତ: പ്രയാസമുള്ള കുഴപ്പം_പിടിച്ച വിഷമമുള്ള ആയാസമുള്ള.
ସମାଗତ: വന്ന തിരിച്ചു_വന്ന വന്നുചേര്‍ന്ന എത്തിയ ആഗമിച്ച ആഗതനായ പ്രാപിച്ച എത്തിച്ചെര്‍ന്ന എത്തിക്കഴിഞ സമീപിക്കുന്ന കയറിക്കൂടിയ വസിക്കുന്ന ചെന്നെത്തിയ. വന്നു_ചേര്‍ന്ന.
ସମାଦରଣୀୟ: ആദരണീയനായ.
ସମାଦରଣୀୟା|: ആദരിക്കപ്പെട്ട.
ସମାଧାନ_ଯୋଗ୍ୟ|: പരിഹാരം_കാണുക സ്പഷ്ട്ടമാക്കുക.
ସମାଧାନ_ହୋଇଥିବା: പ്രശ്നം_പരിഹരിച്ച സംശയ_നിവാരണം_കഴിഞ്ഞ കുരുക്കഴിഞ്ഞ പരിഹ്ര്‌തമായ.
ସମାଧାନିତ: പ്രശ്നം_പരിഹരിച്ച സംശയ_നിവാരണം_കഴിഞ്ഞ കുരുക്കഴിഞ്ഞ പരിഹ്ര്‌തമായ.
ସମାନ: തുല്യമായ സമമായ സമാനമായ ഒരു_പോലെയുള്ള സമാനരൂപിയായ സമമായ തുല്യമൂല്യമായ. നിരപ്പായ മിനുസമായ.
ସମାନାର୍ଥୀ_: പര്യായം
ସମାପନୀୟ: സമാപിപ്പിക്കേണ്ടതായ.
ସମାପ୍ତ: അവസാനിക്കുക.
ସମାପ୍ୟ: സമാപിപ്പിക്കേണ്ടതായ.
ସମାବିଷ୍ଟ: ഗ്രസിക്കപ്പെട്ട.
ସମିଶ୍ରିତ: മിശ്രിതം.
ସମୁଦ୍ରଜାତ: സമുദ്രത്തിന്റെ.
ସମୃଦ୍ଧ: സംരിദ്ധമായ സമ്പന്നമായ.
ସମୃଦ୍ଧିପ୍ରଦ: അഭിവ്ര്ദ്ധിപ്രദമായ ഐശ്വര്യപ്രദമായ സംര്‌ദ്ധിപ്രദമായ.
ସମ୍ପତ୍ତିବାନ: ധനികനായ പണക്കാരനായ
ସମ୍ପନ୍ନ: അവസാനിക്കുക.
ସମ୍ପନ୍ନ|: സംരിദ്ധമായ സമ്പന്നമായ.
ସମ୍ପାଦିତ: പ്രസിദ്ധീകരണയോഗ്യമാക്കപെട്ട.
ସମ୍ପୂର୍ଣ୍ଣ: അവസാനിക്കുക.
ସମ୍ବନ୍ଧହୀନ: സംബന്ധിക്കാത്ത ബന്ധമില്ലാത്ത.
ସମ୍ବନ୍ଧିତ: സംബന്ധമായ സംബന്ധിക്കുന്ന. സംബന്ധിക്കുന്ന കുറിച്ചുള്ള.
ସମ୍ବେଦନଶୀଳ: വിഷമകരമായ.
ସମ୍ବେଦନହାରୀ: വേദന_സംഹാരി.
ସମ୍ବୋଧନକାରୀ: സംബോധന_ചെയ്യുന്നവന്‍.
ସମ୍ଭବ: സംഭവ്യമായ.
ସମ୍ଭାବିତ: സംഭവ്യമായ.
ସମ୍ଭାବ୍ୟ_: സംഭവ്യമായ.
ସମ୍ଭ୍ରାନ୍ତ_: ബഹുമാനിക്കപ്പെട്ട ആദരിക്കപ്പെട്ട.
ସମ୍ମାନନୀୟ: ആദരണീയനായ.
ସମ୍ମାନନୀୟା: ആദരിക്കപ്പെട്ട.
ସମ୍ମାନିତ: ബഹുമാനിക്കപ്പെട്ട ആദരിക്കപ്പെട്ട. ബഹുമാനിക്കപ്പെട്ട.
ସମ୍ମୋହନପୂର୍ଣ୍ଣ|: ആകര്ഷണീയമായ.
ସମୟ_ଅତିକ୍ରାନ୍ତ: സമയം_കഴിഞ്ഞു_പോയ കാലാവധി_കഴിഞ്ഞ.
ସମୟ_ଅସଚେତନ_ବ୍ୟକ୍ତି: സമയം_പാലിക്കാത്തവന്‍.
ସମୟ_ପାଳକ: സമയം_പാലിക്കുന്ന സമയത്തില്‍_ബന്ധിക്കപ്പെട്ട നിയമം_പാലിക്കുന്ന.
ସମୟ_ସଚେତନ_ବ୍ୟକ୍ତି: സമയം_പാലിക്കുന്ന സമയത്തില്‍_ബന്ധിക്കപ്പെട്ട നിയമം_പാലിക്കുന്ന.
ସମୟସୀମା: ത്വണകളായുള്ള ഗടുക്കളായുള്ള.
ସମୟାନୁକୁଳ: സമയോചിതമായ സന്ദര്‍ഭത്തിനു_ചേര്‍ന്ന സമകാലീനമായ.
ସମୟାନୁସାରୀ: സ്മയോചിതമായ സന്ദര്‍ഭത്തിനു_ചേര്‍ന്ന സമകലീനമായ.
ସମୟାନୁସାରେ: സമയോചിതമായ സന്ദര്‍ഭത്തിനു_ചേര്‍ന്ന സമകാലീനമായ.
ସମୟୋଚିତ: സമയോചിതമായ സന്ദര്‍ഭത്തിനു_ചേര്‍ന്ന സമകാലീനമായ.
ସରମପ୍ରଦ: ലജ്ജാവഹമായ അപമാനകരമായ.
ସରମହୀନ: നാണ്മില്ലാത്ത.
ସରମିତ: ലജ്ജാശീലമുള്ള നാണമുള്ള
ସରଳ: ലളിതമായ സരളമായ എളുപ്പമുള്ള മനസ്സിലാക്കാവുന്ന ധരിക്കാവുന്ന. കാപട്യമില്ലാത്ത നിഷ്കളങ്കരായ ശാന്തസ്വഭാവമുള്ള
ସରସର: കുതിര്‍ന്ന
ସରସାଜମି_: ഉല്പാദനക്ഷമമായ ഫലഭൂയിഷ്ഠമായ സംരിദ്ധമായ സമ്പന്നമായ.
ସରସ୍ତରିତମ: എഴുപത്തി_ഏഴാമത്തെ
ସରିସା: ഒരു_പോലെയുള്ള സമാനരൂപിയായ
ସରୀସୃପ: ഇഴയുന്ന പതുക്കെ_നടക്കുന്ന.
ସର୍ଜିକଲ|: ശസ്ത്രക്രിയാ_സംബന്ധമായ.
ସର୍ଜିତ: രചിക്കപ്പെട്ട എഴുതപ്പെട്ട.
ସର୍ବକାଳିକ: എന്നും_നില_നില്‍ക്കുന്ന.
ସର୍ବଗୁଣ_ସମ୍ପନ୍ନ|: സ്ര്വ്വ_ഗുണ_സമ്പന്ന്.
ସର୍ବଜନାଦୃତ: നിലവിലുള്ള പരമ്പരഗതമായ പ്രചാരത്തിലുള്ള പ്രചാരത്തിലിരിക്കുന്ന സറ്വ്വസാധരണമായ പൊതുവായ സാറ്വ്വജനീനമായ ലോകചാരാമായ പ്രചലിതമായ പ്രാബല്യത്തിലുള്ള സ്ഥാപിതമായ ഇപ്പോഴുള്ള നടപ്പിലുള്ള.
ସର୍ବଜ୍ଞାତ|: എല്ലാവരും_അറിയുന്ന.
ସର୍ବଦେଶୀୟ: സാര്വഭൌമികമായ.
ସର୍ବଭକ୍ଷୀ: എല്ലാം_ഭക്ഷിക്കുന്ന എല്ലാം_കഴിക്കുന്ന എല്ലാം_ഭുജിക്കുന്ന.
ସର୍ବମାନ୍ୟ: സര്വസമ്മതമായ
ସର୍ବମୋଟ: ആകെ മുഴുവനും ഒട്ടാകെ ആകപ്പാടെ
ସର୍ବଶ୍ରେଷ୍ଠ: എല്ലാറ്റിലും_ഉപരി.
ସର୍ବସମ୍ମତ: നിലവിലുള്ള പരമ്പരഗതമായ പ്രചാരത്തിലുള്ള പ്രചാരത്തിലിരിക്കുന്ന സറ്വ്വസാധരണമായ പൊതുവായ സാറ്വ്വജനീനമായ ലോകചാരാമായ പ്രചലിതമായ പ്രാബല്യത്തിലുള്ള സ്ഥാപിതമായ ഇപ്പോഴുള്ള നടപ്പിലുള്ള.
ସର୍ବିୟାନ୍: സര്‍ബിയായിലെ.
ସର୍ବେଶ୍ବର|: സമ്രാട്ട് ചക്രവര്ത്തി.
ସର୍ବୋଚ୍ଚ: എല്ലാറ്റിലും_ഉപരി.
ସଳଖ: നേരേ
ସଶକ୍ତ: ശക്തിയുള്ള ബലമുള്ള ദ്രിഢമായ
ସଶତ୍ରୁ: ശത്രുപൂര്‍ണ്ണം വിരോധമുള്ള വൈരിയുള്ള.
ସଶସ୍ତ୍ର: ശസ്ത്ര_ധാരി.
ସଶୁଳ୍କ: നികുതി_ഏര്പ്പെടുത്തല്.
ସସହାୟ: സാധകമാക്കുന്ന സഹായക ഉപകരിക്കുന്ന ഗുണപ്രദമായ അനുകൂലമായ പ്രയോജനകരമായ ചായ്‌വുള്ള പോഷകമായ ഉതകുന്ന ഉന്നതി_വരുത്തുന്ന അഭിവ്ര്‌ദ്ധിപ്പെടുത്തുന്ന.
ସସୀମ: അതിരുള്ള.
ସହକାରୀ: സഹകരിക്കുന്ന യോജിച്ചു_പ്രവറ്ത്തിക്കുന്ന.
ସହଗାମୀ: സഹയാത്രിക
ସହଜ: ലളിതമായ സരളമായ എളുപ്പമുള്ള സ്വാഭാവികമായ. മനസ്സിലാക്കാവുന്ന ധരിക്കാവുന്ന. സൌകര്യപ്രദമായ സൌകര്യങളിണങിയ സൌകര്യമായ ലഘു_ആയിരിക്കുന്ന.
ସହଜ_ବିଶ୍ବାସୀ: അനായാസ_വിശ്വാസി.
ସହଜପ୍ରାପ୍ୟ: സുലഭമായിട്ട.
ସହଜଲବ୍ଧ: സുലഭമായിട്ട.
ସହନକ୍ଷମ: സഹിക്കാവുന്നത്.
ସହନଶୀଳ: സഹിഷ്ണുതയുള്ള സഹനശക്തിയുള്ള.
ସହନୀୟ: സഹിക്കാവുന്നത്.
ସହମତି_ପ୍ରାପ୍ତ: അങ്കീകരിച്ച സ്വീകരിച്ച.
ସହଯାତ୍ରୀ: സഹയാത്രിക
ସହରିଆ: പട്ടണവാസി നഗരവാസി.
ସହରୀ: പട്ടണവാസി നഗരവാസി.
ସହରୀକୃତ: നഗരവത്കരിക്കപെട്ട പരിഷ്കരിക്കപ്പെട്ട വികസിതമായ.
ସହସ୍ରତମ: ആയിരക്കണക്കിന്.
ସହାୟକ_ଯୁକ୍ତ: സാധകമാക്കുന്ന സഹായക ഉപകരിക്കുന്ന ഗുണപ്രദമായ അനുകൂലമായ പ്രയോജനകരമായ ചായ്‌വുള്ള പോഷകമായ ഉതകുന്ന ഉന്നതി_വരുത്തുന്ന അഭിവ്ര്‌ദ്ധിപ്പെടുത്തുന്ന.
ସହାୟତା_ପ୍ରାପ୍ତ: സഹായം_ലഭിച്ചിട്ടുള്ള ധനസഹായം_ലഭിച്ചിട്ടുള്ള.
ସହାୟତା_ଯୁକ୍ତ: സാധകമാക്കുന്ന സഹായക ഉപകരിക്കുന്ന ഗുണപ്രദമായ അനുകൂലമായ പ്രയോജനകരമായ ചായ്‌വുള്ള പോഷകമായ ഉതകുന്ന ഉന്നതി_വരുത്തുന്ന അഭിവ്ര്‌ദ്ധിപ്പെടുത്തുന്ന.
ସହିଷ୍ଣ୍ନୁ: സഹിഷ്ണുതയുള്ള സഹനശക്തിയുള്ള.
ସହୃଦୟ: ദയാലുവായ ക്രിപാലുവായ കാരുണികനായ മഹാമനസ്കനായ മ്രിദുല_വികാരങള്ക്ക്_അടിമപ്പെടുന്ന.
ସହୃଦୟୀ: മ്രിദുല_വികാരങള്ക്ക്_അടിമപ്പെടുന്ന.
ସହୋଦର: കൂടെ_പിറന്ന.
ସହ୍ୟ: സഹിക്കാവുന്നത്.
ସାଂସାରିକ: ഈ_ലോകത്തുള്ള ലൌഗികമായ.
ସାକାର: ആകാരമുള്ള
ସାକ୍ଷର: അഭ്യസ്‌തവിദ്യനായ വിദ്യാഭ്യാസമുള്ള
ସାକ୍ଷାତ: ആകാരമുള്ള
ସାଢେତିନ: മൂന്നര
ସାତ: ഏഴ്‌ 7
ସାତଗୁଣା: ഏഴുമടങ്ങ്.
ସାଦା: സാധാരണമായ
ସାଦୃଶ୍ୟ: ചേര്‍ച്ചയുള്ള.
ସାଧନ_ପୂର୍ଣ: ധനവിഭവങ്ങളോട്‌_കൂടിയ ധനത്താല്‍_സമ്പന്നനായ സമ്പന്നനായ.
ସାଧନ_ଯୁକ୍ତ: ധനവിഭവങ്ങളോട്‌_കൂടിയ ധനത്താല്‍_സമ്പന്നനായ സമ്പന്നനായ.
ସାଧନ_ସଂପନ୍ନ: ധനവിഭവങ്ങളോട്‌_കൂടിയ ധനത്താല്‍_സമ്പന്നനായ സമ്പന്നനായ.
ସାଧନହୀନ: സാധനങ്ങളില്ലാത്ത.
ସାଧାରଣ: പ്രാധാന്യമില്ലാത്ത. സ്വാഭാവികമായ. സാധാരണ. സാമൂഹികമായ.
ସାଧ୍ବୀ_: നല്ല_സ്വഭാവം_ഉള്ള.
ସାଧ୍ୟ: ചികിത്സിക്കാവുന്നത്.
ସାନନ୍ଦ: ആനന്ദപൂര്‍ണ്ണം ആനന്ദമയം ഉല്ലാസപൂര്‍ണ്ണം സാനന്ദം.
ସାପ୍ତାହିକ: ആഴ്ചയിലുള്ള.
ସାବଧାନ: ബോധമുള്ള കരുതലുള്ള ധാരണാശക്തിയുളള
ସାମଞ୍ଜସ୍ୟପୂର୍ଣ: യോജിപ്പോടുകൂടിയ.
ସାମଞ୍ଜସ୍ୟହୀନ: യോജിപ്പില്ലാത്ത_അവസ്ഥ.
ସାମଥ୍ୟହୀନ: സാമര്ഥ്യം_ഇല്ലാത്ത.
ସାମାଜିକ: സാമൂഹികമായ.
ସାମାନ୍ୟ: സാധാരണ.
ସାମୁଦ୍ରିକ: സമുദ്രത്തിന്റെ. സമുദ്ര സമുദ്രവുമായി_ബന്ധപ്പെട്ട.
ସାମୂହିକ: സാമൂഹികമായ.
ସାମ୍ନା: ആദ്യത്തെ.
ସାମ୍ପ୍ରତିକ: വറ്ത്തമാനകാലത്തുള്ള വറ്ത്തമാനസമയത്തുള്ള ഇപ്പൊഴുള്ള ഇന്നത്തെ വറ്ത്തമാനമായ. ആധുനികം. നിലവിലുള്ള്_കാലത്തെ
ସାମ୍ୟବାଦୀ: സമത്വവാദിയായ. സമത്വവാദിയായ.
ସାରଗର୍ଭକ|: സത്യാവസ്ഥയിലുള്ള് യാഥാര്‍ത്ഥ്യപൂര്‍ണ്ണമായ.
ସାରଜମି: ഉല്പാദനക്ഷമമായ ഫലഭൂയിഷ്ഠമായ സംരിദ്ധമായ സമ്പന്നമായ.
ସାରପୂର୍ଣ୍ଣ: സത്യാവസ്ഥയിലുള്ള് യാഥാര്‍ത്ഥ്യപൂര്‍ണ്ണമായ.
ସାରସ୍ବତ: സത്യാവസ്ഥയിലുള്ള് യാഥാര്‍ത്ഥ്യപൂര്‍ണ്ണമായ.
ସାରହୀନ: നിസ്സാരമായ കഴ്മ്പില്ലാത്ത. നിസ്സാരമായ കാര്യമില്ലാത്ത.
ସାର୍ଥକ: സാറ്ത്ഥകമായ ഉപയോഗമുള്ള ഫലമുള്ള ഗുണമുള്ള ഉപയുക്തിയുള്ള പ്രയോജനമുള്ള ഉപകാരമുള്ള.
ସାର୍ବଜନୀନ: സാമൂഹികമായ.
ସାର୍ବଦେଶିକ: സാര്വഭൌമികമായ.
ସାର୍ବଭୌମ: സാര്വഭൌമികമായ.
ସାହସହୀନ: ഭീരുത്വമുള്ള ഭയശീലമുള്ള ആണത്തമില്ലാത്ത നെഞ്ഞുരപ്പില്ലാത്ത
ସାହସୀ|: സഹസി_ആയ_വ്യക്തി.
ସାହାଯ୍ୟକାରୀ: സഹകരിക്കുന്ന യോജിച്ചു_പ്രവറ്ത്തിക്കുന്ന.
ସାହାସିକ: സാഹസിക സാഹസികമായ ധീരമായ. ധൈര്യപൂറ്വ്വം ധീരതയോടെ ധൈര്യത്തോടെ വീര്യത്തോടെ തന്റേടത്തോടെ മനക്കരുത്തോടെ.
ସାହିତ୍ୟପ୍ରେମୀ: സാഹിത്യ_സ്നേഹി.
ସିଂନ୍ଧୀ: സിന്ധി
ସିଂନ୍ଧୀବାସୀ: സിന്ധി
ସିଂହଳୀ: സിംഹള ശ്രീലംഗന്‍ സിംഹള സിംഹള സിംഹള_ഭാഷ
ସିଆଁ: നിരയനുസരിച്ചു_തുന്നിയ
ସିଆଣିଆ: നിപുണനായ സമര്‍ഥനായ മിടുക്കുള്ള ചാതുര്യമുള്ള
ସିକ୍ତ: നനയ്ക്കപ്പെട്ട.
ସିଙ୍ଗଯୁକ୍ତ: കൊമ്പുള്ള.
ସିଙ୍ଗାପୁରୀ: സിംഗപ്പൂരിയന്‍.
ସିଝା: പുഴുങ്ങിയ.
ସିଞ୍ଚନକାରୀ: നനയ്ക്കുന്‍ന അടിക്കുന്ന വെള്ളം_ഒഴിക്കുന്ന.
ସିଦ୍ଧ: സഫലമായ വിജയകരമായ.
ସିଦ୍ଧହସ୍ତ: പ്രാവീണ്യമുള്ള നിപുണതയുള്ള സാമറ്ത്ഥ്യമുള്ള മിടുക്കമുള്ള നൈപുണ്യമുള്ള പ്രായോഗികയോഗ്യതയുള്ള ചാതുര്യമുള്ള കുശലതയുള്ള വിരുതുള്ള വിചക്ഷണതയുള്ള പാടവമുള്ള തഴക്കമുള്ള പ്രാപ്തിയുള്ള.
ସିଧା: നേരേ
ସିଧା_ମାର୍ଗୀ: നേരെ_പോകുന്ന
ସିଧା_ସାଧା: കാപട്യമില്ലാത്ത നിഷ്കളങ്കരായ ശാന്തസ്വഭാവമുള്ള
ସିନ୍ଧୀ: സിന്ധി സിന്ധി
ସିନ୍ଧୀବାସୀ: സിന്ധി
ସିନ୍ଧୁପ୍ରଦେଶ_ଜାତ: സിന്ദ്ധ്
ସିରିୟାନ୍: സിറിയന്‍.
ସିଲେଇ: നിരയനുസരിച്ചു_തുന്നിയ
ସୀମା_ଅତିକ୍ରାମକ|: മറ്റുള്ളവരുടെ_അധികാര_സീമയില്_കടക്കുന്ന.
ସୀମା_ରକ୍ଷକ: അതിര്‍ത്തി_കാവല്‍ക്കാര്‍ അതിര്‍ത്തി_രക്ഷകര്‍.
ସୀମାଙ୍କିତ: അതിര്‍ത്തി_നിശ്ചയിച്ച.
ସୀମାହୀନ: നിസ്സീമമായ അതിരറ്റ.
ସୀମିତ: അതിരുള്ള.
ସୁଇଜର୍_ଲ୍ୟାଣ୍ଡୀୟ_: സ്വിറ്റ്സര്‍ലാന്റിന്റെ.
ସୁଇସ୍: സ്വിറ്റ്സര്‍ലാന്റിന്റെ.
ସୁକର୍ମୀ|: പുണ്യകര്മ്മങള്_ചെയ്യുന്നവന്.
ସୁକୁମାର: കോമളം സുകുമാരം.
ସୁକ୍ଷ୍ମ: സൂക്ഷ്മമായ.
ସୁଖକର: സന്തോഷിപ്പിക്കുന്ന ത്രിപ്തിപ്പെടുത്തുന്ന. വിശ്രമദായകമായ വിശ്രമം_നല്കുന്ന ക്ഷീണമകറ്റുന്ന ആശ്വാസം_നല്കുന്ന.
ସୁଖଦ: സന്തോഷമേറിയ.
ସୁଖଦାୟକ: സന്തോഷമേറിയ.
ସୁଖଦାୟୀ: സന്തോഷമേറിയ.
ସୁଖପ୍ରଦ: സന്തോഷമേറിയ. വിശ്രമദായകമായ വിശ്രമം_നല്കുന്ന ക്ഷീണമകറ്റുന്ന ആശ്വാസം_നല്കുന്ന.
ସୁଖଭରା: സന്തോഷത്തോടെ സസുഖത്തോടെ ആഹ്ലാദപൂര്‍വ്വം
ସୁଖମୟ: സന്തോഷത്തോടെ സസുഖത്തോടെ ആഹ്ലാദപൂര്‍വ്വം
ସୁଖାତ୍ମକ: സന്തോഷാത്മകം
ସୁଖାନ୍ତ_: സന്തോഷാത്മകം
ସୁଖାସୀନ: സുഖമായി_ഇരിക്കുന്ന.
ସୁଖୀ: സന്തോഷത്തോടെ സസുഖത്തോടെ ആഹ്ലാദപൂര്‍വ്വം
ସୁଖ୍ୟାତ|: സുപ്രസിദ്ധ്നായ
ସୁଗଠିତ: ആകാരവടിവുള്ള. ദൃഢതയുള്ള ഉറപ്പുള്ള
ସୁଗନ୍ଧପୂର୍ଣ୍ଣ: സുഗന്ധമുള്ള.
ସୁଗନ୍ଧିତ: സുഗന്ധമുള്ള. മണമുള്ള. വാസനയുള്ള
ସୁଗମ: ലളിതമായ സരളമായ എളുപ്പമുള്ള മനസ്സിലാക്കാവുന്ന ധരിക്കാവുന്ന.
ସୁଡୌଲ: ആകാരവടിവുള്ള. സൌന്ദര്യമുള്ള സുമുഖമുള്ള ചേലുള്ള ചന്തമുള്ള
ସୁତରା: നിര്‍മ്മലമായ വിമലമായ പവിത്രമായ് ശുദ്ധമായ
ସୁଦର୍ଶନ: നയനാഭിരാമാ‍മായ നയനരമ്യമായ നേത്രാഭിരമാമായ.
ସୁଦାନ_ସମ୍ବନ୍ଧୀୟ: സുഡാനിയന്
ସୁଦାନୀଜ୍: സുഡാനിയന്
ସୁଦୂର: ദൂരെയുള്ള അകലെയുള്ള.അപാറ്ണ്ണമായ വിപ്രക്ര്‌ഷ്ടമായ പര വിദൂരമായ ബഹുദൂരെയുള്ള.
ସୁଦୃଢ: ഒന്നായത്. സുദ്ര്‌ഢമായ കൂടുതല്‍_ശക്തിയുള്ള ദ്ര്‌ഢതയുള്ള ബലമുള്ള ഉറപ്പുള്ള സുസ്ഥാപിതമായ കനത്ത കഠിനമായ കരുത്തുള്ള ഗാഢമായ.
ସୁନିବାର୍ଯ୍ୟ|: നിവാരണമുള്ള്_അവസ്ഥ.
ସୁନ୍ଦର: ആകാരവടിവുള്ള. സൌന്ദര്യമുള്ള സുമുഖമുള്ള ചേലുള്ള ചന്തമുള്ള ആകര്‍ഷിക്കുന്ന ആകര്‍ഷകമായ ആകര്‍ഷണീയമായ വശ്യ മാസ്മരശക്‌തിയുള്ള മാദകമായ ചേതോഹാരിയായ ആനന്ദിപ്പിക്കുന്ന വശീകൃതമായ
ସୁନ୍ଦର_: സുന്ദരമായ മനോഹരമായ.
ସୁନ୍ଦର|: മിടുക്കുള്ള ചുറുചുറുക്കുള്ള.
ସୁନ୍ଦରତମ: മനോഹരമാ‍യ സുന്ദരമായ കോമളമായ ഹ്ര്‌ദ്യമായ ആകറ്ഷകമായ അഴകുള്ള മനോജ്ഞമായ.
ସୁପାଠ୍ୟ_ଅଧ୍ୟୟନୀୟ: വായിക്കുവാന്_പറ്റിയ
ସୁପାତ୍ର: അര്ഹതയുള്ള_വ്യക്തി.
ସୁପ୍ତ|: നിദ്രാനിമഗ്നനായ_‍ ഉറങ്ങിയ.
ସୁପ୍ରସିଦ୍ଧ: സുപ്രസിദ്ധ്നായ
ସୁପ୍ରାପ୍ୟ: സുലഭമായിട്ട.
ସୁବର୍ଣ୍ଣ: നല്ല_നിറമുള്ള. സ്വര്‍ണ്ണമയമായ.
ସୁବାସିତ: സുഗന്ധമുള്ള. വാസനയുള്ള
ସୁବିକଶିତ: വികസിതമായ.
ସୁବିଖ୍ୟାତ: സുപ്രസിദ്ധ്നായ
ସୁବିଧା_ଜନକ: സൌകര്യപ്രദമായ സൌകര്യങളിണങിയ സൌകര്യമായ ലഘു_ആയിരിക്കുന്ന.
ସୁବିଧାପୂର୍ଣ୍ଣ: സൌകര്യപ്രദമായ സൌകര്യങളിണങിയ സൌകര്യമായ ലഘു_ആയിരിക്കുന്ന.
ସୁବିନ୍ୟସ୍ତ|: നന്നായി_ക്രമപ്പെടുത്തപ്പെട്ട സുനിശ്ചിതമായ.
ସୁବୋଧ୍ୟ: മനസ്സിലാക്കാവുന്ന ധരിക്കാവുന്ന.
ସୁବ୍ୟବସ୍ଥିତ: നന്നായി_ക്രമപ്പെടുത്തപ്പെട്ട സുനിശ്ചിതമായ.
ସୁମନିତ: വിടര്‍ന്ന വികസിച്ച.
ସୁରକ୍ଷିତ: സുരക്ഷിതമായ.
ସୁରଭିତ|: സുഗന്ധമുള്ള.
ସୁରମ୍ୟ: ആകര്‍ഷിക്കുന്ന ആകര്‍ഷകമായ ആകര്‍ഷണീയമായ വശ്യ മാസ്മരശക്‌തിയുള്ള മാദകമായ ചേതോഹാരിയായ ആനന്ദിപ്പിക്കുന്ന വശീകൃതമായ
ସୁରୂପ: നല്ല_നിറമുള്ള.
ସୁଲକ୍ଷଣ: നല്ല_ലക്ഷണമുള്ള ഭാഗ്യമുള്ള.
ସୁଲବ୍ଧ: സുലഭമായിട്ട.
ସୁଲଭ: ലഭിച്ച നേടിയ സ്വീകരിക്കപ്പെട്ട. സുലഭമായിട്ട.
ସୁଲେଖ_: സുന്ദരമായ_കയ്യക്ഷരമുള്ള
ସୁଶାନ୍ତ|: വളരേ_ശാന്തമായ_മനസ്സുള്ള.
ସୁଶିକ୍ଷିତ: ഉത്തമനായ സര്‍വ്വശ്റേഷ്ടനായ അതിവിശിഷ്ടനായ ഉല്‍കൃഷ്ടനായ അതുല്യനായ അദ്വിതീനായ മികവുള്ളവനായ
ସୁଶୀଳ: ഉത്തമനായ സര്‍വ്വശ്റേഷ്ടനായ അതിവിശിഷ്ടനായ ഉല്‍കൃഷ്ടനായ അതുല്യനായ അദ്വിതീനായ മികവുള്ളവനായ സജ്ജനം കുലീനനായ മാന്യനായ മര്യാദയുള്ള. സൌമ്യമ്മായ സുശീലയായ.
ସୁଶ୍ରୁତ: നന്നായി_കേട്ട് പൂറ്ണ്ണമായി_കേട്ട.
ସୁସଜ୍ଜିତ: തയ്യാറാക്കിയ ഒരുക്കിയ സജ്ജമാക്കിയ പൂറ്ത്തിയാക്കിയ.
ସୁସ୍ଥ: ആരോഗ്യപൂര്‍ണ്ണമായ ആരോഗ്യകരമായ
ସୁସ୍ବର|: മധുര_സ്വരമുള്ള.
ସୁସ୍ବାଦୁ: സ്വാദിഷ്ട്ടമായ.
ସୂକ୍ଷ୍ମ: കഠിനമായ. നേര്‍മയുള്ള
ସୂକ୍ଷ୍ମତମ: അത്യധികം_സൂക്ഷ്മമായ.
ସୂଚକ: പറയുന്ന വിവരിക്കുന്ന.
ସୂଚିତ: പറഞ്ഞ
ସୂର୍ଯ୍ୟ_ନାଡି: അടുത്തുള്ള.
ସୃଜିତ: രചിക്കപ്പെട്ട എഴുതപ്പെട്ട.
ସୃଷ୍ଟ: ഉല്പന്ന് ഉണ്ടായ ജനിച്ച.ഉത്ഭവിച്ച രൂപപ്പെട്ട ഉല്പാദിപ്പിച്ച. രചിക്കപ്പെട്ട എഴുതപ്പെട്ട.
ସେଚକ: നനയ്ക്കുന്‍ന അടിക്കുന്ന വെള്ളം_ഒഴിക്കുന്ന.
ସେଚିତ: നനയ്ക്കപ്പെട്ട.
ସେନେଗାଲ_ବାସୀ: സിനഗളിയന്
ସେବନୀୟ: ഉപയോഗിക്കാന്‍_കൊള്ളാവുന്ന സേവിക്കാന്‍_അര്‍ഹമായ ആരാധ്യമായ.
ସେବାକାରୀ: ശുശ്രൂഷിക്കുന്ന
ସେବାନିବୃତ୍ତ: ജോലിയില്‍_നിന്ന്_വിരമിച്ച റിട്ടയറായ പെന്‍ഷന്‍_പറ്റിയ വിശ്രമയ_സമയം_പ്രാപിച്ച ഉദ്യോഗമൊഴിഞ്ഞ.
ସେବିତ: സേവിക്കപ്പെട്ട.
ସେବ୍ୟ: സേവിക്കപ്പെട്ട. ഉപയോഗിക്കാന്‍_കൊള്ളാവുന്ന സേവിക്കാന്‍_അര്‍ഹമായ ആരാധ്യമായ.
ସେମଟା: ചുരുങ്ങുക.
ସୈନ୍ଧବ: സിന്ദ്ധ് സമുദ്രത്തിന്റെ.
ସୌଖୀନ: സ്ത്രീ_ലംബടനായ വിലാസപ്രിയനായ ഭോഗപ്രിയനായ.
ସୌଭାଗ୍ୟଶାଳୀ: സൌഭാഗ്യമുള്ള ഭാഗ്യമുള്ള.
ସୌମ୍ୟ: സൌമ്യനായ. സൌമ്യമ്മായ സുശീലയായ. ഗൌരവമുള്ള പതറാത്ത സുദൃഢമായ സുസ്ഥിരമായ
ସୌରମଣ୍ଡଳୀୟ: സൂര്യന്റെ.
ସୌହାର୍ଦ୍ଦ୍ୟପୂର୍ଣ୍ଣ: ഒരുമയോടെ അഖണ്ഡമായ അനന്യമായ ഏകീക്ര്‌തമായ ഒന്നായ സംഗതമായ പൊരുത്തപ്പെട്ട ഏക സംഘടിതമായ ഏകീഭവിച്ച ഏകചിത്തമായ യോജിച്ച ഏകകണ്ഡമായ.
ସ୍କେଣ୍ଡିନେବିୟାଈ: സ്കാന്റിനേവിയന്‍
ସ୍ଖଳିତ: തകര്‍ത്ത നിലത്തു_വീണ. മാറിയ ഇളക്കപ്പെട്ട അസ്ഥിരമായ ചഞ്ചലമായ പരിഭ്രമിച്ച.
ସ୍ତନପାୟୀ: മുലകുടിക്കുന്ന.
ସ୍ତନ୍ୟ: സ്തന_സംബന്ധമായ.
ସ୍ତରଯୁକ୍ତ: മടക്കുകളുള്ള തട്ടുകളുള്ള.
ସ୍ତରସ୍ତର: മടക്കുകളുള്ള തട്ടുകളുള്ള.
ସ୍ତରିତ: മടക്കുകളുള്ള തട്ടുകളുള്ള.
ସ୍ତରୀୟ: നിലവാരമുള്ള
ସ୍ତ୍ରୈଣ: സ്ത്രീക്കു_ചേര്ന്നതായ. സ്ത്രീക്കു_ചേര്ന്നതായ.
ସ୍ଥଗିତ: സതംഭിച്ച.
ସ୍ଥାନଚ୍ୟୁତ: സ്ഥാനത്തു_നിന്നു_നീക്കിയ സ്ഥലത്തു_നിന്നു_അകറ്റപ്പെട്ട.
ସ୍ଥାନାନ୍ତରିତ: സ്ഥാനത്തു_നിന്നു_നീക്കിയ സ്ഥലത്തു_നിന്നു_അകറ്റപ്പെട്ട.
ସ୍ଥାନୀୟ: സ്വദേശീയ തത്സ്ഥാനത്തുള്ള ജനിച്ച_സ്ഥലത്തുള്ള.
ସ୍ଥାପନଯୋଗ୍ୟ: സ്ഥാപിക്കപ്പെടാന്_യോഗ്യം.
ସ୍ଥାପନୀୟ: സ്ഥാപിക്കപ്പെടാന്_യോഗ്യം.
ସ୍ଥାପିତ: സ്ഥാപിക്കപ്പെട്ട.
ସ୍ଥାପିତ୍ବ: ഗ്രഹിക്കപ്പെട്ട
ସ୍ଥାପ୍ୟ: സ്ഥാപിക്കപ്പെടാന്_യോഗ്യം.
ସ୍ଥାୟୀ: സ്ഥിരമായ ശാശ്വതമായ സ്ഥായിയായ അനശ്വരമായ സ്ഥായിയായ
ସ୍ଥିତ: ക്രിത്യമായി_സ്ഥാന_നിര്ണ്യം_നടത്തിയ.
ସ୍ଥିର: പ്രവഹിക്കാത്ത ശാന്ത_മായ നില്‍ക്കുന്ന സ്ഥിരമായ ഗതിഹീനമായ. ചലനമില്ലാത്ത ചലിക്കാത്ത ഗതിരോധമുള്ള. ഗൌരവമുള്ള പതറാത്ത സുദൃഢമായ സുസ്ഥിരമായ സ്ഥിരമായ. ദ്രിഢമായ. വളരേ_ശാന്തമായ_മനസ്സുള്ള. നിശ്ചലമായ
ସ୍ଥିରଚିତ୍ତ: വളരേ_ശാന്തമായ_മനസ്സുള്ള.
ସ୍ଥୂଳ: തടിച്ച സ്ഥുലശരീരിയായ
ସ୍ଥୂଳକାୟ: തടിച്ച സ്ഥുലശരീരിയായ
ସ୍ନିଗ୍ଧ_: സ്നേഹമുള്ള.
ସ୍ନେହୀ: സ്നേഹമുള്ള.
ସ୍ପଷ୍ଟ: സ്പഷ്ടമായ ശരിയായ സ്പഷ്ടമായ വ്യക്തമായ സ്ഫുടമായ
ସ୍ପଷ୍ଟବାଦୀ|: സ്പഷ്ട്ട_വാദി.
ସ୍ପାନିଶ_: സ്പയ്നിഷ്.
ସ୍ପୁର୍ତ୍ତିବାନ: സ്ഥിരമായി_പരിശ്രമിക്കുന്ന
ସ୍ପେନିୟ: സ്പാനിഷ്
ସ୍ପେନୀୟ: സ്പയ്നിഷ്.
ସ୍ପେସାଲ: അസാമാന്യമായ സാധാരണമല്ലാത്ത.
ସ୍ପ୍ରିଙ୍ଗ୍_ଯୁକ୍ତ: പൂറ്വ്വസ്ഥിതിഗമ്യമുള്ള സ്പ്രിംഗുള്ള.
ସ୍ଫୁର୍ତ୍ତି_ଦାୟକ: ഉത്സാഹം_തരുന്ന.
ସ୍ଫୁର୍ତ୍ତିପ୍ରଦ: ഉത്സാഹം_തരുന്ന.
ସ୍ଫୂର୍ତ୍ତିହୀନ: അനുത്സാഹികളായ.
ସ୍ବକୀୟ: അവനവന്റെ സ്വന്തമായ തന്റെ തന്റേതായ.
ସ୍ବକୃତ: അടിസ്ഥാനപരമായ മൌലീക യഥാറ്ത്ഥമായ തനതായ അക്ര്‌ത്രിമമായ.
ସ୍ବଚ୍ଛ: സ്വച്ഛമായ സ്പഷ്ട്ടമായ തെളിഞ്ഞ. പരിഷ്ക്കരിച്ച ശുദ്ധീകരിച്ച സ്ഫുടം_ചെയ്ത. തിളങ്ങുന്ന ശോഭയുള്ള തെളിമയുള്ള ശുദ്ധമായ സ്പഷ്ട്ടമായ.
ସ୍ବଜନ_ଭାବନାପୂର୍ଣ୍ଣ|: സ്വജന_സങ്കല്പത്തോടു_കൂടി.
ସ୍ବଜନୀୟ: എന്നെ_സംബന്ധിക്കുന്ന എന്റേതായ സ്വന്തം തന്റേതായ.
ସ୍ବଜାତୀୟ: സ്വജാതീയ ഒരേ_വറ്ഗ്ഗത്തില്‍_പെട്ട സജാതീയ.
ସ୍ବତନ୍ତ୍ର|: സ്വതന്ത്രമായ.
ସ୍ବଦେଶୀ: പ്രാദേശിക പ്രദേശികമായ സ്വദേശിയമായ ദേശിയതദ്ദേശീയമായ.
ସ୍ବପକ୍ଷୀୟ: എന്റെ_പക്ഷത്തുള്ള സ്വ്ന്തം_ഭാഗത്തുള്ള തന്റെ തന്റെ_പക്ഷത്തുള്ള സ്വപക്ഷത്തുള്ള.
ସ୍ବବଶ: സ്വതന്ത്ര്മായ നിയന്ത്രണമില്ലാത്ത.
ସ୍ବଭାବଗତ: സ്വാഭാവികമായ.
ସ୍ବଭାବତଃ: സ്വാഭാവികമായ.
ସ୍ବଭାବିକ: സ്വാഭാവികമായ.
ସ୍ବର: സ്വരം_ചേര്‍ന്ന.
ସ୍ବରଚିତ: അടിസ്ഥാനപരമായ മൌലീക യഥാറ്ത്ഥമായ തനതായ അക്ര്‌ത്രിമമായ.
ସ୍ବରଯୁକ୍ତ: സ്വരം_ചേര്‍ന്ന.
ସ୍ବର୍ଜିତ: തനിയെ_ഉണ്ടാക്കിയത് താന്‍_സമ്പാദിച്ച്.
ସ୍ବର୍ଣ୍ଣ: സ്വര്‍ണ്ണമയമായ.
ସ୍ବର୍ଣ୍ଣିମ: സ്വര്‍ണ്ണമയമായ.
ସ୍ବଳ୍ପାହାରୀ: അല്പമായും_ക്രമീക്ര്‌തമായും_ആഹാരം_കഴിക്കുന്ന മിതമായി_ഭക്ഷിക്കുന്ന സ്വല്പം_ഭക്ഷിക്കുന്ന.
ସ୍ବଳ୍ପାୟୁ: അല്പായുസ്സുള്ള ആയുസ്സ്_കുറഞ്ഞ.
ସ୍ବଶିକ୍ଷିତ: സ്വന്തം_ശിക്ഷണം_കൊണ്ട്_വിദ്യ_കൈവരിച്ച.
ସ୍ବାକ୍ଷରିତ: ഒപ്പുവെച്ച്ത്.
ସ୍ବାଜୀ: സ്വാസിലാന്റിയന്
ସ୍ବାଦପୂର୍ଣ୍ଣ: സ്വാദോടുകൂടിയ.
ସ୍ବାଦଯୁକ୍ତ: സ്വാദോടുകൂടിയ.
ସ୍ବାଦହୀନ: സ്വാദില്ലാത്ത. രുചിയില്ലാത്ത.
ସ୍ବାଦିଷ୍ଟ: സ്വാദിഷ്ട്ടമായ.
ସ୍ବାଦୁହୀନ: സ്വാദില്ലാത്ത.
ସ୍ବାଧୀନ: സ്വതന്ത്രമായ.
ସ୍ବାବଲମ୍ବିନୀ: സ്വതന്ത്രമായ.
ସ୍ବାବଲମ୍ବୀ: സ്വയം_ആശ്രയിക്കുന്ന.
ସ୍ବାଭାବିକ: സ്വാഭാവികമായ.
ସ୍ବାଭିମାନହୀନ: സ്വാഭിമാനം_ഇല്ലാത്ത.
ସ୍ବାଭିମାନୀ: ആത്മാഭിമാനമുള്ള.
ସ୍ବାର୍ଥ: സ്വാര്‍ത്ഥ_താത്പര്യമുള്ള തങ്കാര്യത്തിലുള്ള_ശ്രദ്ധയുള്ള സ്വാര്‍ത്ഥ_ബുദ്ധിയുള്ള സ്വതാത്പര്യ്മുള്ള ആത്മാരാധന അഹങ്കാരോന്മാദിയായ പൊങച്ചം_കാണിക്കുന്ന സ്വജന_പക്ഷപാതമുള്ള ഭൌതിക_താത്പര്യങളുള്ളൈടുങിയ_മനസ്ത്ഥിതിയുള്ള_. സ്വന്തം_ഇഷ്ട്ടാനുസരണം.
ସ୍ବାର୍ଥତ୍ୟାଗୀ: സ്വാര്ഥം_ത്യജിച്ച.
ସ୍ବାର୍ଥପର: സ്വാര്‍ത്ഥ_താത്പര്യമുള്ള തങ്കാര്യത്തിലുള്ള_ശ്രദ്ധയുള്ള സ്വാര്‍ത്ഥ_ബുദ്ധിയുള്ള സ്വതാത്പര്യ്മുള്ള ആത്മാരാധന അഹങ്കാരോന്മാദിയായ പൊങച്ചം_കാണിക്കുന്ന സ്വജന_പക്ഷപാതമുള്ള ഭൌതിക_താത്പര്യങളുള്ളൈടുങിയ_മനസ്ത്ഥിതിയുള്ള_.
ସ୍ବାର୍ଥପରାୟଣ: സ്വാര്‍ത്ഥ_താത്പര്യമുള്ള തങ്കാര്യത്തിലുള്ള_ശ്രദ്ധയുള്ള സ്വാര്‍ത്ഥ_ബുദ്ധിയുള്ള സ്വതാത്പര്യ്മുള്ള ആത്മാരാധന അഹങ്കാരോന്മാദിയായ പൊങച്ചം_കാണിക്കുന്ന സ്വജന_പക്ഷപാതമുള്ള ഭൌതിക_താത്പര്യങളുള്ളൈടുങിയ_മനസ്ത്ഥിതിയുള്ള_.
ସ୍ବାର୍ଥହୀନ: സ്വാര്ഥഹീനനായ നിസ്വാര്ഥിയായ.
ସ୍ବାସ୍ଥପ୍ରଦ: ആരോഗ്യപ്രദമായ.
ସ୍ବାସ୍ଥ୍ୟନାଶକ: ആരോഗ്യത്തിനു_ഹാനികരമായ
ସ୍ବାୟତ୍ତ: സ്വാശ്രയ സ്വയം_പര്യാപ്തമായ സ്വായത്തമായ സ്വയം_ഭരണാവകാശമുള്ള. സ്വതന്ത്ര്മായ നിയന്ത്രണമില്ലാത്ത.
ସ୍ବିଡିଶ୍: സ്വീഡന്റെ.
ସ୍ବୀକାର_କରିବା: വിശ്വസിക്കുന്ന സമ്മതിക്കുന്ന അംഗീകരിക്കുന്ന.
ସ୍ବୀକାରଯୋଗ୍ୟ: സ്വീകാര്യമായ.
ସ୍ବୀକାର୍ଯ୍ୟ: സ്വീകാര്യമായ.
ସ୍ବୀକୃତ: സ്വീകരിച്ച സ്വീകരിക്കപ്പെട്ട അനുമതി_കിട്ടിയ അനുമതി_പ്രദാനം_ചെയ്ത. സ്വന്തമായി_തിരഞ്ഞെടുത്ത. അങ്കീകരിച്ച സ്വീകരിച്ച. അങ്ഗീകാര_യോഗ്യമായ. സ്വീക്രിതമായ
ସ୍ବୀକୃତି_ପ୍ରାପ୍ତ: അങ്കീകരിച്ച സ്വീകരിച്ച.
ସ୍ବୀଡେନୀୟ: സ്വീടിഷ്
ସ୍ବେଚ୍ଛାଚାରୀ: തന്നിഷ്ടം_പോലെ സ്വന്തം_ഇഷ്ടമനുസരിച്ച് സ്വതാത്പര്യം_അനുസരിച്ച്.
ସ୍ବେଚ୍ଛାର୍ଥ_: സ്വന്തം_ഇഷ്ട്ടാനുസരണം.
ସ୍ବେଦେଶ: പ്രാദേശിക പ്രദേശികമായ സ്വദേശിയമായ ദേശിയതദ്ദേശീയമായ.
ସ୍ବୋପାର୍ଜିତ: തനിയെ_ഉണ്ടാക്കിയത് താന്‍_സമ്പാദിച്ച്.
ସ୍ବୟଂସିଦ୍ଧ_|: സ്വമേധയാ_ശരിയായത്.
ସ୍ଲୋବାକୀୟ: സ്ലൊവാക്കിയയുടെ. സ്ലൊവാക്കിന്റെ.
ସ୍ୱଚ୍ଛନ୍ଦ: സ്വേച്ഛാധിപതിയായ അനിയന്ത്രിതനായ നിരങ്കുശനായ കടിഞ്ഞാണില്ലാത്ത.
ସ୍ୱଛ: നിര്‍മ്മലമായ വിമലമായ പവിത്രമായ് ശുദ്ധമായ
ସ୍ୱର୍ଗବାସୀ: മരിച്ച അന്തരിച്ച സമാധിയായ മഹാനിദ്രയിലായ നിര്യാതനായ
ସ୍ୱର୍ଗୀୟ: മരിച്ച അന്തരിച്ച സമാധിയായ മഹാനിദ്രയിലായ നിര്യാതനായ
ସ୍ୱସ୍ଥ: ആരോഗ്യപൂര്‍ണ്ണമായ ആരോഗ്യകരമായ
ହକଦାର|: അവകാസപ്പെട്ട് അധികാരപ്പെട്ട.
ହଜିଲା: വംശനാശം_സംഭവിച്ചത്.
ହଟିଆ: വാശിക്കാരനായ.
ହଡବଡିଆ: സൂക്ഷ്മതയില്ലാത്ത വേണ്ടപോലെ_ആലോചിക്കാത്ത ദ്രുതഗതിയിലുള്ള.
ହତାଶ: നിരാശയുള്ള.
ହତ୍ୟାକାରୀ: കൊലപാതകികള്.
ହରିତ: പച്ചയാര്‍ന്ന.
ହର୍ଷଦାୟକ: ആനന്ദപ്രദം ആനന്ദ_ദായകം സുഖപ്രദം പ്രസന്നതാദായകം ആനന്ദദായി ആനന്ദകാരി ആഹ്ലാദി.
ହର୍ଷିତ: ആനന്ദം_നിറഞ്ഞ സന്തോഷം_പ്രകടിപ്പിക്കുന്ന.
ହଳଦିଆ: മഞ്ഞയായ പാണ്‌ഡുരമായ പീതവറ്‍ണ്ണമായ പിംഗലവര്‍ണ്ണമായ
ହସକୁରା: ചിരിക്കുന്ന ചിറിക്കുന്ന പുഞ്ചിരിക്കുന്ന.
ହସକୁରିଆ: നര്‍മ്മബോധമുള്ള രസികത്വമുള്ള
ହସମୁଖ: ചിരിച്ചമുഖം പുഞ്ചിരി_തൂകുക
ହସମୁହାଁ: ചിരിക്കുന്ന ചിറിക്കുന്ന പുഞ്ചിരിക്കുന്ന.
ହସହସମୁହଁ: ചിരിച്ചമുഖം പുഞ്ചിരി_തൂകുക
ହସିଲା: ചിരിച്ചമുഖം പുഞ്ചിരി_തൂകുക
ହସୁଆ: ചിരിക്കുന്ന ചിറിക്കുന്ന പുഞ്ചിരിക്കുന്ന.
ହସୁଥିବା: ചിരിച്ചമുഖം പുഞ്ചിരി_തൂകുക
ହସୁରା: ചിരിക്കുന്ന ചിറിക്കുന്ന പുഞ്ചിരിക്കുന്ന.
ହସ୍ତଗତ: കിട്ടിയ നേടിയ.
ହସ୍ତନିର୍ମିତ|: കരകൌശല കൈ_കൊണ്ട്_നിറ്മ്മിച്ച.
ହସ୍ତାକ୍ଷରିତ_: ഒപ്പുവെച്ച്ത്.
ହାଇଦ୍ରାବାଦୀ: ഹൈദരബാദിനെ_സംബന്ധിക്കുന്ന.
ହାଜିର: ഹാജരുള്ള സന്നിഹിതമായ വന്ന ഉള്ള
ହାଡମୟ: അസ്ഥി_പഞരം_പോലെ എല്ലും_തോലും_മാത്രമാവുക.
ହାଡୁଆ: അസ്ഥി_പഞരം_പോലെ എല്ലും_തോലും_മാത്രമാവുക.
ହାତତିଆରି: കരകൌശല കൈ_കൊണ്ട്_നിറ്മ്മിച്ച.
ହାନିକାର: ദോഷം_ചെയ്യുന്ന നാശം_ചെയ്യുന്ന.
ହାନିକାରକ: ദോഷം_ചെയ്യുന്ന നാശം_ചെയ്യുന്ന.
ହାନିପ୍ରଦ: ദോഷം_ചെയ്യുന്ന നാശം_ചെയ്യുന്ന.
ହାରାମୀ: ദുഷ്ട ദുഷിച്ച ചീത്ത നീച തെമ്മാടി പോക്കിരി താന്തോന്നി ആഭാസന്‍ നെറികെട്ടവന്‍
ହାର୍ଦ୍ଦିକ: ഹ്ര്ദയംഗമമായ ഹ്ര്ദയപൂറ്വ്വമായ ആത്മാറ്ഥമായ ഹ്ര്ദയത്തില്_നിന്നുള്ള യഥാറ്ത്ഥ നിഷ്കളങ്കമായ.
ହାଲ: നിലവിലുള്ള്_കാലത്തെ
ହାଲୁକା: കനം_കുറഞ്ഞ
ହାସଲ: കിട്ടിയ നേടിയ.
ହାସ୍ୟହୀନ: തമാശയില്ലാത്ത.
ହାସ୍ୟାସ୍ପଦ: ചിരിപ്പിക്കുന്ന.
ହାସ୍ୟୋତ୍ପାଦକ: ചിരിപ്പിക്കുന്ന.
ହିଂସ୍ର: ഹിംസകന്. ഭയാനകമായ ഭീകരമായ ഉഗ്രമായ ഞെട്ടിക്കുന്ന ഭീതിജനകമായ ഭയാവഹമായ രുദ്രമായ
ହିଂସ୍ରକ: ഹിംസകന്.
ହିତକାରକ: നന്മ_നല്കുന്ന
ହିତକାରୀ: ലാഭദായകം ഗുണകരം ഉപയോഗപ്രദം. നന്മ_നല്കുന്ന നന്മ_നല്കുന്ന
ହିମବତ: മഞ്ഞുപോലെയുള്ള.
ହିମଯୁକ୍ତ: ഐസ്സുള്ള.
ହୀବ୍ରୁ: യഹൂദ ജൂത.
ହୁଗୁଳା: അയഞ്ഞ. അഴിഞ്ഞ. മുറുക്കമില്ലാത്ത.
ହୁସିଆର: ബോധമുള്ള കരുതലുള്ള ധാരണാശക്തിയുളള
ହୃଦୟବାନ: ഉദാരമതിയായ വിശാലഹ്രിദയനായ . കോമള_ഹ്രിദയം.
ହୃଦୟସ୍ପର୍ଶୀ_: ഭാവനാത്മകമായ.
ହୃଦୟହୀନ: വികാരമില്ലാത്ത.
ହେୟ: ഉപേക്ഷിക്കത്തക്ക അവഹേളിക്കത്തക്ക. ചീത്ത
ୟାଡୁସେଆଡୁ: അസംബന്ധം.
ୟୁଗୋସ୍ଲୋଭୀୟ: യൂഗോസ്ലാവിയായിലെ.
ୟୁନାନୀ|: യവനയിലേ ഗ്രീസിലേ.
ୟୂକ୍ରେନୀୟ: യൂക്രേനിന്റെ. യൂക്രേനിന്റെ_ഭാഷ.
ୟୂନାନୀ: യുനാനി
ୟୂରେସିୟାଈ: യുരേശിയയുടെ.
ୟୂରୋପୀୟ: യൂരോപിലെ.
ୟେମେନ_ସମ୍ବନ୍ଧିତ: യമന്‍.
ୟେମେନୀ: യമന്‍.
୦୦୦|: പതിനായിരം പത്ത്_ആയിരം.
୧: ഒരു ഒന്ന് 1.
୧୦: പത്ത് ദശം ദശകം 10 പത്താം പതിനായിരം പത്ത്_ആയിരം.
୧୦୦ତମ_: നൂറാമത്തെ.
୧୦୦୦ତମ: ആയിരക്കണക്കിന്.
୧୦୦୦୦୦୦|: പത്ത്_ലക്ഷം മില്ല്യണ്‍ 100000.
୧୦୦୦୦୦୦୦|: ഒരു_കോടി 10000000
୧୧ତମ: പതിനൊന്നാം പതിനൊന്നാമത്തെ
୧୨ତମ: പന്ത്ര്ണ്ടാമത്തെ പന്ത്രണ്ടാം
୧୩ତମ: പതിമൂന്നാം പതിമൂന്നാമത്തെ
୧୪ତମ: പതിനാലാം പതിനാലാമത്തെ
୧୫ତମ: പതിനഞ്ചാം പതിനഞ്ചാമത്തെ
୧୭_: പതിനേഴ്.
୧୭ତମ: പതിനേഴാം പതിനേഴാമത്തെ
୧୮ତମ: പതിനെട്ടാം പതിനെട്ടാമത്തെ
୧୯ତମ: പത്തൊന്‍പതാം പത്തൊന്‍പതാമത്തെ
୨ୟ: രണ്ടാം ദ്വിതീയ
୨୦: ഇരുപതാം
୨୨: ഇരുപത്തി_രണ്ട്.
୨୨ତମ: ഇരുപത്തി_രണ്ടാമത്തെ.
୪: നാലാം നാല്‌ 4
୫: അഞ്ച് 5
୫ମ: അഞ്ചാമത്തെ അഞ്ചാം
୫୨|: അന്പത്തി_രണ്ട്.
୬ଷ୍ଠ: ആറാം ആ‍റാമത്തെ
୬୦_: അറുപത്.
୭: ഏഴ്‌ 7
୭ମ: ഏഴാം ഏഴാമത്തെ
୭୦_: എഴുപത്.
୭୭: എഴുപത്തി_ഏഴ്
୭୯: എഴുപത്തി_ഒന്പത്
୮: എട്ട് 8
୮ମ: എട്ടാം എട്ടാമത്തെ
୮୧: എണ്പത്തി_ഒന്ന്
୯: ഒന്‍പത് 9
୯୦ତମ: തൊണ്ണൂറാമത്തെ
୯୧: തൊണ്ണൂറ്റി_ഒന്ന്
୯୨|: തൊണ്ണൂറ്റി_രണ്ട്.
୯୭: തൊണ്ണൂറ്റി_ഏഴ്
ୱାଜିବ: യുക്തമായ ഉചിതമായ ഒത്ത തക്ക
