अंकीत: લિખિત લખેલું લેખિત લખેલ લિપિબદ્ધ અંકિત મકતૂબ અંકિત ચિત્રિત અભિલક્ષિત ચિન્હિત
अंगरक्षक: રક્ષક ચોકીદાર રખવાળ પાલક વૉર્ડન
अंडज: અંડજ અંડજાત દ્વિજ
अंतरयामी: અંતર્યામી અંતરજ્ઞ સર્વજ્ઞ સર્વજ્ઞાતા
अंतर्दर्शी: આત્મનિરીક્ષક અંતદર્શી આત્મદર્શી
अंतर्मुखी: અંતર્મુખી અંતરાભિમુખ આત્માભિમુખી અંતર્લીન
अंधश्रद्धाळू: મતાંધ સ્વમતાગ્રહી કટ્ટરપંથી
अंधूक: ઝાંખું ધૂંધળું અસ્પષ્ટ
अकथनीय: અકથનીય અકથ્ય અકથ અવર્ણનીય અવ્યક્તવ્ય અવાચ્ય અવચનીય અવદ્ય અસંભાષ્ય
अकर्मी: અકર્તા અકર્તાર
अकलात्मक: અકલાત્મક અકલા વિકલા
अकल्पीत: અકલ્પનીય અકલ્પ્ય અકળ અકલ્પિત અચિંત્ય
अकल्याणकारी: હાનિકારક અકલ્યાણકારી અનિષ્ટકર અમંગલકારી અમાંગલિક અકુશળ અશુભકારી અહિતકર અહિતકારી અશુભ અનભીષ્ટ અકલ્યાણ_કામી અશુભેચ્છક અનર્થદર્શી અશુભચિંતક
अकस्मात: આકસ્મિક અનપેક્ષિત અચાનક એકાએક ઓચિતું અણધાર્યુ અપ્રત્યાશિત આપાતી દૈવી દૈવાગત દૈવયોગી
अकाळीक: અકાલજ અકાલજન્મ અકાલ_પ્રસૂત અકાળ કવેળા અનવસર કવખત અસામયિક અકાલિક
अकुळीन: અકુલીન નિમ્ન_વંશીય હલકા_વંશનું અકુલ
अकूशळ: અકુશલ અકુશળ અનિષ્ટ અણકસબી ગમાર અપટુ અનિપુણ અપ્રવીણ અણઘડ અપાટવ
अकृत: અકૃત ન_કરેલું અરચિત અનિર્મિત અકૃત
अकृतज्ञ: કૃતઘ્ન કૃતજ્ઞ કૃતઘ્ની અપકારી નિમકહરામ લૂણહરામ
अक्षम्य: અક્ષમ્ય ક્ષમાશૂન્ય
अक्षय: અમર અવિનાશી નિત્ય અક્ષર સનાતન અક્ષય શાશ્વત અનાશ અનાશવાન અનાશ્ય અભંગુર અચ્યુત અભંગ અવિગત અવિગત અમરણીય અમૃતાક્ષર અનપાય
अखंड: અભેદ અભેદ્ય દુર્ભેદ દુર્ભેદ અખંડનીય અપ્રવેશ્ય ગૂઢ ગહન અગમ્ય અભેદત્વ અભંજનશીલ અભંગ અભંજન અતૂટ અખંડ
अखंडीत: અભંગુર અભંજનશીલ અભંગ અખંડ અખંડિત અક્ષત અખંડ ખંડહીન અભંજિત અવિચ્છિન્ન અવિભક્ત અખંડ આખું સમગ્ર અખંડિત અભગ્ન અવિભક્ત અટૂટ અતૂટ અભંગ અભંજન અવિચ્છિન્ન વિચ્છિન્ન અવિદ્ધ અણવીંધ્યું અનબેધા અનબીંધા
अखेरच्या: અંતિમ છેલ્લું છેવટનું આખરી અંત્ય ચરમ આખર અવમ
अग्नीशामक: શામક પ્રશામક શાંતિકર શમક
अग्रगामी: આગેવાન અગ્રગામી નેતા દોરનાર અગ્રણી અગ્રેસર મુખી સરદાર નાયક પુરોગામી
अग्रणी: પુરોગામી અગ્રગામી પૂર્વગામી
अघटीत: અઘટિત અઘટનીય અઘટ અઘટિત અણછાજતું
अचंचळ: અડગ અવિચલિત સ્થિર અચળ દૃઢ અશિથિલ
अचंबीत: વિલક્ષણ વિચિત્ર અદ્ભુત અસાધારણ વિભિન્ન જુદું અજાયબ આશ્ચર્યકારક અજબ અનોખું આશ્ચર્યજનક અભૂતપૂર્વ અપૂર્વ અલૌકિક અસંસારી આશ્ચર્ય અચંભિત ચકિત દંગ આશ્ચર્યચકિત અવાક છક_થયેલું નવાઈ_પામેલું વિસ્મય_પામેલું સ્તબ્ધ
अचकीत: આકસ્મિક અનપેક્ષિત અચાનક એકાએક ઓચિતું અણધાર્યુ અપ્રત્યાશિત આપાતી દૈવી દૈવાગત દૈવયોગી
अचल: અચળ દૃઢ સ્થિર ગતિહીન અચલ સ્થાવર અચર વિભુ સ્થિર સ્થાયી અચેષ્ટ નિશ્ચલ અડગ અચળ અચલ અટલ ધ્રુવ નિશ્વળ નિશ્વિત અવિચલ અડોલ દૃઢ અટળ નિત્ય
अचेतन: જડ અચેતન સ્થૂળ ભૌતિક અનાત્મ અજૈવ અજીવ નિર્જીવ ચેતના_રહિત
अजय: અજેય અજય અજિત અપરાજિત અપરાજેય દુર્જેય
अजरंवर: અમર ચિરંજીવ ચિરંજીવી અવિનાશી નિત્ય અક્ષર સનાતન કાળજિત મૃત્યુંજય અમર્ત્ય ચિરંજીવી લાંબા_આવરદાવાળું આયુષ્યમાન ચિરાયુ દીર્ઘાયુ શતશરદ દીર્ઘજીવી
अजरामर: અજર ચિરયુવાન ચિરયૌવનપૂર્ણ જરારહિત
अजागळ: અણઘડ ફૂહડ
अजाण: અજ્ઞેય અકળ ગહન ગૂઢ અગમ અગમ્ય અવેદ્ય અવિવેકી અવિચારી અણસમજુ અબુધ અજાણ નાસમજ અસભ્ય બેઅદબ અમર્યાદ અવિનયી
अजातशत्रू: અજાતશત્રુ શત્રુહીન શત્રુવિહીન અરિહીન અભૂતશત્રુ
अजापाचें: અભૂતપૂર્વ અપૂર્વ અદ્ભુત
अजापीत: નિરપેક્ષિત નિઃસ્પૃહ આશ્ચર્ય અચંભિત ચકિત દંગ આશ્ચર્યચકિત અવાક છક_થયેલું નવાઈ_પામેલું વિસ્મય_પામેલું સ્તબ્ધ
अजीर्ण: અજીર્ણ અજીરણ
अजैत: અપરાજિત અપરાસ્ત અજિત અપ્રતિહત અજેય અજય અજિત અપરાજિત અપરાજેય દુર્જેય
अज्ञात: અજ્ઞાત અજાણ્યું અવિદિત અનવગત અપરિચિત અપરિગત અનધિગત બિનવાકેફ અનભિજ્ઞ અજ્ઞ બેખબર બિનવાકેફગાર અણજાણ અજાણ ગુમનામ અપરિચિત અજાણ્યું અજનબી અજનવી અજ્ઞાત અપરિગત બિનવાકેફ અનભિજ્ઞ
अज्ञानी: અજ્ઞેય અકળ ગહન ગૂઢ અગમ અગમ્ય અવેદ્ય અજ્ઞાની જ્ઞાનહીન કમઅક્કલ અભણ અજાણ
अज्ञेय: અજ્ઞેય અકળ ગહન ગૂઢ અગમ અગમ્ય અવેદ્ય
अटूट: ઘનિષ્ઠ નિકટનું ગાઢ અનન્ય પ્રગાઢ આત્મીય જિગરી અભંગુર અભંજનશીલ અભંગ અખંડ અભંજનશીલ અભંગ અભંજન અતૂટ અખંડ
अडचणीन_भरिल्लें: અવરોધિત અવરોધાત્મક અવરોધપૂર્ણ
अडाणी: અકુશલ અકુશળ અનિષ્ટ અણકસબી ગમાર અપટુ અનિપુણ અપ્રવીણ અણઘડ અપાટવ અશિક્ષિત અભણ અંગુઠાછાપ અશિષ્ટ નિરક્ષર અનપઢ અજ્ઞાન અપઢ અનપઢા અપઠ અણપઢ અવિદ્ય અપ્રાજ્ઞ અજ્ઞાની જ્ઞાનહીન કમઅક્કલ અભણ અજાણ
अडेचें: બનાવટી નકલી કૃત્રિમ અપ્રાકૃતિક અપ્રકૃત અસ્વાભાવિક_આહાર્ય
अडेज: અઢી ઢાઈ ૨।।
अणकार_करपी: દુભાષિયું અનુવાદક ભાષાંતરકાર
अणकारक: દુભાષિયું અનુવાદક ભાષાંતરકાર
अणकारपी: દુભાષિયું અનુવાદક ભાષાંતરકાર
अणकारीत: અનુવાદિત ભાષાંતરિત અનુવાદી અનૂદિત
अणभवशुन्य: બિનઅનુભવી કાચો અનભિજ્ઞ અનુભવરહિત
अणभवहीण: બિનઅનુભવી કાચો અનભિજ્ઞ અનુભવરહિત
अणभवी: અનુભવી જાણકાર પરિપક્વ પાવરધું ઘડાયેલું કસાયેલું ટેવાયેલું વ્યસની બંધાણી રૂઢ દૃઢમૂલ પાકું હઠીલું આદતવાળું
अतंत्रीक: અપ્રાદ્યોગિક અતકનીકી ગેરતકનીકી
अतिंद्रीय: ઇંદ્રિયાતીત અતીંદ્રિય અગોચર અગમ્ય અપ્રત્યક્ષ પરોક્ષ અભૌતિક અવિષય અવ્યક્ત
अतिक्रमी: અતિક્રામક
अतिक्रमीत: અતિક્રાંત અતિક્રમિત અધિકૃત અધિગત સંપાદિત
अती_धाडशी: દુ ઢીઠતા અવિચારી
अतीरागिश्ट: ઉગ્ર ઉચ્ચંડ આકરું અતિ_આવિષ્ટ અત્યુગ્ર અતિ_ક્રુદ્ધ અત્યુગ્ર અતિશય_ક્રોધિત
अतुलनीय: અતુલ્ય અનુપમ અતુલનીય અતોલનીય અતુલ અનુપ અજોડ અપ્રતિમ અપ્રતુલ
अतुल्य: અતુલ્ય અનુપમ અતુલનીય અતોલનીય અતુલ અનુપ અજોડ અપ્રતિમ અપ્રતુલ
अतूट: અભેદ અભેદ્ય દુર્ભેદ દુર્ભેદ અખંડનીય અપ્રવેશ્ય ગૂઢ ગહન અગમ્ય અભેદત્વ
अतृप्त: અતૃપ્ત અસંતુષ્ટ અતુષ્ટ
अत्याचारी: જુલમી જુલમગાર અન્યાયી અન્યાયયુક્ત સિતમગર અત્યાચારી અનાચારી આતતાયી નૃશંસ ક્રૂર જુલ્મી ઝાલિમ જુલમગાર ખૂંખાર ઉત્પીડક સંતાપક
अत्युत्तम: અત્યુત્તમ સર્વોત્તમ અત્યુત્કૃષ્ટ
अथक: અક્લાંત અવિશ્રાંત અથાક
अथांग: અગાધ ગંભીર અપાર અગાહ અવગાહ ઊંડું ઘેરું ગહન અતળ
अदाह्य: અદહ અદાહ્ય અદહનીય
अदृश्य: અદ્રશ્ય અદ્રષ્ટ અદર્શનીય અદીઠ અગોચર અદૃશ્ય અદર્શ અડીઠ અપેખ અંતર્હિત તિરોહિત
अद्वैत: અદ્વૈત એકતા એકરૂપ અદ્વિતીય
अधर्मी: અધર્મિ અધાર્મિક ધર્મહીન અધર્મિષ્ઠ દુરાચારી અધર્મી
अधाशिल्ले: લાલચુ લોભી લોભિત
अधाशी: લાલચુ ધનલોભી લોભી લોલુપ કુમુદ
अधिकार_नाशिल्लें: અધિકારહીન
अधिकारहीण: અધિકારહીન
अधिकाराची: અધીકાર-પૂર્ણ સાધિકાર
अधिकारी: અધિકારિક અધિકારી હકદાર હક્કદાર દાવાદાર
अधीन: આધીન અધીન તાબેદાર વશ તાબે માતહત અમુખ્ય આધીન તાબે અધીન
अधीनहीण: અવશ્ય
अधोगतीक: અધોગતિશીલ પતનોન્મુખ પતનગામી અવનતિશીલ અવગતિશીલ અવરોહી ઊતરતો
अध्यक्ष: અનુશાસક અનુશાસી
अध्यात्मज्ञानी: બ્રહ્મજ્ઞાની બ્રહ્મજ્ઞ આધ્યાત્મજ્ઞાન સિદ્ધ
अनंत: અસીમ અમર્યાદ અપાર બેહદ અગાધ અત્યંત અમિત અનંતા અપ્રમાણ અનાપા અબાધ અમિત અમાપ અનહદ અમાત્ર અમેવ અશેષ અમેય સીમારહિત માત્રારહિત અમાન
अनंताचो: અનંત અનન્ત_અપાર અસીમ અમર્યાદ અંતહીન અનવસાન
अननुवंशीक: અનાનુવંશિક
अनपेक्षीत: નિરપેક્ષિત નિઃસ્પૃહ આશાતીત અનુમાનાતીત અપ્રત્યાશિત પ્રત્યશાતીત
अनमन्या_बगर: નિ છૂટથી સંકોચ_રહિત બેધડક અનિભૃત
अनर्थकारी: અનર્થકારી અનર્થકારક અનર્થકાર
अनळंकृत: અનલંકૃત અમંડિત સાદું અલંકારહીન અવિભૂષિત
अनवळखी: અજ્ઞાત અજાણ્યું અવિદિત અનવગત અપરિચિત અપરિગત અનધિગત બિનવાકેફ અનભિજ્ઞ અજ્ઞ બેખબર બિનવાકેફગાર અણજાણ અજાણ ગુમનામ અપરિચિત અજાણ્યું અજનબી અજનવી અજ્ઞાત અપરિગત બિનવાકેફ અનભિજ્ઞ
अनात्मदर्शी: બહિર્મુખી
अनाथ: અનાથ લાવારિસ યતીમ નિરાધાર
अनामीक: અનામ નનામું બેનામ નામહીન અનામ નનામું
अनासक्त: અનાસક્ત અલિપ્ત માયારહિત માયાશૂન્ય વિરક્ત અમુગ્ધ નિરાસક્ત
अनितीक: અનૈતિક અપ્રામાણિક અવૈધ નીતિવિરુદ્ધ અનીતિમત્ત દુરાચાર વ્યભિચારી
अनित्सूक: જિજ્ઞાસાહીન નિરુત્સુક અનુત્સુક ઉત્સુકતાહીન અનિચ્છુક અનિચ્છ નિઃસ્પૃહ નિસ્પૃહ નિસ્પૃહી નિઃસ્પૃહા આકાંક્ષારહિત અનિચ્છુ નિરાકાંક્ષી
अनियमीत: અનિયત અનિત્ય અનિશ્ચિત અચોક્કસ અનિયમિત અનિર્દિષ્ટ અધ્રુવ
अनिर्णीत: અનિર્ણીત
अनिर्धारीत: અચોક્કસ અનિશ્વિત અનિર્ધારિત
अनिर्मीत: અરચિત અનિર્મિત અકૃત
अनिश्चीत: અનિચ્છિત અણધાર્યું અરુચિકર અણગમતું અનિષ્ટ અવાંછિત અનપેક્ષિત અનીપ્સિત અનીઠ અનભિલષિત અનિયત અનિત્ય અનિશ્ચિત અચોક્કસ અનિયમિત અનિર્દિષ્ટ અધ્રુવ
अनुकरणीय: અનુકરણીય
अनुकृतीत: અમૌલિક અનુકૃત અનુસરિત
अनुक्रमान: ક્રમિક ક્રમાનુસાર ક્રમપૂર્વક ક્રમબદ્ધ ક્રમસર અનુક્રમિક અનુક્રમવાર શૃંખલાબદ્ધ શૃંખલિત કડીબંધ અનુપૂર્વ
अनुचीत: અનુચિત અસંગત વિસંગત અયોગ્ય અઘટિત અજુગતું નામુનાસિબ ગેરવાજબી
अनुत्तीर्ण: નાપાસ અનુત્તીર્ણ નપાસ ફેલ
अनुपकारादीक: અપકારી અપકર્તા અપકારક અનુપકારી કૃતઘ્ન નિમકહરામ
अनुपलब्ध: અપ્રાપ્ય અનુપલબ્ધ અલભ્ય અપ્રાપ્ત અમિલ
अनुपस्थीत: ગેરહાજર અનુપસ્થિત અપ્રસ્તુત અવિદ્યમાન
अनुपेक्षीत: અપેક્ષિત આકાંક્ષિત
अनुपेगी: નિરુપયોગી બિનઉપયોગી બિનજરૂરી નકામું મિથ્યા બાતલ અનુપયોગી અનુપયુક્ત વ્યર્થ ફાલતુ બેકાર બેકામ રદ્દી અલીક
अनुबंधक: સંબંધી અનુબંધી
अनुमतीत: માન્ય સ્વીકૃત સ્વીકારેલું
अनुमतीप्राप्त: માન્ય સ્વીકૃત સ્વીકારેલું
अनुमोदीत: સમર્થિત સ્વીકૃત માન્ય સ્વીકારેલું અનુમોદિત
अनुयायी: અનુયાયી અનુચર અનુગામી સેવક દાસ ચાકર નોકર અનુસરનાર
अनुवंशीक: આનુવંશિક પૈતૃક બાપીકું વારસાગત કુલક્રમાગત પેઢીઉતાર વંશપરંપરાગત મૌરૂસી પેઢીધર
अनुवादक: દુભાષિયું અનુવાદક ભાષાંતરકાર
अनुवादपी: દુભાષિયું અનુવાદક ભાષાંતરકાર
अनुवादीत: અનુવાદિત ભાષાંતરિત અનુવાદી અનૂદિત
अनुशासक: અનુશાસક અનુશાસી
अनुशीक: થોડું ઓછું અલ્પ ન્યૂન
अनुसरून: પ્રમાણે અનુસાર અનુકૂળ મુતાબિક ફાવતું માફક અનુસાર પ્રણવ
अनेक: અનેક સંખ્યાબંધ બહુ એકાધિક વિવિધ ઘણી અનેકાનેક
अनैतीक: અનૈતિક અપ્રામાણિક અવૈધ નીતિવિરુદ્ધ અનીતિમત્ત દુરાચાર વ્યભિચારી
अनैत्शीक: અનૈચ્છિક
अन्याय_संबंदी: અન્યાયી અન્યાયયુક્ત અન્યાય_વિષયક
अन्यायपुर्ण: અન્યાયયુક્ત અન્યાયત અન્યાયપૂર્ણ
अन्यायी: જુલમી જુલમગાર અન્યાયી અન્યાયયુક્ત સિતમગર
अपंग: અપંગ વિકલાંગ અશક્ત પાંગળું ખોડીલું
अपंगूळ: અપંગ વિકલાંગ અશક્ત પાંગળું ખોડીલું અપંગ લંગડું લૂલું પાંગળું અપાહિજ
अपक्ष.: અપક્ષ પક્ષરહિત
अपक्षपाती: નિષ્પક્ષ તટસ્થ નિરપેક્ષ મધ્યસ્થ નિઃસ્વાર્થ પક્ષપાતરહિત
अपभ्रंश: ખરાબ દૂષિત ગંદું વિકૃત બગડેલું વિકારી અપભ્રંશ અપભ્રંશિત
अपमान: અપમાનિત બેઆબરૂ પ્રતિષ્ઠાહીન તિરસ્કૃત તિરસ્કારાયેલું બેઈજ્જત જલીલ અવમાનિત અપકૃત અવજ્ઞાત ગર્હિત અવમત અવમાનિત અવહેલિત
अपराजीत: અપરાજિત અપરાસ્ત અજિત અપ્રતિહત
अपराधी: અપરાધી ગુનેગાર દોષી કસૂરવાર કસૂરદાર અપરાધશીલ ગુનાહિત
अपरिवर्तनशील: અપરિવર્તનશીલ અપરિવર્તનીય
अपरिवर्तीत: અપરિવર્તનીય
अपरिवारीक: અપારિવારિક અપરિવારીય
अपरूप: અનુપમ સર્વોત્તમ નિરાળું અજોડ બેજોડ અતુલ અનુપ અજોડ શ્રેષ્ઠ અપ્રતિમ અદ્વિતીય અદ્વૈત અપૂર્વ અભૂત બેનમૂન અલબેલું સર્વોત્કૃષ્ટ લાજવાબ બેનમૂન અસાધારણ અનુપમેય અલબેલું અવિક્રાંત
अपवित्र: અશુદ્ધ અસ્વચ્છ મેલું મલિન ગંદુ અશોધિત. અપવિત્ર નાપાક અશુદ્ધ અપુનીત દુષિત અપુણ્ય અપાવન
अपहरण_केल्लें: અપહૃત અપહારિત
अपात्र: અયોગ્ય ગેરવાજબી નાલાયક અપાત્ર નકામું અસભ્ય કુપાત્ર કપાતર અનુચિત અણછાજતું અનધિકારી અલાયક અયુક્ત
अपारदर्शक: અપારદર્શક અપારદર્શી
अपुरें: અધૂરું અધૂરૂં અપૂર્ણ અપૂર અપૂરતાપણું અપર્યાપ્તતા અપૂર્ણ અધૂરું બાકી ઊણું ખૂટતું કમી
अपूर्ण: અધૂરું અધૂરૂં અપૂર્ણ અપૂર અધૂરું અપૂર્ણ બાકી ઊણું અડધું અસમાપ્ત અધૂરૂં અસંપન્ન અસિદ્ધ અધકચરું અનવસિત અનિષ્પન્ન
अपेक्षा_नासतना: નિરપેક્ષિત નિઃસ્પૃહ
अपेक्षीत: ઇચ્છિત ઇષ્ટ ઇચ્છેલું વાંછિત અભિલાષક અભિલાષી ઇચ્છુક મનોવાંછિત અભિવાંછિત અભિપ્રેત કમનીય અભીષ્ટ
अपेक्षे_भायलें: આશાતીત અનુમાનાતીત અપ્રત્યાશિત પ્રત્યશાતીત
अपेक्षेचें: આશાજનક પ્રત્યાશિત આશાનુકૂલ યથાવાંછિત ઇચ્છાન્વિત ઇચ્છાધીન કામનાવાળું સકામ
अप्रचलीत: અપ્રચલિત અપ્રયુક્ત આઉટ_ઓફ_ડેટ
अप्रतिश्ठीत: અપ્રતિષ્ઠ ચંચળ અસ્થિર અમર્યાદ અપ્રતિષ્ઠિત અલિક
अप्रत्यक्ष: અપ્રત્યક્ષ પરોક્ષ અસમક્ષ અસમ્મુખ પરોક્ષ અપ્રત્યક્ષ આડકતરું
अप्रमाणीक: વિશ્વાસઘાતી દગલબાજ કપટી ધૂર્ત ચારસો_વીસ ફરેબી
अप्रमाणीत: અપ્રમાણિત અસત્યાપિત અનુપપન્ન અસિદ્વ અપરીક્ષિત
अप्रयोजक: અપ્રાસંગિક કવખતનું કટાણનું પ્રસંગહીન અનુપયુક્ત
अप्रवेश्य: અપ્રવેશ્ય અગમ્ય અગમનીય
अप्रशिक्षीत: અશિક્ષિત અણશિખ્યું
अप्रसन्न: ઉદાસ ખિન્ન ગમગીન શોકાતુર દિલગીર અનમના અનમન મ્લાન અન્યમન અન્યમનસ્ક વિરક્ત અમનસ્ક અપ્રસન્ન
अप्रसिद्ध: અપ્રસિદ્ધ અખ્યાત અનામ બેનામ અવિખ્યાત અવિત્ત અવિદિત
अप्राकृतीक: અપ્રાકૃતિક અકુદરતી
अप्राप्त: અપ્રાપ્ત અલબ્ધ અલભ્ય અનાપ્ત
अप्रामाणीक: અસભ્ય અવિનયી બેઅદબ ઉદ્ધત અશિષ્ટ અણઘડ ગ્રામ્ય જંગલી અસંસ્કારી અભદ્ર અસાધુ દુષ્ટ ખરાબ આચારભ્રષ્ટ લઠ્ઠ
अप्रासंगीक: અપ્રાસંગિક કવખતનું કટાણનું પ્રસંગહીન અનુપયુક્ત
अप्रीय: અણગમતું નાપસંદ નાપસંદીદા અપ્રિય અનભીષ્ઠ ના_મનનું અપ્રિય અપ્રીતિકર કટુ
अफिमाचें_सेवन_करपी: અફીણી અફીણિયું અફીણિયો બંધાણી
अफीम_घेवपी: અફીણી અફીણિયું અફીણિયો બંધાણી
अबादीत: અક્ષત અનાહત ક્ષતિહીન
अबुद्ध: અવિવેકી અવિચારી અણસમજુ અબુધ અજાણ નાસમજ અસભ્ય બેઅદબ અમર્યાદ અવિનયી
अभक्ष्य: અખાદ્ય અખાજ અનાહાર્ય અભોજ્ય અભક્ષ અભક્ષ્ય
अभागी: અભાગી દુર્ભાગી કમનસીબ મનહૂસ બદકિસ્મત દુર્ભાગ્યશાળી મંદભાગ્ય અલ્પભાગ્ય
अभिनंदीत: પૂજ્ય અભિનંદિત વંદિત આદરણીય પૂજ્ય
अभिव्यक्त: અભિવ્યક્ત સ્પષ્ટ સ્ફુટ_કરેલું જાહેર પ્રકટ વ્યક્ત અભિવ્યંજિત જાહિર વિદિત
अभेद्य: અભેદ અભેદ્ય દુર્ભેદ દુર્ભેદ અખંડનીય અપ્રવેશ્ય ગૂઢ ગહન અગમ્ય અભેદત્વ
अभोज्य: અખાદ્ય અખાજ અનાહાર્ય અભોજ્ય અભક્ષ અભક્ષ્ય
अभौतीक: અભૌતિક અલૌકિક દિવ્ય
अभ्यासहीण: અનભ્યસ્ત અનધીત અનભ્યસિત અભ્યાસરહિત
अभ्यासू: ટેવાયેલું વ્યસની બંધાણી રૂઢ દૃઢમૂલ પાકું હઠીલું આદતવાળું
अमंगळ: અશુભ અમંગલ અમંગળ અમાંગલિક અક્ષેમ અરિષ્ટ રિષ્ટ
अमतिक्रमीत: અનતિક્રમણીય અનુલ્લંધ્ય
अमर: અમર અવિનાશી નિત્ય અક્ષર સનાતન અક્ષય શાશ્વત અનાશ અનાશવાન અનાશ્ય અભંગુર અચ્યુત અભંગ અવિગત અવિગત અમરણીય અમૃતાક્ષર અનપાય અમર ચિરંજીવ ચિરંજીવી અવિનાશી નિત્ય અક્ષર સનાતન કાળજિત મૃત્યુંજય અમર્ત્ય ચિરંજીવી લાંબા_આવરદાવાળું આયુષ્યમાન ચિરાયુ દીર્ઘાયુ શતશરદ દીર્ઘજીવી
अमान्य: મનાઈ બંધી અટકાવેલું પ્રતિબંધિત અંકુશ વર્જ્ય વારિત અસ્વીકાર્ય અમાન્ય અસ્વીકારણીય
अमिश्रीत: વિશુદ્ધ અમિશ્રિત ચોખ્ખું નિર્ભેળ શુદ્ધ સ્વચ્છ નિર્મળ સાફ
अमीट: કાયમનું હમેશનું સનાતન સદાનું અવિનાશી શાશ્વત અમર અક્ષય નિત્ય
अमुरपिकें: અધકચરૂં અધકચ્ચું અપરિપક્વ અધપક્કા અર્ધું_પાકું
अमुर्त: નિરાકાર અશરીર અમૂર્ત સૂક્ષ્મ અરૂપ આકારરહિત અનવાય અનવય નિરવયવ અનાકાર આકૃતિહીન અરૂપક અવિગ્રહ
अमुल्य: બહુમૂલ્ય કિંમતી બહુમૂલી મૂલ્યવાન અનમોલ અમૂલ્ય અનમોલ અમૂલ્ય અમોલ અમોલક અમોલખ
अमूर्त: ઇંદ્રિયાતીત અતીંદ્રિય અગોચર અગમ્ય અપ્રત્યક્ષ પરોક્ષ અભૌતિક અવિષય અવ્યક્ત અશરીરી શરીરરહિત અશારીરિક દૈવી
अयशस्वी: અસફળ નાકામયાબ નાકામ નિષ્ફળ નકામું નિરર્થક
अयोग्य: અયોગ્ય ગેરવાજબી નાલાયક અપાત્ર નકામું અસભ્ય કુપાત્ર કપાતર અનુચિત અણછાજતું અનધિકારી અલાયક અયુક્ત અનુચિત અસંગત વિસંગત અયોગ્ય અઘટિત અજુગતું નામુનાસિબ ગેરવાજબી પ્રતિકૂળ વિરુદ્ધ ઊલટું ખિલાફ અગવડકારક ખિલાફ અસૂત વામ વિપરીત
अरचीत: અરચિત અનિર્મિત અકૃત
अरबी: અરબી
अरसीक: અરસિક નીરસ રસશૂન્ય શુષ્ક
अरिश्टनिवारक: સંકટમોચન સંકટનાશન સંકટનિવારણ સંકટહર્તા સંકટ_નાશક
अरिश्टमय: સંકટપૂર્ણ સંકટગ્રસ્ત સંકટયુક્ત સંકટતા વિપત્તિકર
अरिश्टाचें: સંકટપૂર્ણ સંકટગ્રસ્ત સંકટયુક્ત સંકટતા વિપત્તિકર
अरुचीक: અરુચિકર નીરસ રસહીન રુચિહીન ફીકુ શુશ્ક ખુશ્ક અરસ અસાર
अरूंद: સાંકડું સંકીર્ણ સંકુચિત પાતળુ સંકુલ અવિસ્તૃત અવિસ્તીર્ણ
अरेखीत: અમર્યાદિત અમર્યાદ બેહદ
अर्ज_करपी: ઉમેદવાર મહત્ત્વાકાંક્ષી અભિલાષી આકાંક્ષી પરીક્ષાર્થી ફરિયાદી પ્રાર્થના_કર્તા નિવેદક
अर्ज_केल्लें: અરજદાર આવેદક આવેદન_કર્તા આવેદી
अर्जदार: અરજદાર આવેદક આવેદન_કર્તા આવેદી ઉમેદવાર મહત્ત્વાકાંક્ષી અભિલાષી આકાંક્ષી પરીક્ષાર્થી ફરિયાદી પ્રાર્થના_કર્તા નિવેદક
अर्थपूर्ण: સાર્થક અર્થપૂર્ણ અર્થયુક્ત અન્વર્થ અન્વર્થક યથાર્થ
अर्थशास्त्राचें: અર્થશાસ્ત્રીય
अर्थशास्त्रीय: અર્થશાસ્ત્રીય
अर्थशुन्य: અર્થહીન અર્થરહિત નિરર્થક નકામું અર્થશૂન્ય વ્યર્થ ફોગટ મિથ્યા ફોગટ એળે બેકાર ફોક બેકામ નાહક અમસ્તું વૃથા ખાલી મૃષા અનૃત
अर्थहीन: અર્થહીન અર્થરહિત નિરર્થક નકામું અર્થશૂન્ય વ્યર્થ ફોગટ મિથ્યા ફોગટ એળે બેકાર ફોક બેકામ નાહક અમસ્તું વૃથા ખાલી મૃષા અનૃત
अर्थाचें: સાર્થક અર્થપૂર્ણ અર્થયુક્ત અન્વર્થ અન્વર્થક યથાર્થ
अर्थीक: આર્થિક આર્થી વિત્તીય
अर्द: અર્ધું અરધું અરધ અર્ધ અડધું અડધ
अर्दउकतें: અધખુલ્લું અડધું_ખૂલેલું
अर्दकुटें: અધૂરું અધૂરૂં અપૂર્ણ અપૂર અધૂરું અપૂર્ણ બાકી ઊણું અડધું અસમાપ્ત અધૂરૂં અસંપન્ન અસિદ્ધ અધકચરું અનવસિત અનિષ્પન્ન
अर्दपिकें: અધકચરૂં અધકચ્ચું અપરિપક્વ અધપક્કા અર્ધું_પાકું
अर्दमेलो: અધમરું અધમૂઉં અધસસતું મરણતોલ અધમરણું મૃતપ્રાય
अर्दवट: અધૂરું અધૂરૂં અપૂર્ણ અપૂર
अर्दवर्सुकी: છમાસિક અર્ધવાર્ષિક છ_માસિક
अर्दशिक्षीत: અલ્પશિક્ષિત
अर्दुकुटें: અધૂરું અધૂરૂં અપૂર્ણ અપૂર
अर्दे_तकलेचें: અક્કલનો_ઓથમીર મૂરખો મૂરખ
अर्भक: નવજાત સદ્યોજાત
अलंकृत: વિભૂષિત અલંકૃત
अलभ्य: અપ્રાપ્ત અલબ્ધ અલભ્ય અનાપ્ત
अलिखीत: અલિખિત વણલખ્યું અલિપિબદ્ધ
अलोकीक: અલૌકિક પરલોકનું પરલોકીય દિવ્ય અમાનુષી લોકોત્તર અમાનુષિક
अल्प_काळीन: ક્ષણિક ક્ષણભંગુર નશ્વર અચિર અસ્થાયી અલ્પકાલીન અનિત અનિત્ય
अल्पआहारी: અલ્પાહારી અલ્પભોજી મિતાહારી સ્વલ્પાહારી સૂક્ષ્માહારી
अल्पशिक्षीत: અલ્પશિક્ષિત
अल्पसंख्यांक: અલ્પસંખ્યક અલ્પસંખ્ય
अल्पायुशी: અલ્પાયુ અલ્પજીવી સ્વલ્પાયુ
अळंकारहीण: અનલંકૃત અમંડિત સાદું અલંકારહીન અવિભૂષિત
अळंकारा_बगरचें: અનલંકૃત અમંડિત સાદું અલંકારહીન અવિભૂષિત
अळंकारीत: અલંકૃત વિભૂષિત ભૂષિત આભૂષિત અલંકારિક અભિમંડિત સજ્જિત અલંકિત આભરિત
अवताराचें: અવતારી
अवतारी: અવતારી અવતારી ઈશ્વરીય દૈવી
अवतारीत: અવતાર અવતારી અવતારરૂપ
अवतीर्ण: અવતાર અવતારી અવતારરૂપ
अवयस्क: સગીર અલ્પવયસ્ક અપ્રૌઢ નાબાલિગ કમસિન અલ્હડ
अवर्णनीय: અવર્ણનીય અવર્ણીય અવર્ણ્ય શબ્દાતીત અકથ અકથ્ય અકથનીય અનિર્વચનીય વર્ણનાતીત
अवश: અવશ્ય અવશ્ય અવશ
अवाचनीय: અવાચ્ય અવર્ણ્ય અકથ્ય
अविचारीक: અવિચાર્ય અવિચારણીય અચિંતનીય અવિચારિત અનૂહ અતર્કનીય અનૂહ અવિભાવિત
अविज्ञानीक: અવૈજ્ઞાનિક અશાસ્ત્રીય અવૈજ્ઞાનિક અવિજ્ઞાનીય
अविभाज्य: અવિદ્ધ અણવીંધ્યું અનબેધા અનબીંધા
अविवाहीत: અવિવાહિતા કુમારી અપરિણીતા કુંવારી
अविश्वासी: અવિશ્વાસુ અવિશ્વસનીય
अविश्वासू: અવિશ્વાસી અવિશ્વસનીય અવિશ્વાસ્ય અવિશ્વાસપાત્ર
अवेवस्थीत: અસ્તવ્યસ્ત અવ્યવસ્થિત ગેરવ્યવસ્થિત. અસુવિધાજનક અસુવિધાપૂર્ણ
अवेव्हारी: અવ્યવહારિક વ્યવહાર_અકુશળ
अवेव्हारीक: અભુક્ત કોરું વણવપરાયેલ અણભોગવ્યું
अव्यस्त: નવરો અવ્યસ્ત ખાલી
अशक्त: કમજોર દુર્બળ દુર્બળ નિર્બલ નિર્બળ અબલ અપ્રબલ બલહીન અવીર અસક્ત અસહાય લાચાર પરાધીન નિરાશ્રય શક્તિહીન અલ્પબલ અવીર નામર્દ નબળું બોદું કમજોર નાજુક
अशक्य: અસંભવ અશક્ય અસંભવિત અસંભાવ્ય અસંભાવનીય અસંભવનીય અસાધ્ય અશક્ય અસંભવિત અસંભાવ્ય અસંભવનીય
अशांत: અશાંત શાંતિરહિત અસ્થિર ઉદ્વિગ્ન વ્યગ્ર તોફાની ચંચળ આતુર ઉત્કંઠિત અવ્યવસ્થિત ક્ષુબ્ધ ડહોળાયેલું અવકંપિત બેચિત્ત બેધ્યાન આલોલ
अशिक्षीत: અશિક્ષિત અભણ અંગુઠાછાપ અશિષ્ટ નિરક્ષર અનપઢ અજ્ઞાન અપઢ અનપઢા અપઠ અણપઢ અવિદ્ય અપ્રાજ્ઞ
अशिमांकीत: અમર્યાદિત અમર્યાદ બેહદ
अशीम: અસીમ અમર્યાદ અપાર બેહદ અગાધ અત્યંત અમિત અનંતા અપ્રમાણ અનાપા અબાધ અમિત અમાપ અનહદ અમાત્ર અમેવ અશેષ અમેય સીમારહિત માત્રારહિત અમાન
अशीर: સાંકડું સંકીર્ણ સંકુચિત પાતળુ સંકુલ અવિસ્તૃત અવિસ્તીર્ણ તંગ ટૂકું ચુસ્ત સત્ખ ચપોચપ સાંકડું
अशुद्ध: અશુદ્ધ અસ્વચ્છ મેલું મલિન ગંદુ અશોધિત. અશુદ્ધ મિશ્ર મિશ્રણ ભેળસેળ મિલાવટી મેલુ અસ્વચ્છ ખરાબ અપવિત્ર અશુધ્ધ ગંધારુ બગડેલું દૂષિત અવિમલ અનિર્મલ અવિશુધ્ધ અશુચિ મ્લાન મલિન ગંદુ
अशूभ: અશુભ અમંગલ અમંગળ અમાંગલિક અક્ષેમ અરિષ્ટ રિષ્ટ હાનિકારક અકલ્યાણકારી અનિષ્ટકર અમંગલકારી અમાંગલિક અકુશળ અશુભકારી અહિતકર અહિતકારી અશુભ અનભીષ્ટ
अशे_तरेचो: આવું આના_જેવું આ_જાતનું આ_પ્રમાણેનું
अशें-तशें: મામૂલી નગણ્ય તુચ્છ સામાન્ય જેવું-તેવું નાચીજ હલકું પામર અનુદાત્ત ક્ષુદ્ર
अश्राव्य: અશ્રવણીય અશ્રાવ્ય
अश्लील: અશ્લીલ બીભત્સ નઠારું અસભ્ય ગ્રામ્ય ભૂંડું ખરાબ કપટી ધૂર્ત બૂરું નરસું ગંદું આડુંઅવળું ઊલટુંસૂલટું ગટરપટર
असंख्य: અસંખ્ય અગણિત અગણ્ય અનંત અનગત બેશુમાર અશેષ
असंतुश्ट: અતૃપ્ત અસંતુષ્ટ અતુષ્ટ
असंतोशजनक: અસંતોષજનક અસંતોષપ્રદ અસંતોષકારક
असंबंदीत: અસંબંધ અસંબદ્ધ અયુક્ત અસંગત અબદ્ધ અટપટું અયુક્ત અપ્રસંગ
असंयमी: અસંયમી અનિગ્રહી
असंस्कृत: અપરિષ્કૃત અમાર્જિત અસંસ્કૃત અસ્વચ્છ અનિર્મલ
असत्य: ખોટું જૂઠું અસત્ય મિથ્યા અસત્યતાપૂર્ણ મિથ્યાપૂર્ણ અસત અસત્ મૃષાવચન અલીક અવિદ્યમાન અમૂલક
असत्यपणाचें: ખોટું જૂઠું અસત્ય મિથ્યા અસત્યતાપૂર્ણ મિથ્યાપૂર્ણ અસત અસત્ મૃષાવચન અલીક અવિદ્યમાન અમૂલક
असत्यापीत: અપ્રમાણિત અસત્યાપિત અનુપપન્ન અસિદ્વ અપરીક્ષિત
असफळ: અસફળ નાકામયાબ નાકામ નિષ્ફળ નકામું નિરર્થક
असभावीक: અસ્વાભાવિક કૃત્રિમ અકુદરતી અપ્રાકૃતિક અનૈસર્ગિક અપ્રાકૃત
असभ्य: અસભ્ય અવિનયી બેઅદબ ઉદ્ધત અશિષ્ટ અણઘડ ગ્રામ્ય જંગલી અસંસ્કારી અભદ્ર અસાધુ દુષ્ટ ખરાબ આચારભ્રષ્ટ લઠ્ઠ
असमक्ष: અપ્રત્યક્ષ પરોક્ષ અસમક્ષ અસમ્મુખ
असमजिकाय: અસામંજસ્ય અનમેલ અસામંજસ્યપૂર્ણ
असमजुतदार: અવિવેકી અવિચારી અણસમજુ અબુધ અજાણ નાસમજ અસભ્ય બેઅદબ અમર્યાદ અવિનયી
असमतल: અસમતોલ ઉબડ-ખાબડ અસમતળ વિષમ_પ્રમાણ
असमाधानी: અસમાધાનકારક અસંતોષકારક
असमृद्धिदिणें: અસમૃદ્ધિપ્રદ અનૈશ્વર્યપ્રદ
असलो: આવું આના_જેવું આ_જાતનું આ_પ્રમાણેનું
असहनशील: અસહિષ્ણુ અસહનશીલ અસહ અમર્ષી
असहाय्य: અસહ્ય અસહનીય અસહ નાગવાર દુ દુસ્સહ અપ્રસહ્ય
असादारण: અસામાન્ય અસાધારણ અસમાન ખાસ વિશિષ્ટ વિશેષ વિશેષતાવાળું
असाध्य: અસાધ્ય અશક્ય અસંભવિત અસંભાવ્ય અસંભવનીય અસાધ્ય દુ લાઇલાજ ઉપાયશૂન્ય અવાર્ય
असामान्य: અસામાન્ય અસાધારણ અસમાન ખાસ વિશિષ્ટ વિશેષ વિશેષતાવાળું
असुसंस्कृत: અસભ્ય અવિનયી બેઅદબ ઉદ્ધત અશિષ્ટ અણઘડ ગ્રામ્ય જંગલી અસંસ્કારી અભદ્ર અસાધુ દુષ્ટ ખરાબ આચારભ્રષ્ટ લઠ્ઠ
असैमीक: અપ્રાકૃતિક અકુદરતી
असोच: આવું આના_જેવું આ_જાતનું આ_પ્રમાણેનું
अस्कळीत: અસ્તવ્યસ્ત અવ્યવસ્થિત ગેરવ્યવસ્થિત.
अस्तंती: પશ્ચિમી પાશ્વાત્ય પશ્ચિમી પશ્ચિમનું
अस्ताव्यस्त: અસ્તવ્યસ્ત અવ્યવસ્થિત ગેરવ્યવસ્થિત.
अस्तुरेचें: જનાના સ્ત્રીઓનું સ્ત્રી-સંબંધી
अस्थावर: ચળ જંગમ અસ્થિર
अस्थिहीण: હાડકા_વિનાનું
अस्थीमय: અસ્થિમય હાડકાંમય અસ્થિ_નિર્મિત
अस्थीर: ગતિશીલ ગતિમાન ગતિવંત ગતિવાળું વેગીલું વેગવાળું ઝડપી ગતિવાળું ફરતું જંગમ ભમતું અસ્થિર ચંચળ અધ્રુવ હાલતું ફરતારામ રખડેલ ચંચળ અધીરું ડગડગમતું નટખટ ખટપટીયું ધમાલીયું તોફાની બારકશ ચપળ તરલ વિલોલ ચંચળચિત્ત ચંચળ
अस्पश्ट: અસ્પષ્ટ અસ્ફુટ ઝાંખું અપ્રતીત અણપતીજ તોતડું અવ્યક્ત ગડબડિયું બડબડિયું સંદિગ્ધ ઝાંખું ધૂંધળું અસ્પષ્ટ
अस्पृश्य: અસ્પૃશ્ય અપવિત્ર અશુદ્ધ અછૂત
अस्वस्थ: વ્યાકુળ બાવરું વિહ્વલ આકુળ અભિભૂત બેબાકળું બેચેન બેચૈન
अस्विकृत: અસ્વીકૃત નામંજૂર નાકબૂલ
अस्सल: શુદ્ધ ચોખ્ખું અસલી અસલ વિશુદ્ધ ખરુ અમિશ્રિત ખાલિસ શુદ્ધ ખરું સાચું આસલી ચોખ્ખું વિશુદ્ધ
अहंकारी: અભિમાની અભિમાનવાળું અહંકારી મગરૂબ ઘમંડી દંભી આડંબરી ડોળી ગર્વી ગર્વિષ્ઠ ઉન્મત્ત તોરી છકેલું ઉદ્ધત અવિનયી અવિનમ્ર પ્રગલ્ભ ઉછાંછળું દર્પિત અહંકારી દર્પવાળું
अहिंसक: અહિંસક દયાળું દયાવાન
अहीतकारी: અવનતિકારક અધોગતિકારક પતનકારી અવરોહક અકલ્યાણ_કામી અશુભેચ્છક અનર્થદર્શી અશુભચિંતક
आंकवार: અવિવાહિત કુંવારૂં અપરિણીત કુંવારું વાંઢું અનૂઢ અવિવાહિતા કુમારી અપરિણીતા કુંવારી કુંવારી કુમારી કુમારિકા
आंगाचे: આંગિક અંગસંબંધી અંગનું
आंगाचें: અંગજ
आंगीक: આંગિક અંગસંબંધી અંગનું અંગજ
आंटिल्ल्या_दुदाची: ઠાંઠ વસૂકેલી
आंतकड्यांचें: આંતરડાંનું આંતરડાં_સંબંધી
आंतरदेशी: રાષ્ટ્રિય રાષ્ટ્રીય દેશીય દેશનું
आंतरराज्य: પ્રાદેશિક સ્થાનિક રાષ્ટ્રીય પ્રાંતીય આંતરરાજ્યીય
आंतरीक: આંતરિક અંદરનું અંતરનું ભીતરી અંતસ્થ અંતર્ગત અભ્યંતર અંતરિત અંતરીય
आंतर्राष्ट्रीय: આંતરરાષ્ટ્રીય બહુદેશીય બહુરાષ્ટ્રીય ઇંટરનેશનલ
आंधळो: આંધળું અંધ નેત્રહીન અંધું અક્ષહીન અચક્ષુ અનયન દૃષ્ટિહીન
आंबट: ખાટું અમ્લ તુર્શ
आंबशेल्लें: અંબાવુ ખટાવું
आंवुळिल्ल्या: સંકુચિત આકુંચિત નિકુંચિત
आकर्शक: સોહામણું શોભીતું સુહાવનું સરસ ખુશનૂમા
आकर्शीत: આકર્ષિત આકૃષ્ટ આકૃષ્ટિ ખેંચાણ મંત્રમુગ્ધ
आकलनीय: ગણનીય ગણ્ય
आकस्मीक: આકસ્મિક અનપેક્ષિત અચાનક એકાએક ઓચિતું અણધાર્યુ અપ્રત્યાશિત આપાતી દૈવી દૈવાગત દૈવયોગી
आकाराचें: ઘડવું આરૂપિત આકાર_પ્રદત્ત
आकारीक: દીર્ઘ_કાલિન આયામી આયામયુક્ત
आक्रमक: આક્રમક આક્રમકતાપૂર્ણ અભિધાવક
आक्रमणकारी: આક્રમણકારી આક્રમક આક્રમણ_કરનાર આક્રમણ_કર્તા અભિસારી
आगळीक_करपी: બળાત્કાર બલાત્કારી
आगळें: અલગ અલગ-અલગ જુદું છૂટું અસમ વિષમ ભિન્ન અનમેલ અસમાન પૃથક્ વિભિન્ન અતુલ્ય અયુગ અમિલ અસંબદ્ધ
आगळो: અનુપમ સર્વોત્તમ નિરાળું અજોડ બેજોડ અતુલ અનુપ અજોડ શ્રેષ્ઠ અપ્રતિમ અદ્વિતીય અદ્વૈત અપૂર્વ અભૂત બેનમૂન અલબેલું સર્વોત્કૃષ્ટ લાજવાબ બેનમૂન અસાધારણ અનુપમેય અલબેલું અવિક્રાંત
आगामी: ભવિષ્યકાળ આવનારું ભવિષ્ય_કાલીન ભાવી સંભાવિત આગળનું આગલું ભવ્ય અનાગત ભાવિતા
आचारवान: સભ્ય ભદ્ર શીલ શાલીન સુશીલ ગુણવાન આચારવાન અનવર
आजापीत: વિલક્ષણ વિચિત્ર અદ્ભુત અસાધારણ વિભિન્ન જુદું અજાયબ આશ્ચર્યકારક અજબ અનોખું આશ્ચર્યજનક અભૂતપૂર્વ અપૂર્વ અલૌકિક અસંસારી
आज्ञा_करपी: આજ્ઞાપક આદેશક
आज्ञा_पाळपी: આજ્ઞાકારી આજ્ઞાંકિત આજ્ઞાપાલક તાબેદાર કહ્યાગરૂં વશવર્તી વચનકારી આજ્ઞાવહ અનુકારી
आज्ञाकारी: આજ્ઞાપક આદેશક આજ્ઞાકારી આજ્ઞાંકિત આજ્ઞાપાલક તાબેદાર કહ્યાગરૂં વશવર્તી વચનકારી આજ્ઞાવહ અનુકારી
आज्ञापाळक: આજ્ઞાકારી આજ્ઞાંકિત આજ્ઞાપાલક તાબેદાર કહ્યાગરૂં વશવર્તી વચનકારી આજ્ઞાવહ અનુકારી
आठ_म्हयन्यांचें: આઠમાસી
आठोळें: આઠમાસી
आडखळ_हाडपी: અવરોધક અવરોધી બાધક પ્રતિબંધક અનુરોધક અનુરોધી
आडखळहीण: અવરોધહીન અબાધ અબાધક અબાધિત અનિરુદ્ધ અપવિઘ્ન અવિઘ્ન અરુદ્ધ અપ્રતિહત અયક્ષ્મ વ્યવધાન_રહિત બેરોકટોક
आडखळिल्लें: જટિલ અટપટું
आडखळिल्लो: ખલવું ખલાવું ફસેલું સપડાવું ભરાવું બંધ અવરુદ્ધ અટકાવેલું રોકેલું રુંધેલું
आडखळीन_भरिल्लें: અવરોધિત અવરોધાત્મક અવરોધપૂર્ણ
आडखळीबगरचें: અવરોધહીન અબાધ અબાધક અબાધિત અનિરુદ્ધ અપવિઘ્ન અવિઘ્ન અરુદ્ધ અપ્રતિહત અયક્ષ્મ વ્યવધાન_રહિત બેરોકટોક
आडनदर: ઉપેક્ષિત નજરઅંદાજ નજર-અંદાજ ઉપેક્ષ્ય ઉપેક્ષણીય લંઘનીય લંઘ્ય
आडमेळी_हाडपी: અવરોધક અવરોધી બાધક પ્રતિબંધક અનુરોધક અનુરોધી
आडवादा_बगरचें: નિરપવાદ અપવાદશૂન્ય અબાધ
आतांचें: વર્તમાન સાંપ્રત અભૂત વિદ્યમાન
आतिरिक्त: વધારાનું
आतूर: આતુર આકળું અધીરૂં ઉતાવળું વ્યાકુળ વ્યગ્ર ઉત્કંઠિત કાતર અધીર વ્યગ્ર ગાભરું વિહ્વળ બેબાકળું બહાવરું ગભરું બાવરું બેકલ બેચૈન બેતાબ વિહવળ વિકલ બેકરાર અધીરજ અધૈર્ય અધૈર્યવાન
आते: ફોઈયાત ફોઈયાત
आत्मघातक: આત્મઘાતી આત્મઘાતક આત્મહન
आत्मघातकी: આત્મઘાતી આત્મઘાતક આત્મહન
आत्मघाती: આત્મઘાતી આત્મઘાતક આત્મહન
आत्मज्ञानी: આત્મજ્ઞાની યોગી આત્મદર્શી આત્મદ્રષ્ટા તત્ત્વદર્શી સ્વદર્શી
आत्मदर्शी: આત્મજ્ઞાની યોગી આત્મદર્શી આત્મદ્રષ્ટા તત્ત્વદર્શી સ્વદર્શી આત્મનિરીક્ષક અંતદર્શી આત્મદર્શી
आत्मनिरीक्षक: આત્મનિરીક્ષક અંતદર્શી આત્મદર્શી
आत्मनिर्भर: આત્મનિર્ભર સ્વાવલંબી સ્વનિર્ભર
आत्मविस्वासू: આત્મવિશ્વાસી નિશ્ચયાત્મક આત્મશ્રદ્ધાવાળું
आत्माभिमानी: સ્વાભિમાની સ્વમાની આત્મસંમાની આત્માભિમાની ખુદ્દાર
आत्म्या_विशींचें: આત્મિક આત્માનું જીવ_સંબંધી અધ્યાત્મ આત્મીય આત્મા_સંબંધી આધ્યાત્મિક
आदखळीचे: કઠિન અઘરું દુર્ગમ અગમ દુર્ગમ્ય અનાગમ્ય અગત
आदर्शवादी: આદર્શવાદી
आदलें: જીર્ણ જરેલું જર્જર જર્જરિત પૂર્વકાલીન પ્રાચીન જૂનું પુરાણું અગાઉનું પૂર્વનું
आदारवान: સસહાય સહાયકયુક્ત સહાયતાયુક્ત
आदारहीन: નિરાધાર બિનપાયદાર આધારવિહોણું બિનઆધારભૂત અસ્થાપિત અદ્ધર અધ્ધર આધાર_વિનાનું ટેકા_વગરનું અનાવલમ્બિત નિરાલંબ અનાધાર
आदारा_बगर: નિરાધાર બિનપાયદાર આધારવિહોણું બિનઆધારભૂત અસ્થાપિત અદ્ધર અધ્ધર આધાર_વિનાનું ટેકા_વગરનું અનાવલમ્બિત નિરાલંબ અનાધાર
आदारीत: અવલંબિત આશ્રિત આધારિત આલંબિત નિર્ભર અવલંબી આધારી
आधीन: આધીન તાબે અધીન
आधुनीक: આધુનિક અર્વાચીન અદ્યતન હમણાંનું અત્યારનું હાલનું આજનું અધુનાતન નવું નવીન અપ્રાચીન સાંપ્રતિક નૂતન
आध्यात्मीक: આધ્યાત્મિક અતિભૌતિક મેટાફિઝિકલ
आनंद_दिवपी: સંતોષજનક સંતોષકારક યોગ્યતાવાળું સ્વાગતાર્હ સ્વીકૃત
आनंददायी: સુખદાયી આનંદપ્રદ અનંદદાયક આનંદદાયી આનંદકારી આનંદકર હર્ષદાયક સુખકર નંદક
आनंददिणें: સંતોષજનક સંતોષકારક યોગ્યતાવાળું સ્વાગતાર્હ સ્વીકૃત
आनंदी: પ્રસન્નચિત્ત ખુશમિજાજ આનંદી સદાનંદ મોજી ખુશી રાજી ઉત્સાહી ઉમંગી હોંશીલું અનિવર્તી ઉત્સાહયુક્ત ઉત્સાહીત પ્રગલ્ભ
आनंदीत: આનંદપૂર્ણ આનંદિત આનંદમય સાનંદ ઉલ્લાસપૂર્ણ પ્રસન્નતાપૂર્ણ પ્રસન્ન ખુશ ખુશખુશાલ રાજી આનંદિત હર્ષિત આનંદી પુલકિત આહ્લાદિત આહ્લાદયુક્ત મુદિત મુદમાતું પ્રમુદિત પ્રફુલ્લ પરિતુષ્ટ પ્રફુલ્લિત ઉલ્લસિત ઉલ્લાસિત ઉલ્લાસી તુષ્ટ પ્રહર્ષિત પ્રહૃષ્ટ શાદ અમ્લાન આનંદિત વિનોદિત હર્ષિત
आनिकूय: અન્ય બીજું પરાયું ઈતર
आनिवार्य: અનિવાર્ય અફર દુર્નિવાર્ય
आनीक: અન્ય બીજું પરાયું ઈતર
आनीक_कोणूय: અન્ય બીજું પરાયું ઈતર
आपखोसयेचें: સ્વૈચ્છિક મરજિયાત
आपणायिल्ली: માન્ય બહાલી મંજૂર સ્વીકૃત પાસ મંજૂર અભ્યુપગત સ્વીકારેલું
आपणायिल्लें: સ્વીકૃત સ્વીકાર્ય અંગીકાર્ય અંગીકૃત સ્વીકારેલ આત્મીકૃત આદત્ત ગૃહીત આશ્રુત
आपलें: અંગત ખાનગી નિજી પોતાનું વ્યક્તિગત અંગનું સ્વકીય
आपलेपणाचे_भामनेन: સ્વજન_ભાવનાપૂર્ણ બંધુત્ત્વપૂર્ણ
आपल्या_पक्षाचो: સ્વપક્ષીય સ્વપક્ષી આપણું
आपसांतलें: પારસ્પરિક પરસ્પરનું એકબીજાનું અરસ્પરસનું અન્યોન્યનું
आपसुवार्थी: સ્વાર્થી સ્વાર્થવાળું મતલબી સ્વાર્થપરાયણ ગરજુ અર્થી આત્મગ્રાહી એકલપેટું
आबुझाद: વિચલિત અસ્થિર સ્ખલિત ચલિત ડગી_જવું ડગમગાવું
आबूझ: વિચલિત અસ્થિર સ્ખલિત ચલિત ડગી_જવું ડગમગાવું
आभारी: કૃતજ્ઞ નિમકહલાલ અહસાનમંદ આભારી ઉપકૃત
आभुशीत: અલંકૃત વિભૂષિત ભૂષિત આભૂષિત અલંકારિક અભિમંડિત સજ્જિત અલંકિત આભરિત
आम: સામાન્ય સાધારણ મધ્યમ સાદું કામચલાઉ હંગામી મામૂલી અવિશેષ સર્વસામાન્યતા અવિશિષ્ટ
आमिझाद: મિત્રતાપૂર્ણ મૈત્રીપૂર્ણ દોસ્તારી મિત્રાચારી મિત્રવત મિત્રોચિત
आमीग_आशिल्लो: મિત્રવાળુ સમિત્ર
आयकपा_सारको: શ્રવણીય કર્ણગમ્ય શ્રાવ્ય શ્રોતવ્ય
आयकल्यो: શ્રુત સાંભળેલું આકર્ણિત
आयकुपा_सारकें: શ્રવણીય શ્રાવ્ય શ્રોતવ્ય
आयकूंक_नाशिल्ली: ન_સાંભળેલું અશ્રુત
आयचो_काळ: સાંપ્રત વર્તમાનકાલીન તત્કાલીન સામયિક સમયોચિત નિયતકાલિક
आयच्या_काळांतलें: આધુનિક અર્વાચીન અદ્યતન હમણાંનું અત્યારનું હાલનું આજનું અધુનાતન નવું નવીન અપ્રાચીન સાંપ્રતિક નૂતન
आयामी: દીર્ઘ_કાલિન આયામી આયામયુક્ત
आयिल्लो: આવેલું આવનાર
आरक्षीत: અનામત આરક્ષિત રિઝર્વ
आराधीत: આરાધ્ય પૂજ્ય પૂજનીય આરાધિત પૂજિત અર્ચિત અંજિત અર્ચિત અર્હિત
आरोग्याक_बरें: સ્વાસ્થ્યપ્રદ આરોગ્યદાયક આરોગ્યપ્રદ આરોગ્યદાયી
आरोपमुक्त: આરોપ-મુક્ત બરી મુક્ત આઝાદ
आरोपीत: આરોપિત આરોપાયેલું રોપેલ વાવેલું
आर्थीक: આર્થિક આર્થી વિત્તીય
आर्य_जातीचें: આર્ય_જાતિનું
आर्यसमाजाचें: આર્યસમાજી
आर्यसमाजी: આર્યસમાજી
आलमपेड्ड्यार: નકામું નિરુદ્યમી નવરૂં આળસું પ્રમાદી બેકાર એદી ફાલતુ નિરુદ્યમી અકર્મી નાલાયક
आलायतें: વધારાનું
आल्मीखुशाल: નિશંક બેફિકર આશંકાહીન સંશયહીન
आळशी: આળસુ મંદ આળસવાળું સુસ્ત એદી ધીરૂં ધીમું અજગર વાહી શિથિલ નિરુદ્યોગી નિરુદ્યમ અપાવટ આળસયુક્ત શિથિલ ઉદ્યમરહિત અવ્યવસાયી આરામપ્રિય અપ્રગલ્ભ
आवटें: મૂર્ખ મૂરખ અબૂધ અક્કલહીન ઠોઠ ગમાર બેવકૂફ બુદ્ધિહીન નાદાન મતિમંદ મૂઢ અબૂજ અજ્ઞાની બેસમજ અંધ કમઅક્કલ મૂઢમતિ મૂઢબુદ્ધિ અણસમજુ અલ્પબુદ્ધિ શીન અવિદ પામર પાગલ ગાંડું ઘેલું ઉન્મત્ત ઘેલું અણસમજુ નાદાન મગજનું_ચસકેલું
आवटो: ક્રોધી તામસી ઝક્કી મિજાજી માથાફરેલ પાગલ ગાંડો બાવરો
आवडनाशिल्लें: અણગમતું નાપસંદ નાપસંદીદા અપ્રિય અનભીષ્ઠ ના_મનનું અરુચિકર નીરસ રસહીન રુચિહીન ફીકુ શુશ્ક ખુશ્ક અરસ અસાર
आवडीचें: ઇચ્છિત ઇષ્ટ ઇચ્છેલું વાંછિત અભિલાષક અભિલાષી ઇચ્છુક મનોવાંછિત અભિવાંછિત અભિપ્રેત કમનીય અભીષ્ટ ભાવતું મનપસંદ પ્રિય રુચિકર મનભાવન મનગમતું વાંછિત ઐચ્છિક અભીષ્ટ પ્રિય વહાલું ગમતું અજીજ પ્યારૂં પ્રીતિકર
आवय_नाशिल्लो: અમાતૃક માતાહીન માતૃહીન નમાયું માતાવિહીન
आवरणहीण: ખુલ્લું ઉઘાડું અનાવૃત અનાવરણ આવરણહીન આવરણરહિત
आवरणाचें: બાઇન્ડિંગ વેષ્ટન
आवेगपूर्ण: આવિષ્ટ આવેશયુક્ત ભરાયેલું વળગેલું
आशावादी: આશાવાન આશાન્વિત આશાવંત આશાપૂર્ણ
आशेखोर: લાલચુ ધનલોભી લોભી લોલુપ કુમુદ
आशेचें: ઇચ્છાન્વિત ઇચ્છાધીન કામનાવાળું સકામ
आशेभगत: લાલચુ ધનલોભી લોભી લોલુપ કુમુદ
आशेल्ले: લાલચુ લોભી લોભિત
आशेल्लो: લાલસી લોભી લાલચુ
आश्चर्याचें: અભૂતપૂર્વ અપૂર્વ અદ્ભુત
आसक्त: મુગ્ધ મોહિત મંત્રમુગ્ધ આસક્ત
आसा: સ્થિત સ્થિર અવસ્થિત વિદ્યમાન અધિષ્ઠિત આહિત
आसामी: આસામી
आस्पाविल्ले: સમાવેશ સમાસ સમાવિષ્ટ સમાયેલું સમન્વિત અંગભૂત
आहाराचें: ખાદ્ય ભોજ્ય આહાર્ય અશનીય ભક્ષ્ય
आहारी: ખાનાર ભક્ષક આહારી
इंद्रजीत: ઇંદ્રજિત ઇંદ્રજિત્
इंद्रियनिग्रही: સંયમી જીતેંદ્રિય ઇંદ્રિયનિગ્રહી
इंद्रीयगम्य: ઇંદ્રિયગમ્ય ઇંદ્રિયગોચર ઇંદ્રિયગ્રાહ્ય પ્રત્યક્ષ ગોચર અપરોક્ષ
इंद्रीयगोचर: ઇંદ્રિયગમ્ય ઇંદ્રિયગોચર ઇંદ્રિયગ્રાહ્ય પ્રત્યક્ષ ગોચર અપરોક્ષ
इतलें: સમાન સરખું જેવું સરખું તુલ્ય સમ બરોબર યોગ્ય સરિસ સરીખું અનુહાર અવિષમ એકસરખું
इतिहासीक: ઐતિહાસિક ઈતિહાસને_લગતું
इत्शीक: વૈકલ્પિક મરજિયાત ઐચ્છિક વિકલ્પવાળું
इत्शीत: સ્વેચ્છિત મરજિયાત ઐચ્છિક
इत्सा_नासतना: અનૈચ્છિક
इत्साहीण: અનિચ્છા નામરજી ઇચ્છા_રહિત નિ અનિચ્છ અનિચ્છુક અનિચ્છ નિઃસ્પૃહ નિસ્પૃહ નિસ્પૃહી નિઃસ્પૃહા આકાંક્ષારહિત અનિચ્છુ નિરાકાંક્ષી
इत्सीत: ઇચ્છિત ઇષ્ટ ઇચ્છેલું વાંછિત અભિલાષક અભિલાષી ઇચ્છુક મનોવાંછિત અભિવાંછિત અભિપ્રેત કમનીય અભીષ્ટ
इत्सुक: ઇચ્છુક ઇચ્છાવાળો અભિલાષી અભીપ્સુ કામી ઈપ્સુ અભિકાંશી અભિલાખી અરથી
इत्सूक: ઇચ્છાન્વિત ઇચ્છાધીન કામનાવાળું સકામ
इत्से_बगर: અનૈચ્છિક
इबाडिल्लें: સડેલું બગડેલું વાસી_થઇ_ગયેલું કોહવાટ બગાડ
इबाडिल्लो: ખરાબ દૂષિત ગંદું વિકૃત બગડેલું વિકારી અપભ્રંશ અપભ્રંશિત
इराकी: ઈરાકી
इर्शेन_भरिल्लें: અદેખું ઈર્ષાળુ ઈર્ષાપૂર્ણ ઝેરીલું દ્વેષી દ્વેષપૂર્ણ
इल्लें: કમ થોડા જરા અલ્પ ન્યૂન તનિક લેશ આંશિક થોડું લગાર નાનું ઝીણું ટૂંકું ક્ષુદ્ર ક્ષુલ્લક પામર કતિપય અમુક
इल्लेशें: બહું_ઓછું અત્યલ્પ ઘણું_થોડું જરાક અતિઅલ્પ સ્વલ્પ
इश्ट_आशिल्लो: મિત્રવાળુ સમિત્ર
इश्टागत: મિલનસાર ભળતું ભલમનસાઈ સુશીલ મિત્રતાપૂર્ણ મૈત્રીપૂર્ણ દોસ્તારી મિત્રાચારી મિત્રવત મિત્રોચિત
इश्टाबगरचो: મિત્રહીન સખાહીન અબંધુ મિત્રરહિત બંધુહીન બંધુરહિત
इश्टाविरयतचो: મિત્રહીન સખાહીન અબંધુ મિત્રરહિત બંધુહીન બંધુરહિત
इश्वरी: ઈશ્વરીય ઈશ્વરી દૈવી દિવ્ય અલૌકિક પરમેશ્વરી ઇલાહી
इश्वरीदेणें: ઇશ્વરપ્રદત્ત પ્રભુપ્રદત્ત
इहलोकीक: લૌકિક દુન્યવી સાંસારિક સંસારી જાગતિક ઇહલૌકિક
उंचल्या_कुळातलो: ખાનદાની કુલીન_વર્ગ ઉદાત્ત_વર્ગ અમીરશાહી અમીરપણું અભિજાત
उंचवटो: ટેકરો ઉભાર ઉભારણી
उंचेलें: ઊંચું ઉચ્ચ ચડિયાતું ઉમદા બુલંદ મોટું ઉતુંગ પ્રાંશુ
उकडिल्लें: બાફવું
उकतायिल्लें: અભિવ્યક્ત સ્પષ્ટ સ્ફુટ_કરેલું જાહેર પ્રકટ વ્યક્ત અભિવ્યંજિત જાહિર વિદિત
उकती: રહસ્ય_વગર રહસ્યહીન અગૂઢ
उकतें: ખુલ્લું ઉઘાડું અનાવૃત અનાવરણ આવરણહીન આવરણરહિત અગોપનીય અગોપ્ય કથ્ય પ્રકાશ્ય
उकतो: નિર્વસ્ત્ર નગ્ન નાગું ખુલ્લું ઉઘાડું નવસ્ત્રું નિવસ્ત્ર વિવસ્ત્ર દિગંબર અવસ્ત્ર વસ્ત્રહીન
उक्तें: ઉઘાડું ખુલ્લું છતું અગુપ્ત જાહેર
उगडास_नाशिल्लें: વિસ્મૃત ભુલાયેલું અસ્મરણીય પ્રસ્મૃત
उगडें: ખુલ્લું ઉઘાડું અનાવૃત અનાવરણ આવરણહીન આવરણરહિત
उग्रवादी: ઉગ્રવાદી આતંકવાદી ત્રાસવાદી
उचांबळ: વ્યાકુળ બાવરું વિહ્વલ આકુળ અભિભૂત બેબાકળું બેચેન બેચૈન આતુર આકળું અધીરૂં ઉતાવળું વ્યાકુળ વ્યગ્ર ઉત્કંઠિત કાતર અધીર વ્યગ્ર ગાભરું વિહ્વળ બેબાકળું બહાવરું ગભરું બાવરું બેકલ બેચૈન બેતાબ વિહવળ વિકલ બેકરાર અધીરજ અધૈર્ય અધૈર્યવાન
उचांबळीत: ચંચળ અધીરું ડગડગમતું નટખટ ખટપટીયું ધમાલીયું તોફાની બારકશ ચપળ તરલ વિલોલ
उचीत: નૈતિક નીતિપૂર્ણ ઉચિત યોગ્ય સંગત સંબદ્ધ યોગ્ય વ્યાજબી જાયજ વાજબી યથાર્થ ઉચિત મુનાસિબ
उजळ: સફેદ શ્વેત ધવલ ધોળું ઉજ્જવલ ઊજળું રજત સિત શુક્લ શુભ્ર શિતિ અવદાત તેજ તેજપૂર્ણ તેજોમય જાજરમાન દેદીપ્યમાન કાંતિમય કાંતિમાન પ્રકાશમાન દિવ્ય
उजू: પ્રમાણિક ઈમાનદાર વિશ્વાસપાત્ર ઈમાની ઋજુ સત્યપર સત્યપરાયણ નિષ્કપટ નિખાલસ સાચું ખરૂં
उजो_पालोवपी: શામક પ્રશામક શાંતિકર શમક
उठवणेचें: અડિયલ હઠીલું
उडपी: ઉડતું ઉડનશીલ ઉડનારું ઉડન ઉડનશીલ
उणे_पिरायेचें: અલ્પાયુ અલ્પજીવી સ્વલ્પાયુ
उणें: અપૂરતાપણું અપર્યાપ્તતા અપૂર્ણ અધૂરું બાકી ઊણું ખૂટતું કમી કમ થોડા જરા અલ્પ ન્યૂન તનિક લેશ આંશિક થોડું લગાર નાનું ઝીણું ટૂંકું ક્ષુદ્ર ક્ષુલ્લક પામર કતિપય અમુક
उणें_उलोवपी: અલ્પભાષી મિતભાષી ઓછાબોલું થોડાબોલું કમબોલ
उणें_केल्लें: પદભ્રષ્ટ પદચ્યુત નિલંબિત બરખાસ્ત અનુલંબિત
उणें_जाल्लें: ઓછો મંદ અવનત નરમ નીચું કમ
उण्या_आयुश्याचें: અલ્પાયુ અલ્પજીવી સ્વલ્પાયુ
उण्यांतउणें: ન્યૂનતમ ઓછામાં_ઓછું
उतरांखेळाचो: શબ્દાડંબરપૂર્ણ શબ્દાડંબરયુક્ત
उतरांचें: શાબ્દિક મૌખિક
उताणें: ચત્તુ ચત્તુપાટ ચત્તા સીધુ ઉતાન
उतावळें: ઉતાવળું આતુર અધીરૂં ધાંધલિયું ઉતાવલું હડબડિયું ઉતાવળિયું
उतावळो: ચંચળ અધીરું ડગડગમતું નટખટ ખટપટીયું ધમાલીયું તોફાની બારકશ ચપળ તરલ વિલોલ
उत्तम: ઉત્તમ શ્રેષ્ઠ ઉત્કૃષ્ટ અનમોલ ઉમદા પ્રશસ્ત નાયાબ વિરલ અનન્ય પ્રશસ્ય અવ્વલ આકર આગર
उत्तरकाळीन: ઉત્તર_કાલીન
उत्तरजिवी: ઉત્તરજીવી
उत्तरदायी: ઉત્તરદાયી જવાબદાર જોખમદારક જુમ્મેદાર જવાબગાર ઉત્તરદાયક જુમ્મેવાર જિમ્મેવાર જિમ્મેદાર
उत्तीर्ण: ઉતીર્ણ પાસ.
उत्तेजक: ઉત્તેજક ઉદ્દીપક ભડકાઉ ઉત્તેજનાપ્રદ
उत्तेजीत: ઉત્તેજિત ઉશ્કેરાયેલું ગરમ અર્ણવ
उत्पन्न: ઉત્પન્ન પેદા નીપજેલું પાક ઊપજેલું પ્રસૂત
उत्पादक: ઉત્પાદક ઉત્પાદનકર્તા પેદા_કરનાર આવહ
उत्पादीत: ઉત્પાદિત
उत्पादीत_जाल्लें: ઉત્પન્ન પેદા નીપજેલું પાક ઊપજેલું પ્રસૂત
उत्साहपूर्ण: ઉત્સાહપૂર્ણ ઉમંગપૂર્ણ
उत्साहहीण: જિજ્ઞાસાહીન નિરુત્સુક અનુત્સુક ઉત્સુકતાહીન
उत्साही: ઉત્સાહી ઉમંગી હોંશીલું અનિવર્તી ઉત્સાહયુક્ત ઉત્સાહીત પ્રગલ્ભ જોશીલું જોશવાળું જોસદાર
उत्सुक: જિજ્ઞાસુ જિજ્ઞાસક જિજ્ઞાસાવાળું ઉત્સુક ઉત્કંઠાવાળું આતુર પ્રણવ
उदक_भरशिल्लें: પનિહા પનિયલ
उदकांतली: જળજ જળિય વારિજ વારિજાત તોયજ
उदकाचें: પનિહા પનિયલ
उदकाळ: જલીય જલજ પનિહા પનિયલ
उदय_जाल्लो: ઊગતું ઉદિત ઊગેલું
उदार: ઉદાર ઉદાત્ત ઉમદા ઉદારવાદી નમ્ર પ્રવણ ઉદાર દરિયાદિલ ખૂબ_ઉદાર દિલદાર અકૃપણ પ્રવણ અકૃપણ ઉદારચિત્ત
उदारदानी: દાનેશ્વરી
उदारें: ચત્તુ ચત્તુપાટ ચત્તા સીધુ ઉતાન
उदेंती: પૂર્વીય પૂરબી પૂર્વી પ્રાચ્ય
उदेल्लो: ઊગતું ઉદિત ઊગેલું
उद्घाटीत: ઉદ્ઘાટિત આરંભેલું
उद्देगी: ઉધ્યમી મહેનતુ કામઢુ ઉધ્યમશીલ કામગરુ ખંતીલુ
उद्येगीक: ઔદ્યોગિક ઉદ્યોગને_લગતું
उध्वस्त: નષ્ટ ખતમ બરબાદ ખલ્લાસ ચોપટ તહસનહસ નષ્ટ-ભ્રષ્ટ સમાપ્ત નેસ્તોનાબૂદ તબાહ ધ્વસ્ત અપધ્વસ્ત નિકંદન અવધૂત અવધ્વંસ્ત અસ્ત ગારત જેર ફના ઉચ્છિન્ન અપહત મર્દિત તલફ અસ્તમિત વિનષ્ટ ખરાબખસ્ત
उनी: ઊની આવિક ગરમ
उन्नत: વિકસિત સુવિકસિત ઉન્નત મુકુલિત વિકચ અભ્યુદિત ઉન્નત
उन्नतीकारक: ઉન્નતિકારક ઉન્નતિકર પ્રગતિશીલ ઉન્નતકારી
उपकारादीक: ઉપકારી ઉપકારક ઉપકારકર ઉપકારકર્તા અનુગ્રહકર્તા અનુગ્રહકારી અનુગ્રહી કૃપાળુ
उपकारी: કૃતજ્ઞ નિમકહલાલ અહસાનમંદ આભારી ઉપકૃત કૃતજ્ઞ કૃતકૃત્ય
उपदेश_करपी: ઉપદેશક ઉપદેશકદાતા
उपदेशक: ઉપદેશક ઉપદેશકદાતા
उपदेशी: ઉપદેશક ઉપદેશકદાતા
उपद्रवग्रस्त: ઉપદ્રવગ્રસ્ત અશાંતિપૂર્ણ
उपद्रवी: ઉપદ્રવી ઉપદ્રવકારી ઉત્પાતી બદમાશ દંગાબાજ
उपभोगी: ઉપભોગ્ય ઉપભોજ્ય
उपमेय: ઉપમેય
उपयुक्त: સંગત સંબદ્ધ યોગ્ય વ્યાજબી જાયજ વાજબી યથાર્થ ઉચિત મુનાસિબ
उपयोगी: ઉપયોગી ખપનું કામનું અર્થકર
उपरो: ટેકરો ઉભાર ઉભારણી
उपस्थीत: હાજર ઉપસ્થિત ઉપસ્થિત મોજૂદ રજૂ પ્રસ્તુત વિદ્યમાન અવસ્થિત
उपाट: પુષ્કળ ખૂબ અતિશય ઘણું બહુ અત્યાધિક અધિક વધારે અતિ બેહદ બેશુમાર અસીમ વિપુલ ઝાઝું ઘણુંવધારે અમાપ અપાર અખૂટ બેપનાહ બેહિસાબ અલેશ અમિત ખૂબ પુષ્કળ બહુ અતિ વિશેષ અત્યંત અતિશય વિપુલ અગાધ અપાર બેશુમાર બેહદ અસીમ અદમ્ય અદમનીય
उपाधीत: વિભૂષિત અલંકૃત
उपासमारो: ભૂખમરું
उपेक्षा: ઉપેક્ષ્ય ઉપેક્ષણીય લંઘનીય લંઘ્ય
उपेक्षीत: ઉપેક્ષિત નજરઅંદાજ નજર-અંદાજ
उपेगाचें: લાભપ્રદ લાભદાયક લાભકારી ફાયદાકારક લાભકર લાભકર્તા લાભકારક ફાયદેમંદ ફાયદામંદ ગુણકારી ઉપયોગી હિતકારી મુફીદ અર્થકર
उपेगी: યોગ્ય લાયક કાબેલ સમર્થ અભિજાત ઉદાત્ત ઉપયોગી ખપનું કામનું અર્થકર
उपोश्णकटीबंधीय: ઉપોષ્ણકટિબંધીય
उप्तादीत: ઉત્પન્ન પેદા નીપજેલું પાક ઊપજેલું પ્રસૂત
उप्राशिल्लें: સમાગત સમાગતિ
उबगणें: કંટાળાજનક ઉબાઊ
उबगल्लें: ઊબાયેલું બેજાર કંટાળી_ગયેલું ઉકતાઈ_ગયેલું ઉકતાયેલું ઉબાઈ_ગયેલું
उबें_केल्लें: રચિત નિર્મિત વિરચિત સૃષ્ટ કૃત સર્જિત પ્રણીત
उभयचर: ઉભયચર જળ-સ્થળચર
उमेदी: પ્રસન્ન ખુશ ખુશખુશાલ રાજી આનંદિત હર્ષિત આનંદી પુલકિત આહ્લાદિત આહ્લાદયુક્ત મુદિત મુદમાતું પ્રમુદિત પ્રફુલ્લ પરિતુષ્ટ પ્રફુલ્લિત ઉલ્લસિત ઉલ્લાસિત ઉલ્લાસી તુષ્ટ પ્રહર્ષિત પ્રહૃષ્ટ શાદ અમ્લાન પ્રસન્નચિત્ત ખુશમિજાજ આનંદી સદાનંદ મોજી ખુશી રાજી આનંદિત વિનોદિત હર્ષિત ઉત્સાહી ઉમંગી હોંશીલું અનિવર્તી ઉત્સાહયુક્ત ઉત્સાહીત પ્રગલ્ભ ઉત્સાહપૂર્ણ ઉમંગપૂર્ણ
उमेदी_बगरचें: જિજ્ઞાસાહીન નિરુત્સુક અનુત્સુક ઉત્સુકતાહીન
उरपी: ટકાઉ પાયદાર
उरफाटे: ઊલટું ઊંધું અવળું વિપરીત વિરુદ્ધ અન્યથા
उरफाटें: વિપરીત અવળું ઊલટું વિરુદ્ધ પ્રતિકૂલ વિરોધી વિલોમ પ્રતિલોમ પ્રતીપ પ્રતિકૂળ ઊંધું અપસવ્ય
उरफाटो_चलपी: પ્રતિગામી પશ્વગામી અવળું
उरफाट्या_काळजाचो: સંગદિલ કઠોરહૃદય નિર્દય ક્રૂર પથ્થરદિલ
उरबेवंत: જોશીલું જોશવાળું જોસદાર
उरमट: અનમ્ય કઠોર દ્રઢ
उरिल्लें: બાકી શેષ અવ્યતીત અવિગત હાજર અગત બચેલું બચેલું-ખુચેલું વધ્યું-ઘટ્યું અવિષ્ટ અવશેષ વધેલું બાકી_રહેલું બાકી ખૂટતું શેષ અધૂરૂં અપૂર્ણ
उरिल्लें_रीण: બાકી બકાયા દાતવ્ય દેય
उर्बेभरीत: પ્રોત્સાહિત ઉત્તેજિત
उर्मट: નફ્ફટ ઉદ્ધત ધીટ અવિનયી અસભ્ય ધૃષ્ટ ઢીઠ
उलटें: ઊલટું ઊંધું અવળું વિપરીત વિરુદ્ધ અન્યથા
उलटें_सुलटें: બકબકાટ;_લવારો બકવાટો અસંગત ઉટપટાંગ ઉટપટંગ ઉટંગ તરંગી અગડબગડ અગડંબગડં ગોટાળો ગડબડગોટો અષ્ટંપષ્ટં સટરપટર
उशीर_जाल्लें: વિલંબિત
उश्टें: એઠું છાંડેલું બોટેલું અજીઠું ઉચ્છિષ્ટ ઉપભુક્ત
उश्ट्याचें: એઠું છાંડેલું બોટેલું અજીઠું ઉચ્છિષ્ટ ઉપભુક્ત
उश्ण: ગરમ ઉષ્ણ ગરમ
ऊंच: ઊંચું ઉચ્ચ ચડિયાતું ઉમદા બુલંદ મોટું ઉતુંગ પ્રાંશુ ઊંચું ઉચ્ચ ઉત્તમ શ્રેષ્ઠ ઉન્નત
एक: એક એકલું ૧
एक_करोड: કરોડ કોટિ ૧૦૦૦૦૦૦૦ 10000000
एकठांय: એકત્રિત એકઠું જમા ભેગું સંઘટિત એકત્રિત સંગઠિત એકત્રિત એકીકૃત સમન્વિત એકીભૂત
एकतर्फी: એકતરફી એકપક્ષી
एकतायपूर्ण: સંગઠીત સંગઠનવાળું સંઘટિત વ્યવસ્થિત.
एकत्र: એકત્રિત એકઠું જમા ભેગું
एकत्रीत: સંગઠીત સંગઠનવાળું સંઘટિત વ્યવસ્થિત. એકત્રિત એકઠું જમા ભેગું એકત્રિત એકીકૃત સમન્વિત એકીભૂત
एकदम: પાકો પાક્કો સંપૂર્ણ પરિપૂર્ણ ન્યૂનતા_વિનાનું ખામી_વિનાનું નિષ્ણાત પારંગત યથાર્થ દક્ષ
एकमुळी: એકાંકી એકલું એકલ અસંગ અદ્વૈત નિ નિહંગ તનહા
एकमुळें: અતડું તોછડું વરવું
एकमुळो: પૃથકચર
एकरुपी: પ્રતિરૂપી સમાંતર અદલોઅદલ એકરૂપ એકાત્મક સમરૂપ
एकलें: એક એકલું ૧
एकलें-दुकलें: એકાદ એકાદું એક-બે એકાદેક એકલ-દોકલ
एकलेंच: એકમાત્ર એકનું_એક માત્ર_એક
एकवटिल्लें: એકત્રિત એકઠું જમા ભેગું
एकवटीत: સંઘટિત એકત્રિત સંગઠિત
एकसुरी: એકાંકી એકલું એકલ અસંગ અદ્વૈત નિ નિહંગ તનહા
एकसुरें: અતડું તોછડું વરવું
एकसुरो: પૃથકચર
एका_वर्साचें: એકવર્ષીય
एकांत: નિર્જન સૂનું એકાંત વિજન વીરાન સુનસાન જનશૂન્ય ઉજ્જડ વેરાન સૂમસામ અજન નિભૃત અમાનુષી
एकाग्र: કેંદ્રિત કેંદ્રિભૂત
एकाच_काळांतलें: સામયિક કાલિક અવસરીય
एकावडो: એકવડું એકસરી
एकासारकें: સમાન સરખું જેવું તુલ્ય સરીખું બરોબર સમરૂપ અનુરુપ સવર્ણ એક_સરખું એક_જેવું
एकुलगें: અતડું તોછડું વરવું
एकुलतें: અતડું તોછડું વરવું
एकुलयो: પૃથકચર
एकूच: એકમાત્ર એકનું_એક માત્ર_એક
एकूलगी: એકાંકી એકલું એકલ અસંગ અદ્વૈત નિ નિહંગ તનહા
एकूलयी: એકાંકી એકલું એકલ અસંગ અદ્વૈત નિ નિહંગ તનહા
एकोडें: એકસરી એકવડુ એકવડિયું એકાવલી
एतिहासीक: ઐતિહાસિક ઈતિહાસને_લગતું
ओंठयें: ઓષ્ઠ્ય
ओंठाचें: ઓષ્ઠ્ય
ओगोत_जाल्लें: વિલંબિત
ओजस्वी: તેજસ્વી પ્રભાવી પ્રભાવશાળી તેજદાર દીપ્તિમાન પ્રતિભાશાળી તેજવંત તેજવાન કાંતિવાન
ओपेरासावीं: શસ્ત્રોપચારિક સર્જિકલ
ओबड_धोबड: ખરબચડું ખાડાટેકરાવાળું તોફાની કઠોર લાગણીવિહોણું ખોડખામીવાળું મુશ્કેલી કષ્ટ મવાલી કુદરતી_સ્થિતિ ડોળિયું કાચો_ખરડો
ओबडधोबड: અસમતોલ ઉબડ-ખાબડ અસમતળ વિષમ_પ્રમાણ ધમધૂસર
ओलें: ભીનું લીલું ભેજવાળું પલળેલું આર્દ્ર તર આપ્લાવિત તરબોળ
औपचारीक: ઔપચારિક ઉપચાર_પૂરતું
औरस: ઔરસ ઔરસ્ય
कंजूस: મક્ખીચૂસ કફનખસોટ કંજૂસ કૃપણ પાજી બખીલ લોભિયો મખ્ખીચૂસ સોમ રંક કુમુદ ચીકણું ચિંગૂસ
कच्चें: કાચું અપક્વ અપરિપક્વ કાચું અપક્વ અપરિપક્વ
कट्टर: ક્ષતિગ્રસ્ત
कट्टरवादी: મતાંધ સ્વમતાગ્રહી કટ્ટરપંથી
कठीण: કઠિન અઘરું દુર્ગમ અગમ દુર્ગમ્ય અનાગમ્ય અગત કૂટ કઠણ અઘરું ગૂઢ જટિલ કઠિન પેચીદું મુશ્કેલ અધરું અસ્ફુટ દુર્બોધ્ય દુર્બોધ અજ્ઞેય અઘરું પેચીદું પેચવાળું પેચદાર જટિલ પેચીલું પેચીદા
कठोर: નિર્દય ક્રૂર ઘાતકી દયાહીન નિર્દયી કસાઈ નિષ્ઠુર કઠોર અમમ અદય અદયાળુ નિર્ઘૂણ કરુણા_વિહીન કરુણાહીન અઘૃણ કર્કશ કઠોર સખ્ત આકરું કર્ણકટુ નિષ્ઠુર રૂક્ષ
कडक: તીક્ષ્ણ તીવ્ર કુશાગ્ર પ્રખર તેજ ઉગ્ર પ્રચંડ આકરૂં અકુંઠ અકુંઠિત દારુણ ભયંકર ભયાનક વિકરાળ ઘોર કડક કઠોર સખ્ત ઉગ્ર ખર રૂઢ સખ્ત આકરું ઉગ્ર નિર્દય ગરમ_સ્વભાવનું
कडकडीत: ગરમાગરમ ધગધગતું
कडें: ગોળમટોળ હૃષ્ટપુષ્ટ જાડું
कडेनचें: પાસેનું નજીકનું જોડેનું સમીપનું નિકટતમ નિકટતર નિકટવર્તી સમીપી સંનિકટ સમીપવર્તી સન્નિહિત લગોલગ નિકટસ્થ આસન્ન
कड्डणाचें: અન્નીય અનાજી
कणखर: તીવ્ર તેજ બુલંદ અસાધારણ
कणीक: કકરા મોટા
कथनीय: કથનીય કથ્ય વાચ્ય વક્તવ્ય અભિધેય
कदें: જાડો સ્થૂળ સ્થૂળકાય ભારે ધીંગો પીવર
कनवाळू: દયાળુ દયાવાન કરુણાળુ કૃપાળુ કરુણાવંત મહેરબાન માયાળુ દયાવંત કરુણામય કરુણાત્મક દયામય અનુકંપામય કરુણાવાન સહ્રદય સહ્રદયી દયાશીલ કરુણાસાગર અનુગ્રાહ દીનદયાલુ દીનદયાલ
कनिश्ट: કનિષ્ઠ અવર
कनिश्ठ: અનુજ અનુજન્મા કનિષ્ઠ લઘુ
कपटहीण: કપટરહિત કપટહીન અછદ્મ છદ્મહીન
कपटी: કપટી કપટપૂર્ણ કપટવાળું કપટમય કપટભર્યું કુટિલ વક્ર વાંકું અસિત દુરાશય ખોટો કુવિચારી બદનિયત કુટિલ છળવાળું કપટી અનાર્જવ વંક દગાબાજ દગલબાજ પ્રપંચી ધૂર્ત ચાલબાજ શાતિર વિશ્વાસઘાતી શઠ હોશિયાર વક્રગામી કિતવ કૈવત પ્રતારક ચંટ વક્રગામી દ્વિભાવ કપટી
कफल्लक: નિર્ધન ગરીબ દીન અકિંચન કંગાલ દરિદ્ર રાંક અસમૃદ્ધ અસંપન્ન દીનહીન બિચારું મુફલિસ ધનહીન રંક બેહાલ તંગહાલ વિધન નિધની ટટપૂંજિયું ટુટપૂંજિયું
कबलातीचें: અનુબદ્ધ અનુબંધિત
कमी: અપૂરતાપણું અપર્યાપ્તતા અપૂર્ણ અધૂરું બાકી ઊણું ખૂટતું કમી કમ થોડા જરા અલ્પ ન્યૂન તનિક લેશ આંશિક થોડું લગાર નાનું ઝીણું ટૂંકું ક્ષુદ્ર ક્ષુલ્લક પામર કતિપય અમુક
कमी_उलोवपी: અલ્પભાષી મિતભાષી ઓછાબોલું થોડાબોલું કમબોલ
कर_आशिल्लो: મહેસૂલી કરયુક્ત કરાધિન
करणारो: કર્ત્તા કર્તા કર્તાર કરણહાર
करपी: કર્ત્તા કર્તા કર્તાર કરણહાર
करमुक्त: કરમુક્ત મહેસૂલ_માફ નિષ્કર કરહીન
करयुक्त: મહેસૂલી કરયુક્ત કરાધિન
करहीण: કરમુક્ત મહેસૂલ_માફ નિષ્કર કરહીન
कराराचें: અનુબદ્ધ અનુબંધિત
करूंक_नाशिल्लें: અકૃત ન_કરેલું
कर्तव्यवादी: કર્તવ્યનિષ્ઠ કર્તવ્યપરાયણ
कर्तृत्ववादी: કર્તવ્યનિષ્ઠ કર્તવ્યપરાયણ
कर्तृत्वाधीन: કર્માધિન
कर्तृत्वी: પુરુષાર્થી કરતબી
कर्तो: કર્ત્તા કર્તા કર્તાર કરણહાર
कर्नाटकी: કર્ણાટકી કર્ણાટકનું
कर्मवादी: કર્તવ્યનિષ્ઠ કર્તવ્યપરાયણ
कर्माधीन: કર્માધિન
कलंकीत: કલંકિત કલંકવાળું લાંછિત ડાઘવાળું બદનામ દોષયુક્ત કલુષિત દાગી
कलात्मक: કલાપૂર્ણ કળાવાન કલાત્મક કળામય
कलापूर्ण: કલાપૂર્ણ કળાવાન કલાત્મક કળામય
कलाप्रेमी: કલાપ્રેમી કલારસિક કલાપ્રિય
कलामोगी: કલાપ્રેમી કલારસિક કલાપ્રિય
कलाहीण: અકલાત્મક અકલા વિકલા
कलियुगाचें: કલયુગી કલિયુગીન કળજુગી કળિયુગીન
कलियुगी: કલયુગી કલિયુગીન કળજુગી કળિયુગીન
कलियुगीन: કલયુગી કલિયુગીન કળજુગી કળિયુગીન
कल्पनेंतलें: કાલ્પનિક કલ્પિત અવાસ્તવિક કલ્પેલું ધારેલું કૃત્રિમ અયથાર્થ મિથ્યા ખોટું કલ્પનાશીલ મનસ્વી
कल्पीत: કપોલકલ્પિત હવાઈ
कल्याणकारी: કલ્યાણકારી મંગળકારી હિતકારી ગુણકારી મંગલકારક કલ્યાણમય કલ્યાણપ્રદ ઇષ્ટકર
कळाव_जाल्लें: વિલંબિત
कवच_घाल्लें: કવચધારી કવચી બખ્તરધારી બખ્તરિયું
कवचधारी: કવચધારી કવચી બખ્તરધારી બખ્તરિયું
कवचाळ: કઠણ આકરું કાઠું
कवितामोगी: કાવ્યરસિક કાવ્ય_પ્રેમી
कव्हराचें: બાઇન્ડિંગ વેષ્ટન
कशे_तरेचें: કેવું કયા_પ્રકારનું કેવા_પ્રકારનું
कशें: કેવું કયા_પ્રકારનું કેવા_પ્રકારનું
कश्टकरी: મહેનતું પરિશ્રમી શ્રમી ઉદ્યોગી કર્મઠ કર્મનિષ્ઠ કર્મશીલ ઉદ્યમી ખંતીલું
कश्टदिणें: દુ દુ દુ પીડાકારક પીડાકારી કષ્ટકારક કષ્ટકર કષ્ટપ્રદ કષ્ટજન્ય કષ્ટદાયક પીડાદાયક
कश्टाची: દુ આપત્તિવાળું આપત્તિજનક દુ દુઃખકારક કષ્ટદાયક કષ્ટકારક તોદ દુ દુઃખી કષ્ટપૂર્ણ દુઃખદાયી
कश्टी: કષ્ટમય દુ વિપન્ન વિપદ્ગ્રસ્ત કાતર કષ્ટપ્રદ
कसरती: કસરતી વ્યાયામી કસાયેલું
कसलें: કેવું કયા_પ્રકારનું કેવા_પ્રકારનું
कांटयारें: કાંટાળું કાંટાદાર કાંટેદાર કંટકી કંટકીલ
कांटे_नाशिल्लें: અકંટક નિષ્કંટક કંટકહીન શૂલહીન
कांटेहीण: અકંટક નિષ્કંટક કંટકહીન શૂલહીન
कांट्याबगरचें: અકંટક નિષ્કંટક કંટકહીન શૂલહીન
कांठा_वयलें: તટવર્તી તટીય
कांतिमान: તેજ તેજપૂર્ણ તેજોમય જાજરમાન દેદીપ્યમાન કાંતિમય કાંતિમાન પ્રકાશમાન દિવ્ય
कांतीमय: તેજસ્વી પ્રભાવી પ્રભાવશાળી તેજદાર દીપ્તિમાન પ્રતિભાશાળી તેજવંત તેજવાન કાંતિવાન
कांय: અનેક સંખ્યાબંધ બહુ એકાધિક વિવિધ ઘણી અનેકાનેક કમ થોડા જરા અલ્પ ન્યૂન તનિક લેશ આંશિક થોડું લગાર નાનું ઝીણું ટૂંકું ક્ષુદ્ર ક્ષુલ્લક પામર કતિપય અમુક થોડું ઓછું અલ્પ ન્યૂન
कांयच: વિરલ વિરલા કોઇ-કોઇ કોઇક_જ
कागदी: કાગજી
कागाळ_करपी: ફરિયાદી વાદી
कागाळकार: ફરિયાદી વાદી ઝગડાળુ તકરારી તકરારિયું વઢકણું બાધકણું લડકણું કજિયાખોર કજિયાળું પ્રપંચી વિવાદી ઝંઝટીયું ઝંઝટી
काजराचें: વૈવાહિક વૈવાહ
काजळ_घातिल्ले: કાજળ_ભરી
काजळहीण: નિરંજન અંજનરહિત
काजळा_बगरचें: નિરંજન અંજનરહિત
काजळाचे: કાજળ_ભરી
काजारी: વિવાહિત પરણેલું પરિણીત શાદીશુદા
काटू: કંજૂસ કૃપણ પાજી બખીલ લોભિયો મખ્ખીચૂસ સોમ રંક કુમુદ ચીકણું ચિંગૂસ
काटूक: કંજૂસ કૃપણ પાજી બખીલ લોભિયો મખ્ખીચૂસ સોમ રંક કુમુદ ચીકણું ચિંગૂસ
काडिल्लें: પદભ્રષ્ટ પદચ્યુત નિલંબિત બરખાસ્ત અનુલંબિત
काणो: કાણું એકાક્ષી એકનયન અસમનેત્ર
कातीचो: ત્વચા ચર્મ ચામડી
कादंबरीक: ઔપન્યાસિક
कादयेचे: કેદખાનું હવાલાતી
कानकातरो: કાનકટ્ટું બૂચો કાનકાપેલ
कानकापो: કાનકટ્ટું બૂચો કાનકાપેલ
कानडी: કર્ણાટકી કર્ણાટકનું
कापीत: આકંપિત ધ્રૂજતું થરથરિત
काप्पी: આકંપિત ધ્રૂજતું થરથરિત
काबार: સમાપ્ત પૂરું ખતમ ખત્મ પૂર્ણ સંપૂર્ણ સંપન્ન તમામ નિષ્પાદિત અવસિત અશેષ
काबीज: અધિકૃત અધિગત સંપાદિત
काम_करपी: કામચલાઉ
कामचोर: કામચોર કસબચોર જાંગર_ચોર
कामनेचें: ઇચ્છાન્વિત ઇચ્છાધીન કામનાવાળું સકામ ઇચ્છિત ઇષ્ટ ઇચ્છેલું વાંછિત અભિલાષક અભિલાષી ઇચ્છુક મનોવાંછિત અભિવાંછિત અભિપ્રેત કમનીય અભીષ્ટ
कामसू: ઉધ્યમી મહેનતુ કામઢુ ઉધ્યમશીલ કામગરુ ખંતીલુ
कामहीण: કામહીન નિષ્કામ અનાસક્ત વાસનાહીન નિર્મમ વિરક્ત
कामाचें: કામચલાઉ
कायदेशीर: ન્યાયપૂર્ણ ન્યાયસંગત ન્યાયોચિત
कायद्याचें: કાનૂની કાયદેસર જાયજ યોગ્ય વાજબી યથાર્થ ઉચિત મુનાસિબ વિધિમાન્ય કાનૂની કાયદેસર કાયદાકીય
कारणां_करपी: ઢોંગી બહાનેબાજ
कारबारी: મહેનતું કામગરું કામઢું કામકાજી ઉદ્યમી ઉદ્યોગી
कारस्थानी: કુટિલ છળવાળું કપટી અનાર્જવ વંક
कार्यरत: કાર્યાન્વિત ક્રિયાન્વિત સક્રિય ક્રિયાશીલ ક્રિયાયુક્ત સકર્મક
कालजयी: અમર ચિરંજીવ ચિરંજીવી અવિનાશી નિત્ય અક્ષર સનાતન કાળજિત મૃત્યુંજય અમર્ત્ય
काल्पनीक: કાલ્પનિક કલ્પિત અવાસ્તવિક કલ્પેલું ધારેલું કૃત્રિમ અયથાર્થ મિથ્યા ખોટું કલ્પનાશીલ મનસ્વી કપોલકલ્પિત હવાઈ
काळखी: અંધારી અંધકારપૂર્ણ અંધકારમય તમિસ્ર અપ્રકાશિત તમોમય તમસોમય
काळजाक_लागपी: ભાવપૂર્વક માર્મિક ભાવાત્મક મર્મસ્પર્શી ભાવક ભાવનાપૂર્ણ હ્રદયસ્પર્શી
काळजेचें: ચિંતાજનક ચિંતાજન્ય ગંભીર ચિંતાકુલ નાજુક ચિંતાગ્રસ્ત ચિંતાવશ ચિંતાશીલ
काळींगकार: ધનાઢ્ય ધની અમીર ધનવાન માલદાર ધનવંત દોલતમંદ વૈભવશાળી વૈભવશાલી વૈભવવાળું સંપન્ન માલામાલ સમૃદ્ધ ઐશ્વર્યવાન સંપત્તિવાન ખુશહાલ પૈસાદાર બહુધન જરદાર
काळीज_चिरपी: હૃદયવિદારક હૃદય-વિદારક હૃદયભેદક હૃદયભંજક મર્મઘાતી મર્મભેદી
काळीज_पिंजपी: વિદારક અવદારક ફાડનાર ચીરનાર
काळे_जिबेचो: કલજિભા
काळें: કાળું શ્યામ કૃષ્ણ શિતિ મેચક અસિત તારીક
काळें_कुळकुळीत: કાળુંડિબાંગ કાળું શ્યામ
काळो: અશ્વેત કાળું
काव्यप्रेमी: કાવ્યરસિક કાવ્ય_પ્રેમી
काव्यमोगी: કાવ્યરસિક કાવ્ય_પ્રેમી
काव्यात्मक: કાવ્યાત્મક કાવ્યમય કાવ્યરૂપ કવિત્વમય કવિતામય રસાત્મક
काश्मिरी: કાશ્મીરી કાશ્મીરનું કાશ્મીર_સંબંધી
कास्तिसांवाचें: દુર્બોધ્ય દુર્બોધ અજ્ઞેય અઘરું પેચીદું પેચવાળું પેચદાર જટિલ પેચીલું પેચીદા
किंकोत: ઉપેક્ષ્ય ઉપેક્ષણીય લંઘનીય લંઘ્ય
किजिली: કર્કશા કંકાસિયણ વઢકણી ચંડી ચંડિકા ઝઘડાળુ વઢકણું બાધકણું લડકણું લડકું કર્કશ કલહકારી કલહાર બળવાખોર બંડખોર તોફાની ફિસાદી હુલ્લડી બખેડાખોર કજિયાખોર
किटकनाशक: જંતુનાશક જંતુઘ્ન કૃમિઘ્ન
किटनाशक: જંતુનાશક કીટનાશક જંતુઘ્ન
किटभक्षी: કીટભક્ષક કીટભોજી
किडकिडीत: હાડપિંજર અસ્થિમય હાડકાંમય દૂબળો-પાતળો દુબળો દુર્બળ કૃશોદર ક્ષીણ કૃશ પાતર અર્ભક ક્ષીણકાય સુકલકડી દૂબળુંપાતળું નબળુંપાતળું
किडकिडें: નબળું બોદું કમજોર નાજુક
किडेल्लें: સળેલું બદડેલુ
किड्यांचें_वखद: જંતુનાશક કીટનાશક જંતુઘ્ન
कितल्योश्योच: અનેક સંખ્યાબંધ બહુ એકાધિક વિવિધ ઘણી અનેકાનેક
किरकिरो: ચીઢિયું ચિડકણું ચિડિયેલ ચીડિયું ખિજાળ છાંછિયું તુંડ-મિજાજી અસહિષ્ણુ અસહનશીલ તુર્શ તુર્શ-મિજાજ
किरकोळ: છૂટક છૂટકિયું
किर्तशाळी: યશસ્વી કીર્તિમાન કીર્તિશાળી કીર્તિમંત કીર્તિવાન કીર્તિવંત
कुकुलें: લઘુકાય નાનુ નાનું ઠીંગણું વામન વામણું બાંઠિયું વામનજી બઠકું ઠીંગણો
कुचकामी: લાચાર વિવશ નિરુપાય નિર્વિકલ્પ નાઇલાજ વિકલ્પ_રહિત
कुचकुचीत: ગીચ ગાઢ ખીચોખીચ ભરચક ઘન
कुच्छित्री: કુબુદ્ધિ બદમિજાજી મિજાજી બદમિઝાજ તુંડમિજાજી
कुटील: કુટિલ છળવાળું કપટી અનાર્જવ વંક
कुटुंबहीण: પરિવારહીન કુટુંબહીન
कुटुंबीक: પારિવારિક ઘરેલું પરિવારિક પૈતૃક પૈત્રુક વડીલોપાર્જિત પિતૃપક્ષનું વંશાનુગત આનુવંશિક વારસાગત ખાનદાની
कुडीचो: શરીરી દેહધારી દેહી શરીરવાળુ અંગધારી શરીરધારી દેહવાન જીવાત્મા
कुड्डो: આંધળું અંધ નેત્રહીન અંધું અક્ષહીન અચક્ષુ અનયન દૃષ્ટિહીન
कुड्डो_विस्वासू: મતાંધ સ્વમતાગ્રહી કટ્ટરપંથી
कुतां_काडपी: છિદ્રાન્વેષક દોષદર્શક દોષગ્રાહી
कुपां_नाशिल्लें: સ્વચ્છ નિરભ્ર અનભ્ર અમેઘ મેઘહીન
कुपां_बगरचें: સ્વચ્છ નિરભ્ર અનભ્ર અમેઘ મેઘહીન
कुपां_विरयत: સ્વચ્છ નિરભ્ર અનભ્ર અમેઘ મેઘહીન
कुपांवीण: સ્વચ્છ નિરભ્ર અનભ્ર અમેઘ મેઘહીન
कुपात्र: કુપાત્ર અપાત્ર નાલાયક અનધિકારી અનર્હ નાલાયક
कुपाळ: મેઘાચ્છાદિત અબરી
कुप्रसिद्द: કુખ્યાત બદનામ કુપ્રસિદ્ધ દુર્નામ પાપનામ નામચીન
कुमारिका: કુંવારી કુમારી કુમારિકા
कुमारी: કુંવારી કુમારી કુમારિકા
कुरूप: કુરૂપ કદરૂપું બેડોળ બદસૂરત બદશિક્લ વરવું ભદ્દું અરૂપ ભદેસ ભદેસિલ અનગઢ અપાટવ અવરૂપ અરૂપ વિરૂપ
कुलिखीत: ખરાબ_લખાણ
कुळपरंपरा: ખાનદાની કુળીય વંશીય
कुळाची_परंपरा: ખાનદાની કુળીય વંશીય
कुळाचो: વંશીય કુળોત્પન્ન
कुळीन: વંશીય કુળોત્પન્ન
कुविख्यात: કુખ્યાત બદનામ કુપ્રસિદ્ધ દુર્નામ પાપનામ નામચીન
कुशळ: પ્રવીણ નિપુણ કુશળ દક્ષ હોશિયાર કાબેલ નિષ્ણાત પારંગત વિદ્વાન તદ્વિદ બાહોશ ચાલાક ચતુર પહોંચેલું પાવરધું પટુ અભ્યસ્ત આકર આગર પ્રવણ યોગ્ય લાયક કાબેલ સમર્થ અભિજાત ઉદાત્ત
कुशिल्लें: સળેલું બદડેલુ સડેલું બગડેલું વાસી_થઇ_ગયેલું કોહવાટ બગાડ
कुशीक: હટવું ચ્યુત ખસેલ ડગેલ અપગત
कुशीकचें: પાસેનું નજીકનું જોડેનું સમીપનું નિકટતમ નિકટતર નિકટવર્તી સમીપી સંનિકટ સમીપવર્તી સન્નિહિત લગોલગ નિકટસ્થ આસન્ન
कुसकें: સડેલું બગડેલું વાસી_થઇ_ગયેલું કોહવાટ બગાડ
कूट: કૂટ કઠણ અઘરું ગૂઢ જટિલ કઠિન પેચીદું મુશ્કેલ અધરું અસ્ફુટ
कूडहीण: અશરીર અશરીરી વિદેહ અદેહ શરીરહીન અદેહ અનંગ અતનુ શરીરવિહીન અપિંડી પિંડરહિત
कूपाळू: દયાળુ દયાવાન કરુણાળુ કૃપાળુ કરુણાવંત મહેરબાન માયાળુ દયાવંત કરુણામય કરુણાત્મક દયામય અનુકંપામય કરુણાવાન સહ્રદય સહ્રદયી દયાશીલ કરુણાસાગર અનુગ્રાહ
कूळहीण: અકુલીન નિમ્ન_વંશીય હલકા_વંશનું અકુલ
कृतघ्न: કૃતઘ્ન કૃતજ્ઞ કૃતઘ્ની અપકારી નિમકહરામ લૂણહરામ
कृतज्ञ: કૃતજ્ઞ નિમકહલાલ અહસાનમંદ આભારી ઉપકૃત
कृतार्थ: કૃતજ્ઞ કૃતકૃત્ય
कृत्रीम: બનાવટી નકલી કૃત્રિમ અપ્રાકૃતિક અપ્રકૃત અસ્વાભાવિક_આહાર્ય
केंद्रीत: કેંદ્રિત કેંદ્રિભૂત
केंद्रीय: કેંદ્રીય મધ્યસ્થ
केर्रेक: ક્રોધી તામસી ઝક્કી મિજાજી માથાફરેલ
केल्लें: કૃત નિષ્પન્ન નિષ્પાદિત
केसरी: કેશરી કેસરી ભગવું કેસરીયું જાફરાની સિંદૂરી સિંદૂરિયું લાલ કુસુંભી રાતું
केसाळ: રેસાદાર રેષામય રોમલ રોમરાજિ
केस्तांवी: બળવાખોર બંડખોર તોફાની ફિસાદી હુલ્લડી બખેડાખોર કજિયાખોર
केस्ताळ: ઝઘડાળુ વઢકણું બાધકણું લડકણું લડકું કર્કશ કલહકારી કલહાર
कैदी: કેદી બંદી બંદીવાન
कोंगरे: વાંકડિયા ગુચ્છાદાર ઘુઘરિયાળ કુંચિત
कोट्याधीश: કરોડપતિ કોટ્યધિપતિ કરોડાધિપતિ
कोडू: બેસ્વાદ કસાણું કષાય કડવું કટુ કટુક તિક્ત અમધુર
कोडू_काजरो: ખૂબ_કડવું બહુ_કડવું અતિ_કડવું અતિ_કટુ ખૂબ_કડવું બહુ_કડવું અતિ_કડવું અતિ_કટુ
कोडू_वीख: ખૂબ_કડવું બહુ_કડવું અતિ_કડવું અતિ_કટુ
कोडूभाशी: કટુભાષી અપ્રિયવાદી
कोनश्यांचें: કોણીય કોણયુક્ત
कोनी: કોણીય કોણયુક્ત
कोनीय: કોણીય કોણયુક્ત
कोप्रकार: દેવાદાર કરજદાર ઋણી ઋણદાતા રુણપ્રદાતા_કર્જદાતા
कोमल: નરમ મુલાયમ કોમળ મૃદુલ મૃદુ તનુ સુંવાળું પોચું
कोमलांगिनी: કોમલાંગી કોમલાંગીની કોમલાંગના તન્વી નાજનીન
कोमेल्ले: ફણગાવેલા અંકુરિત અંકુરવાળું
कोयराचें: કીચડવાળું કાદવવાળું પંકિલ કાર્દમ
कोलवाचें: ઘાસિયું તૃણમય
कोसळिल्लें: પડી_ગયેલું ઢળી_પડેલું અવક્ષિપ્ત અવગત
कौमार्ययुक्त: કૌમાર્યયુક્ત
क्रमहीण: આડુંઅવળું અસ્ત-વ્યસ્ત અક્રમિક ક્રમહિન અક્રમ અનિયમિત
क्रमा_बगरचें: આડુંઅવળું અસ્ત-વ્યસ્ત અક્રમિક ક્રમહિન અક્રમ અનિયમિત
क्रमान: ક્રમિક ક્રમાનુસાર ક્રમપૂર્વક ક્રમબદ્ધ ક્રમસર અનુક્રમિક અનુક્રમવાર શૃંખલાબદ્ધ શૃંખલિત કડીબંધ અનુપૂર્વ
क्रियाशीळ: સક્રિય ક્રિયાશીલ ક્રિયાયુક્ત સકર્મક
क्रुर: નિર્દય ક્રૂર ઘાતકી દયાહીન નિર્દયી કસાઈ નિષ્ઠુર કઠોર અમમ અદય અદયાળુ નિર્ઘૂણ કરુણા_વિહીન કરુણાહીન અઘૃણ
क्रूर: અત્યાચારી અનાચારી આતતાયી નૃશંસ ક્રૂર જુલ્મી ઝાલિમ જુલમગાર ખૂંખાર ઉત્પીડક સંતાપક
क्षणजिवी: નશ્વર નાશવંત ભંગુર વિનાશી નાશવાન નાશુક અસ્થાયી ક્ષણભંગુર અશાશ્વત અનિત
क्षणभंगूर: નશ્વર નાશવંત ભંગુર વિનાશી નાશવાન નાશુક અસ્થાયી ક્ષણભંગુર અશાશ્વત અનિત
क्षणीक: ક્ષણિક ક્ષણભંગુર નશ્વર અચિર અસ્થાયી અલ્પકાલીન અનિત અનિત્ય
क्षमायाचक: ક્ષમાપ્રાર્થી ક્ષમા_યાચક
क्षमायोग्य: ક્ષમ્ય ક્ષમાપાત્ર ક્ષમા_યોગ્ય
क्षमावान: ક્ષમાવાન ક્ષમાશીલ તિતિક્ષુ ક્ષમાવાદી
क्षमाशीळ: ક્ષમાવાન ક્ષમાશીલ તિતિક્ષુ ક્ષમાવાદી
क्षम्य: ક્ષમ્ય ક્ષમાપાત્ર ક્ષમા_યોગ્ય
क्षय_रोगी: ક્ષયી ક્ષય_રોગવાળો
क्षीण: ક્ષીણકાય સુકલકડી દૂબળુંપાતળું નબળુંપાતળું
क्षुद्र: અકુલીન નિમ્ન_વંશીય હલકા_વંશનું અકુલ
क्षुद्र_कुळाचें: નિમ્ન_કુલીન નિમ્ન_વંશીય
क्षेत्रीय: પ્રાદેશિક આંચલિક
खंडणीय: ખંડનીય ભંજનીય ખંડનીય
खंडाचें: પ્રાયદ્વીપીય દ્વીપકલ્પીય
खंडीत: રદ બાતલ રદ્દ નિરસ્ત મંસૂખ ખંડિત ભાગેલું ભગ્ન વિખંડિત તૂટેલું છિન્ન છિન્નભિન્ન
खंडीय: પ્રાયદ્વીપીય દ્વીપકલ્પીય
खंतदिणी: દુ આપત્તિવાળું આપત્તિજનક દુ દુઃખકારક કષ્ટદાયક કષ્ટકારક તોદ
खंती: હતાશ નિરાશ નાઉમેદ નાસીપાસ ભગ્નાશ આશાભંગ નિરાશ આશાહીન નાઉમેદ આશાભંગ ભગ્નાશ હતાશ
खंतीची: દુ આપત્તિવાળું આપત્તિજનક દુ દુઃખકારક કષ્ટદાયક કષ્ટકારક તોદ દુ દુઃખી કષ્ટપૂર્ણ દુઃખદાયી
खंबीर: અટલ અટળ અટ્ટલ દૃઢ અડગ સ્થિર કાયમ અવિચલ અનત અનમિત
खडतर: કઠિન અઘરું દુર્ગમ અગમ દુર્ગમ્ય અનાગમ્ય અગત
खडबडीत: અસમતોલ ઉબડ-ખાબડ અસમતળ વિષમ_પ્રમાણ ખરબચડું ખાડાટેકરાવાળું તોફાની કઠોર લાગણીવિહોણું ખોડખામીવાળું મુશ્કેલી કષ્ટ મવાલી કુદરતી_સ્થિતિ ડોળિયું કાચો_ખરડો
खड्डो: ટકલો ટકો ગંજો ટકોમૂંડો ટક્કો વિકેશ ટકલાં કેશહીન
खतखतीत: ગરમાગરમ ધગધગતું તપ્ત ઊનું તપેલું ગરમ તપુ પ્રતપ્ત
खताळ: ડાઘવાળું દાગદાર
खबर_आशिल्लें: ખબર અવગત જાણેલું જ્ઞાત પરિચિત વાકેફ પ્રતીત અવભાસિત
खबर_नाशिल्लें: અજ્ઞાત અજાણ્યું અવિદિત અનવગત અપરિચિત અપરિગત અનધિગત બિનવાકેફ અનભિજ્ઞ અજ્ઞ બેખબર બિનવાકેફગાર અણજાણ અજાણ ગુમનામ
खबरेपत्र: રોજ દરરોજ દૈનિક
खर: અદમ્ય અદમનીય તીક્ષ્ણ તીવ્ર કુશાગ્ર પ્રખર તેજ ઉગ્ર પ્રચંડ આકરૂં અકુંઠ અકુંઠિત દારુણ ભયંકર ભયાનક વિકરાળ ઘોર મજબૂત ઠોસ દૃઢ પાક્કું જબરદસ્ત જોરાવર જબરું જબરજસ્ત જબ્બર જબર અભંગુર અશિથિલ કર્કશ કઠોર સખ્ત આકરું કર્ણકટુ નિષ્ઠુર રૂક્ષ જોશીલું જોશવાળું જોસદાર તીવ્ર તેજ બુલંદ અસાધારણ
खरसाणीचे: પ્રચંડ ઉગ્ર પ્રખર આકરું પ્રબળ જબરું જબ્બર પ્રબલ તેજ તીવ્ર તીક્ષ્ણ કડા અમંદ દુર્દમ
खरी: શુદ્ધ ખરું સાચું આસલી ચોખ્ખું વિશુદ્ધ વાસ્તવિક યથાર્થ સાચું અસલી ખરેખરું વાજબી સાચેસાચું સાચમાચ મૂળ ખરું
खरो: પ્રમાણિક ઈમાનદાર વિશ્વાસપાત્ર ઈમાની ઋજુ સત્યપર સત્યપરાયણ નિષ્કપટ નિખાલસ સાચું ખરૂં
खर्चीक: ખર્ચાળુ ખર્ચાળ અપવ્યયી વ્યયી ઉડાઉ અતિવ્યયી
खांदये_बगरचें: શાખાહીન શાખારહિત શાખાવિહીન અપ્રકાંડ
खांदये_विरयत: શાખાહીન શાખારહિત શાખાવિહીન અપ્રકાંડ
खांदी_नाशिल्लें: શાખાહીન શાખારહિત શાખાવિહીન અપ્રકાંડ
खांदो: ઘટાદાર ડાળીદાર
खांपें: પ્રવીણ નિપુણ કુશળ દક્ષ હોશિયાર કાબેલ નિષ્ણાત પારંગત વિદ્વાન તદ્વિદ બાહોશ ચાલાક ચતુર પહોંચેલું પાવરધું પટુ અભ્યસ્ત આકર આગર પ્રવણ
खाजगी: અંગત ખાનગી નિજી પોતાનું વ્યક્તિગત અંગનું સ્વકીય અંગત વ્યક્તિગત વૈયક્તિક નિજી
खादाड: ખાઉધરું ભુખ્ખડ અત્યાહારી અતિભોજી ઉદર_પિશાચ
खाद्य: ખાદ્ય ભોજ્ય આહાર્ય અશનીય ભક્ષ્ય
खानदानी: પૈતૃક પૈત્રુક વડીલોપાર્જિત પિતૃપક્ષનું વંશાનુગત આનુવંશિક વારસાગત ખાનદાની
खापो: દિગ્ગજ
खायलें: મામૂલી નગણ્ય તુચ્છ સામાન્ય જેવું-તેવું નાચીજ હલકું પામર અનુદાત્ત ક્ષુદ્ર આધીન અધીન તાબેદાર વશ તાબે માતહત અમુખ્ય
खायलो: નીચું નિમ્ન અતુંગ નિભૃત અનુચ્ચ અનુન્નત અનૂર્ધ્વ
खायल्या_कुळाचें: અકુલીન નિમ્ન_વંશીય હલકા_વંશનું અકુલ નિમ્ન_કુલીન નિમ્ન_વંશીય
खारट: ખારું ખારૂ ક્ષારમય લવણયુક્ત નમકીન
खारें: ખારું ખારૂ ક્ષારમય લવણયુક્ત નમકીન
खाला_दिल्लें: નિમ્નલિખિત નિમ્નાંકિત નિમ્નોક્ત
खाली: ખાલી ખાલીખમ ઠાલું રિક્ત શૂન્ય અવસ્તુ
खावंक_नाशिल्लें: અભુક્ત કોરું અનુપભુક્ત અભોગત
खावगें: ખાઉધરું ભુખ્ખડ અત્યાહારી અતિભોજી ઉદર_પિશાચ
खावपाचें: ખાદ્ય ભોજ્ય આહાર્ય અશનીય ભક્ષ્ય
खावपी: ભક્ષી ભક્ષક ખાનાર ખાદક આશી ખાનાર ભક્ષક આહારી
खाशेलें: વિશિષ્ટ ખાસ અસાધારણ અસામાન્ય વિશેષ ખાસ અનોખું લોકોત્તર અલૌકિક
खाश्या: સહોદર સગું પોતાનું નિજી નિજનું અંગતનું જાતનું પંડનું સ્વકીય પોતીકું
खाश्श्या: સ્વકીય પંડનું જાતનું પોતીકું પોતાનું.
खास: વિશિષ્ટ ખાસ અસાધારણ અસામાન્ય વિશેષ ખાસ અનોખું લોકોત્તર અલૌકિક અસામાન્ય અસાધારણ અસમાન ખાસ વિશિષ્ટ વિશેષ વિશેષતાવાળું
खिणयाळें: ક્ષણિક ક્ષણભંગુર નશ્વર અચિર અસ્થાયી અલ્પકાલીન અનિત અનિત્ય
खीणयाळें: નશ્વર નાશવંત ભંગુર વિનાશી નાશવાન નાશુક અસ્થાયી ક્ષણભંગુર અશાશ્વત અનિત
खुटें: બેસ્વાદ નીરસ નિષ્પ્રાણ
खुनी: ખૂની કાતિલ ઘાતક હત્યારો આલંભન હિંસા વધ મારણ
खुळो: પાગલ ગાંડો બાવરો
खूब: અનેક સંખ્યાબંધ બહુ એકાધિક વિવિધ ઘણી અનેકાનેક ખૂબ પુષ્કળ બહુ અતિ વિશેષ અત્યંત અતિશય વિપુલ અગાધ અપાર બેશુમાર બેહદ અસીમ
खूब_कोडू: ખૂબ_કડવું બહુ_કડવું અતિ_કડવું અતિ_કટુ
खूब_चड: પુષ્કળ ખૂબ અતિશય ઘણું બહુ અત્યાધિક અધિક વધારે અતિ બેહદ બેશુમાર અસીમ વિપુલ ઝાઝું ઘણુંવધારે અમાપ અપાર અખૂટ બેપનાહ બેહિસાબ અલેશ અમિત
खेदहीण: શોકરહિત શોકહીન વિશોક અશોક અવસાદહીન નિરવસાદ
खेरीज: અલગ અલગ-અલગ જુદું છૂટું અસમ વિષમ ભિન્ન અનમેલ અસમાન પૃથક્ વિભિન્ન અતુલ્ય અયુગ અમિલ અસંબદ્ધ
खेळीमेळीचें: મિલનસાર ભળતું ભલમનસાઈ સુશીલ
खोटे: ખોટા નકલી નકલરૂપ બનાવટી કૃત્રિમ પોકળ મિથ્યા જૂઠું જૂઠાણું પોલું
खोटें: અસત્યવાદી ખોટો અસત્યભાષી મિથ્યાભાષી મિથ્યાવાદી અસત્યસેવી ખોટાબોલું ખોટું જૂઠું અસત્ય મિથ્યા અસત્યતાપૂર્ણ મિથ્યાપૂર્ણ અસત અસત્ મૃષાવચન અલીક અવિદ્યમાન અમૂલક નિરાધાર અકારણ આધારશૂન્ય અપ્રમાણિક અપ્રામાણિક આધારહીન નિર્મૂલ સારહીન અનાધાર યથાર્થહીન આધારરહિત
खोटो: દુરાશય ખોટો કુવિચારી બદનિયત કૂટકારક કૂટકાર
खोल: ગહન ઊંડું ગાઢ ઊંડું ઘેરું ગહન અતળ
खोशये_बगरचें: અસંતોષજનક અસંતોષપ્રદ અસંતોષકારક
खोशी: પ્રસન્ન ખુશ ખુશખુશાલ રાજી આનંદિત હર્ષિત આનંદી પુલકિત આહ્લાદિત આહ્લાદયુક્ત મુદિત મુદમાતું પ્રમુદિત પ્રફુલ્લ પરિતુષ્ટ પ્રફુલ્લિત ઉલ્લસિત ઉલ્લાસિત ઉલ્લાસી તુષ્ટ પ્રહર્ષિત પ્રહૃષ્ટ શાદ અમ્લાન પ્રસન્નચિત્ત ખુશમિજાજ આનંદી સદાનંદ મોજી ખુશી રાજી આનંદિત વિનોદિત હર્ષિત
खोस_दिना_अशें: અસંતોષજનક અસંતોષપ્રદ અસંતોષકારક
खोस_दिवपी: સંતોષજનક સંતોષકારક યોગ્યતાવાળું સ્વાગતાર્હ સ્વીકૃત
खोसदिणें: સુખદાયી આનંદપ્રદ અનંદદાયક આનંદદાયી આનંદકારી આનંદકર હર્ષદાયક સુખકર નંદક સોહામણું શોભીતું સુહાવનું સરસ ખુશનૂમા સંતોષજનક સંતોષકારક યોગ્યતાવાળું સ્વાગતાર્હ સ્વીકૃત
खोसयाळें: આનંદપૂર્ણ આનંદિત આનંદમય સાનંદ ઉલ્લાસપૂર્ણ પ્રસન્નતાપૂર્ણ
ख्यास्तपात्र: દંડનીય દંડપાત્ર શિક્ષપાત્ર સજાપાત્ર દંડનીય શિક્ષાપાત્ર
गंधहीण: ગંધહીન વાસહીન ગંધરહિત નિર્ગંધ
गंधीत: સુગંધીદાર સુગંધિત ગંધિત વાસયુક્ત મહેકતા
गच्च: ગીચ ગાઢ ખીચોખીચ ભરચક ઘન
गडद: ભપકાદાર ભડકદાર ચમકદાર
गडबडें: ઉતાવળું આતુર અધીરૂં ધાંધલિયું ઉતાવલું હડબડિયું ઉતાવળિયું
गडबडो: ચંચળ અધીરું ડગડગમતું નટખટ ખટપટીયું ધમાલીયું તોફાની બારકશ ચપળ તરલ વિલોલ
गणनीय: ગણનીય ગણ્ય
गण्य: ગણનીય ગણ્ય
गतिशील: ઝડપી દ્રુતગામી દ્રુતગતિ
गतिहीण: સ્થિર સ્થાયી અચેષ્ટ નિશ્ચલ અડગ અચળ અચલ અટલ ધ્રુવ નિશ્વળ નિશ્વિત અવિચલ અડોલ દૃઢ અટળ નિત્ય
गतीचें: ગતિશીલ ગતિમાન ગતિવંત ગતિવાળું વેગીલું વેગવાળું ઝડપી ગતિવાળું ફરતું જંગમ ભમતું અસ્થિર ચંચળ અધ્રુવ હાલતું
गतीशील: ગતિશીલ ગતિમાન ગતિવંત ગતિવાળું વેગીલું વેગવાળું ઝડપી ગતિવાળું ફરતું જંગમ ભમતું અસ્થિર ચંચળ અધ્રુવ હાલતું
गरजे_भायर: નકામું બિનજરૂરી ઉપયોગ_વિનાનું વ્યર્થ ફોગટ ફાલતું જરૂરિયાત_વિનાનું
गरजेचें: આવશ્યક જરૂરી અપેક્ષિત અપેક્ષ્ય તાકીદી અનિવાર્ય જરુરી આવશ્યક પરમાવશ્યક
गरम: ગરમ ઉષ્ણ ઊની આવિક ગરમ ગરમ
गरमागरम: ગરમાગરમ ધગધગતું
गरीब: નિર્ધન ગરીબ દીન અકિંચન કંગાલ દરિદ્ર રાંક અસમૃદ્ધ અસંપન્ન દીનહીન બિચારું મુફલિસ ધનહીન રંક બેહાલ તંગહાલ વિધન નિધની ટટપૂંજિયું ટુટપૂંજિયું
गर्भेस्त: ગર્ભવતી સગર્ભા દોહદવતી ગર્ભિણી અંતર્વતી અંતર્વત્ની રેતોધ
गर्वहीण: નિરભિમાની નિરભિમાનિતા નિરભિમાનપણું અભિમાનરહિત અદંભી અહંકારહીન સીધુ દંભહીન અભિમાનશૂન્ય ગર્વરહિત નિરહંકાર નિરહંકારિતા અમત્ત ઘમંડરહિત ગૌરવહીન ગરિમાહીન
गर्विश्ट: અભિમાની અહંકારી મગરૂર ગર્વીલું ગર્વી અભિમાની અભિમાનવાળું અહંકારી મગરૂબ ઘમંડી દંભી આડંબરી ડોળી ગર્વી ગર્વિષ્ઠ ઉન્મત્ત તોરી છકેલું ઉદ્ધત અવિનયી અવિનમ્ર પ્રગલ્ભ ઉછાંછળું દર્પિત અહંકારી દર્પવાળું
गवताचें: ઘાસિયું તૃણમય
गवाय: સાક્ષી પ્રત્યક્ષદર્શી અનુભાવી ગવાહ શાહેદ
गांवगिरी: ગ્રામવાસી ગામવાસી ગામડીયણ દેહાતી ગ્રામીણ ગામડિયો દેહાતી ગ્રામવાસી
गांवगिरे: ગ્રામીણ ગામડિયો દેહાતી ગ્રામવાસી ગ્રામ્ય
गांवटी: પાલતૂ ઘરેલું પાલૂ
गाढ: ઘટ્ટ ઘાટું જાડું
गाबणी: ગાભણું ગાભણ
गायब: અદ્રશ્ય અદ્રષ્ટ અદર્શનીય અદીઠ અગોચર અદૃશ્ય અદર્શ અડીઠ અપેખ અંતર્હિત તિરોહિત
गायिल्लें: ગાયેલું ગવાયેલું
गायेपसूनचें: ગવ્ય
गाळाचें: કાંપ
गिड्डो: ઠિંગણો વામન નાટો નિખર્વ
गिन्यानान_भरिल्लें: જ્ઞાનમય જ્ઞાનપૂર્ણ જ્ઞાની ચિન્મય
गिन्यानी: વિદ્વાન જ્ઞાનવાન પંડિત જ્ઞાની વિબુધ જ્ઞાતા વિદ્વત વેત્તા ભિજ્ઞ
गिमाळ्याचो: ગ્રીષ્મકાલીન ગ્રીષ્મીય નૈદાઘ ઉનાળાની
गिरेस्त: ગુણી ધનાઢ્ય ધની અમીર ધનવાન માલદાર ધનવંત દોલતમંદ વૈભવશાળી વૈભવશાલી વૈભવવાળું સંપન્ન માલામાલ સમૃદ્ધ ઐશ્વર્યવાન સંપત્તિવાન ખુશહાલ પૈસાદાર બહુધન જરદાર
गुंगेचें: નિશ્ચેતક સંવેદનાહારક
गुंथिल्लें: કાર્યરત પ્રવૃત્ત અભિમુખ પરાયણ મચેલું લાગેલું
गुजराती: ગુજરાતી
गुडहीण: રહસ્ય_વગર રહસ્યહીન અગૂઢ
गुणग्राहक: કદરદાન ગુણજ્ઞ ગુણગ્રાહી ગુણગ્રાહક
गुणग्राही: કદરદાન ગુણજ્ઞ ગુણગ્રાહી ગુણગ્રાહક
गुणयुक्त: ગુણવત્તાયુક્ત ગુણાન્વિત ગુણયુક્ત
गुणवंत: ગુણવાન ગુણશાળી સદ્ગુણી ગુણવંત ગુણી
गुणवत्तायुक्त: ગુણવત્તાયુક્ત ગુણાન્વિત ગુણયુક્ત
गुणवत्ताहीण: ગુણવત્તાહીન ગુણવત્તા_રહિત
गुणी: ગુણવાન ગુણશાળી સદ્ગુણી ગુણવંત ગુણી ગુણવાન ગુણવંત ગુણાકર ગુણાનિધાન
गुन्यांवकार: અપરાધી ગુનેગાર દોષી કસૂરવાર કસૂરદાર
गुन्यावंकार: અપરાધશીલ ગુનાહિત
गुपीत: ગોપનીય ગોપ્ય ગુપ્ત ખાનગી કૉન્ફિડેન્શિયલ ગુપ્ત છાનું છૂપું ગૂઢ અજ્ઞાત પોશીદા પ્રચ્છન્ન અપ્રગટ અપ્રત્યક્ષ ગુહ્ય ખાનગી અણછતું છદ્મવેશી આચ્છાદિત ગોપ્ય રહસ્ય મર્મ રહસ્યમય અંતરિત અદીઠ ખુફિયા નિભૃત અપ્રગટ અપ્રકાશિત અપ્રકટ અપ્રસિદ્ધ અનુગુપ્ત અપ્રકાશ અપ્રથિત રહસ્યમય રહસ્યાત્મક રહસ્યપૂર્ણ ગૂઢ
गुप्त: ગોપનીય ગોપ્ય ગુપ્ત ખાનગી કૉન્ફિડેન્શિયલ ગુપ્ત છાનું છૂપું ગૂઢ અજ્ઞાત પોશીદા પ્રચ્છન્ન અપ્રગટ અપ્રત્યક્ષ ગુહ્ય ખાનગી અણછતું છદ્મવેશી આચ્છાદિત ગોપ્ય રહસ્ય મર્મ રહસ્યમય અંતરિત અદીઠ ખુફિયા નિભૃત અપ્રગટ અપ્રકાશિત અપ્રકટ અપ્રસિદ્ધ અનુગુપ્ત અપ્રકાશ અપ્રથિત
गुप्तहेरी: જાસૂસી છૂપી_બાતમી_લાવવાનું_કામ
गुबगुबीत: માંસલ પુષ્ટ લઠ્ઠ
गुरवार: ગર્ભવતી સગર્ભા દોહદવતી ગર્ભિણી અંતર્વતી અંતર્વત્ની રેતોધ
गुरुकूलवासी: અંતેવાસી ગુરુકુળવાસી
गुरू_नाशिल्लें: અદીક્ષિત નિગુરુ અગુરુ
गुरूहीण: અદીક્ષિત નિગુરુ અગુરુ
गुलाम: ચાપલૂસ ખુશામદિયું માખણિયું ચમચો
गुल्ल: તલ્લીન ધ્યાનમગ્ન ડૂબેલું મચેલું મશગૂલ પરાયણ નિમગ્ન લીન એકતાર તન્મય મસ્ત ગરક ગરકાવ રત વિભોર મગ્ન નિરત અનુરક્ત અભિનિવિષ્ટ કાર્યરત પ્રવૃત્ત અભિમુખ પરાયણ મચેલું લાગેલું વ્યસ્ત
गूढ: ગોપનીય ગોપ્ય ગુપ્ત ખાનગી કૉન્ફિડેન્શિયલ ગુપ્ત છાનું છૂપું ગૂઢ અજ્ઞાત પોશીદા પ્રચ્છન્ન અપ્રગટ અપ્રત્યક્ષ ગુહ્ય ખાનગી અણછતું છદ્મવેશી આચ્છાદિત ગોપ્ય રહસ્ય મર્મ રહસ્યમય અંતરિત અદીઠ ખુફિયા નિભૃત અપ્રગટ અપ્રકાશિત અપ્રકટ અપ્રસિદ્ધ અનુગુપ્ત અપ્રકાશ અપ્રથિત કૂટ કઠણ અઘરું ગૂઢ જટિલ કઠિન પેચીદું મુશ્કેલ અધરું અસ્ફુટ રહસ્યમય રહસ્યાત્મક રહસ્યપૂર્ણ ગૂઢ
गृहस्ताश्रमी: ગૃહસ્થ ગૃહસ્થાશ્રમી સંસારી
गेल्लें: જપ્ત ખાલસા કુર્ક
गैरहजर: ગેરહાજર અનુપસ્થિત અપ્રસ્તુત અવિદ્યમાન
गोचर: ગોચર ઇંદ્રિયગમ્ય
गोड: સુરીલું સુરેલ સુમધુર મીઠું મધુર ગળ્યું મીઠું મધુરું ગળાશવાળું મધુર
गोड_उलोवपी: મીઠાબોલું પ્રિયભાષી પ્રિયંવદ
गोडभाशी: મીઠાબોલું પ્રિયભાષી પ્રિયંવદ
गोरो: ગોરું ગૌરવર્ણું શ્વેત ધોળુ અવદાત ઉજળુ ગોરુંગફ
गोरो_धवो: ગોરું ગૌરવર્ણું શ્વેત ધોળુ અવદાત ઉજળુ ગોરુંગફ
गौण: ગૌણ અમુખ્ય અપ્રધાન અપ્રમુખ આનુષંગિક
गौरवपूर्ण: ગૌરવપૂર્ણ ગૌરવથી_ભરેલું ગૌરવશાળી ગૌરવાન્વિત ગૌરવમય મહત્તાવાળું ગરિમાયુક્ત
गौरवशीळ: ગૌરવપૂર્ણ ગૌરવથી_ભરેલું ગૌરવશાળી ગૌરવાન્વિત ગૌરવમય મહત્તાવાળું ગરિમાયુક્ત
ग्रंथिकी: પુસ્તકીય પુસ્તકનું
ग्रीक: યૂનાની ગ્રીક
घट: ઘનિષ્ઠ નિકટનું ગાઢ અનન્ય પ્રગાઢ આત્મીય જિગરી અટલ અટળ અટ્ટલ દૃઢ અડગ સ્થિર કાયમ અવિચલ નિર્ભય નીડર નિર્ભીક અભય બેખૌફ બેખોફ ભયહીન નિર્ભીત અધૂત અપભય નિશંક અભિક અભીક અભીત અભીરુ અભૈ વિશ્રબ્ધ કઠણ સખત નક્કર કડક કઠોર સખ્ત ઉગ્ર ખર રૂઢ મજબૂત ઠોસ દૃઢ પાક્કું જબરદસ્ત જોરાવર જબરું જબરજસ્ત જબ્બર જબર અભંગુર અશિથિલ
घट_काळजाचें: નિષ્ઠુર નઠોર ક્રૂર પાષાણી
घट_काळजाचो: સંગદિલ કઠોરહૃદય નિર્દય ક્રૂર પથ્થરદિલ
घटमूट: હૃષ્ટપુષ્ટ તગડો હટ્ટો-કટ્ટો તંદુરસ્ત પુષ્ટ પૃથુલ ભારેખમ
घडपाचें: ઘટનીય ઘટ્ય
घडपी: ઘટનીય ઘટ્ય
घडयिल्लें: કપોલકલ્પિત હવાઈ રચિત નિર્મિત વિરચિત સૃષ્ટ કૃત સર્જિત પ્રણીત
घडिल्लें: બનેલું થયેલું ઘટિત સંવૃત્ત
घडूंक_नाशिल्लें: અઘટિત
घन: કઠણ સખત નક્કર
घमेंडी: અભિમાની અહંકારી મગરૂર ગર્વીલું ગર્વી અભિમાની અભિમાનવાળું અહંકારી મગરૂબ ઘમંડી દંભી આડંબરી ડોળી ગર્વી ગર્વિષ્ઠ ઉન્મત્ત તોરી છકેલું ઉદ્ધત અવિનયી અવિનમ્ર પ્રગલ્ભ ઉછાંછળું દર્પિત અહંકારી દર્પવાળું
घरगुती: પારિવારિક ઘરેલું પરિવારિક પાલતૂ ઘરેલું પાલૂ ઘરનું ઘરેલું અંગત ખાનગી પોતીકું
घरहीण: બેઘર આવાસહીન ઘરવિહોણું અનિકેત નિવાસ_રહિત
घराबें: ઘરનું ઘરેલું અંગત ખાનગી પોતીકું
घरावें: પારિવારિક ઘરેલું પરિવારિક પાલતૂ ઘરેલું પાલૂ ઘરનું ઘરેલું અંગત ખાનગી પોતીકું
घसरिल्लें: ઓછો મંદ અવનત નરમ નીચું કમ
घांसमारें: કરડકણું કડકણું કરડુ કરડતું કાડૂ
घाई_करपी: ઉતાવળું આતુર અધીરૂં ધાંધલિયું ઉતાવલું હડબડિયું ઉતાવળિયું
घाडी: જાદુગર
घाणयारें: મેલુ અસ્વચ્છ ખરાબ અપવિત્ર અશુધ્ધ ગંધારુ બગડેલું દૂષિત અવિમલ અનિર્મલ અવિશુધ્ધ અશુચિ મ્લાન મલિન ગંદુ
घाणीचें: દુર્ગંધિત દુર્ગંધવાળું ગંધાતું
घातकी: હિંસક ઘાતક ખાટકી કસાઈ આતતાયી નૃશંસ ઝાલિમ અત્યાચારી જાલિમ દગાબાજ નમકહરામ વિશ્વાસઘાતી ગદ્દાર બેવફા દગાબાજ જોખમી ખતરનાક ભયંકર સંકટમય સંકટપૂર્ણ આપત્તિકારક હાનિકારક જોખમકારક રિસ્કી દગાબાજ દગલબાજ પ્રપંચી ધૂર્ત ચાલબાજ શાતિર વિશ્વાસઘાતી શઠ હોશિયાર વક્રગામી કિતવ કૈવત પ્રતારક ચંટ વક્રગામી દ્વિભાવ કપટી
घातमारें: દગાબાજ દગલબાજ પ્રપંચી ધૂર્ત ચાલબાજ શાતિર વિશ્વાસઘાતી શઠ હોશિયાર વક્રગામી કિતવ કૈવત પ્રતારક ચંટ વક્રગામી દ્વિભાવ કપટી
घामान_भिजिल्ली: રેબઝેબ પ્રસ્વેદિત
घामेल्ली: રેબઝેબ પ્રસ્વેદિત
घामेल्लें: ઘામછ
घायाळ: ઘાયલ ઇજાગ્રસ્ત ક્ષત જખમી ઘવાયેલું આહત ઈજા_પામેલું
घार्मिक: ધાર્મિક ધર્મશીલ ધર્મવાળું પુણ્યાત્મા ધર્મનિષ્ઠ ધર્મિષ્ઠ ધર્મવાન ધર્માત્મા ધર્મી ધર્મ-પરાયણ
घाळ: અસાવધાન અસાવધ ગાફેલ બેદરકાર બેખબર અચેત ગાફલ બેધ્યાન
घुवळीचें: નિશ્ચેતક સંવેદનાહારક માદક કેફી નશીલુ નશેદાર
घुसपटिल्लें: જટિલ અટપટું
घुसपलिल्लो: ખલવું ખલાવું ફસેલું સપડાવું ભરાવું
घुसपल्लें: જટિલ અટપટું
घुस्पागोंदळाचें: દુર્બોધ્ય દુર્બોધ અજ્ઞેય અઘરું પેચીદું પેચવાળું પેચદાર જટિલ પેચીલું પેચીદા
घुस्पूंक_नाशिल्लें: ઉકેલી_નાખવું ઉકેલવું
घृणास्पद: ઘૃણિત ઘૃણાસ્પદ નિદિત ઘૃણાપાત્ર કુત્સિત બીભત્સ અપકૃષ્ટ જઘન્ય નિંદ્ય નિંદનીય
घृणीत: ઘૃણિત ઘૃણાસ્પદ નિદિત ઘૃણાપાત્ર કુત્સિત બીભત્સ અપકૃષ્ટ જઘન્ય નિંદ્ય નિંદનીય
घेरिल्लो: ઘેરાયેલ ઘેરાવ વેષ્ટિત આચ્છાદિત ઢાંકેલું
घोग्यांचो: મૂશળધાર મૂશલધાર
घोनें: મૂર્ખ મૂરખ અબૂધ અક્કલહીન ઠોઠ ગમાર બેવકૂફ બુદ્ધિહીન નાદાન મતિમંદ મૂઢ અબૂજ અજ્ઞાની બેસમજ અંધ કમઅક્કલ મૂઢમતિ મૂઢબુદ્ધિ અણસમજુ અલ્પબુદ્ધિ શીન અવિદ પામર
घोळटी: પ્રચલિત ચાલુ અનાયત જારી રુઢ જારી
घोस्ताचें: ભાવતું મનપસંદ પ્રિય રુચિકર મનભાવન મનગમતું વાંછિત ઐચ્છિક અભીષ્ટ
चंचळ: વિચલિત અસ્થિર સ્ખલિત ચલિત ડગી_જવું ડગમગાવું ચંચળ અધીરું ડગડગમતું નટખટ ખટપટીયું ધમાલીયું તોફાની બારકશ ચપળ તરલ વિલોલ અશાંત શાંતિરહિત અસ્થિર ઉદ્વિગ્ન વ્યગ્ર તોફાની ચંચળ આતુર ઉત્કંઠિત અવ્યવસ્થિત ક્ષુબ્ધ ડહોળાયેલું અવકંપિત બેચિત્ત બેધ્યાન આલોલ ચંચળચિત્ત ચંચળ
चकचकपी: ચમક્તો દમક્તો ઉજ્જવલ રોશન ઝગમગ દીપ્ત પ્રકાશવાન દ્ર્યુતિમાન કાંતિમાન
चकचकीत: પ્રકાશમાન તેજસ્વી તેજોમય પ્રકાશતું ઉજ્જવલ ઉજ્જવલિત દીપ્તિપૂર્ણ આલોકિત ઉજ્જવળ ઊજળું પ્રકાશિત કાંતિમાન તેજસ્વી સાફ સ્વચ્છ સિત અવદાત દેદીપ્યમાન ચમકદાર ચળકતું તેજવાળું ચમકવાળું પ્રકાશિત ઝકાઝક ઉજ્જવલ તેજદાર શુક્ર
चक्रम: મૂર્ખ મૂરખ અબૂધ અક્કલહીન ઠોઠ ગમાર બેવકૂફ બુદ્ધિહીન નાદાન મતિમંદ મૂઢ અબૂજ અજ્ઞાની બેસમજ અંધ કમઅક્કલ મૂઢમતિ મૂઢબુદ્ધિ અણસમજુ અલ્પબુદ્ધિ શીન અવિદ પામર ક્રોધી તામસી ઝક્કી મિજાજી માથાફરેલ પાગલ ગાંડો બાવરો
चक्रवर्ती: ચક્રવર્તી સમ્રાટ એકાધિપતિ સર્વેશ્વર સર્વેશ
चड: અનેક સંખ્યાબંધ બહુ એકાધિક વિવિધ ઘણી અનેકાનેક ખૂબ પુષ્કળ બહુ અતિ વિશેષ અત્યંત અતિશય વિપુલ અગાધ અપાર બેશુમાર બેહદ અસીમ
चड_काळाचें: ચિરકાલીન દીર્ઘકાલીન બદ્ધમૂલ
चड_कोडो: ખૂબ_કડવું બહુ_કડવું અતિ_કડવું અતિ_કટુ
चड_गरजेचें: જરૂરી અત્યાવશ્યક અપરિહાર્ય
चड_रागीश्ट: ઉગ્ર ઉચ્ચંડ આકરું અતિ_આવિષ્ટ અત્યુગ્ર
चतुर्भुजी: ચતુર્ભુજ
चतूर: સ્ફૂર્તિલું સ્ફૂર્તિવાળું તેજ ચુસ્ત અશિથિલ ચાલાક ચતુર કાબેલ હોશિયાર નિપુણ પ્રવીણ હોશિયાર કુશળ નિષ્ણાત સમજુ બુદ્ધિશાળી પ્રગલ્ભ આગર દક્ષ
चपळ: ચાલાક ચતુર કાબેલ હોશિયાર નિપુણ પ્રવીણ હોશિયાર કુશળ નિષ્ણાત સમજુ બુદ્ધિશાળી પ્રગલ્ભ આગર દક્ષ
चमचो: ચાપલૂસ ખુશામદિયું માખણિયું ચમચો અનુયાયી આશ્રિત
चमत्कारी: ચમત્કારી ચમત્કારિક ચમત્કારવાળું જાદૂઈ તિલિસ્માતી અદ્ભુત કરિશ્માઈ
चरबी_आशिल्लें: વસાયુક્ત ચરબીદાર મેદુર
चरबी_नाशिल्लें: અમેદસ્ક વસામુક્ત વસાહીન
चरबीहीण: અમેદસ્ક વસામુક્ત વસાહીન
चरबेचें: વસાયુક્ત ચરબીદાર મેદુર
चरित्रवान: સદ્ગુણી નીતિમાન શુદ્ધ_ચારિત્ર્યવાળું તત્ત્વનિષ્ઠ સુશીલ સગુણો ગુણકારી શિષ્ટાચારી સદાચારી સચ્ચરિત
चरित्रहीण: છિનાળ વ્યભિચારિણી જારિણી ચરિત્રહીન કુલટા ચરિત્રહીન ભ્રષ્ટાચારી આચારભ્રષ્ટ દુરાચારી વ્યભિચારી અનાચારી અપચારી દુશ્ચરિત્ર ભ્રષ્ટ નીતિભ્રષ્ટ બદચલન કુલક્ષણુ
चर्चीत: ચર્ચિત ચર્ચાયેલ ચર્ચેલું
चलणुकेंत_नाशिल्लो: અપ્રચલિત અપ્રયુક્ત આઉટ_ઓફ_ડેટ
चलणुकेची: પ્રચલિત ચાલુ અનાયત જારી રુઢ જારી
चलपी: ચલિત ચળેલું સ્થાનભ્રષ્ટ ગતિમાન ગતિમંત પદચર પાયદળ પ્યાદું પદચારી પાદચારી પગપાળું કામચલાઉ
चळवळें: વિદ્રોહી બાગી બંડખોર બળવાખોર રાજદ્રોહી ગદ્દાર
चांदीचें: રૂપેરી
चांद्र: ચાંદ્ર ચાન્દ્ર
चाबपी: કરડકણું કડકણું કરડુ કરડતું કાડૂ
चामटो: મક્ખીચૂસ કફનખસોટ કંજૂસ કૃપણ પાજી બખીલ લોભિયો મખ્ખીચૂસ સોમ રંક કુમુદ ચીકણું ચિંગૂસ
चामाराचें: ચમારી
चारशेंवीस: વિશ્વાસઘાતી દગલબાજ કપટી ધૂર્ત ચારસો_વીસ ફરેબી
चारित्र्यवान: સદ્ગુણી નીતિમાન શુદ્ધ_ચારિત્ર્યવાળું તત્ત્વનિષ્ઠ સુશીલ સગુણો ગુણકારી શિષ્ટાચારી સદાચારી સચ્ચરિત
चालंत: ગતિશીલ ગતિમાન ગતિવંત ગતિવાળું વેગીલું વેગવાળું ઝડપી ગતિવાળું ફરતું જંગમ ભમતું અસ્થિર ચંચળ અધ્રુવ હાલતું
चालाक: ચાલાક ચતુર કાબેલ હોશિયાર નિપુણ પ્રવીણ હોશિયાર કુશળ નિષ્ણાત સમજુ બુદ્ધિશાળી પ્રગલ્ભ આગર દક્ષ
चालू: ગતિશીલ ગતિમાન ગતિવંત ગતિવાળું વેગીલું વેગવાળું ઝડપી ગતિવાળું ફરતું જંગમ ભમતું અસ્થિર ચંચળ અધ્રુવ હાલતું ચલિત ચળેલું સ્થાનભ્રષ્ટ ગતિમાન ગતિમંત કામુક ઇચ્છુક વિષયી કામી લંપટ કામાસક્ત વિલાસી વિષયાસક્ત ભોગી કામચારી વ્યભિચારી કામકૂટ છિનાળવો અનુક અભિક અભીક
चाळीस: ચાલીસ ચાળીસ ૪૦ 40
चावपी: કરડકણું કડકણું કરડુ કરડતું કાડૂ
चिंतपाचें: ચિંતનીય વિચારણીય લક્ષ્ય વિચાર્ય ચિંત્ય અનુશીલનીય અવધેય
चिंताजनक: ચિંતાજનક ચિંતાજન્ય ગંભીર ચિંતાકુલ નાજુક ચિંતાગ્રસ્ત ચિંતાવશ ચિંતાશીલ
चिंताहीण: અવિચાર્ય અવિચારણીય અચિંતનીય
चिंतेबगरची: અવિચારિત અનૂહ અતર્કનીય અનૂહ અવિભાવિત
चिंतेस्त: ચિંતિત ચિંતાવાળું ફિકરવાળું ચિંતાગ્રસ્ત ફિકરમંદ
चिकित्सा: તબીબી વૈદ્યકીય મેડિકલ
चिकू: મક્ખીચૂસ કફનખસોટ
चिकू_मारवाडी: કંજૂસ કૃપણ પાજી બખીલ લોભિયો મખ્ખીચૂસ સોમ રંક કુમુદ ચીકણું ચિંગૂસ
चिकें: કમ થોડા જરા અલ્પ ન્યૂન તનિક લેશ આંશિક થોડું લગાર નાનું ઝીણું ટૂંકું ક્ષુદ્ર ક્ષુલ્લક પામર કતિપય અમુક
चिखलाचें: કીચડવાળું કાદવવાળું પંકિલ કાર્દમ
चिडचिडो: ચીઢિયું ચિડકણું ચિડિયેલ ચીડિયું ખિજાળ છાંછિયું તુંડ-મિજાજી અસહિષ્ણુ અસહનશીલ તુર્શ તુર્શ-મિજાજ
चिडिल्लें: પદદલિત અવમર્દિત પાદદલિત પામાલ
चिड्डयिल्लें: દમિત
चित्रमय: આબેહૂબ તાર્દશ
चित्रांकीत: ચિત્રાંકિત
चित्रायिल्लें: ચિત્રાંકિત
चित्रीत: ચિત્રાંકિત અંકિત ચિત્રિત અભિલક્ષિત ચિન્હિત વર્ણિત ચિત્રિત નિરૂપિત
चिन्हीत: અંકિત ચિત્રિત અભિલક્ષિત ચિન્હિત
चिरंजिवी: અજર ચિરયુવાન ચિરયૌવનપૂર્ણ જરારહિત
चिरंजीव: અમર ચિરંજીવ ચિરંજીવી અવિનાશી નિત્ય અક્ષર સનાતન કાળજિત મૃત્યુંજય અમર્ત્ય ચિરંજીવી લાંબા_આવરદાવાળું આયુષ્યમાન ચિરાયુ દીર્ઘાયુ શતશરદ દીર્ઘજીવી
चीनी: ચીની ચીનનું ચાઇનીઝ
चुकीची: અનુચિત અસંગત વિસંગત અયોગ્ય અઘટિત અજુગતું નામુનાસિબ ગેરવાજબી
चुरगळिल्ल्या: સંકુચિત આકુંચિત નિકુંચિત
चुलत: પિતરાઈ પિત્રાઈ પિતરાઈ પિત્રાઈ
चेंचिल्लें: પદદલિત અવમર્દિત પાદદલિત પામાલ
चेंचिल्लो: ખસિયલ ખસિયું ખસિયા ખસિયેલ ખસ્સી ખસી
चेंचूंक_नाशिल्लें: ખૂંટિયો આખલો
चेंपिल्लें: પદદલિત અવમર્દિત પાદદલિત પામાલ
चेडी: છિનાળ વ્યભિચારિણી જારિણી ચરિત્રહીન કુલટા
चेतन: સજીવ જીવિત જીવંત પ્રાણવાન ચેતન જાનદાર જીવધારી અમૃત જાનદાર પ્રાણમય
चेतनायुक्त: સજીવ ચેતન ચૈતન્ય ચેતનમય
चोरपी: ઉઠાઉગીર ઉચક્કો ઠગ લુચ્ચો બદમાશ
चौकोनी: ચતુષ્કોણ ચતુષ્કોણી ચોખૂણિયું ચતુષ્કોશી
चौदा: ચૌદ ૧૪ 14
छंदबद्द: અંત્યાનુપ્રાસ પ્રાસ
छंदबद्ध: આબદ્ધ નિબદ્ધ સંબદ્ધ બાંધેલું અમુક્ત બંધાયેલું પાબંધ અવિમુક્ત
छंदी: દુર્વ્યસની કુટેવી વ્યસની બંધાણી
छापिल्लें: મુદ્રિત છાપેલું છાપેલ
जंगम: જંગમ અસ્થાવર સચલ ચળ જંગમ અસ્થિર
जंगली: વન્ય જંગલી રાની વગડાઉ વનેરુ આરણ્ય આરણ્યક વનવાસી અરણ્યવાસી બનૈલા આટવિક જંગલી વનીય અરણ્યક જંગલી વનજાત વન્ય આરણ્યક અગ્રામ્ય વગડાઉ
जंतूनाशक: જંતુનાશક જંતુઘ્ન કૃમિઘ્ન
जखमी: ઘાયલ ઇજાગ્રસ્ત ક્ષત જખમી ઘવાયેલું આહત ઈજા_પામેલું
जगजयी: વિશ્વવિજયી વિશ્વવિજેતા દિગ્વિજયી જગવિજયી
जगजाहीर: જગજાહેર સર્વજ્ઞાત
जटाधारी: જટાધારી જટાધર
जड: ભારે વજનદાર વજની બોઝલ પીવર
जप_करपी: જપી જાપી
जपानाचो: જાપાની જાપાનીઝ
जपानी: જાપાની જાપાનીઝ
जप्त: જપ્ત ખાલસા કુર્ક
जप्पी: જપી જાપી
जबाबदार: બેજવાબદાર અનુત્તરદાયી ગેર-જિમ્મેદાર
जयी: સફળ કામયાબ કૃતાર્થ સિદ્ધ સાર્થક કૃતકૃત્ય સફળતા
जर्जर: મરણોન્મુખ મરણાસન્ન આસન્નમરણ મરણાંત મુમૂર્ષુ મુમૂર્ષ
जलस्थलचर: ઉભયચર જળ-સ્થળચર
जल्म_घेतिल्लें: જન્મેલું ઉત્પન્ન પ્રસૂત પ્રસૂન જનિત જાત સૂત
जल्म_घेवंकना_असो: અજન્મા અજાત અજ અજન અજન્મ અનાગત અયોનિ અનુત્પન્ન
जल्मल्लें: જન્મેલું ઉત્પન્ન પ્રસૂત પ્રસૂન જનિત જાત સૂત
जल्माक_आयिल्लें: જન્મેલું ઉત્પન્ન પ્રસૂત પ્રસૂન જનિત જાત સૂત
जल्मीत: જન્મેલું ઉત્પન્ન પ્રસૂત પ્રસૂન જનિત જાત સૂત
जल्मूक_नाशिल्लो: અજન્મા અજાત અજ અજન અજન્મ અનાગત અયોનિ અનુત્પન્ન
जांबळें: જાંબલી જામલી
जागरूक: જાગૃત જાગ્રત જાગતું સભાન જાગ્રર્તિ અનિદ્રિત અસુપ્ત જાગૃત સભાન ચૈતન્ય
जागृत: જાગૃત જાગ્રત જાગતું સભાન જાગ્રર્તિ અનિદ્રિત અસુપ્ત
जागे: જાગૃત સભાન ચૈતન્ય
जागें: જાગૃત જાગ્રત જાગતું સભાન જાગ્રર્તિ અનિદ્રિત અસુપ્ત
जाणकार: અનુભવી જાણકાર પરિપક્વ પાવરધું ઘડાયેલું કસાયેલું વિદ્વાન જ્ઞાનવાન પંડિત જ્ઞાની વિબુધ જ્ઞાતા વિદ્વત વેત્તા ભિજ્ઞ
जाणटी: વૃદ્ધા ઘરડી_સ્ત્રી ડોસી બૂઢ્ઢી
जाणटें: વૃદ્ધ ઘરડું વડીલ વધેલું જૈફ બુઢ્ઢું મોટેરું વયોવૃદ્ધ
जाणपी: બોધગમ્ય બોધ્ય જ્ઞેય જ્ઞાતવ્ય ગ્રાહ્ય અવગત અવધેય અભિમંતવ્ય
जाणा_आशिल्लें: ખબર અવગત જાણેલું જ્ઞાત પરિચિત વાકેફ પ્રતીત અવભાસિત
जाणाजाल्लें: ખબર અવગત જાણેલું જ્ઞાત પરિચિત વાકેફ પ્રતીત અવભાસિત
जातिभायरें: નાત_બહારનું અજાતિ અજાત જાતિચ્યુત
जाती_भितरलें: સજાતીય સ્વજાતિય સ્વજાતિ સવર્ણ નાતીલું
जाती_विशींचें: જાતીય કોમી
जातीचें: જાતીય કોમી
जातीवाचक: જાતિવાચક જાતિ-વાચક સંજ્ઞાવાચક
जापसालदार: બેજવાબદાર અનુત્તરદાયી ગેર-જિમ્મેદાર ઉત્તરદાયી જવાબદાર જોખમદારક જુમ્મેદાર જવાબગાર ઉત્તરદાયક જુમ્મેવાર જિમ્મેવાર જિમ્મેદાર
जाबाबदार: ઉત્તરદાયી જવાબદાર જોખમદારક જુમ્મેદાર જવાબગાર ઉત્તરદાયક જુમ્મેવાર જિમ્મેવાર જિમ્મેદાર
जाम: અશક્ત નિર્બળ અસમર્થ કમજોર માંદલું કમતાકાત દુર્બળ દૂબળું નબળું શક્તિહીન અકુશળ
जाम_जाल्लें: થાકેલું થકિત ક્લાંત પરિશ્રાંત થાક્યો-માંદો થાક્યો-હાર્યો
जायत्यो: અનેક સંખ્યાબંધ બહુ એકાધિક વિવિધ ઘણી અનેકાનેક
जाल्लें: કૃત નિષ્પન્ન નિષ્પાદિત બનેલું થયેલું ઘટિત સંવૃત્ત
जावन_गेल्लें: બનેલું થયેલું ઘટિત સંવૃત્ત
जासुसी: જાસૂસી છૂપી_બાતમી_લાવવાનું_કામ
जाहीर: અગોપનીય અગોપ્ય કથ્ય પ્રકાશ્ય અભિવ્યક્ત સ્પષ્ટ સ્ફુટ_કરેલું જાહેર પ્રકટ વ્યક્ત અભિવ્યંજિત જાહિર વિદિત
जिक्के: જેટલું
जिखिल्लें: જેય પરાભવ્ય જીતવા_યોગ્ય
जिज्ञासु: જિજ્ઞાસુ જિજ્ઞાસક જિજ્ઞાસાવાળું ઉત્સુક ઉત્કંઠાવાળું આતુર પ્રણવ
जितके: જેટલું
जितले: જેટલું
जितेंद्री: જિતેંદ્રિય ઇંદ્રિયજીત જિતેંદ્ર જિતાત્મા આત્મવશ નિયતેંદ્રિય સંયમી સંયમવાન
जितो: સજીવ જીવિત જીવંત પ્રાણવાન ચેતન જાનદાર જીવધારી અમૃત જાનદાર પ્રાણમય સજીવ ચેતન ચૈતન્ય ચેતનમય
जिद्दी: હઠી હઠીલું જિદ્દી જીદી અભિનિવેશી આગ્રહી મતાગ્રહી
जिवंत: સજીવ જીવિત જીવંત પ્રાણવાન ચેતન જાનદાર જીવધારી અમૃત જાનદાર પ્રાણમય
जिवघेणें: જીવલેણ પ્રાણઘાતક પ્રાણહારક કાતિલ ઘાતક પ્રાણાંતક
जिवनदान: સંજીવની જીવદાયી જીવનદાયી
जिवीत: સજીવ જીવિત જીવંત પ્રાણવાન ચેતન જાનદાર જીવધારી અમૃત જાનદાર પ્રાણમય
जिवो: સજીવ જીવિત જીવંત પ્રાણવાન ચેતન જાનદાર જીવધારી અમૃત જાનદાર પ્રાણમય સજીવ ચેતન ચૈતન્ય ચેતનમય
जुनें: જીર્ણ જરેલું જર્જર જર્જરિત
जुल्मी: અત્યાચારી અનાચારી આતતાયી નૃશંસ ક્રૂર જુલ્મી ઝાલિમ જુલમગાર ખૂંખાર ઉત્પીડક સંતાપક
जुवळीं: જોડિયા જોડકા યમલ બેલડું
जेझू_विशीं: ઈસુ_સંબંધી ઈસાઈ ઈસવી ઈસુના_ધર્મનું
जेवपाचें: ખાદ્ય ભોજ્ય આહાર્ય અશનીય ભક્ષ્ય
जेश्ठ: જ્યેષ્ઠ અગ્રજ વરિષ્ઠ અગ્રજન્મા અગ્રજાત મોટું પુરોજન્મા મોટા જયેષ્ઠ વડું
जैतवंत: જેય પરાભવ્ય જીતવા_યોગ્ય સફળ કામયાબ કૃતાર્થ સિદ્ધ સાર્થક કૃતકૃત્ય સફળતા
जोखिल्लें: જોખેલું માપિત માપેલું
जोडपें: દાંપત્ય દાંપત્યજીવન દંપતીપણું દંપતીભાવ લગ્નજીવન લગ્નસંબંધ
जोडिल्लें: સંલગ્ન લાગેલું વળગેલું ચોટેલું અનુલગ્ન અનુરાગી આસક્ત સંબદ્ધ જોડાયેલું યુક્ત સંબંધવાળું અનુવિદ્ધ જડેલું બેસાડેલું
ज्ञात: જાણીતું પ્રજ્ઞાત પરિજ્ઞાત વિજ્ઞાત
ज्ञानपूर्ण: જ્ઞાનમય જ્ઞાનપૂર્ણ જ્ઞાની ચિન્મય
ज्ञानमय: જ્ઞાનમય જ્ઞાનપૂર્ણ જ્ઞાની ચિન્મય
ज्ञानहीण: અજ્ઞાની જ્ઞાનહીન કમઅક્કલ અભણ અજાણ
ज्ञेय: બોધગમ્ય બોધ્ય જ્ઞેય જ્ઞાતવ્ય ગ્રાહ્ય અવગત અવધેય અભિમંતવ્ય
ज्वालामुखी: જ્વાળામુખીય
झगझगीत: પ્રકાશમાન તેજસ્વી તેજોમય પ્રકાશતું ઉજ્જવલ ઉજ્જવલિત દીપ્તિપૂર્ણ આલોકિત ભભકદાર ભપકાવાળું ચમકદાર
झगडपी: કર્કશા કંકાસિયણ વઢકણી ચંડી ચંડિકા
झगडाळ: કર્કશા કંકાસિયણ વઢકણી ચંડી ચંડિકા ઝઘડાળુ વઢકણું બાધકણું લડકણું લડકું કર્કશ કલહકારી કલહાર
झगडाळू: બળવાખોર બંડખોર તોફાની ફિસાદી હુલ્લડી બખેડાખોર કજિયાખોર
झगडूल: કર્કશા કંકાસિયણ વઢકણી ચંડી ચંડિકા
झगड्याचें: વિવાદાસ્પદ
झणझणीत: મક્કમ સશકત પ્રબળ તગડું
झांकपी: પ્રલાપી પ્રલાપક બકવાદી મગજચટ બહુબોલું બોલકણું દિમાગચટ
झिरझिरिल्ली: જીર્ણ જરેલું જર્જર જર્જરિત
झुंलपी: ડોલતું ઝૂલતું
झुजपी: ઝનૂની વીર્યવાન
झुजा_इत्सुक: યુદ્ધેચ્છુક યુદ્ધ_ઇચ્છુક યુદ્ધાર્થી યુદ્ધાતુર યુદ્ધોન્મત યુયુત્સુ
झुजारी: શૂરવીર યુધ્ધવીર રણવીર રણધીર રણશૂર લડવૈયો
झेंपें: મૂર્ખ મૂરખ અબૂધ અક્કલહીન ઠોઠ ગમાર બેવકૂફ બુદ્ધિહીન નાદાન મતિમંદ મૂઢ અબૂજ અજ્ઞાની બેસમજ અંધ કમઅક્કલ મૂઢમતિ મૂઢબુદ્ધિ અણસમજુ અલ્પબુદ્ધિ શીન અવિદ પામર
झेमें: મૂર્ખ મૂરખ અબૂધ અક્કલહીન ઠોઠ ગમાર બેવકૂફ બુદ્ધિહીન નાદાન મતિમંદ મૂઢ અબૂજ અજ્ઞાની બેસમજ અંધ કમઅક્કલ મૂઢમતિ મૂઢબુદ્ધિ અણસમજુ અલ્પબુદ્ધિ શીન અવિદ પામર
झेलाचें: બરફનું બરફવાળું બરફને_લીધે_પેદા_થતું
टकटक: અનિમેષ અપલક એકીટશે અનિમિષ નિર્નિમેષ
टकलू: ટકલાં કેશહીન
टकलो: ટકલો ટકો ગંજો ટકોમૂંડો ટક્કો વિકેશ
टणक: મજબૂત ઠોસ દૃઢ પાક્કું જબરદસ્ત જોરાવર જબરું જબરજસ્ત જબ્બર જબર અભંગુર અશિથિલ
टवटवीत: તાજુ અમ્લાન અશુષ્ક
टाळूं_येना: નિશ્ચિત નક્કી અટલ અવશ્યંભાવી ચોક્કસ અટળ અટ્ટલ અમિટ અબાધ્ય અનિવાર્ય અપરિહાર્ય
टिकाकार: નિંદક અપવાદક અપવાદી આક્ષેપી આક્ષેપક ગીબતખોર બદગો બદગોફતાર
टिकेसयतचें: સટીક ટીકાવાળું વિવરણવાળું ટીકા_સહિત
ठगो: લુચ્ચું લુચ્ચુંલફંગું બદમાશ ખંધું લફંગું દોંગું
ठिपक्यांचें: કાબરચીતરું કાબરચીતરૂં બહુરંગી કાબરચીત્રું રંગબેરંગી ચિત્રવિચિત્ર કાબરું શાર
डोलत: લથડિયાં_ખાતું લથડતું ડગમગતું
ढोंगी: પાખંડી ઢોંગી દંભી આડંબરી કપટી શઠ ધૂતારો ધ્વજિક
णव: નવ નૌ ૯ 9
णववें: નવમું નવમ ૯મું 9મું
तंत्रांविशींचें: તકનીકી ટૅક્નૉલૉજિકલ
तंत्राबगरचें: અપ્રાદ્યોગિક અતકનીકી ગેરતકનીકી
तंत्रीक: તકનીકી ટૅક્નૉલૉજિકલ
तकलेंतलें: કાલ્પનિક કલ્પિત અવાસ્તવિક કલ્પેલું ધારેલું કૃત્રિમ અયથાર્થ મિથ્યા ખોટું કલ્પનાશીલ મનસ્વી
तकलेचें: મગજનું ભેજાનું
तटवासी: તટવાસી
तटस्थ: તટસ્થ નિષ્પક્ષ નિરપેક્ષ અપક્ષ ત્રાહિત ઉદાસીન અપક્ષપાતી અનપેક્ષ નિર્પેક્ષ
तडी_वयलें: તટવર્તી તટીય
तड्डकी: અસત્યવાદી ખોટો અસત્યભાષી મિથ્યાભાષી મિથ્યાવાદી અસત્યસેવી ખોટાબોલું
तथाकथीत: નામનું કહેવાનું_જ તથાકથિત કહેવાતું દેખીતું ઉપલકિયું સ્વીકારેલું
तथ्यपूर्ण: પ્રમાણભૂત પ્રમાણિક વિશ્વાસપાત્ર આધારરૂપ પ્રમાણરૂપ સાબિતીરૂપ
तपाशिल्लें: અવલોકિત સમીક્ષિત જોયેલું તપાસેલું
तपासणी: તબીબી વૈદ્યકીય મેડિકલ
तयार: તૈયાર પરિપક્વ સજ્જ ઉપલબ્ધ
तयार_करूंक_नाशिल्लें: અરચિત અનિર્મિત અકૃત
तयार_केल्लें: રચિત નિર્મિત વિરચિત સૃષ્ટ કૃત સર્જિત પ્રણીત
तयार_जाल्लें: ઉત્પન્ન પેદા નીપજેલું પાક ઊપજેલું પ્રસૂત
तरबेज: તાલીમબદ્ધ કુશળ પ્રવીણ
तरातरांचें: વિવિધ બહુવિધ બહુ_પ્રકારનું બહુ_પ્રકારે અનેક_રીતે
तरेकवार: વિવિધ બહુવિધ બહુ_પ્રકારનું બહુ_પ્રકારે અનેક_રીતે
तरेकवार_रंगांचें: રંગબેરંગી રંગ-બેરંગી પચરંગી નવરંગી બહુરંગી શબલ
तर्क_नाशिल्लें: અતર્ક તર્કરહીત તર્કહીન અયુક્ત યુક્તિહીન
तर्कपुर्ण: તર્કપૂર્ણ તર્કયુક્ત તર્કસંગત યુક્તિપૂર્ણ યુક્તિયુક્ત
तर्कहीण: અતર્ક તર્કરહીત તર્કહીન અયુક્ત યુક્તિહીન અતર્કય તર્કાતીત તર્કાગમ્ય
तर्का_बगरचें: અતર્કય તર્કાતીત તર્કાગમ્ય
तर्काबगरचें: અતર્ક તર્કરહીત તર્કહીન અયુક્ત યુક્તિહીન
तांकीवंत: શક્તિશાળી બળવાન તાકતવર સબળ સશક્ત શક્તિવાન બલિષ્ઠ બળશાળી શક્તિમાન જબ્બર જબર જબરજસ્ત જબરદસ્ત જોરાવર જબરું બલવંત બળીયું અપરબલ શક્તિસંપન્ન ધુરંધર
तांतया_आकाराचो: અંડાકાર ઈંડાકાર ઇંડા_જેવું
तांत्रीक: જાદુગર
तांबडो: લાલ રાતું રોહિત સુર્ખ રક્ત-વર્ણ આરક્ત
तांबसो: લાલિમાયુક્ત રતાશ_પડતું
तांबूस: લાલિમાયુક્ત રતાશ_પડતું
ताकतिकेन: તીવ્ર વેગીલું તેજ દ્રુત ઉડતું
ताकतीक_करपी: ઉતાવળું આતુર અધીરૂં ધાંધલિયું ઉતાવલું હડબડિયું ઉતાવળિયું
ताचे_खेरीज: વધારાનું
ताचे_बगर: વધારાનું
ताचे_भायर: વધારાનું
ताचे_शिवाय: વધારાનું
ताजें: તાજું ગરમાગરમ તાજુંતમ
ताजो: તાજુ અમ્લાન અશુષ્ક
ताठ: અનત અનમિત
तापट: ક્રોધી ક્રુદ્ધ કુપિત રુષ્ટ ક્રોધિત ક્રોધયુક્ત ભામી ક્ષુબ્ધ ક્રોધી ક્રોધવાળું ગરમ_મિજાજી ચંડ જલાતન અમરખી
तापिल्लें: તપ્ત ઊનું તપેલું ગરમ તપુ પ્રતપ્ત
ताब्यांत: આધીન તાબે અધીન
तामसी: તામસી તામસિક તમોગુણી તામસ
तामसीक: તામસી તામસિક તમોગુણી તામસ
तारहीण: બેતાર બિનતારી વાયરલેસ
तारीख_सोंपिल्लें: કાલાતીત એક્સપાયરડ
तारे_बगरचें: બેતાર બિનતારી વાયરલેસ
तार्कीक: તર્કવાદી તાર્કિક તર્કગમ્ય તર્કસંગત
तार्‍याविणें: તારાવિહીન તારાહીન
ताळो: ઘટાદાર ડાળીદાર
तिकतीकपी: ચમક્તો દમક્તો ઉજ્જવલ રોશન ઝગમગ દીપ્ત પ્રકાશવાન દ્ર્યુતિમાન કાંતિમાન
तिक्ष्ण: તીક્ષ્ણ તીવ્ર કુશાગ્ર પ્રખર તેજ ઉગ્ર પ્રચંડ આકરૂં અકુંઠ અકુંઠિત
तिखट: ચટપટું તીખું તિક્ષ્ણ તેજ દાહક મરચાવાળું તીખુંતમતમ
तिगपी: ટકાઉ પાયદાર
तिगाय: ત્રણેય
तिबक्यांचें: કાબરચીતરું કાબરચીતરૂં બહુરંગી કાબરચીત્રું રંગબેરંગી ચિત્રવિચિત્ર કાબરું શાર
तिरंगी: ત્રિરંગી
तिरकटी: કટુભાષી કુભાષી
तिरसुवादीक: કટુભાષી કુભાષી
तिरायताचें: પારકું પરાયું બીજાનું ગેર પરકીય
तिव्र: તીક્ષ્ણ તીવ્ર કુશાગ્ર પ્રખર તેજ ઉગ્ર પ્રચંડ આકરૂં અકુંઠ અકુંઠિત તીવ્ર તેજ બુલંદ અસાધારણ
तीख: ચટપટું તીખું તિક્ષ્ણ તેજ દાહક મરચાવાળું તીખુંતમતમ
तीग: ત્રણેય
तीगजाण: ત્રણેય
तीन_कोनशांचे: ત્રિભૂજી
तीन_कोनांचे: ત્રિભૂજી
तीनरंगी: ત્રિરંગી
तुंबिल्लें: બંધિયાર સ્થિર મંદ જડ સ્થાયી નિઃસ્તબ્ધ
तुंबिल्लो: બંધ અવરુદ્ધ અટકાવેલું રોકેલું રુંધેલું
तुकुतुकू: અનિમેષ અપલક એકીટશે અનિમિષ નિર્નિમેષ
तुजें: તારું તમારું આપનું
तुटकें: ફાટું-તૂટું જીર્ણ જર્જરિત
तुटकें-फुटकें: ફાટું-તૂટું જીર્ણ જર્જરિત
तुमचें: તમારું આપનું
तुमचें.: તારું તમારું આપનું
तुल्य: તુલ્ય તુલનીય
तुश्ट: સંતોષી ધૈર્યશીલ ધીરજવાન ધીર
तुस्तेचें: પૂજ્ય અભિનંદિત વંદિત આદરણીય પૂજ્ય
तृप्त: તૃપ્ત સંતુષ્ટ પરિતુષ્ટ તોષિત તુષ્ટ અયાચ્ય છકાછક
तेंगशेचें: ઊંચું ઉચ્ચ ચડિયાતું ઉમદા બુલંદ મોટું ઉતુંગ પ્રાંશુ
तेजपूर्ण: તેજ તેજપૂર્ણ તેજોમય જાજરમાન દેદીપ્યમાન કાંતિમય કાંતિમાન પ્રકાશમાન દિવ્ય
तेजस्वी: તેજ તેજપૂર્ણ તેજોમય જાજરમાન દેદીપ્યમાન કાંતિમય કાંતિમાન પ્રકાશમાન દિવ્ય તેજસ્વી પ્રભાવી પ્રભાવશાળી તેજદાર દીપ્તિમાન પ્રતિભાશાળી તેજવંત તેજવાન કાંતિવાન
तेजहीण: નિસ્તેજ તેજહીન તેજોહીન ઝાંખું ફીકું પ્રભાહીન આભાહીન મુરઝાયેલું અપ્રભ
तेमकाचें: ઊંચું ઉચ્ચ ચડિયાતું ઉમદા બુલંદ મોટું ઉતુંગ પ્રાંશુ
तोंकाचें: ઊંચું ઉચ્ચ ચડિયાતું ઉમદા બુલંદ મોટું ઉતુંગ પ્રાંશુ અણીદાર તીણું તીક્ષ્ણ તેજ અણિયાળું ભેદક
तोंकाळ: કાંટાદાર અણીદાર ફાંસ અણીદાર તીણું તીક્ષ્ણ તેજ અણિયાળું ભેદક
तोंडा_वयलें: નજીકનું આસન્ન સંનિક્ટ
तोंप्पी: કાંટાદાર અણીદાર ફાંસ
तोखणायेचे: પ્રશંસનીય પ્રશસ્ય પ્રશંસાપાત્ર પ્રશંસાયોગ્ય સરાહનીય ધન્ય અભિનંદનીય અભિનંદ્ય અભિવંદનીય પ્રશસ્ય સ્તુત્ય શ્લાઘ્ય સ્તુતિપાત્ર શ્લાઘનીય પ્રશસ્ત અભિવંદનીય
तोखणायेचें: પૂજ્ય અભિનંદિત વંદિત આદરણીય પૂજ્ય
त्याज्य: ત્યાજ્ય વર્જ્ય વર્જનીય હેય તજવા_યોગ્ય છોડી_દેવા_લાયક
त्रस्त: ત્રસિત ત્રસ્ત પીડિત મજલૂમ ઉત્પીડિત દુ આર્ત
त्रासदिणी: દુ આપત્તિવાળું આપત્તિજનક દુ દુઃખકારક કષ્ટદાયક કષ્ટકારક તોદ
त्रासदिणें: દુ દુ દુ પીડાકારક પીડાકારી કષ્ટકારક કષ્ટકર કષ્ટપ્રદ કષ્ટજન્ય કષ્ટદાયક પીડાદાયક
त्रासाची: દુ દુઃખી કષ્ટપૂર્ણ દુઃખદાયી
त्रासिल्लो: ત્રસિત ત્રસ્ત પીડિત મજલૂમ ઉત્પીડિત દુ આર્ત
त्रासीक: દુ દુઃખવાળું દુખિયું પીડિત વ્યથિત દુઃખિત દુ પીડાયેલું કચવાયેલું આર્ત રંજીદા ખિન્ન ગમગીન દિલગીર
त्रिकोनी: ત્રિભૂજી
त्रिबुनालीन: ન્યાયવિષયક અદાલતી ઇન્સાફી
त्वचेचो: ત્વચા ચર્મ ચામડી
थंड: સૌમ્ય સુશીલ શાંત સૌમ્ય સુશીલ શાંત સાલસ સુજન સજ્જન ગંભીર ધીર ઠરેલ શાંત સૌમ્ય અચંચળ સ્થિર દૃઢ અડગ સહનશીલ મંદ શીતળ ઠંડું શીતલ ટાઢું શીત અનુષ્ણ અતપ્ત ઠંડું શીતળ ટાઢું ઠંડું શમિત શાંત ઠંડું ટાઢું શાંત શીતલ ટાઢું ઠંડું શાંતિપૂર્ણ શાંતિમય
थकिल्लें: થાકેલું થકિત ક્લાંત પરિશ્રાંત થાક્યો-માંદો થાક્યો-હાર્યો
थकूंक_नाशिल्लें: અક્લાંત અવિશ્રાંત અથાક
थपकटें: સમતલ સમતળ સપાટ બરાબર હમવાર લેવલ
थरथरपी: આકંપિત ધ્રૂજતું થરથરિત
थरांचें: પરતદાર સ્તરયુક્ત
थरावीक: સીમિત સીમાબદ્ધ મર્યાદિત નિયત નિર્ણીત મર્યાદાવાળું હદવાળું
थरिल्ली: નિર્ણીત નિપટેલું નક્કી જ્ઞાપિત
थळावीक: સ્થાનિક સ્થાનીય પ્રાદેશિક તળપદું આંચલિક
थळीय: સ્થળજ સ્થળચર ભૂમિજ સ્થળીય જમીની ધરાતલીય ધરાતલી
थांबिल्ली: સ્થિર અચલિત અગતિ અયાન
थायां_पडपी: દ્રશ્ય દૃશ્યમાન દૃષ્ટિગોચર દેખાતું દીસતું વ્યક્ત દૃશ્ય દેખીતું
थारनासतना: અવિરત સતત અવિશ્રાન્ત ચાલુ નિરંતર લગાતાર અશ્રાંત
थारायिल्लें: નિશ્ચિત નિર્ધારિત નિયત નિયમિત નિર્દિષ્ટ
थारायिल्ल्या: સીમાવાળું સીમાબદ્ધ મર્યાદિત સીમાયુક્ત પરિમિત
थिकाळ: ડાઘવાળું દાગદાર
थिरप्रतीज्ञ: દૃઢપ્રતિજ્ઞ પ્રતિજ્ઞાનિષ્ઠ
थीर: અડગ અવિચલિત સ્થિર અચળ દૃઢ અશિથિલ ગંભીર ધીર ઠરેલ શાંત સૌમ્ય અચંચળ સ્થિર દૃઢ અડગ સહનશીલ મંદ અટલ અટળ અટ્ટલ દૃઢ અડગ સ્થિર કાયમ અવિચલ અનત અનમિત સ્થાવર અચલ સ્થિર
थीर_चित्ताचो: સ્થિરચિત્ત શાંત સ્થિર પ્રશાંત અચંચલ ધીર ગંભીર અમત્ત
थीर_मताचें: દૃઢનિશ્ચયી દૃઢમત મતાગ્રહી
थोक: થોકબંધ જથ્થાબંધ સામટું થોક
थोडे_भितर: સંક્ષિપ્ત ટૂકું
थोडें: કમ થોડા જરા અલ્પ ન્યૂન તનિક લેશ આંશિક થોડું લગાર નાનું ઝીણું ટૂંકું ક્ષુદ્ર ક્ષુલ્લક પામર કતિપય અમુક
थोडें_उलोवपी: અલ્પભાષી મિતભાષી ઓછાબોલું થોડાબોલું કમબોલ
थोडोसो: થોડું ઓછું અલ્પ ન્યૂન
दंग: વ્યસ્ત
दणकट: કસાયેલું ઘડાયેલ સુગઠિત ચુસ્ત
दणकेबाज: જોરદાર ધુંઆધાર ધમાકેદાર
दबदबीत: રગડા_જેવું
दयाळू: દયાળુ દયાવાન કરુણાળુ કૃપાળુ કરુણાવંત મહેરબાન માયાળુ દયાવંત કરુણામય કરુણાત્મક દયામય અનુકંપામય કરુણાવાન સહ્રદય સહ્રદયી દયાશીલ કરુણાસાગર અનુગ્રાહ
दयेस्त: દયાળુ દયાવાન કરુણાળુ કૃપાળુ કરુણાવંત મહેરબાન માયાળુ દયાવંત કરુણામય કરુણાત્મક દયામય અનુકંપામય કરુણાવાન સહ્રદય સહ્રદયી દયાશીલ કરુણાસાગર અનુગ્રાહ
दर: પ્રત્યેક એકેએક હરેક દરેક બધા_જ
दर_एक: પ્રત્યેક એકેએક હરેક દરેક બધા_જ
दर्शनीय: દર્શનીય આલોકનીય વિલોકનીય પ્રેક્ષણીય દ્રશ્ય જોવા_લાયક લક્ષ્ય અભિલક્ષ્ય અદર્શનીય કૂબડું
दलीत: પદદલિત દલિત પાયમાલ પદક્રાંત દલિત અશક્ત નિર્બળ
दळडिरो: નિર્ધન ગરીબ દીન અકિંચન કંગાલ દરિદ્ર રાંક અસમૃદ્ધ અસંપન્ન દીનહીન બિચારું મુફલિસ ધનહીન રંક બેહાલ તંગહાલ વિધન નિધની દલિત અશક્ત નિર્બળ
दळिद्रो: નિર્ધન ગરીબ દીન અકિંચન કંગાલ દરિદ્ર રાંક અસમૃદ્ધ અસંપન્ન દીનહીન બિચારું મુફલિસ ધનહીન રંક બેહાલ તંગહાલ વિધન નિધની
दांडगट: કસાયેલું ઘડાયેલ સુગઠિત ચુસ્ત
दांत_नाशिल्लो: અદંત નીરદ અરદ અરદન બોખું દાંતરહીત પોપલા અપુરોદંત
दांतयाळी: દાંતવું દાંતરું દંતુ દંતી દંતુર દંતુરિત
दांतोळी: દાંતવું દાંતરું દંતુ દંતી દંતુર દંતુરિત
दांपत्य: દાંપત્ય દાંપત્યજીવન દંપતીપણું દંપતીભાવ લગ્નજીવન લગ્નસંબંધ
दागाळ: ડાઘવાળું દાગદાર
दाट: ગીચ ગાઢ ખીચોખીચ ભરચક ઘન ગીચ સઘન ગીચોગીચ ઘટ્ટ ઘાટું જાડું
दातयाळें: દાંતેદાર
दातरांचें: દાંતેદાર
दादलेपणाचें: પુરુષોચિત મરદાની મરદોનું નરજાતિનું મર્દાના મરદાના વીરતા_ભરેલું
दादलो: નર
दादल्यां_संबंदीं: પુરુષોચિત મરદાની મરદોનું નરજાતિનું
दानवीर: દાનવીર દાનેશરી દાન_કરવામાં_શૂરો_માણસ
दानशूर: દાનવીર દાતા દાની ઉદાર દાનેશરી દાનેશ્વરી દાનશીલ કરીમ દરિયાદિલ ઉદાત્ત દાનવીર દાનેશરી દાન_કરવામાં_શૂરો_માણસ
दानी: દાનવીર દાતા દાની ઉદાર દાનેશરી દાનેશ્વરી દાનશીલ કરીમ દરિયાદિલ ઉદાત્ત દાનવીર દાનેશરી દાન_કરવામાં_શૂરો_માણસ
दिखावटी: બનાવટી દેખાવટી ઉપરછલ્લું ઉપર_ઉપરથી સહેજ_સાજ દેખાવ-ડોળ ઔપચારિક ઉપચાર_પૂરતું
दिखावू: વ્યવસ્થિત નવું_નક્કોર ભભકાદાર સજીલું સજધજ છેલછબીલા રંગીલું અલબેલું ફાંકડું
दिग्गज: દિગ્ગજ દિગ્ગજ પ્રકાંડ મહાન પ્રકાણ્ડ મહા પ્રખર બહુ_મોટો
दिनवाशी: કૃતજ્ઞ નિમકહલાલ અહસાનમંદ આભારી ઉપકૃત
दिल्लें: ઉપ્લબ્ધ પ્રાપ્ત મેળવેલું મળેલું હાથવગુ સુલભ હસ્તપટુ આપેલું પ્રદત્ત અર્પિત
दिवंगत: મૃત મૂએલું મૃતક મુડદું શબ વૈકુંઠવાસી પરલોકવાસી સ્વર્ગવાસી સ્વર્ગીય સ્વર્ગસ્થ મરહૂમ દિવંગત અપગત
दिवपाचें: લેણું માગણું આદેય
दिवाळखोर: નાદાર દેવાળું દામાસાહ
दिव्य: અલૌકિક પરલોકનું પરલોકીય દિવ્ય અમાનુષી લોકોત્તર અમાનુષિક
दिश्टी_पडपी: દ્રશ્ય દૃશ્યમાન દૃષ્ટિગોચર દેખાતું દીસતું વ્યક્ત દૃશ્ય દેખીતું
दिसपी: દ્રશ્ય દૃશ્યમાન દૃષ્ટિગોચર દેખાતું દીસતું વ્યક્ત દૃશ્ય દેખીતું
दिसाळें: રોજ દરરોજ દૈનિક
दीन: દયનીય દયાપાત્ર દયાજનક
दीनदयाळू: દીનદયાલુ દીનદયાલ
दीर्घ_काळाचें: ચિરકાલીન દીર્ઘકાલીન બદ્ધમૂલ
दुकाळिल्लो: અશ્રુપૂર્ણ સજલ આંસુવાળું સાશ્રુ આંસુથી_ભરેલું
दुखदिणें: દુ દુ દુ પીડાકારક પીડાકારી કષ્ટકારક કષ્ટકર કષ્ટપ્રદ કષ્ટજન્ય કષ્ટદાયક પીડાદાયક
दुखापती_बगरचे: અક્ષત અનાહત ક્ષતિહીન
दुखावल्लें: ઘાયલ ઇજાગ્રસ્ત ક્ષત જખમી ઘવાયેલું આહત ઈજા_પામેલું
दुख्खदिणी: દુ આપત્તિવાળું આપત્તિજનક દુ દુઃખકારક કષ્ટદાયક કષ્ટકારક તોદ
दुख्खहीण: શોકરહિત શોકહીન વિશોક અશોક અવસાદહીન નિરવસાદ
दुख्खाची: દુ આપત્તિવાળું આપત્તિજનક દુ દુઃખકારક કષ્ટદાયક કષ્ટકારક તોદ દુ દુઃખી કષ્ટપૂર્ણ દુઃખદાયી
दुख्खी: શોકગ્રસ્ત શોકાતુર શોકાકુલ શોકાવિષ્ટ માતમી દુ દુઃખવાળું દુખિયું પીડિત વ્યથિત દુઃખિત દુ પીડાયેલું કચવાયેલું આર્ત રંજીદા ખિન્ન ગમગીન દિલગીર કષ્ટમય દુ વિપન્ન વિપદ્ગ્રસ્ત કાતર કષ્ટપ્રદ
दुडवांकार: ધનાઢ્ય ધની અમીર ધનવાન માલદાર ધનવંત દોલતમંદ વૈભવશાળી વૈભવશાલી વૈભવવાળું સંપન્ન માલામાલ સમૃદ્ધ ઐશ્વર્યવાન સંપત્તિવાન ખુશહાલ પૈસાદાર બહુધન જરદાર
दुदाचें: દૂધનું દૂધિયું દૂધવાળું દૂધયુક્ત
दुदारू: દુધાળું દુજણું દુધાળ દૂધિયું દુધેલ
दुदाळ: દૂધનું દૂધિયું દૂધવાળું દૂધયુક્ત દૂધિયું
दुदाहारी: પૈહારી દુગ્ધાહારી
दुबळें: કમજોર દુર્બળ દુર્બળ નિર્બલ નિર્બળ અબલ અપ્રબલ બલહીન અવીર અસક્ત અસહાય લાચાર પરાધીન નિરાશ્રય શક્તિહીન અલ્પબલ અવીર નામર્દ
दुबळो: અશક્ત નિર્બળ અસમર્થ કમજોર માંદલું કમતાકાત દુર્બળ દૂબળું નબળું શક્તિહીન અકુશળ
दुबावा_बगरचो: અસંદિગ્ધ શંકારહિત
दुबावा_विरयत: અસંદિગ્ધ શંકારહિત નિ અસંશયી સંશયરહિત સંશયહીન નિ છૂટથી સંકોચ_રહિત બેધડક અનિભૃત નિ શંકાહીન સંદેહહીન
दुबावीत: આશંકિત સશંક આશંકાપૂર્ણ ફિકરમંદ સંદિગ્ધ ભ્રામક સંદેહયુક્ત અસ્પષ્ટ સંશયાત્મક સંદિગ્ધ સંદેહયુક્ત શકમંદ સંશયગ્રસ્ત શંકિત
दुभती: દુધાળું દુજણું દુધાળ દૂધિયું દુધેલ
दुयेंती: રોગી બીમાર માંદું અસ્વસ્થ આજારી રોગવાળું રોગિષ્ઠ રોગિયું રુગ્ણ આર્ત
दुरदर्शिकायहीण: અલ્પદૃષ્ટિ અદૂરદર્શી અલ્પદર્શી અદૂરદૃષ્ટિ અદીર્ઘદૃષ્ટિ
दुरदर्शी: દૂરદર્શી દીર્ઘદ્રષ્ટા દૂરદૃષ્ટિવાળું દીર્ઘદર્શી અગમબુદ્ધિ દુરંદેશી
दुर्गूण: દુર્ગુણી દુર્ગુણથી_ભરેલુ દુર્ગુણવાળું અગુણી અવગુણવાળું
दुर्जन: દુષ્ટ અધમ નઠારું અધમ પાપી ખરાબ પામર નીચ હલકટ ખલ શઠ ધૂર્ત
दुर्दशाग्रस्त: બેહાલ દુર્દશાગ્રસ્ત ભૂંડાહાલ ફટેહાલ ફટીચર
दुर्भागी: અભાગી દુર્ભાગી કમનસીબ મનહૂસ બદકિસ્મત દુર્ભાગ્યશાળી મંદભાગ્ય અલ્પભાગ્ય
दुर्मीळ: કઠિન અઘરું દુર્ગમ અગમ દુર્ગમ્ય અનાગમ્ય અગત દુર્લભ મુશ્કેલ અઘરૂં મળવું_મુશ્કેલ દુષ્પ્રાપ અપ્રાપ્ય અસુલભ અલભ્ય
दुर्वेव्हारी: દુર્વ્યવહારી દુર્વર્તનશીલ અસદાચારી અશીલ શીલરહિત અશીલવાન
दुश्ट: દુષ્ટ અધમ નઠારું અધમ પાપી ખરાબ પામર નીચ હલકટ ખલ શઠ ધૂર્ત દુષ્ટ દુરાત્મા પાપી દુષ્ટાત્મા પાપબુદ્ધિ પાપિયું નઠારું અધમ હલકટ પાપાશય
दुसरे_जातीचें: વિજાતીય વિજાતિ પરજાતીય ભિન્ન_જાતીય
दुसर्‍यांचेर_आदारून: પરાશ્રયી પરાધીન પરાવલંબી પરવશ પરાશ્રિત અનુજીવી
दुसर्‍यांच्या_कुडक्यांचेर_जगपी: આશ્રિત ઓશિયાળું
दुसर्‍यांच्या_जिवार_जगपी: આશ્રિત ઓશિયાળું
दुसर्‍याचें: પારકું પરાયું બીજાનું ગેર પરકીય
दुस्मानकेचो: વેરભર્યુ શત્રુતા અદાવત અટસ_ઘૃણા
दुस्मानहीण: અજાતશત્રુ શત્રુહીન શત્રુવિહીન અરિહીન અભૂતશત્રુ
दुस्मानी: શત્રુપૂર્ણ શત્રુયુક્ત
दुस्वाशी: ઘૃણાશીલ જુગુપ્સાકર દુષ્ટ અધમ નઠારું અધમ પાપી ખરાબ પામર નીચ હલકટ ખલ શઠ ધૂર્ત
दुस्वासी: ઉપેક્ષક
दूझ: બાર ડઝન ડઝનબંધ ૧૨ 12
दूर: દૂર દૂરસ્થ દૂરવર્તી દૂરસ્થિત છેટું આઘું વેગળું
दृढ: અટલ અટળ અટ્ટલ દૃઢ અડગ સ્થિર કાયમ અવિચલ
दृश्टियुक्त: દૃષ્ટિવંત દૃષ્ટિમાન
दृश्टिहीण: આંધળું અંધ નેત્રહીન અંધું અક્ષહીન અચક્ષુ અનયન દૃષ્ટિહીન
देंवतें: ઓછો મંદ અવનત નરમ નીચું કમ
देंवयिल्लें: પદભ્રષ્ટ પદચ્યુત નિલંબિત બરખાસ્ત અનુલંબિત
देखणें: સુંદર ખૂબસૂરત રૂપાળું મનોહર સુશોભિત મોહક મજેનું દેખાવડું કૂટડું રળિયામણું લલિત રૂપવાન રૂપવંત મનહર કમનીય પાકીઝા છબીલું સોહન અભિજાત સુડોલ અભિરૂપ લાવણ્યમય
देगे_वयलें: તટવર્તી તટીય
देगेचें: પાસેનું નજીકનું જોડેનું સમીપનું નિકટતમ નિકટતર નિકટવર્તી સમીપી સંનિકટ સમીપવર્તી સન્નિહિત લગોલગ નિકટસ્થ આસન્ન
देणें: લેણું માગણું આદેય
देण्याचें: આપવા_લાયક દેય આપવા_યોગ્ય પ્રદેય
देवादेणें: ઇશ્વરપ્રદત્ત પ્રભુપ્રદત્ત
देवासूर: દેવાસુર
देशद्रोही: દેશદ્રોહી રાષ્ટ્રદ્રોહી
देशी: દેશી દેસી સ્વદેશી મુલ્કી
देशी.: સ્વદેશી દેશી દેશીય દેશજ
दैववादी: ભાગ્યવાદી પ્રારબ્ધવાદી દૈવવાદી
दैवी: ઈશ્વરીય ઈશ્વરી દૈવી દિવ્ય અલૌકિક પરમેશ્વરી ઇલાહી દૈવી દેવતાઈ દિવ્ય અલૌકિક અમાનુષ સુરીય
दोंगराळ: પહાડી પર્વતવાસી પર્વતીય પર્વતી
दोन_माळ्यांचें: બેમાળિયું બેમજલું
दोन_हाताचें: બેહત્થુ બેહથ્થુ
दोननाळी: બેનાળી દોનલી દુનાલી દુનલી
दोनभुजी: દ્વિભુજ દ્વિબાહુ દ્વિભુજા
दोनमाळी: બેમાળિયું બેમજલું
दोनवर्सुकी: દ્વિવર્ષી દ્વિવર્ષીય
दोळ्याचें: આંખનું નેત્રીય ચક્ષુષ્ય
दोशमुक्त: આરોપ-મુક્ત બરી મુક્ત આઝાદ
दोशी: અપરાધી ગુનેગાર દોષી કસૂરવાર કસૂરદાર ખરાબ નિંદનીય નિંદ્ય નિંદાત્મક અપ્રશંસનીય અશ્લાધ્ય
द्रव: પ્રવાહી દ્રવ્ય તરલ
द्राक्षा_भशेन: અંગુરી
द्राक्षांचें: અંગૂરી
द्राक्षाच्या_रंगाचें: અંગુરી
द्राक्षाळ: અંગુરી
द्विधाग्रस्थ: મૂંઝવણ_ભરેલું મૂંઝવણયુક્ત દુવિધાગ્રસ્ત કિંકર્તવ્ય-વિમૂઢ
द्विवर्शी: દ્વિવર્ષી દ્વિવર્ષીય
धंदेकार: વ્યવહારુ દુનિયાદાર વ્યવહાર_કુશળ
धंद्याचें: વ્યાપારિક વ્યાપારિય વાણિજ્યિક વ્યવસાયિક પેશાવર
धडधाकट: કસાયેલું ઘડાયેલ સુગઠિત ચુસ્ત હૃષ્ટપુષ્ટ તગડો હટ્ટો-કટ્ટો તંદુરસ્ત પુષ્ટ પૃથુલ ભારેખમ
धडपडो: ઉપદ્રવી ઉપદ્રવકારી ઉત્પાતી બદમાશ દંગાબાજ
धडाकेबाज: જોરદાર ધુંઆધાર ધમાકેદાર
धनलोभी: ધનલોભી ધનલોલુપ ધનપિચાશ અર્થલોલુપ ધનલાલચી
धनवान: ગુણી
धनसुवार्थी: ધનલોભી ધનલોલુપ ધનપિચાશ અર્થલોલુપ ધનલાલચી
धनी: ગુણી ધનાઢ્ય ધની અમીર ધનવાન માલદાર ધનવંત દોલતમંદ વૈભવશાળી વૈભવશાલી વૈભવવાળું સંપન્ન માલામાલ સમૃદ્ધ ઐશ્વર્યવાન સંપત્તિવાન ખુશહાલ પૈસાદાર બહુધન જરદાર
धन्य: કૃતજ્ઞ કૃતકૃત્ય
धन्यवादी: કૃતજ્ઞ નિમકહલાલ અહસાનમંદ આભારી ઉપકૃત
धर्म_मानपी: ધર્મ_પાળનારું ધર્મપરાયણ ધર્મલક્ષણ_ધરાવનાર
धर्मगिन्यानी: ધર્મજ્ઞ ધર્મજ્ઞાની ધર્મવિદ ધર્મશાસ્ત્રી
धर्मज्ञानी: ધર્મજ્ઞ ધર્મજ્ઞાની ધર્મવિદ ધર્મશાસ્ત્રી
धर्मनिरपेक्ष: ધર્મનિરપેક્ષ બિનસાંપ્રદાયિક બિનમજહબી ધર્મતટસ્થ
धर्मनिश्ट: ધાર્મિક ધર્મશીલ ધર્મવાળું પુણ્યાત્મા ધર્મનિષ્ઠ ધર્મિષ્ઠ ધર્મવાન ધર્માત્મા ધર્મી ધર્મ-પરાયણ
धर्मवीद: ધર્મજ્ઞ ધર્મજ્ઞાની ધર્મવિદ ધર્મશાસ્ત્રી
धर्मशास्त्री: ધર્મજ્ઞ ધર્મજ્ઞાની ધર્મવિદ ધર્મશાસ્ત્રી
धर्मालंबी: ધર્મ_પાળનારું ધર્મપરાયણ ધર્મલક્ષણ_ધરાવનાર
धर्मावलंबी: ધર્મ_પાળનારું ધર્મપરાયણ ધર્મલક્ષણ_ધરાવનાર
धर्मिक: ધાર્મિક ધર્મશીલ ધર્મવાળું પુણ્યાત્મા ધર્મનિષ્ઠ ધર્મિષ્ઠ ધર્મવાન ધર્માત્મા ધર્મી ધર્મ-પરાયણ
धर्मिश्ठ: ધર્મ_પાળનારું ધર્મપરાયણ ધર્મલક્ષણ_ધરાવનાર
धर्मीक: ધર્મ_પાળનારું ધર્મપરાયણ ધર્મલક્ષણ_ધરાવનાર આધ્યાત્મિક ધાર્મિક પવિત્ર દિવ્ય
धवें: સફેદ શ્વેત ધવલ ધોળું ઉજ્જવલ ઊજળું રજત સિત શુક્લ શુભ્ર શિતિ અવદાત
धवो: ગોરું ગૌરવર્ણું શ્વેત ધોળુ અવદાત ઉજળુ ગોરુંગફ
धांपिल्लो: ઢંકાયેલું આચ્છાદિત છવાયેલું સંતાડેલું ઢાંકેલું સંવૃત આવૃત આવરેલું અપિહિત
धांवडायिल्लें: પદભ્રષ્ટ પદચ્યુત નિલંબિત બરખાસ્ત અનુલંબિત
धांवडायिल्लो: નિર્વાસિત રેફ્યુજી
धाकलो: અનુજ અનુજન્મા કનિષ્ઠ લઘુ
धाडशी: ધૈર્યશીલ ધૈર્યવાળું ધૈર્યવાન શાંત ધીર ધીરજવાન સાહસિક સાહસી હિમ્મતબાજ હિંમતવાન દિલચલા દિલાવર પ્રગલ્ભ ઉત્સાહી હિંમતવાન શૂર છાતીવાળું
धाडिल्लें: પ્રેષિત મોકલેલું સંપ્રેષિત
धातूचें: ધાત્વિક ધાતુઈ
धात्वीय: ધાત્વિક ધાતુઈ
धादोशी: સંતોષી ધૈર્યશીલ ધીરજવાન ધીર
धादोस: તૃપ્ત સંતુષ્ટ પરિતુષ્ટ તોષિત તુષ્ટ અયાચ્ય છકાછક
धार_आशिल्लें: ધારદાર તીક્ષ્ણ તીણું ધારાલ શિત
धार_गेल्लें: બુઠ્ઠું બૂઠું કુંઠિત ખાંડું અતીક્ષ્ણ
धार_पडिल्लें: બુઠ્ઠું બૂઠું કુંઠિત ખાંડું અતીક્ષ્ણ
धारदार: ધારદાર તીક્ષ્ણ તીણું ધારાલ શિત
धारेचें: ધારદાર તીક્ષ્ણ તીણું ધારાલ શિત
धार्मीक: આધ્યાત્મિક ધાર્મિક પવિત્ર દિવ્ય
धिरिश्ट: ધૈર્યશીલ ધૈર્યવાળું ધૈર્યવાન શાંત ધીર ધીરજવાન
धीट: ધૈર્યશીલ ધૈર્યવાળું ધૈર્યવાન શાંત ધીર ધીરજવાન સાહસિક સાહસી હિમ્મતબાજ હિંમતવાન દિલચલા દિલાવર પ્રગલ્ભ ઉત્સાહી હિંમતવાન શૂર છાતીવાળું
धील: શિથિલ ઢીલા
धुंवरट: ધૂંધળું ધૂમિલ
धुंवराळ: ઝાંખું ધૂંધળું અસ્પષ્ટ
धुंवरें: ધૂંધળું ધૂમિલ
धुंवसर: ધૂંધળું ધૂમિલ
धुक्याचें: ઝાંખું ધૂંધળું અસ્પષ્ટ
धुगधुगीत: ઊનું કવોષ્ણ નવશેકું થોડું_ગરમ
धैर्यहीण: અધીરૂં આકળું અધૈર્યવાન ધૈર્યહીન
धोणूधारी: ધનુર્ધર ધનુર્ધારી ધનુષધારી બાણાવળી તીરંદાજ શારંગધારી ધનુર્ગ્રહ ધન્વી ધાનક ધાનકી ધાનુક કમનૈત
धोदेल: જાડો સ્થૂળ સ્થૂળકાય ભારે ધીંગો પીવર
धोनयो: ખાઉધરું ભુખ્ખડ અત્યાહારી અતિભોજી ઉદર_પિશાચ
धोलत: લથડિયાં_ખાતું લથડતું ડગમગતું
धोलपी: હલતું હાલતું-ડોલતું ડોલાયમાન આંદોલિત ડોલતું ઝૂલતું
ध्यानमग्न: ધ્યાનમગ્ન ધ્યાની ધ્યાનસ્થ ધ્યાનનિષ્ઠ
ध्यानहीन: બેધ્યાન ધ્યાનહીન
ध्यानी: ધ્યાની ધ્યાનરત ધ્યાનમગ્ન ધ્યાનમગ્ન ધ્યાની ધ્યાનસ્થ ધ્યાનનિષ્ઠ
ध्यानेस्त: ધ્યાનમગ્ન ધ્યાની ધ્યાનસ્થ ધ્યાનનિષ્ઠ
न_फेडी_सारकें: અદેય
नकल_करपी: નકલખોર અનુકરણકાર નકલી અનુહારી અનુહારક
नकली: બનાવટી નકલી કૃત્રિમ અપ્રાકૃતિક અપ્રકૃત અસ્વાભાવિક_આહાર્ય વ્યવસ્થિત નવું_નક્કોર ભભકાદાર સજીલું સજધજ છેલછબીલા રંગીલું અલબેલું ફાંકડું નકલખોર અનુકરણકાર નકલી અનુહારી અનુહારક
नकारात्मक: નકારાત્મક નકારવાળું નિષેધક
नक्षत्रहीण: તારાવિહીન તારાહીન
नक्षत्रांविणें: તારાવિહીન તારાહીન
नखेत्रांनी_भरिल्लें: તારાંકિત તારકાંકિત તારાવાળું
नगरवासी: શહેરી નગર_વાસી નગર_નિવાસી અગ્રામ્ય
नगरी: શહેરી નાગરિક શહેરનું પૌર
नगरेंतले: શહેરી નગર_વાસી નગર_નિવાસી અગ્રામ્ય
नग्न: નિર્વસ્ત્ર નગ્ન નાગું ખુલ્લું ઉઘાડું નવસ્ત્રું નિવસ્ત્ર વિવસ્ત્ર દિગંબર અવસ્ત્ર વસ્ત્રહીન
नटिल्लो: સજ્જિત
नडणी: જંગલી આરણ્યક
नतमस्तक: નતમસ્તક
नदर_आशिल्लो: દૃષ્ટિવંત દૃષ્ટિમાન
नदरेक_पडपी: દ્રશ્ય દૃશ્યમાન દૃષ્ટિગોચર દેખાતું દીસતું વ્યક્ત દૃશ્ય દેખીતું
नमस्कार_करि_सारकें: વંદનીય પૂજ્ય આદરણીય પૂજનીય અભિવંદનીય નમ્ય નમનીય પ્રણમ્ય વંદ્ય અભિવંદ્ય
नमस्कार_करी_सारकें: પ્રણમ્ય વંદનીય
नम्र: વિનમ્ર નમ્રભાવી નમ્ર વિનયી પ્રણત વિનયશીલ અવાગ્ર નિભૃત શાંત શીતલ ટાઢું ઠંડું
नर: નર
नरभक्षक: નરભક્ષી માણસખાઉ આદમખોર માનવભક્ષી નરભક્ષક માનવભક્ષક મનુજાદ
नरभक्षी: નરભક્ષી માણસખાઉ આદમખોર માનવભક્ષી નરભક્ષક માનવભક્ષક મનુજાદ
नरम: સૌમ્ય સુશીલ શાંત લચકદાર નમ્ય નમનીય લવચીક નરમ સુનમ્ય મૃદુ સુનમ્ય નરમ મુલાયમ કોમળ મૃદુલ મૃદુ તનુ સુંવાળું પોચું
नवनिर्मीत: નવરચિત નવું નવનિર્મિત નવલ નવ્ય
नवलकाणीक: ઔપન્યાસિક
नवशिकें: શિખાઉ નવશિખાઉ નવશિખ નવું કાચું અસિદ્ધ અપક્વ અનભ્યસ્ત
नवशिक्षीत: શિખાઉ નવશિખાઉ નવશિખ નવું કાચું અસિદ્ધ અપક્વ અનભ્યસ્ત
नविनीकरणी: નવીનીકરણીય નવીકરણીય સમરામણીય નવીકૃત નવીનીકૃત
नवी: નવરચિત નવું નવનિર્મિત નવલ નવ્ય
नवीन: નવું નવીન નૂતન અભિનવ નવેલું નવલ નવ નવું-નવેલું
नवे: નવું નવીન નૂતન અભિનવ નવેલું નવલ નવ નવું-નવેલું
नवेंच_शिकिल्लें: શિખાઉ નવશિખાઉ નવશિખ નવું કાચું અસિદ્ધ અપક્વ અનભ્યસ્ત
नवो: આધુનિક અર્વાચીન અદ્યતન હમણાંનું અત્યારનું હાલનું આજનું અધુનાતન નવું નવીન અપ્રાચીન સાંપ્રતિક નૂતન
नशीबवान: ભાગ્યશાળી નસીબદાર સદ્ભાગી સુભાગી ખુશનસીબ ખુશકિસ્મત ભાગ્યવાન
नशेचें: માદક કેફી નશીલુ નશેદાર
नशेबाज: નશાખોર નશાબાજ નશેબાજ અમલી વ્યસની બંધાણી કેફી
नश्ट: નષ્ટ ખતમ બરબાદ ખલ્લાસ ચોપટ તહસનહસ નષ્ટ-ભ્રષ્ટ સમાપ્ત નેસ્તોનાબૂદ તબાહ ધ્વસ્ત અપધ્વસ્ત નિકંદન અવધૂત અવધ્વંસ્ત અસ્ત ગારત જેર ફના ઉચ્છિન્ન અપહત મર્દિત તલફ અસ્તમિત વિનષ્ટ ખરાબખસ્ત
नश्टो: ઘૃણાશીલ જુગુપ્સાકર દુષ્ટ દુરાત્મા પાપી દુષ્ટાત્મા પાપબુદ્ધિ પાપિયું નઠારું અધમ હલકટ પાપાશય ઇર્ષાળુ અદેખું દ્ધેષી ખારીલું
नश्वर: નશ્વર નાશવંત ભંગુર વિનાશી નાશવાન નાશુક અસ્થાયી ક્ષણભંગુર અશાશ્વત અનિત
नसाय_करपी: ઇર્ષાળુ અદેખું દ્ધેષી ખારીલું
नसायहीण: અદ્વેષી સમભવી દ્વેષહીન અનસૂય અસૂયા_રહિત
नसायें: ઇર્ષાળુ અદેખું દ્ધેષી ખારીલું ઉપેક્ષક
नस्तार: નકારાત્મક નકારવાળું નિષેધક
नांमाबगरचें: અનામ નનામું
नांवा_पुरतें: નામનું કહેવાનું_જ તથાકથિત કહેવાતું દેખીતું ઉપલકિયું સ્વીકારેલું
नांवाचें: નામક નામનું નામધારી નામી નામવાળું નામનું કહેવાનું_જ તથાકથિત કહેવાતું દેખીતું ઉપલકિયું સ્વીકારેલું
नांवाजतो: પ્રસિદ્ધ નામી પ્રખ્યાત વિખ્યાત જાહેર નામાંકિત જાણીતું જગજાહેર મશહૂર ખ્યાત નામદાર નામવર નામચીન આખ્યાત સુશ્રુત
नांवादीक: પ્રસિદ્ધ નામી પ્રખ્યાત વિખ્યાત જાહેર નામાંકિત જાણીતું જગજાહેર મશહૂર ખ્યાત નામદાર નામવર નામચીન આખ્યાત સુશ્રુત
नाउमेदी: જિજ્ઞાસાહીન નિરુત્સુક અનુત્સુક ઉત્સુકતાહીન
नाकाजाल्लें: નકામું બિનજરૂરી ઉપયોગ_વિનાનું વ્યર્થ ફોગટ ફાલતું જરૂરિયાત_વિનાનું
नाखूश: નાખુશ નારાજ અપ્રસન્ન ઉદાસ રુષ્ટ ક્રુદ્ધ કુપિત ખફા ઇતરાજ
नाखोशयेचें: અસંતોષજનક અસંતોષપ્રદ અસંતોષકારક
नागडो: નિર્વસ્ત્ર નગ્ન નાગું ખુલ્લું ઉઘાડું નવસ્ત્રું નિવસ્ત્ર વિવસ્ત્ર દિગંબર અવસ્ત્ર વસ્ત્રહીન
नागमोडो: વક્રગામી
नागोवणो: લુચ્ચું લુચ્ચુંલફંગું બદમાશ ખંધું લફંગું દોંગું જમાખોર
नागोवपी: જમાખોર
नाजूक: મૃદુલ કૂણું સુંવાળું નરમ મુલાયમ કોમળ નાજુક સુકુમાર નબળું બોદું કમજોર નાજુક
नाटकी: બનાવટી નકલી કૃત્રિમ અપ્રાકૃતિક અપ્રકૃત અસ્વાભાવિક_આહાર્ય ઔપચારિક ઉપચાર_પૂરતું
नापसंतीचें: અપ્રિય અપ્રીતિકર કટુ
नापास: નાપાસ અનુત્તીર્ણ નપાસ ફેલ
नापीक: બિનઉપજાઉ અફળદ્રુપ નિટર
नामंजुर: અસ્વીકૃત નામંજૂર નાકબૂલ અપારિત
नामंजूर: અસ્વીકૃત નામંજૂર નાકબૂલ નામંજૂર અસ્વીકૃત ખારિજ બહિષ્કૃત
नामक: નામક નામનું નામધારી નામી નામવાળું
नामनेचे: વિશ્વવિખ્યાત લોકપ્રસિદ્ધ જગવિખ્યાત જગજાહેર વિશ્વપ્રસિદ્ધ જગપ્રસિદ્ધ
नामनेचो: પ્રસિદ્ધ નામી પ્રખ્યાત વિખ્યાત જાહેર નામાંકિત જાણીતું જગજાહેર મશહૂર ખ્યાત નામદાર નામવર નામચીન આખ્યાત સુશ્રુત
नामी: નામક નામનું નામધારી નામી નામવાળું
नालायक: અયોગ્ય ગેરવાજબી નાલાયક અપાત્ર નકામું અસભ્ય કુપાત્ર કપાતર અનુચિત અણછાજતું અનધિકારી અલાયક અયુક્ત નકામું નિરુદ્યમી નવરૂં આળસું પ્રમાદી બેકાર એદી ફાલતુ નિરુદ્યમી અકર્મી નાલાયક
नावडटें: અણગમતું નાપસંદ નાપસંદીદા અપ્રિય અનભીષ્ઠ ના_મનનું
नावडीचें: અપ્રિય અપ્રીતિકર કટુ
नावाडगें: તોફાની નટખટ અટકચાળું તોફાની ટીખળી બદમાશ મસ્તીખોર
नावाडगो: કુખ્યાત બદનામ કુપ્રસિદ્ધ દુર્નામ પાપનામ નામચીન
नावेश: લુપ્ત નાશ_પામેલું લોપાયેલું નષ્ટ નદારદ ગેબ અંતર્હિત ઉચ્છન્ન
नाशक: વિનાશક નાશક નાશકારક વિનાશકારી વિનાશી વિનાયક ગણપતિ ગણેશ ગજાનન વોલોપક અપાય મારક
नाशवंत: નશ્વર નાશવંત ભંગુર વિનાશી નાશવાન નાશુક અસ્થાયી ક્ષણભંગુર અશાશ્વત અનિત
निंदक: નિંદક અપવાદક અપવાદી આક્ષેપી આક્ષેપક ગીબતખોર બદગો બદગોફતાર
निंदा_करपी: નિંદક અપવાદક અપવાદી આક્ષેપી આક્ષેપક ગીબતખોર બદગો બદગોફતાર
निंदेस्त: ખરાબ નિંદનીય નિંદ્ય નિંદાત્મક અપ્રશંસનીય અશ્લાધ્ય
नितळ: સ્વચ્છ નિરભ્ર અનભ્ર અમેઘ મેઘહીન સ્પષ્ટ ખુલ્લું સ્ફુટ જાહેર નિર્મળ નિર્મલ વિમલ વિમળ શુદ્ધ સાફ સ્વચ્છ પવિત્ર સાફ-સુથરું વિશુદ્ધ ચોખ્ખું અમલ પાવિત અમલિન અમ્લાન અપંકિલ શુક્ર અવદાત સિત પરિશોધિત સુધારેલું વિશોધિત પરિશુદ્ધ
नितीक: કાનૂની કાયદેસર જાયજ યોગ્ય વાજબી યથાર્થ ઉચિત મુનાસિબ વિધિમાન્ય
नितीकतायपूर्ण: નૈતિક નીતિપૂર્ણ ઉચિત યોગ્ય
नितीपूर्ण: નૈતિક નીતિપૂર્ણ ઉચિત યોગ્ય
निद्रागत: નિદ્રાધીન નિદ્રાગ્રસ્ત સુપ્ત સૂતેલું ઊંઘેલું
निनावी: અનામ નનામું
निपक्ष: તટસ્થ નિષ્પક્ષ નિરપેક્ષ અપક્ષ ત્રાહિત ઉદાસીન અપક્ષપાતી અનપેક્ષ નિર્પેક્ષ
निपुत्रीक: નિસ્સંતાન નિ સંતાનહીન સંતાનરહિત અનપત્ય વાંઝિયું અવંશ અશિશુ નિરન્વય
निपूण: પ્રવીણ નિપુણ કુશળ દક્ષ હોશિયાર કાબેલ નિષ્ણાત પારંગત વિદ્વાન તદ્વિદ બાહોશ ચાલાક ચતુર પહોંચેલું પાવરધું પટુ અભ્યસ્ત આકર આગર પ્રવણ યોગ્ય લાયક કાબેલ સમર્થ અભિજાત ઉદાત્ત
निबर: નિર્દય ક્રૂર ઘાતકી દયાહીન નિર્દયી કસાઈ નિષ્ઠુર કઠોર અમમ અદય અદયાળુ નિર્ઘૂણ કરુણા_વિહીન કરુણાહીન અઘૃણ નિર્ભય નીડર નિર્ભીક અભય બેખૌફ બેખોફ ભયહીન નિર્ભીત અધૂત અપભય નિશંક અભિક અભીક અભીત અભીરુ અભૈ વિશ્રબ્ધ નિષ્ઠુર નઠોર ક્રૂર પાષાણી કડક કઠોર સખ્ત ઉગ્ર ખર રૂઢ સખ્ત આકરું ઉગ્ર નિર્દય ગરમ_સ્વભાવનું સંગદિલ કઠોરહૃદય નિર્દય ક્રૂર પથ્થરદિલ મજબૂત ઠોસ દૃઢ પાક્કું જબરદસ્ત જોરાવર જબરું જબરજસ્ત જબ્બર જબર અભંગુર અશિથિલ
निमतां_करपी: ઢોંગી બહાનેબાજ
निमताळो: ઢોંગી બહાનેબાજ
निमाण्या: અંતિમ છેલ્લું છેવટનું આખરી અંત્ય ચરમ આખર અવમ
नियंत्रीत: નિયંત્રિત પ્રતિબદ્ધ તાબે વશ
नियमीत: નિયમિત નિયમબદ્ધ
नियाळिल्लें: અવલોકિત સમીક્ષિત જોયેલું તપાસેલું
नियुक्तीत: નિયુક્ત નિમાયેલું નીમેલું નીમેલ નિયત મુકરર નિયોજિત નિમાયેલ
निरंकूश: નિરંકુશ ઉદ્દંડ મદોન્મત્ત ઉચ્છૃંખલ ઉદ્ધત બેલગામ સ્વચ્છંદી સ્વેચ્છાચારી મનમોજી તરંગી મનસ્વી બેકાબૂ
निरंहकारी: નિરભિમાની નિરભિમાનિતા નિરભિમાનપણું અભિમાનરહિત અદંભી અહંકારહીન સીધુ દંભહીન અભિમાનશૂન્ય ગર્વરહિત નિરહંકાર નિરહંકારિતા અમત્ત ઘમંડરહિત
निरक्षर: અશિક્ષિત અભણ અંગુઠાછાપ અશિષ્ટ નિરક્ષર અનપઢ અજ્ઞાન અપઢ અનપઢા અપઠ અણપઢ અવિદ્ય અપ્રાજ્ઞ
निरपराधी: નિર્દોષ નિરપરાધી બેકસૂર નિરપરાધ અનપરાધી બિનગુનેગાર બેગુનાહ માસૂમ નિરપરાધી અનપરાધ
निरभिमानी: નિરભિમાની નિરભિમાનિતા નિરભિમાનપણું અભિમાનરહિત અદંભી અહંકારહીન સીધુ દંભહીન અભિમાનશૂન્ય ગર્વરહિત નિરહંકાર નિરહંકારિતા અમત્ત ઘમંડરહિત
निरर्थक: બકબકાટ;_લવારો બકવાટો અસંગત ઉટપટાંગ ઉટપટંગ ઉટંગ તરંગી અગડબગડ અગડંબગડં ગોટાળો ગડબડગોટો અષ્ટંપષ્ટં સટરપટર અર્થહીન અર્થરહિત નિરર્થક નકામું અર્થશૂન્ય વ્યર્થ ફોગટ મિથ્યા ફોગટ એળે બેકાર ફોક બેકામ નાહક અમસ્તું વૃથા ખાલી મૃષા અનૃત
निरस: અરસિક નીરસ રસશૂન્ય શુષ્ક
निराकार: નિરાકાર અશરીર અમૂર્ત સૂક્ષ્મ અરૂપ આકારરહિત અનવાય અનવય નિરવયવ અનાકાર આકૃતિહીન અરૂપક અવિગ્રહ અશરીરી શરીરરહિત અશારીરિક દૈવી
निरादार: નિરાધાર બિનપાયદાર આધારવિહોણું બિનઆધારભૂત અસ્થાપિત અદ્ધર અધ્ધર આધાર_વિનાનું ટેકા_વગરનું અનાવલમ્બિત નિરાલંબ અનાધાર
निराधार: અસહાય નિરાધાર નિ લાચાર બિચારું બીચારું બાપડું પરાધીન નિરાશ્રય આશ્રયહીન એકલું અનાથ અશરણ અપાશ્રય બાપુરા નિરાધાર અકારણ આધારશૂન્ય અપ્રમાણિક અપ્રામાણિક આધારહીન નિર્મૂલ સારહીન અનાધાર યથાર્થહીન આધારરહિત
निरावासीत: નિર્વાસિત અનિવાસિત ઉજડેલું અવાસિત
निराश: નિરાશ આશાહીન નાઉમેદ આશાભંગ ભગ્નાશ હતાશ
निराश्रीत: નિરાશ્રિત આશ્રયહીન અનાશ્રિત અપાશ્રય નિરાશ્રય
निरुत्तर: નિરુત્તર અનુત્તર બેજવાબ
निरुत्साही: જિજ્ઞાસાહીન નિરુત્સુક અનુત્સુક ઉત્સુકતાહીન
निरुपेगी: નિરુપયોગી બિનઉપયોગી બિનજરૂરી નકામું મિથ્યા બાતલ અનુપયોગી અનુપયુક્ત વ્યર્થ ફાલતુ બેકાર બેકામ રદ્દી અલીક
निरूपयोगी: લાચાર વિવશ નિરુપાય નિર્વિકલ્પ નાઇલાજ વિકલ્પ_રહિત
निरोगी: સ્વસ્થ નીરોગી તંદુરસ્ત સેહત સારું આરોગ્ય વ્યાધિ_રહિત નિરામય અનામય ફિટ અગદ સારું અરોગી સેહતમંદ રોગરહીત ચંગુ વ્યાધિહીન
निर्जन: નિર્જન સૂનું એકાંત વિજન વીરાન સુનસાન જનશૂન્ય ઉજ્જડ વેરાન સૂમસામ અજન નિભૃત અમાનુષી
निर्जाप: નિરુત્તર અનુત્તર બેજવાબ
निर्जीव: નિર્જીવ અચેતન નિષ્પ્રાણ પ્રાણરહિત મૃત બેજાન અજીવ અપ્રાણ અપ્રાણી જડ અચેતન સ્થૂળ ભૌતિક અનાત્મ અજૈવ અજીવ નિર્જીવ ચેતના_રહિત
निर्णय_जाल्ली: નિર્ણીત નિપટેલું નક્કી જ્ઞાપિત
निर्णया_बगरचें: અનિર્ણીત
निर्णायक: નિર્ણાયક અમ્પાયર રેફરી નિર્ણય_કરનાર
निर्णीत: નિર્ણીત નિપટેલું નક્કી જ્ઞાપિત
निर्दयी: નિર્દય ક્રૂર ઘાતકી દયાહીન નિર્દયી કસાઈ નિષ્ઠુર કઠોર અમમ અદય અદયાળુ નિર્ઘૂણ કરુણા_વિહીન કરુણાહીન અઘૃણ
निर्दोश: નિર્દોષ નિરપરાધી બેકસૂર નિરપરાધ અનપરાધી બિનગુનેગાર બેગુનાહ માસૂમ નિરપરાધી અનપરાધ
निर्बळ: અશક્ત નિર્બળ અસમર્થ કમજોર માંદલું કમતાકાત દુર્બળ દૂબળું નબળું શક્તિહીન અકુશળ કમજોર દુર્બળ દુર્બળ નિર્બલ નિર્બળ અબલ અપ્રબલ બલહીન અવીર અસક્ત અસહાય લાચાર પરાધીન નિરાશ્રય શક્તિહીન અલ્પબલ અવીર નામર્દ
निर्भय: નિર્ભય નીડર નિર્ભીક અભય બેખૌફ બેખોફ ભયહીન નિર્ભીત અધૂત અપભય નિશંક અભિક અભીક અભીત અભીરુ અભૈ વિશ્રબ્ધ
निर्भेळ: શુદ્ધ ચોખ્ખું અસલી અસલ વિશુદ્ધ ખરુ અમિશ્રિત ખાલિસ નિર્મળ નિર્મલ વિમલ વિમળ શુદ્ધ સાફ સ્વચ્છ પવિત્ર સાફ-સુથરું વિશુદ્ધ ચોખ્ખું અમલ પાવિત અમલિન અમ્લાન અપંકિલ શુક્ર અવદાત સિત
निर्मळ: નિર્મળ નિર્મલ વિમલ વિમળ શુદ્ધ સાફ સ્વચ્છ પવિત્ર સાફ-સુથરું વિશુદ્ધ ચોખ્ખું અમલ પાવિત અમલિન અમ્લાન અપંકિલ શુક્ર અવદાત સિત
निर्माण_केल्लें: રચિત નિર્મિત વિરચિત સૃષ્ટ કૃત સર્જિત પ્રણીત
निर्मिल्लें: રચિત નિર્મિત વિરચિત સૃષ્ટ કૃત સર્જિત પ્રણીત
निर्मीत: રચિત નિર્મિત વિરચિત સૃષ્ટ કૃત સર્જિત પ્રણીત
निर्लज्ज: નિર્લજ્જ બેશરમ નાગું નિર્મર્યાદ શરમ_વિનાનું લાજ_વગરનું બેશર્મ બેહયા નિલજ નકટું નિહંગ અપત બેમુરવ્વત લજ્જાહીન અલજ્જ નિહંગમ ત્રપાનિરસ્ત ખાસડાંખાઉ માથાકૂટિયું ખાસડુંકુટ્ટું
निर्विवाद: અખંડનીય અકાટ્ય દૃઢ મજબૂત
निर्वीर: નિર્વીર વીર્યહીન
निर्शेल्लें: ઉદાસ ખિન્ન ગમગીન શોકાતુર દિલગીર અનમના અનમન મ્લાન અન્યમન અન્યમનસ્ક વિરક્ત અમનસ્ક અપ્રસન્ન
निर्शेवप: હતાશ નિરાશ નાઉમેદ નાસીપાસ ભગ્નાશ આશાભંગ
निलंबीत: પદભ્રષ્ટ પદચ્યુત નિલંબિત બરખાસ્ત અનુલંબિત
निळसार: વાદળી આસમાની નીલુ
निळें: વાદળી આસમાની નીલુ
निवडिल्ली: નિયુક્ત નિમાયેલું નીમેલું નીમેલ નિયત મુકરર નિયોજિત નિમાયેલ
निवडिल्लें: ગોઠવવું સ્વચ્છ_કરવું સુઘડ_કરવું ચૂંટાયેલ ચયિત ચયનિત ચુનિંદા ચૂંટાયેલું ચૂંટાયેલ નિર્વાચિત
निवळ: નિર્મળ નિર્મલ વિમલ વિમળ શુદ્ધ સાફ સ્વચ્છ પવિત્ર સાફ-સુથરું વિશુદ્ધ ચોખ્ખું અમલ પાવિત અમલિન અમ્લાન અપંકિલ શુક્ર અવદાત સિત ઉજ્જવળ ઊજળું પ્રકાશિત કાંતિમાન તેજસ્વી સાફ સ્વચ્છ સિત અવદાત દેદીપ્યમાન પરિશોધિત સુધારેલું વિશોધિત પરિશુદ્ધ
निवारक: નિવારક
निवृत्त: નિવૃત્ત વિરત વિમુખ
निव्वळ: સ્પષ્ટ ખુલ્લું સ્ફુટ જાહેર
निशस्त्र: નિ શસ્ત્રહીન નિશસ્ત્ર
निशाचर: નિશાચર રાત્રિચર નિશિચર તમચર નિશાચારી યામિનિચર નિશાટ નિશાટન
निशाणी__केल्ली: સહીવાળું હસ્તાક્ષર_કરેલ હસ્તાક્ષરિત દસ્તખતી
निशाणे_बगर: અહસ્તાક્ષરિત
निशाणे_विरयत: અહસ્તાક્ષરિત
निशुल्क: મફત નિશુલ્ક વગર_પૈસે
निश्कपट: નિર્મળ નિર્મલ વિમલ વિમળ શુદ્ધ સાફ સ્વચ્છ પવિત્ર સાફ-સુથરું વિશુદ્ધ ચોખ્ખું અમલ પાવિત અમલિન અમ્લાન અપંકિલ શુક્ર અવદાત સિત
निश्कपटी: પ્રમાણિક ઈમાનદાર વિશ્વાસપાત્ર ઈમાની ઋજુ સત્યપર સત્યપરાયણ નિષ્કપટ નિખાલસ સાચું ખરૂં કપટરહિત કપટહીન અછદ્મ છદ્મહીન
निश्चींत: નિશ્ચિંત બેફિકર નચિંત નિષ્ફિકર બેપરવા ચિંતામુક્ત બેફિકર_નફિકરું આઝાદ
निश्चीत: નિશ્ચિત નક્કી અટલ અવશ્યંભાવી ચોક્કસ અટળ અટ્ટલ અમિટ અબાધ્ય અનિવાર્ય અપરિહાર્ય નિશ્ચિત નિર્ધારિત નિયત નિયમિત નિર્દિષ્ટ
निश्टूर: નિર્દય ક્રૂર ઘાતકી દયાહીન નિર્દયી કસાઈ નિષ્ઠુર કઠોર અમમ અદય અદયાળુ નિર્ઘૂણ કરુણા_વિહીન કરુણાહીન અઘૃણ
निश्ठावान: નિષ્ઠાવાન
निश्ठाहीण: દંભી ઢોંગી નિષ્ઠાહીન
निश्पर्णी: પર્ણહીન
निश्पाप: નિર્મળ નિર્મલ વિમલ વિમળ શુદ્ધ સાફ સ્વચ્છ પવિત્ર સાફ-સુથરું વિશુદ્ધ ચોખ્ખું અમલ પાવિત અમલિન અમ્લાન અપંકિલ શુક્ર અવદાત સિત નિષ્પાપ અપાપ પાપરહિત પવિત્ર પુનિત પાવન અનઘ નિર્દોષ નિરપરાધી બેકસૂર નિરપરાધ અનપરાધી બિનગુનેગાર બેગુનાહ માસૂમ નિરપરાધી અનપરાધ
निश्प्राण: નિર્જીવ અચેતન નિષ્પ્રાણ પ્રાણરહિત મૃત બેજાન અજીવ અપ્રાણ અપ્રાણી
निसंकोच: નિ શંકાહીન સંદેહહીન
निस्तेज: નિસ્તેજ કરમાયેલ મ્લાન
निस्वार्थी: નિ સ્વાર્થહીન પરોપકારી સ્વાર્થ_રહિત
नीच: નીચ ઘટિયા હીન નિકૃષ્ટ અધમ હલકું નઠારું તુચ્છ ક્ષુદ્ર મ્લેચ્છ પોચ નીચમાં_નીચ અધમાધમ અધમતમ અત્યંત_અધમ સૌથી_હલકું
नीच_कुळाचें: નિમ્ન_કુલીન નિમ્ન_વંશીય
नुतनीकरणी: નવીનીકરણીય નવીકરણીય સમરામણીય નવીકૃત નવીનીકૃત
नेटाचें: પ્રચંડ ઉગ્ર પ્રખર આકરું પ્રબળ જબરું જબ્બર પ્રબલ તેજ તીવ્ર તીક્ષ્ણ કડા અમંદ દુર્દમ તોફાની બેકાબૂ ધાંધલિયું હુલ્લડખોર નિરંકુશ
नेटान: તીવ્ર વેગીલું તેજ દ્રુત ઉડતું
नेणटें: સગીર અલ્પવયસ્ક અપ્રૌઢ નાબાલિગ કમસિન અલ્હડ
नेणार: અકુશલ અકુશળ અનિષ્ટ અણકસબી ગમાર અપટુ અનિપુણ અપ્રવીણ અણઘડ અપાટવ અવિવેકી અવિચારી અણસમજુ અબુધ અજાણ નાસમજ અસભ્ય બેઅદબ અમર્યાદ અવિનયી
नेम_पाळपी: નિયમી નિયમ_પાલક નેમી
नेमान: નિયમિત નિયમબદ્ધ
नेमाळें: રોજ દરરોજ દૈનિક
नेमी: નિયમી નિયમ_પાલક નેમી નેમી
नैसर्गीक: પ્રાકૃતિક કુદરતી નૈસર્ગિક પ્રાકૃત પ્રકૃત અકૃત્રિમ સ્વાભાવિક
नोंदणी: પંજિકૃત દાખલ અધિકૃત નોંધણી ટાંચણ દર્ઝ
नोंदीत: પંજિકૃત દાખલ અધિકૃત નોંધણી ટાંચણ દર્ઝ
न्याय_करपी: ન્યાયી ન્યાયનિષ્ઠ ઇન્સાફી ઇન્સાફવાળું પ્રામાણિક ન્યાયપુર આદિલ
न्यायकरतो: ન્યાયી ન્યાયનિષ્ઠ ઇન્સાફી ઇન્સાફવાળું પ્રામાણિક ન્યાયપુર આદિલ
न्यायालयीन: ન્યાયવિષયક અદાલતી ઇન્સાફી
न्यायी: ન્યાયી ન્યાયનિષ્ઠ ઇન્સાફી ઇન્સાફવાળું પ્રામાણિક ન્યાયપુર આદિલ
न्हयकार: નકારાત્મક નકારવાળું નિષેધક
न्हाण_घेतिल्लो: સ્નાત નિમજ્જિત નાહેલું
न्हाल्लो: સ્નાત નિમજ્જિત નાહેલું
न्हाविल्लो: સ્નાત નિમજ્જિત નાહેલું
न्हिदखुरो: નિદ્રાગ્રસ્ત નિદ્રાળુ ઊંઘાળવું ઊંઘણશી નિદ્રાશીલ નિદ્રાલુ
न्हिदिल्लें: નિદ્રાધીન નિદ્રાગ્રસ્ત સુપ્ત સૂતેલું ઊંઘેલું
न्हिदेस्त: નિદ્રાગ્રસ્ત નિદ્રાળુ ઊંઘાળવું ઊંઘણશી નિદ્રાશીલ નિદ્રાલુ
न्हिद्राळू: નિદ્રાગ્રસ્ત નિદ્રાળુ ઊંઘાળવું ઊંઘણશી નિદ્રાશીલ નિદ્રાલુ
न्हीदमग्न: નિદ્રાધીન નિદ્રાગ્રસ્ત સુપ્ત સૂતેલું ઊંઘેલું
पंचकोनी: પંચકોણ પંચખૂણિયું પંચકોણીય
पंचभुतांचें: પંચભૌતિક ભૌતિક પાર્થિવ પંચતત્ત્વીય પંચભૂતિય
पंचायती: પંચાયતી
पंचायतीचें: પંચાયતી
पंचेचाळिसावें: પિસ્તાળીસમું
पंडीत: બુદ્ધિમાન બુદ્ધિશાળી હોશિયાર સમઝદાર સમઝુ અક્કલમંદ શાણું ડાહ્યું હોશિયાર કુશળ બુદ્ધિમંત મેઘાવી મતિમંત અમૂઢ મતિમાન દાનિશમંદ પાટવિક પટુ આકિલ આકેલ વિદ્વાન જ્ઞાનવાન પંડિત જ્ઞાની વિબુધ જ્ઞાતા વિદ્વત વેત્તા ભિજ્ઞ
पकदस्त: ભારે વજનદાર વજની બોઝલ પીવર
पक्षपाती: સમર્થક અનુમોદક અનુમોદનાર હિમાયતી તરફદાર પક્ષકાર
पगारी: વૈતનિક પગારદાર દરમાયાદાર ભૃતક કર્મકર
पचकळ: પ્રલાપી પ્રલાપક બકવાદી મગજચટ બહુબોલું બોલકણું દિમાગચટ
पचनाशिल्लें: અપાચ્ય ભારે
पचपी: સુપચ્ય સહજ_પાચ્ય હલકું પથ્ય નરમ લઘુપાક
पटेकार: બડાઈખોર ડંફાશિયું શેખીખોર પતરાજીખોર ગપ્પોરી શેખી ઝલ્લી ગપ્પીદાસ
पडकें: પડી_ગયેલું ઢળી_પડેલું અવક્ષિપ્ત અવગત
पडमूर: કૃતઘ્ન કૃતજ્ઞ કૃતઘ્ની અપકારી નિમકહરામ લૂણહરામ
पडिल्लें: પડી_ગયેલું ઢળી_પડેલું અવક્ષિપ્ત અવગત ઉદાસ ખિન્ન ગમગીન શોકાતુર દિલગીર અનમના અનમન મ્લાન અન્યમન અન્યમનસ્ક વિરક્ત અમનસ્ક અપ્રસન્ન ઓછો મંદ અવનત નરમ નીચું કમ
पड्डो: જાળીદાર ઝિલ્લીદાર
पतिव्रता: પતિવ્રતા સતી પતિપ્રાણા
पतीतपावन: પતિતપાવન
पथी: સંયમી સંયત નિયમી સંયમશીલ પરહેજગાર પરહેજીગાર નિગ્રહી
पदचारी: પદચર પાયદળ પ્યાદું પદચારી પાદચારી પગપાળું
पनवतीचो: પતિત અધોગત નીતિભ્રષ્ટ આચારભ્રષ્ટ અવનત ચ્યૂત સ્ખલિત અપકૃષ્ટ અબતર
पयलींचें: જીર્ણ જરેલું જર્જર જર્જરિત
पयलें: પ્રથમ પહેલા પહેલું અવ્વલ આદિનું ૧લું 1લું
पयशेकार: ધનાઢ્ય ધની અમીર ધનવાન માલદાર ધનવંત દોલતમંદ વૈભવશાળી વૈભવશાલી વૈભવવાળું સંપન્ન માલામાલ સમૃદ્ધ ઐશ્વર્યવાન સંપત્તિવાન ખુશહાલ પૈસાદાર બહુધન જરદાર
पयश्यांची: આર્થિક આર્થી વિત્તીય
पयस: દૂર દૂરસ્થ દૂરવર્તી દૂરસ્થિત છેટું આઘું વેગળું વંચિત રહિત
पयसचो: દૂરાગત
पयसुल्लो: દૂરાગત
परक्याचें: પારકું પરાયું બીજાનું ગેર પરકીય
परजळपी: ચમક્તો દમક્તો ઉજ્જવલ રોશન ઝગમગ દીપ્ત પ્રકાશવાન દ્ર્યુતિમાન કાંતિમાન
परजळीत: પ્રકાશમાન તેજસ્વી તેજોમય પ્રકાશતું ઉજ્જવલ ઉજ્જવલિત દીપ્તિપૂર્ણ આલોકિત
परजातीचें: વિજાતીય વિજાતિ પરજાતીય ભિન્ન_જાતીય
परत_घेतिल्लो: બહાલ પુનર્નિયુક્ત
परत_दिल्लो: બહાલ પુનર્નિયુક્ત
परतें: વિપરીત અવળું ઊલટું વિરુદ્ધ પ્રતિકૂલ વિરોધી વિલોમ પ્રતિલોમ પ્રતીપ પ્રતિકૂળ ઊંધું અપસવ્ય ઊલટું ઊંધું અવળું વિપરીત વિરુદ્ધ અન્યથા
परदेशी: વિદેશી પરદેશી દેશાવરી વિલાયતી અન્યદેશીય અજનવી અજનબી વિદેશી પરદેશી વિલાયતી અન્યદેશીય દેશાવરનું
परमळहीण: ગંધહીન વાસહીન ગંધરહિત નિર્ગંધ
परमळीत: સુગંધિત સુવાસિત સુગંધીદાર ખુશબોદાર ખુશ્બૂદાર સુરભિત આમોદિત સુગંધીદાર સુગંધિત ગંધિત વાસયુક્ત મહેકતા
परलोकी: અલૌકિક પરલોકનું પરલોકીય દિવ્ય અમાનુષી લોકોત્તર અમાનુષિક
परलोकीक: અલૌકિક પરલોકનું પરલોકીય દિવ્ય અમાનુષી લોકોત્તર અમાનુષિક
पराधीन: પરાધીન પરવશ પરતંત્ર ગુલામ અધીન અન્યાધીન અવશ અસ્વાધીન
परावर्तीत: પરાવર્તિત
परावलंबी: પરાવલંબી પરાધીન પરતંત્ર પરવશ અવલંબિત આશ્રિત આધારિત આલંબિત નિર્ભર અવલંબી આધારી
परिचीत: ખબર અવગત જાણેલું જ્ઞાત પરિચિત વાકેફ પ્રતીત અવભાસિત જાણીતું પ્રજ્ઞાત પરિજ્ઞાત વિજ્ઞાત
परित्यागी: ત્યાજ્ય વર્જ્ય વર્જનીય હેય તજવા_યોગ્ય છોડી_દેવા_લાયક
परिपक्व: અનુભવી જાણકાર પરિપક્વ પાવરધું ઘડાયેલું કસાયેલું પાકું પક્વ પરિપક્વ
परिपूर्ण: પરિપૂર્ણ ભરપૂર પૂર્ણ સભર અવપૂર્ણ પરિપૂર્ણ ભરેલું
परिभाशीत: વ્યાખ્યાયિત પરિભાષિત
परिवर्तन: પરિવર્તિત પલટાવેલું બદલાયેલું તબ્દીલ
परिवर्तनशील: પરિવર્તનશીલ પરિવર્તી પરિવર્તનીય બદલાતું ફેરવાતું
परिवारांतलें: પારિવારિક ઘરેલું પરિવારિક
परिसिमीत: સીમાવાળું સીમાબદ્ધ મર્યાદિત સીમાયુક્ત પરિમિત
परोपकारी: પરોપકારી પરગજુ પરમાર્થી
पर्यायहीण: લાચાર વિવશ નિરુપાય નિર્વિકલ્પ નાઇલાજ વિકલ્પ_રહિત
पर्यायी: વૈકલ્પિક મરજિયાત ઐચ્છિક વિકલ્પવાળું
पळपी: ભાગેડુ પલાયનવાદી
पळपुटो: ભાગેડુ પલાયનવાદી
पळयिल्लें: અવલોકિત સમીક્ષિત જોયેલું તપાસેલું
पळोवंक_नाशिल्लें: અનવલોકિત અનદેખા અણદીઠું અપેખ્યું અદૃષ્ટ નજર_અંદાજ_કરેલું
पळोवपा_सारकें: દર્શનીય આલોકનીય વિલોકનીય પ્રેક્ષણીય દ્રશ્ય જોવા_લાયક લક્ષ્ય અભિલક્ષ્ય અદર્શનીય કૂબડું
पवित्र: પવિત્ર શુદ્ધ નિર્મળ પાવન શુચિ પુનિત ચોખ્ખું પાક પૂત
पसंतीचें: પ્રિય વહાલું ગમતું અજીજ પ્યારૂં પ્રીતિકર
पसरिल्लें: વિસ્થાપિત સ્થાનભ્રષ્ટ હટાવેલી વેરાવું ફેલવું પ્રસરવું ફાલવું પ્રકિર્ણ વિકીર્ણ
पांखयाळें: પંખદાર પંખાળું પાંખોવાળું પરદાર
पांखां_आशिल्लें: પંખદાર પંખાળું પાંખોવાળું પરદાર
पांचकोनी: પંચકોણ પંચખૂણિયું પંચકોણીય
पांयां_पड_सारकें: પ્રણમ્ય વંદનીય
पाखंडी: પાખંડી ઢોંગી દંભી આડંબરી કપટી શઠ ધૂતારો ધ્વજિક
पाचक: સુપચ્ય સહજ_પાચ્ય હલકું પથ્ય નરમ લઘુપાક
पाचवेंचार: લીલું હરિત હર્યું-ભર્યું શાદ્વલ ગુલજાર લીલું હરિત શાદ્વલ ગુલજાર
पाठ्य: પાઠ્ય પઠનીય પઠ્ય અધ્યેય
पाड: મેલુ અસ્વચ્છ ખરાબ અપવિત્ર અશુધ્ધ ગંધારુ બગડેલું દૂષિત અવિમલ અનિર્મલ અવિશુધ્ધ અશુચિ મ્લાન મલિન ગંદુ ફલાણું કોઈ ચોક્કસ
पाड_जाल्लें: સડેલું બગડેલું વાસી_થઇ_ગયેલું કોહવાટ બગાડ
पाडे_बुद्धीचो: દુષ્ટ દુરાત્મા પાપી દુષ્ટાત્મા પાપબુદ્ધિ પાપિયું નઠારું અધમ હલકટ પાપાશય
पाडें: મેલુ અસ્વચ્છ ખરાબ અપવિત્ર અશુધ્ધ ગંધારુ બગડેલું દૂષિત અવિમલ અનિર્મલ અવિશુધ્ધ અશુચિ મ્લાન મલિન ગંદુ
पाडो: ઘૃણાશીલ જુગુપ્સાકર દુષ્ટ દુરાત્મા પાપી દુષ્ટાત્મા પાપબુદ્ધિ પાપિયું નઠારું અધમ હલકટ પાપાશય
पाण: જલીય જલજ
पाणाविल्लो: અશ્રુપૂર્ણ સજલ આંસુવાળું સાશ્રુ આંસુથી_ભરેલું
पातयेवणें: વિશ્વાસુ વિશ્વાસપાત્ર વફાદાર ભરોસાપાત્ર વિશ્વસનીય ખાતરી_લાયક
पातळ: અઘન આછું પાંખું પનિહા પનિયલ પાતળું પ્રવાહી દ્રવ્ય તરલ
पातळिल्लें: વેરાવું ફેલવું પ્રસરવું ફાલવું પ્રકિર્ણ વિકીર્ણ
पात्र: સુપાત્ર સારું_પાત્ર સારું_માણસ સત્પાત્ર
पानाळ: પત્તીદાર
पापहीण: નિષ્પાપ અપાપ પાપરહિત પવિત્ર પુનિત પાવન અનઘ
पापी: પાપી અધમ અપરાધી પાપાત્મક ગુનેગાર અધર્મી પાપિષ્ઠ દુરાચારી પાતકી નીચ પાપાચારી પાપકર્મી પામર મલિન કુમાર્ગી કલુષ અવર દુષ્ટ દુરાત્મા પાપી દુષ્ટાત્મા પાપબુદ્ધિ પાપિયું નઠારું અધમ હલકટ પાપાશય
पापूय_नाशिल्लो: પિતૃહીન તાતહીન પિતાહીન પિતૃવિહીન અપિતૃ અપિતૃક
पारखुपी: દૂરદર્શી દીર્ઘદ્રષ્ટા દૂરદૃષ્ટિવાળું દીર્ઘદર્શી અગમબુદ્ધિ દુરંદેશી
पारदर्शक: પારદર્શક પારદર્શી
पारदर्शी: પારદર્શક પારદર્શી
पारपांरीक: પારંપરિક પરંપરાગત ક્રમાગત ક્લાસિકીય
पारस्पारीक: પારસ્પરિક પરસ્પરનું એકબીજાનું અરસ્પરસનું અન્યોન્યનું
पालविल्लें: ઠંડું શમિત શાંત
पाळिल्लें: પાલતૂ ઘરેલું પાલૂ
पावयिल्लें: ચૂકતું બેબાક અદા ચૂકવી_દીધેલ ભરપાઈ_કરેલ
पावसाळी: વરસાદી વર્ષા_કાલીન વર્ષાકાલીન
पाशाणी: નિષ્ઠુર નઠોર ક્રૂર પાષાણી
पाशुपत: શૈવ શૈવી પાશુપત
पाश्चात्य: પશ્ચિમી પાશ્વાત્ય
पाश्च्यात्य: પશ્ચિમી પશ્ચિમનું
पास: ઉતીર્ણ પાસ. પારિત પાસ પસાર ઉત્તીર્ણ
पिंजिल्लें: જીર્ણશીર્ણ જર્જરિત તૂટેલ-ફૂટેલ
पिकसावं: ચિંતિત ચિંતાવાળું ફિકરવાળું ચિંતાગ્રસ્ત ફિકરમંદ
पिकाळ: ફળદ્રુપ રસાળ ઉપજાઉ ઉર્વર ઉર્વર ફળદ્રુપ
पिकिल्लें: પાકું પક્વ પરિપક્વ
पिकें: પાકું પક્વ પરિપક્વ
पिचो: પાગલ ગાંડો બાવરો
पिडिल्लो: ત્રસિત ત્રસ્ત પીડિત મજલૂમ ઉત્પીડિત દુ આર્ત
पिडेस्त: રોગી બીમાર માંદું અસ્વસ્થ આજારી રોગવાળું રોગિષ્ઠ રોગિયું રુગ્ણ આર્ત દુ દુઃખવાળું દુખિયું પીડિત વ્યથિત દુઃખિત દુ પીડાયેલું કચવાયેલું આર્ત રંજીદા ખિન્ન ગમગીન દિલગીર
पितृहीण: પિતૃહીન તાતહીન પિતાહીન પિતૃવિહીન અપિતૃ અપિતૃક
पित्ताचें: પૈત્તિક પૈત્ત પિત્તજ
पिशें: પાગલ ગાંડું ઘેલું ઉન્મત્ત ઘેલું અણસમજુ નાદાન મગજનું_ચસકેલું
पिसांट: મૂર્ખ મૂરખ અબૂધ અક્કલહીન ઠોઠ ગમાર બેવકૂફ બુદ્ધિહીન નાદાન મતિમંદ મૂઢ અબૂજ અજ્ઞાની બેસમજ અંધ કમઅક્કલ મૂઢમતિ મૂઢબુદ્ધિ અણસમજુ અલ્પબુદ્ધિ શીન અવિદ પામર
पिसाट: પાગલ ગાંડો બાવરો
पिसो: ક્રોધી તામસી ઝક્કી મિજાજી માથાફરેલ
पुंवाळ: દુર્ગંધવાળું દુર્ગંધી સડેલું પૂતિ પૂતિક
पुजनीय: પૂજનીય પૂજ્ય વંદનીય આરાધ્ય આરાધનીય અભિવંદનીય
पुजपा_सारकी: પૂજનીય પૂજ્ય વંદનીય આરાધ્ય આરાધનીય અભિવંદનીય
पुजा_केल्लें: પૂજિત આરાધિત અર્ચિત પૂજેલું ઉપાસિત ઋત અંજિત
पुजिल्ली: પૂજિત આરાધિત
पुजिल्लें: પૂજિત આરાધિત અર્ચિત પૂજેલું ઉપાસિત ઋત અંજિત
पुज्य: પૂજનીય પૂજ્ય વંદનીય આરાધ્ય આરાધનીય અભિવંદનીય આરાધ્ય પૂજ્ય પૂજનીય આરાધિત પૂજિત અર્ચિત અંજિત અર્ચિત અર્હિત પૂજનીય પૂજ્ય વંદનીય વંદ્ય
पुण्यवान: પુણ્યાત્મા પરમાર્થી ધર્માત્મા પુણ્યશીલ પુણ્યવાન પુણ્યશાળી
पुण्यात्मो: પુણ્યાત્મા પરમાર્થી ધર્માત્મા પુણ્યશીલ પુણ્યવાન પુણ્યશાળી
पुत्र_इच्छीत: પુત્રાર્થી
पुत्रवती: પુત્રવતી પુત્રવાળી
पुत्रवान: પુત્રવાન પુત્રવાળું
पुनर्नियुक्ती: બહાલ પુનર્નિયુક્ત
पुनर्वसणुकीत: પુનર્વસન પુનર્વસવાટ
पुनर्वासीत: પુનર્વસન પુનર્વસવાટ
पुरस्कार_मेळिल्लो: પુરસ્ક્રૃત
पुरस्कृत: પુરસ્ક્રૃત
पुराय: પાકો પાક્કો સંપૂર્ણ પરિપૂર્ણ ન્યૂનતા_વિનાનું ખામી_વિનાનું નિષ્ણાત પારંગત યથાર્થ દક્ષ સંપૂર્ણ આખું પૂરેપૂરૂ સમગ્ર સઘળું તમામ બધું પરિપૂર્ણ આદ્યાંત
पुरुशी: પુરુષોચિત મરદાની મરદોનું નરજાતિનું મર્દાના મરદાના વીરતા_ભરેલું
पुरूश: નર
पुरो: પર્યાપ્ત પૂરતું પરિમિત મર્યાદિત મર્યાદાવાળું હદવાળું પર્યાપ્ત સંપૂર્ણ
पुरो_जाल्लें: થાકેલું થકિત ક્લાંત પરિશ્રાંત થાક્યો-માંદો થાક્યો-હાર્યો
पुर्वापार: પૈતૃક પૈત્રુક વડીલોપાર્જિત પિતૃપક્ષનું વંશાનુગત આનુવંશિક વારસાગત ખાનદાની
पुर्विल्लें: પ્રાચીન પુરાણું જૂનું પુરાતન આદિમ આદિકાળ પ્રાચ્ય પૂર્વકાલીન પ્રાચીન જૂનું પુરાણું અગાઉનું પૂર્વનું
पुश्टीक: પૌષ્ટિક પુષ્ટિકારક પુષ્ટિકર બળવર્ધક પુષ્ટિપ્રદ
पुसट: અસ્પષ્ટ અસ્ફુટ ઝાંખું અપ્રતીત અણપતીજ તોતડું અવ્યક્ત ગડબડિયું બડબડિયું સંદિગ્ધ ઝાંખું ધૂંધળું અસ્પષ્ટ
पुस्तकी: પુસ્તકીય પુસ્તકનું
पूत_आशिल्लो: પુત્રવાન પુત્રવાળું
पूर्ण: સંપૂર્ણ આખું પૂરેપૂરૂ સમગ્ર સઘળું તમામ બધું પરિપૂર્ણ આદ્યાંત
पूर्णप्रभावीत: ઓતપ્રોત એકાગ્ર એકતાન તલ્લીન તન્મય ધ્યાનમગ્ન મશગૂલ પરાયણ ગરક લીન
पूर्वी: પૂર્વીય પૂરબી પૂર્વી પ્રાચ્ય
पृश्ठ: પાછલું પાછળનું પૃષ્ઠ
पेंवपी: તૈરાક તારૂ તરનાર
पेज: પ્રલાપી પ્રલાપક બકવાદી મગજચટ બહુબોલું બોલકણું દિમાગચટ
पेझाद: શક્તિશાળી બળવાન તાકતવર સબળ સશક્ત શક્તિવાન બલિષ્ઠ બળશાળી શક્તિમાન જબ્બર જબર જબરજસ્ત જબરદસ્ત જોરાવર જબરું બલવંત બળીયું અપરબલ શક્તિસંપન્ન ધુરંધર
पोंग: કુબ્જ કૂબડું કૂબડો ખુંધુ
पोकळ: પોલું ખાલી ઠાલું બખોલ કોતર ખો ગુફા પોલ
पोको: પોલું ખાલી ઠાલું બખોલ કોતર ખો ગુફા પોલ
पोजडें: અશ્લીલ બીભત્સ નઠારું અસભ્ય ગ્રામ્ય ભૂંડું ખરાબ કપટી ધૂર્ત બૂરું નરસું ગંદું આડુંઅવળું ઊલટુંસૂલટું ગટરપટર
पोजडो: કટુભાષી બદજબાન બદજબાં
पोटभर: ભરપેટ પેટભર ધરાઇને
पोटयो: ખાઉધરું ભુખ્ખડ અત્યાહારી અતિભોજી ઉદર_પિશાચ
पोटसरें: સરીસૃપ
पोर: વર્ણસંકર સંકર ભેળસેળિયું મિશ્રિત વિજાત હરામજાદું જારજ જારજ જારજાત વર્ણસંકર હરામજાદું
पोरणें: જીર્ણ જરેલું જર્જર જર્જરિત પ્રાચીન પુરાણું જૂનું પુરાતન આદિમ આદિકાળ પ્રાચ્ય પૂર્વકાલીન પ્રાચીન જૂનું પુરાણું અગાઉનું પૂર્વનું ભૂતકાળ અતીત ભૂત ગત વીતેલ વીતેલું વ્યતીત વિગત
पोल: પોલું ખાલી ઠાલું બખોલ કોતર ખો ગુફા પોલ
पोलो: પોલું ખાલી ઠાલું બખોલ કોતર ખો ગુફા પોલ
पोशिल्लें: પાલતૂ ઘરેલું પાલૂ
प्रखर: તીક્ષ્ણ તીવ્ર કુશાગ્ર પ્રખર તેજ ઉગ્ર પ્રચંડ આકરૂં અકુંઠ અકુંઠિત
प्रगट: અભિવ્યક્ત સ્પષ્ટ સ્ફુટ_કરેલું જાહેર પ્રકટ વ્યક્ત અભિવ્યંજિત જાહિર વિદિત
प्रगतिशील: વિકસિત સુવિકસિત ઉન્નત મુકુલિત વિકચ અભ્યુદિત ઉન્નત
प्रगती_केल्लो: પ્રગતિમાન અગ્રગત
प्रगतीकर्तो: પ્રગતિશીલ અગ્રગામી પુરોગામી અગ્રદર્શી
प्रचलीत: ચલિત ચળેલું સ્થાનભ્રષ્ટ ગતિમાન ગતિમંત પ્રચલિત ચાલુ અનાયત જારી રુઢ જારી
प्रतापी: પ્રતાપી પ્રતાપશાળી પ્રતાપવાળું વિક્રાંત
प्रतिक्षीत: પ્રતીક્ષિત
प्रतिगामी: પ્રતિગામી પશ્વગામી અવળું
प्रतिभावान: પ્રતિભાશાળી પ્રતિભાવાન પ્રતિભાસંપન્ન મતિગર્ભ પ્રગલ્ભ
प्रतिभाशाली: પ્રતિભાશાળી પ્રતિભાવાન પ્રતિભાસંપન્ન મતિગર્ભ પ્રગલ્ભ
प्रतिरुपी: પ્રતિરૂપી સમાંતર અદલોઅદલ એકરૂપ એકાત્મક સમરૂપ
प्रतिश्ठीत: પ્રતિષ્ઠિત આબરૂદાર પ્રખ્યાત પ્રસિદ્ધ વિખ્યાત માનવંત આબરૂદાર માનનીય વિશિષ્ટ
प्रत्यक्ष: ઇંદ્રિયગમ્ય ઇંદ્રિયગોચર ઇંદ્રિયગ્રાહ્ય પ્રત્યક્ષ ગોચર અપરોક્ષ
प्रत्येक: પ્રત્યેક એકેએક હરેક દરેક બધા_જ
प्रथम: પ્રથમ પહેલા પહેલું અવ્વલ આદિનું ૧લું 1લું
प्रदर्शीत: ભજવેલું મંચિત અભિમંચિત પ્રદર્શિત પ્રસિદ્ધ કરેલું જાહેર_કરેલું.
प्रदुशीत: પ્રદૂષિત
प्रदेशीक: પ્રાદેશિક પ્રાંતીય રાજ્ય
प्रमाणीक_वेव्हारी: સદાચારી સદ્વ્યવહારી
प्रमाणीत: પ્રમાણિત નિશ્ચિત નક્કી ઑથેન્ટિક સર્ટિફાઇડ પ્રમાણિત પ્રમાણભૂત પ્રમાણરૂપ વિશ્વાસપાત્ર સાબિત સિદ્ધ પ્રમાણિત પુરવાર
प्रमाणें: પ્રમાણે અનુસાર અનુકૂળ મુતાબિક ફાવતું માફક અનુસાર પ્રણવ સમાન સરખું જેવું સરખું તુલ્ય સમ બરોબર યોગ્ય સરિસ સરીખું અનુહાર અવિષમ એકસરખું
प्रयत्नशील: પ્રયત્નશીલ પ્રયત્નશાળી પ્રયત્નશાલી પ્રયત્નવાન ઉદ્યમી ઉદ્યોગી પ્રયાસી ઉદ્યમશીલ
प्रयोजनार्थी: ગરજમંદ ગરજૂ પ્રયોજની પ્રયોજનાર્થી ગરજવાળું
प्रवाहीत: અવિરત અસ્ખલિત
प्रवेशाचें: પ્રવેશ્ય પ્રવેશનીય
प्रवेशीत: પ્રવિષ્ટ પેઠેલું ઘૂસેલું પ્રવેશિત પેસારેલું આગત અભિનિવેશિત
प्रशंसक: પ્રશંસક વખાણનાર
प्रशिक्षणार्थी: પ્રશિક્ષુ
प्रशिक्षीत: તાલીમબદ્ધ કુશળ પ્રવીણ
प्रसन्न: પ્રસન્ન ખુશ ખુશખુશાલ રાજી આનંદિત હર્ષિત આનંદી પુલકિત આહ્લાદિત આહ્લાદયુક્ત મુદિત મુદમાતું પ્રમુદિત પ્રફુલ્લ પરિતુષ્ટ પ્રફુલ્લિત ઉલ્લસિત ઉલ્લાસિત ઉલ્લાસી તુષ્ટ પ્રહર્ષિત પ્રહૃષ્ટ શાદ અમ્લાન
प्रसन्नचित्त: પ્રસન્નચિત્ત ખુશમિજાજ આનંદી સદાનંદ મોજી ખુશી રાજી
प्रसन्नमूख: પ્રસન્નમુખ પ્રસન્નવદન
प्रसिद्ध: પ્રસિદ્ધ નામી પ્રખ્યાત વિખ્યાત જાહેર નામાંકિત જાણીતું જગજાહેર મશહૂર ખ્યાત નામદાર નામવર નામચીન આખ્યાત સુશ્રુત વિશ્વવિખ્યાત લોકપ્રસિદ્ધ જગવિખ્યાત જગજાહેર વિશ્વપ્રસિદ્ધ જગપ્રસિદ્ધ
प्रस्तावीत: પ્રસ્તાવિત
प्रस्तुतीकरणाचें: મંચનીય મંચ્ય ભજવવા_તોગ્ય
प्रांतीय: પ્રાદેશિક પ્રાંતીય રાજ્ય
प्राकृतीक: પ્રાકૃતિક કુદરતી નૈસર્ગિક પ્રાકૃત પ્રકૃત અકૃત્રિમ સ્વાભાવિક
प्राचीन: પ્રાચીન પુરાણું જૂનું પુરાતન આદિમ આદિકાળ પ્રાચ્ય
प्राणघातक: જીવલેણ પ્રાણઘાતક પ્રાણહારક કાતિલ ઘાતક પ્રાણાંતક
प्राथमीक: આરંભિક પ્રારંભિક પ્રાથમિક આરંભનું શરૂઆતનું આરંભમાણ
प्रादेशीक: પ્રાદેશિક પ્રાંતીય રાજ્ય
प्राप्त: પ્રાપ્ત મેળવેલું મેળવાયેલું મળેલું ઉપાર્જિત હસ્તગત પ્રસ્તુત સ્વાધીન સંપ્રાપ્ત પામેલું વસૂલ
प्राप्त_करपी: મેળવનાર સ્વીકારનાર લેનાર પ્રાપ્તકર્તા પ્રાપક પ્રાપ્ત_કર્તા આદાતા ગ્રહણ_કરનાર લેનાર
प्राप्त_केल्लें: ઉપ્લબ્ધ પ્રાપ્ત મેળવેલું મળેલું હાથવગુ સુલભ હસ્તપટુ
प्रामाणीक: વિશ્વાસુ વિશ્વાસપાત્ર વફાદાર ભરોસાપાત્ર વિશ્વસનીય ખાતરી_લાયક પ્રમાણભૂત પ્રમાણિક વિશ્વાસપાત્ર આધારરૂપ પ્રમાણરૂપ સાબિતીરૂપ પ્રમાણિક ઈમાનદાર વિશ્વાસપાત્ર ઈમાની ઋજુ સત્યપર સત્યપરાયણ નિષ્કપટ નિખાલસ સાચું ખરૂં નેકદિલ પ્રામાણિક સદાશય
प्रारब्दवादी: ભાગ્યવાદી પ્રારબ્ધવાદી દૈવવાદી
प्रासंगीक: પ્રસ્તુત પ્રાસંગિક પ્રસંગ-સંબંધી પ્રસંગોચિત પ્રસંગાનુસાર આનુસંગિક
प्रीयभाशी: મીઠાબોલું પ્રિયભાષી પ્રિયંવદ
प्रेत_खायरें: શબ_ભક્ષી લાશભક્ષી
प्रेमपूर्ण: પ્રેમમય પ્રેમપૂર્ણ આશિકાના
प्रेममय: પ્રેમમય પ્રેમપૂર્ણ આશિકાના
प्रेमासक्त: પ્રેમાતુર પ્રેમાસક્ત અનુરાગી અનુરક્ત મોહિત ફિદા અનુરાગયુક્ત ભાવક
प्रेरणा_दिवपी: પ્રેરણાત્મક પ્રેરણાદાયક પ્રેરણાદાયી પ્રેરણારૂપ
प्रेरणादायक: પ્રેરણાત્મક પ્રેરણાદાયક પ્રેરણાદાયી પ્રેરણારૂપ
प्रेरणास्पद: પ્રેરણાત્મક પ્રેરણાદાયક પ્રેરણાદાયી પ્રેરણારૂપ
प्रेशीत: પ્રેષિત મોકલેલું સંપ્રેષિત
प्रोत्साहक: પ્રોત્સાહક
प्रोत्साहीत: પ્રોત્સાહિત ઉત્તેજિત
फकत: કેવળ માત્ર ફક્ત બસ ખાલી એકમાત્ર કેવલ
फकीर: ટટપૂંજિયું ટુટપૂંજિયું
फटकिरें: અસત્યવાદી ખોટો અસત્યભાષી મિથ્યાભાષી મિથ્યાવાદી અસત્યસેવી ખોટાબોલું ખોટું જૂઠું અસત્ય મિથ્યા અસત્યતાપૂર્ણ મિથ્યાપૂર્ણ અસત અસત્ મૃષાવચન અલીક અવિદ્યમાન અમૂલક
फटकिरो: કૂટકારક કૂટકાર
फटकीरपणाचें: ખોટું જૂઠું અસત્ય મિથ્યા અસત્યતાપૂર્ણ મિથ્યાપૂર્ણ અસત અસત્ મૃષાવચન અલીક અવિદ્યમાન અમૂલક
फटाश्यो_मारपी: બડાઈખોર ડંફાશિયું શેખીખોર પતરાજીખોર ગપ્પોરી શેખી ઝલ્લી ગપ્પીદાસ
फटींग: અસત્યવાદી ખોટો અસત્યભાષી મિથ્યાભાષી મિથ્યાવાદી અસત્યસેવી ખોટાબોલું નિરાધાર અકારણ આધારશૂન્ય અપ્રમાણિક અપ્રામાણિક આધારહીન નિર્મૂલ સારહીન અનાધાર યથાર્થહીન આધારરહિત વિશ્વાસઘાતી દગલબાજ કપટી ધૂર્ત ચારસો_વીસ ફરેબી અસભ્ય અવિનયી બેઅદબ ઉદ્ધત અશિષ્ટ અણઘડ ગ્રામ્ય જંગલી અસંસ્કારી અભદ્ર અસાધુ દુષ્ટ ખરાબ આચારભ્રષ્ટ લઠ્ઠ લુચ્ચું લુચ્ચુંલફંગું બદમાશ ખંધું લફંગું દોંગું કૂટકારક કૂટકાર બેઇમાન વિશ્વાસઘાતી અવિશ્વસનીય ગદ્દાર દગાબાજ દગલબાજ પ્રપંચી ધૂર્ત ચાલબાજ શાતિર વિશ્વાસઘાતી શઠ હોશિયાર વક્રગામી કિતવ કૈવત પ્રતારક ચંટ વક્રગામી દ્વિભાવ કપટી
फटीचें: ખોટું જૂઠું અસત્ય મિથ્યા અસત્યતાપૂર્ણ મિથ્યાપૂર્ણ અસત અસત્ મૃષાવચન અલીક અવિદ્યમાન અમૂલક કપોલકલ્પિત હવાઈ
फडफडीत: તાજુ અમ્લાન અશુષ્ક
फरारी: ભાગેડુ ફરાર ગાયબ ફરારી રફુચક્કર ઉડનછૂ ચંપત પલાયન અપગત અપસરક
फळां_दिवपी: ફલદાયી ફળાઉ ફલદાયક
फळां_लागपी: ફલદાયી ફળાઉ ફલદાયક
फळां_लागिल्लें: ફળદાર ફળવાન ફળવાળુ
फळांचें: ફળદાર ફળવાન ફળવાળુ
फळादीक: સફળ કામયાબ કૃતાર્થ સિદ્ધ સાર્થક કૃતકૃત્ય સફળતા
फळादीक.: ફલિત પરિણત ફળીભૂત
फांकिल्लें: વેરાવું ફેલવું પ્રસરવું ફાલવું પ્રકિર્ણ વિકીર્ણ
फांटो: ઘટાદાર ડાળીદાર
फांफार्रांव: ધૃષ્ટ હિંમતવાન ઉદ્ધત નિડર ઉચ્છૃંખલ ઉછાંછળું અવિવેકી હઠીલું સ્વચ્છંદી
फाकिवंत: પ્રસિદ્ધ નામી પ્રખ્યાત વિખ્યાત જાહેર નામાંકિત જાણીતું જગજાહેર મશહૂર ખ્યાત નામદાર નામવર નામચીન આખ્યાત સુશ્રુત
फाटलें: પાછલું પાછળનું પૃષ્ઠ
फाटल्या: ભૂતકાળ અતીત ભૂત ગત વીતેલ વીતેલું વ્યતીત વિગત
फाटल्यान: પરોક્ષ અપ્રત્યક્ષ આડકતરું
फाटीं_उरिल्लो: પાછળ_રહેવું પાછળ_પડવું પ્રતિગત સુસ્ત મંદ
फाटीचें: ખોટા નકલી નકલરૂપ બનાવટી કૃત્રિમ પોકળ મિથ્યા જૂઠું જૂઠાણું પોલું
फातरा_काळजाचो: સંગદિલ કઠોરહૃદય નિર્દય ક્રૂર પથ્થરદિલ
फाफशिल्लें: વેરાવું ફેલવું પ્રસરવું ફાલવું પ્રકિર્ણ વિકીર્ણ
फामाद: પ્રસિદ્ધ નામી પ્રખ્યાત વિખ્યાત જાહેર નામાંકિત જાણીતું જગજાહેર મશહૂર ખ્યાત નામદાર નામવર નામચીન આખ્યાત સુશ્રુત સુપ્રસિદ્ધ પ્રસિદ્ધ સુવિખ્યાત સુખ્યાત ખ્યાત જાણીતું પંકાયેલું પ્રખ્યાત મશહૂર વિશ્વવિખ્યાત લોકપ્રસિદ્ધ જગવિખ્યાત જગજાહેર વિશ્વપ્રસિદ્ધ જગપ્રસિદ્ધ
फायद्याचें: લાભપ્રદ લાભદાયક લાભકારી ફાયદાકારક લાભકર લાભકર્તા લાભકારક ફાયદેમંદ ફાયદામંદ ગુણકારી ઉપયોગી હિતકારી મુફીદ અર્થકર
फारावपी: ઉઠાઉગીર ઉચક્કો ઠગ લુચ્ચો બદમાશ
फाराविल्लो: ખલવું ખલાવું ફસેલું સપડાવું ભરાવું
फारीक_करिनासपा_सारकें: અદેય
फारीक_केल्लें: ચૂકતું બેબાક અદા ચૂકવી_દીધેલ ભરપાઈ_કરેલ
फारीक_ना_करी_सारकें: અદેય
फालतू: બકબકાટ;_લવારો બકવાટો અસંગત ઉટપટાંગ ઉટપટંગ ઉટંગ તરંગી અગડબગડ અગડંબગડં ગોટાળો ગડબડગોટો અષ્ટંપષ્ટં સટરપટર નિરુપયોગી બિનઉપયોગી બિનજરૂરી નકામું મિથ્યા બાતલ અનુપયોગી અનુપયુક્ત વ્યર્થ ફાલતુ બેકાર બેકામ રદ્દી અલીક નીચ ઘટિયા હીન નિકૃષ્ટ અધમ હલકું નઠારું તુચ્છ ક્ષુદ્ર મ્લેચ્છ પોચ નકામું બિનજરૂરી ઉપયોગ_વિનાનું વ્યર્થ ફોગટ ફાલતું જરૂરિયાત_વિનાનું અર્થહીન અર્થરહિત નિરર્થક નકામું અર્થશૂન્ય વ્યર્થ ફોગટ મિથ્યા ફોગટ એળે બેકાર ફોક બેકામ નાહક અમસ્તું વૃથા ખાલી મૃષા અનૃત
फाळीक_लागिल्लो: મરણોન્મુખ મરણાસન્ન આસન્નમરણ મરણાંત મુમૂર્ષુ મુમૂર્ષ
फावोशें: પ્રમાણે અનુસાર અનુકૂળ મુતાબિક ફાવતું માફક અનુસાર પ્રણવ સંગત સંબદ્ધ યોગ્ય વ્યાજબી જાયજ વાજબી યથાર્થ ઉચિત મુનાસિબ
फिकें: રંગહીન વર્ણહીન બેરંગ બેરંગી અવર્ણ વર્ણશૂન્ય અવરણ વિવર્ણ નિરંગ
फिटफिटें: નબળું બોદું કમજોર નાજુક
फिन: બુદ્ધિમાન બુદ્ધિશાળી હોશિયાર સમઝદાર સમઝુ અક્કલમંદ શાણું ડાહ્યું હોશિયાર કુશળ બુદ્ધિમંત મેઘાવી મતિમંત અમૂઢ મતિમાન દાનિશમંદ પાટવિક પટુ આકિલ આકેલ
फिशाल: યોગ્ય લાયક કાબેલ સમર્થ અભિજાત ઉદાત્ત બુદ્ધિમાન બુદ્ધિશાળી હોશિયાર સમઝદાર સમઝુ અક્કલમંદ શાણું ડાહ્યું હોશિયાર કુશળ બુદ્ધિમંત મેઘાવી મતિમંત અમૂઢ મતિમાન દાનિશમંદ પાટવિક પટુ આકિલ આકેલ
फीट: તંગ ટૂકું ચુસ્ત સત્ખ ચપોચપ સાંકડું
फुकट: મફત નિશુલ્ક વગર_પૈસે
फुटकें: ફાટું-તૂટું જીર્ણ જર્જરિત
फुटिल्लें: ફાટેલું
फुटीर: અસંગઠિત સંગઠનહીન
फुटें: બેસ્વાદ નીરસ નિષ્પ્રાણ
फुडलो: અગ્ર આગળનો પૂર્વ સામેનો પુરોગામી અગ્રગામી પૂર્વગામી
फुडल्या: આગામી આવનારું ભવિષ્યનું ભાવી
फुडाराचें: ભવિષ્યકાળ આવનારું ભવિષ્ય_કાલીન ભાવી સંભાવિત આગળનું આગલું ભવ્ય અનાગત ભાવિતા
फुलां_बगरचें: પુષ્પહીન અપુષ્પિત પુષ્પરહિત અપુષ્પ કુસુમરહિત
फुलांनी_भरिल्लें: પુષ્પિત પુષ્પયુક્ત પુષ્પરૂપ મંજરિત
फुलिल्लें: પુષ્પિત વિકસિત પ્રફુલ્લિત ખીલેલું ખીલેલું પ્રસ્ફુટિત સ્ફુટિત પ્રફુલ્લ વિકસિત
फुलूंक_नाशिल्लें: અપુષ્પિત અણખીલેલું અણખીલ્યું અવિકસિત અફુલ્લ
फुश्यारी_मारपी: બડાઈખોર ડંફાશિયું શેખીખોર પતરાજીખોર ગપ્પોરી શેખી ઝલ્લી ગપ્પીદાસ
फॅल: નાપાસ અનુત્તીર્ણ નપાસ ફેલ
फेडिनासपा_सारकें: અદેય
फॉरेन: વિદેશી પરદેશી વિલાયતી અન્યદેશીય દેશાવરનું
फोराचें: બાઇન્ડિંગ વેષ્ટન
फोर्त: મજબૂત ઠોસ દૃઢ પાક્કું જબરદસ્ત જોરાવર જબરું જબરજસ્ત જબ્બર જબર અભંગુર અશિથિલ
फोलगी: અપવ્યયી ઉડાઉ ઉડાવનારૂં ઉડાવનારું
फोल्गी: ખર્ચાળુ ખર્ચાળ અપવ્યયી વ્યયી ઉડાઉ અતિવ્યયી વિલાસી ભોગવિલાસી ઐયાશ એશઆરામી રંગીન
फ्राक: કમજોર દુર્બળ દુર્બળ નિર્બલ નિર્બળ અબલ અપ્રબલ બલહીન અવીર અસક્ત અસહાય લાચાર પરાધીન નિરાશ્રય શક્તિહીન અલ્પબલ અવીર નામર્દ
बंडखोर: વિદ્રોહી બાગી બંડખોર બળવાખોર રાજદ્રોહી ગદ્દાર
बंद: બંધ અવરુદ્ધ અટકાવેલું રોકેલું રુંધેલું
बंदखणीचे: કેદખાનું હવાલાતી
बंदिस्त: બંદીવાન કેદી બંધક
बंदो: ચાપલૂસ ખુશામદિયું માખણિયું ચમચો અનુયાયી આશ્રિત
बकासूर: ખાઉધરું ભુખ્ખડ અત્યાહારી અતિભોજી ઉદર_પિશાચ
बकें: દૂબળો-પાતળો દુબળો દુર્બળ કૃશોદર ક્ષીણ કૃશ પાતર અર્ભક ક્ષીણકાય સુકલકડી દૂબળુંપાતળું નબળુંપાતળું
बडबडे: વાચાળ વાતોડિયું બહુબોલું બટકબોલું
बडबडें: બકવાસી બકવાટી લવારો
बडबडेचें: બકબકાટ;_લવારો બકવાટો અસંગત ઉટપટાંગ ઉટપટંગ ઉટંગ તરંગી અગડબગડ અગડંબગડં ગોટાળો ગડબડગોટો અષ્ટંપષ્ટં સટરપટર
बडबडो: પ્રલાપી પ્રલાપક બકવાદી મગજચટ બહુબોલું બોલકણું દિમાગચટ
बडाय_मारपी: બડાઈખોર ડંફાશિયું શેખીખોર પતરાજીખોર ગપ્પોરી શેખી ઝલ્લી ગપ્પીદાસ
बडीची: પૈતૃક પૈત્રુક વડીલોપાર્જિત પિતૃપક્ષનું વંશાનુગત આનુવંશિક વારસાગત ખાનદાની
बडीचें: આનુવંશિક પૈતૃક બાપીકું વારસાગત કુલક્રમાગત પેઢીઉતાર વંશપરંપરાગત મૌરૂસી પેઢીધર
बत्तीस_दांतांचो: કલજિભા
बदल: પરિવર્તિત પલટાવેલું બદલાયેલું તબ્દીલ
बदलनासपी: અપરિવર્તનશીલ અપરિવર્તનીય
बदलपी: પરિવર્તનશીલ પરિવર્તી પરિવર્તનીય બદલાતું ફેરવાતું
बदली_केल्लो: સ્થાનાંતરિત સ્થલાંતરિત
बदिस्त: આબદ્ધ નિબદ્ધ સંબદ્ધ બાંધેલું અમુક્ત બંધાયેલું પાબંધ અવિમુક્ત
बद्‍दल: વિષયક સંબંધી સંબંધવાળું અન્વયી અનુષંગી સંયુક્ત
बनावट: બનાવટી દેખાવટી ઉપરછલ્લું ઉપર_ઉપરથી સહેજ_સાજ દેખાવ-ડોળ બનાવટી નકલી કૃત્રિમ અપ્રાકૃતિક અપ્રકૃત અસ્વાભાવિક_આહાર્ય કપોલકલ્પિત હવાઈ
बरयल्लें: કાગજી
बरयल्लो: લિખિત લખેલું લેખિત લખેલ લિપિબદ્ધ અંકિત મકતૂબ
बरयिल्लें: લેખાકૃત અભિલિખિત લેખાંકિત
बरी: ઉત્તમ શ્રેષ્ઠ ઉત્કૃષ્ટ અનમોલ ઉમદા પ્રશસ્ત નાયાબ વિરલ અનન્ય પ્રશસ્ય અવ્વલ આકર આગર
बरे_वळखीचो: સુપરિચીત
बरें: ભલા સદ્ગૃહસ્થ સારા સજ્જન સભ્ય ભદ્ર સારા શ્લીલ ચિકિત્સ્ય સાધ્ય ઉપચાર્ય નિવાર્ય નિવારણીય સ્વાદિષ્ટ સ્વાદુ રોચક_સ્વાદવાળું સારું લહેજતદાર લિજ્જતદાર લહેજતવાળું
बरें_जायना__अशें: અસાધ્ય દુ લાઇલાજ ઉપાયશૂન્ય અવાર્ય
बरें_मागपी: હિતેચ્છુ હિતૈષી શુભેચ્છક હિતચિંતક શુભચિંતક
बरो: સજ્જન સદ્ગૃહસ્થ સભ્ય નેક સદ્ગુણી શીલવાન શરીફ અશઠ સારું ઉત્તમ ઉત્તમતર શ્રેષ્ઠ બહેતર ઠીક બેટર
बर्फाळ: બરફનું બરફવાળું બરફને_લીધે_પેદા_થતું
बलात्कारी: બળાત્કાર બલાત્કારી
बल्ल: જાડો સ્થૂળ સ્થૂળકાય ભારે ધીંગો પીવર
बळकट: કસાયેલું ઘડાયેલ સુગઠિત ચુસ્ત
बळजबरी_करपी: બળાત્કાર બલાત્કારી
बळादीक: શક્તિશાળી બળવાન તાકતવર સબળ સશક્ત શક્તિવાન બલિષ્ઠ બળશાળી શક્તિમાન જબ્બર જબર જબરજસ્ત જબરદસ્ત જોરાવર જબરું બલવંત બળીયું અપરબલ શક્તિસંપન્ન ધુરંધર
बळिश्ट: શક્તિશાળી બળવાન તાકતવર સબળ સશક્ત શક્તિવાન બલિષ્ઠ બળશાળી શક્તિમાન જબ્બર જબર જબરજસ્ત જબરદસ્ત જોરાવર જબરું બલવંત બળીયું અપરબલ શક્તિસંપન્ન ધુરંધર મજબૂત ઠોસ દૃઢ પાક્કું જબરદસ્ત જોરાવર જબરું જબરજસ્ત જબ્બર જબર અભંગુર અશિથિલ કસાયેલું ઘડાયેલ સુગઠિત ચુસ્ત
बहिर्दृश्टी: બહિર્મુખી
बहिर्मूख: બહિર્મુખી
बांदिल्लें: રચિત નિર્મિત વિરચિત સૃષ્ટ કૃત સર્જિત પ્રણીત
बाकी: બાકી બકાયા દાતવ્ય દેય
बाकीचें: બચેલું બચેલું-ખુચેલું વધ્યું-ઘટ્યું અવિષ્ટ અવશેષ વધેલું બાકી_રહેલું બાકી ખૂટતું શેષ અધૂરૂં અપૂર્ણ
बागवल्लें: ઝૂકવું નમવું
बाजारांतलें: બજારુ બજારને_લગતું બજારમાં_ચાલતું
बाजाराचें: બજારુ બજારને_લગતું બજારમાં_ચાલતું
बाजारी: બજારુ બજારને_લગતું બજારમાં_ચાલતું
बाद: નકામું નિરુદ્યમી નવરૂં આળસું પ્રમાદી બેકાર એદી ફાલતુ નિરુદ્યમી અકર્મી નાલાયક ફલાણું કોઈ ચોક્કસ
बादीत: ક્ષતિગ્રસ્ત
बाधक: અવરોધક અવરોધી બાધક પ્રતિબંધક અનુરોધક અનુરોધી
बापोल: પિતરાઈ પિત્રાઈ
बापोलयो: પિતરાઈ પિત્રાઈ
बायजणपणाचे: સ્ત્રૈણ સ્ત્રૈણ_ગુણવાળું
बायजणपणाचें: સ્ત્રૈણ સ્ત્રીના_સ્વભાવનું
बायलांचें: જનાના સ્ત્રીઓનું સ્ત્રી-સંબંધી સ્ત્રૈણ સ્ત્રૈણ_ગુણવાળું
बायलाडे: સ્ત્રૈણ સ્ત્રૈણ_ગુણવાળું
बायलाडें: સ્ત્રૈણ સ્ત્રીના_સ્વભાવનું
बायलेचे: સ્ત્રૈણ સ્ત્રીનું સ્ત્રી-સંબંધી સ્ત્રી_સંબંધી
बारा: બાર ડઝન ડઝનબંધ ૧૨ 12
बारामाही: બારમાસી વર્ષસ્થાયી સદાબહાર બારમાસી બાર_માસનું બારે_મહિના_ઉત્પન્ન_થનારું બારે_મહિના_ફૂલનારું
बारीक: દૂબળો-પાતળો દુબળો દુર્બળ કૃશોદર ક્ષીણ કૃશ પાતર અર્ભક ક્ષીણકાય સુકલકડી દૂબળુંપાતળું નબળુંપાતળું સૂક્ષ્મ બારીક ઝીણું ક્ષુદ્ર
बारीकसाणेचो.: મક્ખીચૂસ કફનખસોટ
बालपण: બાલિશ છોકરમત છોકરવાદ
बालोपयोगी: બાલોપયોગી બાળકોના_કામનું
बाळंटेर: આસન્નપ્રસવા
बाळक: નવજાત સદ્યોજાત
बावट्याचें: ધજાળું પતાકાયુક્ત
बावन: બાવન ૫૨ 52
बाविल्लें: નિસ્તેજ તેજહીન તેજોહીન ઝાંખું ફીકું પ્રભાહીન આભાહીન મુરઝાયેલું અપ્રભ નિસ્તેજ કરમાયેલ મ્લાન ઉદાસ ખિન્ન ગમગીન શોકાતુર દિલગીર અનમના અનમન મ્લાન અન્યમન અન્યમનસ્ક વિરક્ત અમનસ્ક અપ્રસન્ન
बावीस: બાવીસ બાવીશ દ્વાવિંશતિ ૨૨ 22
बावीसावें: બાવીસમું ૨૨મું 22મું
बाशें: વાસી બગડેલું પર્યુષિત
बासठ: બાસઠ ૬૨ 62
बाह्य: બાહ્ય બહિરંગ
बिकट: પ્રતિકૂળ વિરુદ્ધ ઊલટું ખિલાફ અગવડકારક ખિલાફ અસૂત વામ વિપરીત
बिगरनिवासी: પ્રવાસી પ્રોષિત
बिनकांटयारें: અકંટક નિષ્કંટક કંટકહીન શૂલહીન
बिनराखीव: અનારક્ષિત
बिनविरोध: નિર્વિઘ્ન અવિરોધ
बियेचें: બીજૂ
बीन_विखारी: વિષહીન વિષરહિત અવિષ
बीनतारी: બેતાર બિનતારી વાયરલેસ
बुंदेलखंडी: બુંદેલખંડી
बुडकुलो: ગોળમટોળ હૃષ્ટપુષ્ટ જાડું
बुडिल्लो: અસ્ત અસ્તગત આથમેલું ડૂબેલું
बुदवंत: બુદ્ધિજીવી બુદ્ધિમાન બુદ્ધિશાળી હોશિયાર સમઝદાર સમઝુ અક્કલમંદ શાણું ડાહ્યું હોશિયાર કુશળ બુદ્ધિમંત મેઘાવી મતિમંત અમૂઢ મતિમાન દાનિશમંદ પાટવિક પટુ આકિલ આકેલ વિદ્વાન જ્ઞાનવાન પંડિત જ્ઞાની વિબુધ જ્ઞાતા વિદ્વત વેત્તા ભિજ્ઞ
बुद्दिजिवी: બુદ્ધિજીવી
बुन्यादीक: આધારભૂત પ્રમાણભૂત મૂળભૂત મૂળગત મૂળ મૌલિક મૂલ
बुरकाचें: છિદ્રિત છિદ્રવાળું
बुरशें: મેલુ અસ્વચ્છ ખરાબ અપવિત્ર અશુધ્ધ ગંધારુ બગડેલું દૂષિત અવિમલ અનિર્મલ અવિશુધ્ધ અશુચિ મ્લાન મલિન ગંદુ અશ્લીલ બીભત્સ નઠારું અસભ્ય ગ્રામ્ય ભૂંડું ખરાબ કપટી ધૂર્ત બૂરું નરસું ગંદું આડુંઅવળું ઊલટુંસૂલટું ગટરપટર
बुराक_नाशिल्लें: અછિદ્ર અછિદ્રી છિદ્ર_વિહીન અચ્છિદ્ર
बुराकाची: કાણાંવાળું છિદ્રયુક્ત છિદ્રમય રંધ્રયુક્ત સુષિર
बेकायदेशीर: ગેરકાનૂની અવૈધ અમાન્ય ગેરકાયદે ગેરવાજબી નિયમવિરુદ્ધ અવૈધાનિક
बेकार: ઉદ્યમહીન નિરુદ્યમી પુરુષાર્થહીન અયત્ન ઉદ્યોગહીન અકર્મઠ નકામું નિરુદ્યમી નવરૂં આળસું પ્રમાદી બેકાર એદી ફાલતુ નિરુદ્યમી અકર્મી નાલાયક નવરો અવ્યસ્ત ખાલી બેકાર બેરોજગાર ઉદ્યમ_રહિત નવરૂં નિરુદ્યમ આજીવિકાહીન
बेकारलवडी: નકામું નિરુદ્યમી નવરૂં આળસું પ્રમાદી બેકાર એદી ફાલતુ નિરુદ્યમી અકર્મી નાલાયક
बेगडी: બનાવટી દેખાવટી ઉપરછલ્લું ઉપર_ઉપરથી સહેજ_સાજ દેખાવ-ડોળ બનાવટી નકલી કૃત્રિમ અપ્રાકૃતિક અપ્રકૃત અસ્વાભાવિક_આહાર્ય વ્યવસ્થિત નવું_નક્કોર ભભકાદાર સજીલું સજધજ છેલછબીલા રંગીલું અલબેલું ફાંકડું ઔપચારિક ઉપચાર_પૂરતું
बेगीन: તીવ્ર વેગીલું તેજ દ્રુત ઉડતું
बेघर: ઘરબારી ઘરબારવાળું સંસારી ગૃહસ્થાશ્રમી બેઘર આવાસહીન ઘરવિહોણું અનિકેત નિવાસ_રહિત
बेचैन: વ્યાકુળ બાવરું વિહ્વલ આકુળ અભિભૂત બેબાકળું બેચેન બેચૈન
बेजार: નાખુશ નારાજ અપ્રસન્ન ઉદાસ રુષ્ટ ક્રુદ્ધ કુપિત ખફા ઇતરાજ હતાશ નિરાશ નાઉમેદ નાસીપાસ ભગ્નાશ આશાભંગ નિરાશ આશાહીન નાઉમેદ આશાભંગ ભગ્નાશ હતાશ
बेजारदिणें: કંટાળાજનક ઉબાઊ
बेजारिल्लें: ઊબાયેલું બેજાર કંટાળી_ગયેલું ઉકતાઈ_ગયેલું ઉકતાયેલું ઉબાઈ_ગયેલું
बेताल: બેતાલ બેતાલું તાલહીન
बेनाळ: બેનાળી દોનલી દુનાલી દુનલી
बेनुल्ल: આશ્રિત ઓશિયાળું
बेपरवा: ઉપેક્ષ્ય ઉપેક્ષણીય લંઘનીય લંઘ્ય
बेपरवाय: બેદરકાર બેપરવા અચિંત બિંદાસ બેફિકર બેગરજ બેતમા અલગારી નચિંત અલમસ્ત
बेबदो: નશાખોર નશાબાજ નશેબાજ અમલી વ્યસની બંધાણી કેફી
बेमुदत: અનવધિ અમર્યાદ અપાર અનંત
बेयमान: કૃતઘ્ન કૃતજ્ઞ કૃતઘ્ની અપકારી નિમકહરામ લૂણહરામ બેઇમાન વિશ્વાસઘાતી અવિશ્વસનીય ગદ્દાર
बेवारशी: અનાથ લાવારિસ યતીમ નિરાધાર લાવારીસ અનાથ સડકછાપ અપતિ
बेशुद्ध: બેભાન બેહોશ અચેત બેખબર બેસુધ બેશુદ્ધ મૂર્ચ્છિત મૂર્છિત અચેતન નિસસ ચેતનાહીન ચેતનાશૂન્ય
बेसावध: અસાવધાન અસાવધ ગાફેલ બેદરકાર બેખબર અચેત ગાફલ બેધ્યાન
बेसूर: બેસૂરું બસૂરું કર્કશ વિરોધી વિસંવાદી
बोंडें: મૂર્ખ મૂરખ અબૂધ અક્કલહીન ઠોઠ ગમાર બેવકૂફ બુદ્ધિહીન નાદાન મતિમંદ મૂઢ અબૂજ અજ્ઞાની બેસમજ અંધ કમઅક્કલ મૂઢમતિ મૂઢબુદ્ધિ અણસમજુ અલ્પબુદ્ધિ શીન અવિદ પામર
बोडकीं: પર્ણહીન
बोडकें: ઠૂંઠું
बोडको: પત્રરહીત પર્ણહીન નિષ્પત્ર અપત્ર અદલ અપત
बोधपूर्ण: જ્ઞાનમય જ્ઞાનપૂર્ણ જ્ઞાની ચિન્મય
बोध्य: બોધ્ય બોધગ્મ સરળ સુગમ સુબોધ આસાન સુગમ્ય
बौद्ध: બૌદ્ધ
बौद्ध_धर्मावलंबी: બૌદ્ધ બૌદ્ધ_ધર્માવલંબી
ब्याणव: બાણું બાણુ ૯૨ 92
ब्रह्मज्ञानी: બ્રહ્મજ્ઞાની બ્રહ્મજ્ઞ આધ્યાત્મજ્ઞાન સિદ્ધ
ब्रह्मांडांतलें: બ્રહ્માંડીય બ્રહ્માંડનું
भंगीत: ખંડિત ભાગેલું ભગ્ન વિખંડિત તૂટેલું છિન્ન છિન્નભિન્ન
भंयकर: પ્રચંડ ભયાનક ભયંકર બિહામણું ડરામણું બીકવાળું વિકરાળ ઘોર ભીષણ ભયાવહ ઉગ્ર રૌદ્ર રુદ્ર મહાચંડ કરાલ ખૂંખાર રૌરવ વિષમ દારુણ તામ
भंयभीत: ભયભીત ડરી_ગયેલું બી_ગયેલું ભીત બીધેલું ડરેલું ભય_પામેલું આતંકિત ત્રસ્ત ત્રાસિત ક્ષુબ્ધ
भक्तवत्सल: ભક્તવત્સલ
भक्तिपूर्ण: ભક્તિપૂર્ણ ભક્તિથી_ભરેલું ભક્તિયુક્ત
भक्तीहीण: અભક્ત ભક્તિહીન અભગત
भक्षक: ભક્ષી ભક્ષક ખાનાર ખાદક આશી
भक्ष्य: ખાદ્ય ભોજ્ય આહાર્ય અશનીય ભક્ષ્ય
भगवें: ભગવું ગૈરિક ભૂખરૂં લાલ કુસુંભી રાતું
भगवो: કેશરી કેસરી ભગવું કેસરીયું જાફરાની
भटकें: ભ્રમણશીલ રખડુ યાયાવર રમતારામ અતિચારી
भडक: ઉત્તેજક ઉદ્દીપક ભડકાઉ ઉત્તેજનાપ્રદ ભભકદાર ભપકાવાળું ચમકદાર ભપકાદાર ભડકદાર ચમકદાર
भड्डो: કકરા મોટા
भयंकर: વિકરાળ દારુણ ભયાનક
भयभीत: ભયપૂર્ણ ભયયુક્ત ભયાત્મક ભયમય
भयरो: બહેરું બધિર શ્રોતહીન
भयांकृत: નિર્દય ક્રૂર ઘાતકી દયાહીન નિર્દયી કસાઈ નિષ્ઠુર કઠોર અમમ અદય અદયાળુ નિર્ઘૂણ કરુણા_વિહીન કરુણાહીન અઘૃણ પ્રચંડ ભયાનક ભયંકર બિહામણું ડરામણું બીકવાળું વિકરાળ ઘોર ભીષણ ભયાવહ ઉગ્ર રૌદ્ર રુદ્ર મહાચંડ કરાલ ખૂંખાર રૌરવ વિષમ દારુણ તામ
भयानक: આક્રમક આક્રમકતાપૂર્ણ અભિધાવક પ્રચંડ ભયાનક ભયંકર બિહામણું ડરામણું બીકવાળું વિકરાળ ઘોર ભીષણ ભયાવહ ઉગ્ર રૌદ્ર રુદ્ર મહાચંડ કરાલ ખૂંખાર રૌરવ વિષમ દારુણ તામ
भरड: કકરા મોટા
भरदस्त: ભારે વજનદાર વજની બોઝલ પીવર
भरपूर: પુષ્કળ ખૂબ અતિશય ઘણું બહુ અત્યાધિક અધિક વધારે અતિ બેહદ બેશુમાર અસીમ વિપુલ ઝાઝું ઘણુંવધારે અમાપ અપાર અખૂટ બેપનાહ બેહિસાબ અલેશ અમિત ખૂબ પુષ્કળ બહુ અતિ વિશેષ અત્યંત અતિશય વિપુલ અગાધ અપાર બેશુમાર બેહદ અસીમ
भरशिल्लें: સંમિલિત મિશ્ર મિશ્રિત એકઠું ભેગું મળેલું
भरिल्लें: પરિપૂર્ણ ભરપૂર પૂર્ણ સભર અવપૂર્ણ પરિપૂર્ણ ભરેલું ચૂકતું બેબાક અદા ચૂકવી_દીધેલ ભરપાઈ_કરેલ સંમિલિત મિશ્ર મિશ્રિત એકઠું ભેગું મળેલું
भलायकेक_बरें: સ્વાસ્થ્યપ્રદ આરોગ્યદાયક આરોગ્યપ્રદ આરોગ્યદાયી
भलायकेवंत: સ્વસ્થ નીરોગી તંદુરસ્ત સેહત સારું આરોગ્ય વ્યાધિ_રહિત નિરામય અનામય ફિટ અગદ સારું અરોગી સેહતમંદ રોગરહીત ચંગુ વ્યાધિહીન
भलें: ભલા સદ્ગૃહસ્થ સારા સજ્જન
भव्य: મહાકાય કદાવર અતિકાય વિશાળકાય ભીમકાય વિકરાળ બૃહત્કાય વિશાળ વિશાળકાય વિરાટ ભવ્ય અઝીમ મહા
भशेन: સમાન સરખું જેવું સરખું તુલ્ય સમ બરોબર યોગ્ય સરિસ સરીખું અનુહાર અવિષમ એકસરખું જેવું સરખું સરિખુ સમ
भांगरा_पसून_तयार_केल्ली: સુવર્ણ_નિર્મિત કાંચન હૈમ
भांगराची: સુવર્ણ_નિર્મિત કાંચન હૈમ
भाग्यशाली: ભાગ્યશાળી નસીબદાર સદ્ભાગી સુભાગી ખુશનસીબ ખુશકિસ્મત ભાગ્યવાન
भाट: પ્રશંસક વખાણનાર
भाड्याच्यो: લવાજમવાળી શુલ્કવાળી
भायलें: બાહ્ય બહિરંગ વિદેશી પરદેશી વિલાયતી અન્યદેશીય દેશાવરનું
भायलो: વિદેશી પરદેશી દેશાવરી વિલાયતી અન્યદેશીય અજનવી અજનબી
भायल्याचें: પારકું પરાયું બીજાનું ગેર પરકીય
भारतीय: ભારતીય હિન્દુસ્તાની હિંદી હિંદુસ્તાની
भावपूर्ण: ભાવપૂર્વક માર્મિક ભાવાત્મક મર્મસ્પર્શી ભાવક ભાવનાપૂર્ણ હ્રદયસ્પર્શી
भाविल्लें: પ્રિય વહાલું ગમતું અજીજ પ્યારૂં પ્રીતિકર
भावी: આગામી આવનારું ભવિષ્યનું ભાવી
भावीक: ભક્તિપૂર્ણ ભક્તિથી_ભરેલું ભક્તિયુક્ત
भावूक: ભાવુક સહૃદય દયાળુ લાગણીશીલ દિલસોજ ભાવપ્રણવ
भाशांतरकार: દુભાષિયું અનુવાદક ભાષાંતરકાર
भाशांतरीत: અનુવાદિત ભાષાંતરિત અનુવાદી અનૂદિત
भाशातंर_करपी: દુભાષિયું અનુવાદક ભાષાંતરકાર
भिकाड्डो: મક્ખીચૂસ કફનખસોટ
भिकुड्डो: કાયર ડરપોક બુજદિલ ભીરુ નાહિંમત ડરકણ બાયલું ભડવો અસાહસિક ધીર
भिजिल्लें: સિંચેલું છાંટેલું સિંચિત સિક્ત સેચિત ઉક્ષિત ભીંજવેલ અભિષિક્ત
भिजूड: કાયર ડરપોક બુજદિલ ભીરુ નાહિંમત ડરકણ બાયલું ભડવો અસાહસિક ધીર
भिडेस्त: શરમાળ લજ્જાશીલ લજજાળુ લાજવાળું
भितर_पावूंक_नाशिल्लो: અપ્રવિષ્ટ
भितरले: આંતરિક અંદરનું અંતરનું ભીતરી અંતસ્થ અંતર્ગત અભ્યંતર અંતરિત અંતરીય
भित्रो: કાયર ડરપોક બુજદિલ ભીરુ નાહિંમત ડરકણ બાયલું ભડવો અસાહસિક ધીર
भिन्नरुपी: વિભિન્ન જુદી-જુદી વિષમરૂપી અસમરૂપ
भियेल्लो: ભયભીત બીધેલું ડરેલું બીનેલ આતંકિત ત્રસ્ત પરેશાન ભયાતુર બાવરું ગાભરું બેબાકળું
भिरांकूळ: ભયપૂર્ણ ભયયુક્ત ભયાત્મક ભયમય આક્રમક આક્રમકતાપૂર્ણ અભિધાવક પ્રચંડ ભયાનક ભયંકર બિહામણું ડરામણું બીકવાળું વિકરાળ ઘોર ભીષણ ભયાવહ ઉગ્ર રૌદ્ર રુદ્ર મહાચંડ કરાલ ખૂંખાર રૌરવ વિષમ દારુણ તામ
भिवकुरो: કાયર ડરપોક બુજદિલ ભીરુ નાહિંમત ડરકણ બાયલું ભડવો અસાહસિક ધીર
भुंयगत: કવચી બખ્તરિયું કોચલાવાળું
भुंयचर: ભૂચર સ્થળચર થલચર સ્થલવાસી
भुकेल्लो: ભૂખ્યું બુભુક્ષિત ક્ષુધિત જિઘત્સુ અશનાયિત ક્ષુધાતુર
भुकेस्त: ભૂખ્યું બુભુક્ષિત ક્ષુધિત જિઘત્સુ અશનાયિત ક્ષુધાતુર
भुतकाळ: ભૂતકાળ અતીત ભૂત ગત વીતેલ વીતેલું વ્યતીત વિગત
भुतकाळीन: ભૂતકાલીન પૂર્વકાલીન પ્રાચીન
भुताचें: ભૂતીયું ભૂતપિશાચવાળું અવાસ્તવિક વર્ણપટનું
भुताटकेचें: ભૂતીયું ભૂતપિશાચવાળું અવાસ્તવિક વર્ણપટનું
भुरगें: સગીર અલ્પવયસ્ક અપ્રૌઢ નાબાલિગ કમસિન અલ્હડ
भुरगेंकारीण: છોકરાંવાળી
भुरगेकान्न: છોકરાંવાળી
भुरगेपण: બાલિશ છોકરમત છોકરવાદ
भुरग्याकारीण: છોકરાંવાળી
भुलयणें: સંમોહનપૂર્ણ જાદુવાળી કામણભરેલી
भेड्डो: બહેરું બધિર શ્રોતહીન
भेदनीय: ભેદ્ય ભેદનીય ભેદનશીલ વેધ્ય વેધનીય વેધનશીલ
भेद्य: ભેદ્ય ભેદનીય ભેદનશીલ વેધ્ય વેધનીય વેધનશીલ
भेरो: બહેરું બધિર શ્રોતહીન
भेळशेल्लें: વાસી બગડેલું પર્યુષિત
भेसळीचें: અશુદ્ધ મિશ્ર મિશ્રણ ભેળસેળ મિલાવટી
भोंवपी: ભ્રમણશીલ રખડુ યાયાવર રમતારામ અતિચારી
भोगसणी_मागपी: ક્ષમાપ્રાર્થી ક્ષમા_યાચક
भोगिल्लो: ભુક્તભોગી ભોગી ભોગવનાર
भोगी: કામુક ઇચ્છુક વિષયી કામી લંપટ કામાસક્ત વિલાસી વિષયાસક્ત ભોગી કામચારી વ્યભિચારી કામકૂટ છિનાળવો અનુક અભિક અભીક
भोगूंक_नाशिल्लो: અભુક્તભોગી
भोळें: ભોળું ભોળિયું સાદું સાલસ ભલું
भोळो: સૌમ્ય સુશીલ શાંત સરળ સરલ સીધું ભોળું નિખાલસ નિષ્કપટી સીધું-સાદું ભલું-ભોળું અવક્ર પ્રાંજલ ઋજુ
भोवगुणी: યોગ્ય લાયક કાબેલ સમર્થ અભિજાત ઉદાત્ત
भोवधंधी: બહુધંધાર્થી
भोवमान_करूंक_नाशिल्लो: અસત્કારિત અસ્તાર_કૃત
भोवमानीत: સત્કારિક સત્કૃત
भोवमानेस्त: આદરણીય સંમાનનીય માનનીય સંમાન્ય માન્ય અભિજાત
भोवरंगी: રંગબેરંગી રંગ-બેરંગી પચરંગી નવરંગી બહુરંગી શબલ
भोववर्शी: બહુવર્ષજીવી બહુવર્ષ_જીવી દીર્ઘજીવી દીર્ઘાયુષી દીર્ઘાયુ બહુવર્ષાયુ
भोववेवसायी: બહુધંધાર્થી
भोवसंख्या: સંખ્યાબંધ બહુસંખ્ય બહુસંખ્યક
भ्रमिश्ट: પાગલ ગાંડું ઘેલું ઉન્મત્ત ઘેલું અણસમજુ નાદાન મગજનું_ચસકેલું ભ્રમિત ભ્રાંત
भ्रमीत: ભ્રમિત ભ્રાંત
मंगलकारी: કલ્યાણકારી મંગળકારી હિતકારી ગુણકારી મંગલકારક કલ્યાણમય કલ્યાણપ્રદ ઇષ્ટકર
मंचनीय: મંચનીય મંચ્ય ભજવવા_તોગ્ય
मंचीत: ભજવેલું મંચિત અભિમંચિત
मंत्र_मारिल्लें.: અભિમંત્રિત
मंत्रीत: અભિમંત્રિત
मंद: મંદ ધીમું ધીરું થોડું મંથર સુસ્ત અપ્રબલ અપ્રબળ મંદ નિસ્તેજ અજોત કુંદ કુંઠિત નબળું મંદા ધીમું મંદ હલકું મૃદુ આછું હળવું
मग्न: કાર્યરત પ્રવૃત્ત અભિમુખ પરાયણ મચેલું લાગેલું વ્યસ્ત
मचमचीत: સ્વાદિષ્ટ સ્વાદુ રોચક_સ્વાદવાળું સારું લહેજતદાર લિજ્જતદાર લહેજતવાળું મસાલેદાર ચટાકેદાર ચટપટું
मजती: સહયોગી સાથી મદદનીશ મદદગાર સહાયક અસિસ્ટંટ
मजबूत: મજબૂત ઠોસ દૃઢ પાક્કું જબરદસ્ત જોરાવર જબરું જબરજસ્ત જબ્બર જબર અભંગુર અશિથિલ
मजेशीर: રોમાંચક રોચક મધુર મજેદાર મિષ્ટ ચટપટી
मडील्लें: ઘડવું આરૂપિત આકાર_પ્રદત્ત
मडें_खायरें: શબ_ભક્ષી લાશભક્ષી
मढोवंक_नाशिल्लें: અનઘડ અણઘડ બેડોળ અરૂપિત
मताधिकारी: મતાધિકારી મતદાર મતદાતા
मतींतलें: કાલ્પનિક કલ્પિત અવાસ્તવિક કલ્પેલું ધારેલું કૃત્રિમ અયથાર્થ મિથ્યા ખોટું કલ્પનાશીલ મનસ્વી
मदलो: વચેટ વચલો
मदांद: મદોન્મત્ત મદઘેલું મદમસ્ત મદાંધ પ્રમત્ત ધુત મસ્ત પીધેલ ચકચૂર મદહોશ મત્ત મદમસ્ત અલમસ્ત
मदेवर्ती: મધ્યભાગ મધ્ય વચલું મધ્યવર્તી મધ્યસ્થિત મધ્યમ કેંદ્રીય અવાંતર સેન્ટ્રલ
मद्यम_पिरायेचें: આધેડ પ્રૌઢ પીઢ ઠરેલ પુખ્ત
मध्यवर्ती: મધ્યભાગ મધ્ય વચલું મધ્યવર્તી મધ્યસ્થિત મધ્યમ કેંદ્રીય અવાંતર સેન્ટ્રલ
मनभुलयणी: મનોહર રમણીય રમ્ય આકર્ષક મોહક ચિત્તહારક
मनभुलयणें: સોહામણું શોભીતું સુહાવનું સરસ ખુશનૂમા
मनरिजवणेचें: મનોરંજક આનંદી લહેરી આનંદકારક આનંદપ્રદ આનંદદાયી આનંદકારી ચિત્તાકર્ષક મનોહર
मनायेचें: મનાઈ બંધી અટકાવેલું પ્રતિબંધિત અંકુશ વર્જ્ય વારિત
मनीस_निर्मीत: માનવકૃત માનવનિર્મિત કૃત્રિમ બનાવટી નકલી નકલરૂપ
मनीसचलीत: માનવ_સંચાલિત
मनीसपण: ભલા સદ્ગૃહસ્થ સારા સજ્જન
मनीसपणाचें: માનવીય માનવી માનુષિક મનુષ્યસંબંધી
मरणा_उपरांत: મરણોત્તર મૃત્યુપશ્ચાત મરણોપરાંત મૃત્યૂપરાંત
मरणा_धडेर_आशिल्लो: મરણોન્મુખ મરણાસન્ન આસન્નમરણ મરણાંત મુમૂર્ષુ મુમૂર્ષ
मरणाक_तेंकिल्लो: મરણોન્મુખ મરણાસન્ન આસન્નમરણ મરણાંત મુમૂર્ષુ મુમૂર્ષ
मरणादीक: પ્રાણઘાતક જીવલેણ મૃત્યુકારી મૃત્યુકર મૃત્યુકારક
मरतकच: મરણોત્તર મૃત્યુપશ્ચાત મરણોપરાંત મૃત્યૂપરાંત
मर्दानी: મર્દાના મરદાના વીરતા_ભરેલું
मर्यादीत: કરકસરિયું કોસરિયું મિતવ્યયી ત્રેવડવાળું સીમિત સીમાબદ્ધ મર્યાદિત નિયત નિર્ણીત મર્યાદાવાળું હદવાળું સીમાવાળું સીમાબદ્ધ મર્યાદિત સીમાયુક્ત પરિમિત
मळकें: મેલુ અસ્વચ્છ ખરાબ અપવિત્ર અશુધ્ધ ગંધારુ બગડેલું દૂષિત અવિમલ અનિર્મલ અવિશુધ્ધ અશુચિ મ્લાન મલિન ગંદુ
मळबस्पर्शी: ગગનચુંબી ગગનભેદી આકાશભેદી ગગનસ્પર્શી ઉત્તુંગ
मळबाक_तेंकपी: ગગનચુંબી ગગનભેદી આકાશભેદી ગગનસ્પર્શી ઉત્તુંગ
मळ्यांचीं: માળ મજલો તલ્લો
मशागत: પાલન-પોષણ પોષિત સંવર્ધિત પુષ્ટ
मसालेदार: મસાલેદાર
मसाल्याचें: મસાલેદાર ચટાકેદાર ચટપટું
मस्तिल्लें: પદદલિત અવમર્દિત પાદદલિત પામાલ
मस्तें: તોફાની નટખટ અટકચાળું તોફાની ટીખળી બદમાશ મસ્તીખોર
महत्वाकांक्षी: મહત્ત્વાકાંક્ષી માનાભિલાષી કીર્તિલોભી
महान: મહાન મોટુ વડુ ઉંચુ શ્રેષ્ઠ મૂર્ધન્ય ઉદાત્ત માનનીય પૂજય વંદનનીય આદરણીય ઉત્કૃષ્ટ અસાધારણ મહત્વનું
मागलें: પાછલું પાછળનું પૃષ્ઠ
माचयेबगरचें: અમંચનીય મંચનક્ષમહીન
माजी: ભૂતપૂર્વ માજી પૂર્વ
माड्डिल्लें: પદદલિત અવમર્દિત પાદદલિત પામાલ
माणकुलें: લઘુકાય નાનુ નાનું ઠીંગણું વામન વામણું બાંઠિયું વામનજી બઠકું ઠીંગણો
मातयेभरवण: નષ્ટ ખતમ બરબાદ ખલ્લાસ ચોપટ તહસનહસ નષ્ટ-ભ્રષ્ટ સમાપ્ત નેસ્તોનાબૂદ તબાહ ધ્વસ્ત અપધ્વસ્ત નિકંદન અવધૂત અવધ્વંસ્ત અસ્ત ગારત જેર ફના ઉચ્છિન્ન અપહત મર્દિત તલફ અસ્તમિત વિનષ્ટ ખરાબખસ્ત જમીનદોસ્ત ભૂમિસાત્
मातसो: બહું_ઓછું અત્યલ્પ ઘણું_થોડું જરાક અતિઅલ્પ સ્વલ્પ
मातृहीण: અમાતૃક માતાહીન માતૃહીન નમાયું માતાવિહીન
मातेराचें: દુર્ગંધવાળું દુર્ગંધી સડેલું પૂતિ પૂતિક
मादक: માદક કેફી નશીલુ નશેદાર
माननीय: આદરણીય સંમાનનીય માનનીય સંમાન્ય સમાદરણીય
मानपी: અનુયાયી અનુચર અનુગામી સેવક દાસ ચાકર નોકર અનુસરનાર
मानवल्लें: પ્રિય વહાલું ગમતું અજીજ પ્યારૂં પ્રીતિકર
मानवी: માનવીય માનવી માનુષિક મનુષ્યસંબંધી
मानसीक: માનસિક મન_સંબંધી દિમાગી દિમાગવાળું દિમાગદાર
मानादीक: આદરણીય સંમાનનીય માનનીય સંમાન્ય સમાદરણીય આદરણીય સંમાનનીય માનનીય સંમાન્ય માન્ય અભિજાત
मानिल्लें: ખુલ્લું ઉઘાડું અનિષિદ્ધ અપ્રતિબંધિત અટોક અવર્જિત અત્યક્ત અબાધ
मानिल्लो: ધરમનું
मान्य: ખુલ્લું ઉઘાડું અનિષિદ્ધ અપ્રતિબંધિત અટોક અવર્જિત અત્યક્ત અબાધ પારિત પાસ પસાર ઉત્તીર્ણ
मान्य_केल्ली: માન્ય બહાલી મંજૂર સ્વીકૃત પાસ મંજૂર અભ્યુપગત સ્વીકારેલું
मान्य_नाशिल्लें: અસ્વીકાર્ય અમાન્ય અસ્વીકારણીય
मापिल्लें: જોખેલું માપિત માપેલું
मापूंक_नाशिल्लें: અમાપ્ય અમાપ અપરિમિત અપરિમાણ
माफ_करी_सारकी: ક્ષમ્ય ક્ષમાપાત્ર ક્ષમા_યોગ્ય
माफी-बगरचो: અક્ષમ્ય ક્ષમાશૂન્ય
मामे: મામીસાસુ મામેરિયું
मायेस्त: સ્નેહી નેહી
मारक: મારક
मालक्रियाद: તોફાની નટખટ અટકચાળું તોફાની ટીખળી બદમાશ મસ્તીખોર
माळी: માળ મજલો તલ્લો
मावळिल्लो: અસ્ત અસ્તગત આથમેલું ડૂબેલું
मावशे: મસિયાઈ
मावस: મસિયાઈ
मासाळ: માંસલ પુષ્ટ લઠ્ઠ ગરયુક્ત ગરભવાળું લગદાવાળું માવાયુક્ત
मासाहारी: માંસાહારી માંસભક્ષી ક્રવ્યાદ માંસખોર આમિષાહારી
मिटना__अशें: કાયમનું હમેશનું સનાતન સદાનું અવિનાશી શાશ્વત અમર અક્ષય નિત્ય
मित्रत्व: મિલનસાર ભળતું ભલમનસાઈ સુશીલ
मिरयांचें: ગડીબંધ ગડીભેર
मिरयो_आशिल्लें: ગડીબંધ ગડીભેર
मिळमीळीत: ચંચળચિત્ત ચંચળ
मिश्कील: વિનોદી વિનોદક દિલ્લગીબાજ વિનોદપ્રિય મશ્કરા મજાકિયું
मिश्र: મિશ્ર ભેળવેલું મિશ્રિત સંમિશ્રિત આમેજ ભેળસેળવાળું
मिस्तुराद: અશુદ્ધ મિશ્ર મિશ્રણ ભેળસેળ મિલાવટી મિશ્ર ભેળવેલું મિશ્રિત સંમિશ્રિત આમેજ ભેળસેળવાળું
मीर्गाचें: વરસાદી વર્ષા_કાલીન વર્ષાકાલીન
मुक्त: સ્વતંત્ર સ્વાધીન આઝાદ આજાદ અનન્યાશ્રિત અનધીન અનાયત્ત અનિર્બંધ અપરતંત્ર આઝાદ મુક્ત છૂટું સ્વતંત્ર સ્વાધીન ઉન્મુક્ત બંધનમુક્ત અબદ્ધ
मुक्तछंद: અતુકાન્તમુક્ત
मुखार_धाडिल्लें: મોકલેલું રવાના_કરેલું
मुखार_येवपी: આગામી આવનારું ભવિષ્યનું ભાવી
मुखारचो: અગ્ર આગળનો પૂર્વ સામેનો
मुखावयलो: અગ્ર આગળનો પૂર્વ સામેનો પુરોગામી અગ્રગામી પૂર્વગામી
मुखेली: મુખ્ય પ્રધાન પ્રમુખ વરિષ્ઠ અગ્રણી શ્રેષ્ઠ સદર ધુરંધર ધોરી
मुगलायी: મુગલાઈ મોગલાઈ
मुदयाळे: વાંકડિયા ગુચ્છાદાર ઘુઘરિયાળ કુંચિત
मुद्रांकीत: મુદ્રાંકિત છાપેલું મુદ્રિત
मुद्रीत: મુદ્રાંકિત છાપેલું મુદ્રિત મુદ્રિત છાપેલું છાપેલ
मुनेल्लें: બુઠ્ઠું બૂઠું કુંઠિત ખાંડું અતીક્ષ્ણ
मुल्यवान: બહુમૂલ્ય કિંમતી બહુમૂલી મૂલ્યવાન અનમોલ અમૂલ્ય
मुळावें: આરંભિક પ્રારંભિક પ્રાથમિક આરંભનું શરૂઆતનું આરંભમાણ
मुळाव्यो: આધારભૂત પ્રમાણભૂત મૂળભૂત મૂળગત મૂળ મૌલિક મૂલ
मुसळधार: મૂશળધાર મૂશલધાર
मुस्तिल्लें: પદદલિત અવમર્દિત પાદદલિત પામાલ
मूर्ख: મૂર્ખ મૂરખ અબૂધ અક્કલહીન ઠોઠ ગમાર બેવકૂફ બુદ્ધિહીન નાદાન મતિમંદ મૂઢ અબૂજ અજ્ઞાની બેસમજ અંધ કમઅક્કલ મૂઢમતિ મૂઢબુદ્ધિ અણસમજુ અલ્પબુદ્ધિ શીન અવિદ પામર
मूर्त: સાક્ષાત સાક્ષાત્ સાકર મૂર્તિમંત આકારવાન આકારયુક્ત
मूळ: મૌલિક સ્વરચિત સ્વકૃત મૂળ આદ્ય આત્મકૃત
मृत: મૃત મૂએલું મૃતક મુડદું શબ વૈકુંઠવાસી પરલોકવાસી સ્વર્ગવાસી સ્વર્ગીય સ્વર્ગસ્થ મરહૂમ દિવંગત અપગત
मृदू: નરમ મુલાયમ કોમળ મૃદુલ મૃદુ તનુ સુંવાળું પોચું
मेकळें: ઉઘાડું ખુલ્લું છતું અગુપ્ત જાહેર સ્વતંત્ર સ્વાધીન આઝાદ આજાદ અનન્યાશ્રિત અનધીન અનાયત્ત અનિર્બંધ અપરતંત્ર ખાલી ખાલીખમ ઠાલું રિક્ત શૂન્ય અવસ્તુ નવરો અવ્યસ્ત ખાલી
मेकळो: આઝાદ મુક્ત છૂટું સ્વતંત્ર સ્વાધીન ઉન્મુક્ત બંધનમુક્ત અબદ્ધ
मेघहीण: સ્વચ્છ નિરભ્ર અનભ્ર અમેઘ મેઘહીન
मेजपा_योग्य: ગણનીય ગણ્ય
मेजी_सारक्यो: ગણનીય ગણ્ય
मेले_उपरांत: મરણોત્તર મૃત્યુપશ્ચાત મરણોપરાંત મૃત્યૂપરાંત
मेल्लें: મૃત લુપ્ત નાશ ઠૂંઠું સૂકું
मेल्लो: મૃત મૂએલું મૃતક મુડદું શબ વૈકુંઠવાસી પરલોકવાસી સ્વર્ગવાસી સ્વર્ગીય સ્વર્ગસ્થ મરહૂમ દિવંગત અપગત
मेळनाशिल्लें: અપ્રાપ્ય અનુપલબ્ધ અલભ્ય અપ્રાપ્ત અમિલ
मेळिल्लें: પ્રાપ્ત મેળવેલું મેળવાયેલું મળેલું ઉપાર્જિત હસ્તગત પ્રસ્તુત સ્વાધીન સંપ્રાપ્ત પામેલું વસૂલ સંમિલિત મિશ્ર મિશ્રિત એકઠું ભેગું મળેલું
मेळोवन_दिल्लें: ઉપ્લબ્ધ પ્રાપ્ત મેળવેલું મળેલું હાથવગુ સુલભ હસ્તપટુ
मेळोवपी: મેળવનાર સ્વીકારનાર લેનાર પ્રાપ્તકર્તા પ્રાપક પ્રાપ્ત_કર્તા આદાતા ગ્રહણ_કરનાર લેનાર
मैत्री: મિત્રતાપૂર્ણ મૈત્રીપૂર્ણ દોસ્તારી મિત્રાચારી મિત્રવત મિત્રોચિત
मोगभरीत: પ્રેમમય પ્રેમપૂર્ણ આશિકાના
मोगाळ: સ્નેહી નેહી
मोगासक्त: પ્રેમાતુર પ્રેમાસક્ત અનુરાગી અનુરક્ત મોહિત ફિદા અનુરાગયુક્ત ભાવક
मोटें: જ્યેષ્ઠ અગ્રજ વરિષ્ઠ અગ્રજન્મા અગ્રજાત મોટું પુરોજન્મા મોટા જયેષ્ઠ વડું
मोटो: જાડો સ્થૂળ સ્થૂળકાય ભારે ધીંગો પીવર
मोड: સ્વાર્થ_ત્યાગી નિ સ્વાર્થ_વિનાનું પરોપકારી
मोडकें: ફાટું-તૂટું જીર્ણ જર્જરિત
मोडको: ઠિંગણો વામન નાટો નિખર્વ
मोडण: વાંકું વક્ર ટેડું વળેલું વાંકવાળું વાંકું-ચુકું કુંચિત બંક બંકિમ વામ
मोडवो: ઠિંગણો વામન નાટો નિખર્વ
मोडिल्लें: પડી_ગયેલું ઢળી_પડેલું અવક્ષિપ્ત અવગત ખંડિત ભાગેલું ભગ્ન વિખંડિત તૂટેલું છિન્ન છિન્નભિન્ન
मोडूं_येत_अशें: ભંજનશીલ ભંજનીય
मोनें: અપુષ્પિત અણખીલેલું અણખીલ્યું અવિકસિત અફુલ્લ વાચારુદ્ધ
मोनो: મૌન અવાક શાંત મૂંગું ગૂંગું અબોલ અવાચક ચુપ મૂક અનુત્તર ખામોશ નિર્વાક નિર્વચન નિભૃત મૂગું મૂક ગૂંગું અવાચક અબોલ અવચવ બેજુબાન અવચન
मोफत: મફત નિશુલ્ક વગર_પૈસે
मोलादीक: બહુમૂલ્ય કિંમતી બહુમૂલી મૂલ્યવાન અનમોલ અમૂલ્ય અનમોલ અમૂલ્ય અમોલ અમોલક અમોલખ
मोव: સૌમ્ય સુશીલ શાંત લચકદાર નમ્ય નમનીય લવચીક નરમ સુનમ્ય મૃદુ સુનમ્ય નરમ મુલાયમ કોમળ મૃદુલ મૃદુ તનુ સુંવાળું પોચું નબળું બોદું કમજોર નાજુક
मोव_काळजाचें: આર્દ્રહૃદય દયાવાન કરુણાળુ કૃપાળુ
मोहक: સંમોહનપૂર્ણ જાદુવાળી કામણભરેલી સોહામણું શોભીતું સુહાવનું સરસ ખુશનૂમા
मोहीत: મુગ્ધ મોહિત મંત્રમુગ્ધ આસક્ત
मौनव्रती: મૌનધારી મૌની મૌનવ્રતી
म्हगेलो.: મારું પોતીકું જાતનું પંડનું સ્વકીય
म्हजो: મારું પોતીકું જાતનું પંડનું સ્વકીય
म्हत्व_नाशिल्लें: મહત્ત્વહીન
म्हत्वकांक्षा_नाशिल्लें: અમહત્ત્વકાંક્ષી
म्हत्वपूर्ण: મહત્ત્વપૂર્ણ મહત્ત્વયુક્ત બહુમૂલ્ય અહેમ અર્થપૂર્ણ મોટું
म्हत्वहीण: મહત્ત્વહીન
म्हत्वाचें: મહત્ત્વપૂર્ણ મહત્ત્વયુક્ત બહુમૂલ્ય અહેમ અર્થપૂર્ણ મોટું
म्हा: પ્રકાંડ મહાન પ્રકાણ્ડ મહા પ્રખર બહુ_મોટો
म्हातारी: વૃદ્ધા ઘરડી_સ્ત્રી ડોસી બૂઢ્ઢી
म्हातारें: વૃદ્ધ ઘરડું વડીલ વધેલું જૈફ બુઢ્ઢું મોટેરું વયોવૃદ્ધ
म्हान: મહાન મોટુ વડુ ઉંચુ શ્રેષ્ઠ મૂર્ધન્ય ઉદાત્ત માનનીય પૂજય વંદનનીય આદરણીય ઉત્કૃષ્ટ અસાધારણ મહત્વનું પ્રકાંડ મહાન પ્રકાણ્ડ મહા પ્રખર બહુ_મોટો
म्हापातकी: મહાપાપી મહાપાતકી
म्हापापी: મહાપાપી દુષ્ટ દુર્ગુણી મહાનીચ મહાપાપી મહાપાતકી
म्हामुर्ख: મૂર્ખશિરોમણિ મહામૂર્ખ મૂરખનો_સરદાર જટ
म्हारग: બહુમૂલ્ય કિંમતી બહુમૂલી મૂલ્યવાન અનમોલ અમૂલ્ય મોંઘું
म्हालम्हातारी: વૃદ્ધા ઘરડી_સ્ત્રી ડોસી બૂઢ્ઢી
म्हालम्हातारें: વૃદ્ધ ઘરડું વડીલ વધેલું જૈફ બુઢ્ઢું મોટેરું વયોવૃદ્ધ
म्हावराक: માંસાહારી માંસભક્ષી ક્રવ્યાદ માંસખોર આમિષાહારી
म्हेळें: અશુદ્ધ અસ્વચ્છ મેલું મલિન ગંદુ અશોધિત. મેલુ અસ્વચ્છ ખરાબ અપવિત્ર અશુધ્ધ ગંધારુ બગડેલું દૂષિત અવિમલ અનિર્મલ અવિશુધ્ધ અશુચિ મ્લાન મલિન ગંદુ
म्होंवाळ: સુરીલું સુરેલ સુમધુર મીઠું મધુર ગળ્યું મીઠું મધુરું ગળાશવાળું મધુર
म्होंवाळ_उलोवपी: મીઠાબોલું પ્રિયભાષી પ્રિયંવદ
यंत्रचलीत: યંત્ર_સંચાલિત યાંત્રિક સ્વચાલિત યંત્ર-સંચાલિત
यत्नशील: પ્રયત્નશીલ પ્રયત્નશાળી પ્રયત્નશાલી પ્રયત્નવાન ઉદ્યમી ઉદ્યોગી પ્રયાસી ઉદ્યમશીલ
यमकाचें: અંત્યાનુપ્રાસ પ્રાસ
याचक: ઉમેદવાર મહત્ત્વાકાંક્ષી અભિલાષી આકાંક્ષી પરીક્ષાર્થી ફરિયાદી પ્રાર્થના_કર્તા નિવેદક
याद__नाशिल्लें: વિસ્મૃત ભુલાયેલું અસ્મરણીય પ્રસ્મૃત
यानहीण: અયાન અવાહન
यानाचेर_चडिल्लें: રથિક રથી
यानारूड: રથિક રથી
युनानी: યૂનાની ગ્રીક
येवंक_नाशिल्लो: અનાગત
येवजिल्लें: સ્વેચ્છિત મરજિયાત ઐચ્છિક
येवपी: ભવિષ્યકાળ આવનારું ભવિષ્ય_કાલીન ભાવી સંભાવિત આગળનું આગલું ભવ્ય અનાગત ભાવિતા
येशस्वी: સફળ કામયાબ કૃતાર્થ સિદ્ધ સાર્થક કૃતકૃત્ય સફળતા યશસ્વી કીર્તિમાન કીર્તિશાળી કીર્તિમંત કીર્તિવાન કીર્તિવંત
योगी: આત્મજ્ઞાની યોગી આત્મદર્શી આત્મદ્રષ્ટા તત્ત્વદર્શી સ્વદર્શી
योग्य: યોગ્ય લાયક કાબેલ સમર્થ અભિજાત ઉદાત્ત પ્રમાણે અનુસાર અનુકૂળ મુતાબિક ફાવતું માફક અનુસાર પ્રણવ નિશ્ચિત નિર્ધારિત નિયત નિયમિત નિર્દિષ્ટ સુપાત્ર સારું_પાત્ર સારું_માણસ સત્પાત્ર સંગત સંબદ્ધ યોગ્ય વ્યાજબી જાયજ વાજબી યથાર્થ ઉચિત મુનાસિબ કાનૂની કાયદેસર જાયજ યોગ્ય વાજબી યથાર્થ ઉચિત મુનાસિબ વિધિમાન્ય
योग्य_वेळार: સમયોચિત સમયાનુકૂલ સામયિક અવસરોચિત કાલોચિત
योद्धो: શૂરવીર યુધ્ધવીર રણવીર રણધીર રણશૂર લડવૈયો
यौगीक: યૌગિક
रंगकुड्डेपण: રંગઅંધ
रंगयाळें: રંગબેરંગી રંગ-બેરંગી પચરંગી નવરંગી બહુરંગી શબલ
रंगहीण: રંગહીન વર્ણહીન બેરંગ બેરંગી અવર્ણ વર્ણશૂન્ય અવરણ વિવર્ણ નિરંગ
रक्तवर्णी: લોહિત રાતું રક્તવર્ણું
रक्तहीण: રક્તહીન લોહી_વિનાનું
रक्ताचें: ખૂની
रक्षक: રક્ષક ચોકીદાર રખવાળ પાલક વૉર્ડન
रगत_नाशिल्लें: રક્તહીન લોહી_વિનાનું
रचिल्लें: કાલ્પનિક કલ્પિત અવાસ્તવિક કલ્પેલું ધારેલું કૃત્રિમ અયથાર્થ મિથ્યા ખોટું કલ્પનાશીલ મનસ્વી રચિત નિર્મિત વિરચિત સૃષ્ટ કૃત સર્જિત પ્રણીત
रचूंक_नाशिल्लें: અરચિત અનિર્મિત અકૃત
रणवीर: શૂરવીર યુધ્ધવીર રણવીર રણધીર રણશૂર લડવૈયો
रणशूर: શૂરવીર યુધ્ધવીર રણવીર રણધીર રણશૂર લડવૈયો
रथहीण: વિરથ અરથ અરથી રથહીન
रथारूढ: રથારોહી રથી રથ_આરૂઢ
रद्द: રદ બાતલ રદ્દ નિરસ્ત મંસૂખ
रबरबीत: ઢીલું પોચું નરમ ઢીલુપોચુ
रमणीय: મનોહર રમણીય રમ્ય આકર્ષક મોહક ચિત્તહારક
रम्य: મનોહર રમણીય રમ્ય આકર્ષક મોહક ચિત્તહારક સુંદર ખૂબસૂરત રૂપાળું મનોહર સુશોભિત મોહક મજેનું દેખાવડું કૂટડું રળિયામણું લલિત રૂપવાન રૂપવંત મનહર કમનીય પાકીઝા છબીલું સોહન અભિજાત સુડોલ અભિરૂપ લાવણ્યમય
रवो: કકરા મોટા
रसहीण: નિરસ નીરસ લૂખું સૂકું રસરહિત બેરસ
रसात्मक: કાવ્યાત્મક કાવ્યમય કાવ્યરૂપ કવિત્વમય કવિતામય રસાત્મક
रसाळ: રસાળ રસીલું રસિયું સ્વાદિષ્ટ સ્વાદિષ્ટ સરસ રસપૂર્ણ રસવંત
रसीक: કલાપ્રેમી કલારસિક કલાપ્રિય રસિક રસિયું ભાવુક રસજ્ઞ રંગીલો મનમોજી રસિકમિજાજ
रस्ताद: લાવારીસ અનાથ સડકછાપ અપતિ
रहस्य: રહસ્યમય રહસ્યાત્મક રહસ્યપૂર્ણ ગૂઢ
रहस्यहीण: રહસ્ય_વગર રહસ્યહીન અગૂઢ
राखीव: અનામત આરક્ષિત રિઝર્વ
राखीवतेबगरचें: અનારક્ષિત
रागिश्ट: ક્રોધી ક્રુદ્ધ કુપિત રુષ્ટ ક્રોધિત ક્રોધયુક્ત ભામી ક્ષુબ્ધ ક્રોધી ક્રોધવાળું ગરમ_મિજાજી ચંડ જલાતન અમરખી
राजकारणाचे: રાજનૈતિક રાજકારણીય રાજનીતિ_વિષયક
राजकारणी: રાજનૈતિક રાજકારણીય રાજનીતિ_વિષયક નીતિજ્ઞ નીતિકુશળ નીતિનિપુણ
राजनितीक: રાજનૈતિક રાજકારણીય રાજનીતિ_વિષયક
राज्य_पांवड्या_वयलें: પ્રાદેશિક પ્રાંતીય રાજ્ય
राज्यस्तरीय: પ્રાદેશિક પ્રાંતીય રાજ્ય
राणटी: જંગલી વનજાત વન્ય આરણ્યક અગ્રામ્ય વગડાઉ
रातचर: નિશાચર રાત્રિચર નિશિચર તમચર નિશાચારી યામિનિચર નિશાટ નિશાટન
रानटी: વન્ય જંગલી રાની વગડાઉ વનેરુ આરણ્ય આરણ્યક વનવાસી અરણ્યવાસી બનૈલા આટવિક જંગલી વન્ય આરણ્યક રાની વનીય આરણીય જંગલી વનીય અરણ્યક
रानवटी: વન્ય જંગલી રાની વગડાઉ વનેરુ આરણ્ય આરણ્યક વનવાસી અરણ્યવાસી બનૈલા આટવિક જંગલી વન્ય આરણ્યક રાની વનીય આરણીય જંગલી વનીય અરણ્યક જંગલી વનજાત વન્ય આરણ્યક અગ્રામ્ય વગડાઉ
रानवासी: વનવાસી આરણ્યક અરણ્યવાસી વની
राबित्याचें: વસ્તી આબાદી ગુલજાર
राबित्याच्यो: ગૃહ્ય ઘરનું ઘર_સંબંધી
रामनामी: રામનામી
रावपी: વસ્તી આબાદી ગુલજાર
राष्ट्रताये_संबंदी: રાષ્ટ્રીયતા_સંબંધી
राष्ट्रद्रोही: દેશદ્રોહી રાષ્ટ્રદ્રોહી
राष्ट्रीय: રાષ્ટ્રિય રાષ્ટ્રીય દેશીય દેશનું રાષ્ટ્રીય
रासायनीक: રાસાયણિક રસાયણી રાસાયનિક
रिकामी: ખાલી ખાલીખમ ઠાલું રિક્ત શૂન્ય અવસ્તુ
रिकामें: નવરો અવ્યસ્ત ખાલી
रिणहीन: અઋણ
रिणा_बगरचें: અઋણ
रितसर: સુવ્યવસ્થિત સારી_વ્યવસ્થાવાળું સારી_રીતે_ગોઠવેલું વ્યવસ્થાપૂર્વકનું
रीण_दिवपी: દેવાદાર કરજદાર ઋણી ઋણદાતા રુણપ્રદાતા_કર્જદાતા
रीणकार: કરજદાર દેવાદાર ઋણી રણિયું કરજવાળું ઋણવાળું
रीतसर: વ્યવસ્થિત ઠીક વિન્યસ્ત
रुंद: પહોળું ચોડું વિસ્તીર્ણ વિસ્તૃત પટવાળું
रुचीक: સ્વાદિષ્ટ લહેજતદાર સ્વાદુ
रुचीचें: સ્વાદિષ્ટ લહેજતદાર સ્વાદુ
रुढिवादी: રૂઢિવાદી મૂળતત્વવાદી પુરાણપંથી
रुपांतरीत: રૂપાંતરિત બદલાયેલું
रुपेरी: રૂપેરી
रुप्याचें: રૂપેરી
रूक्ष: સૂકું શુષ્ક ખુશ્ક કોરૂં અનાર્દ
रूच_नाशिल्लें: બેસ્વાદ ફીકું કુરુચિવાળું અસ્વાદિષ્ટ રુક્ષ અસ્વાદુ અરસ અનાસ્વાદ
रूचीक: સ્વાદિષ્ટ સ્વાદુ રોચક_સ્વાદવાળું સારું લહેજતદાર લિજ્જતદાર લહેજતવાળું
रूप_नाशिल्लें: કુરૂપ કદરૂપું બેડોળ બદસૂરત બદશિક્લ વરવું ભદ્દું અરૂપ ભદેસ ભદેસિલ અનગઢ અપાટવ અવરૂપ અરૂપ વિરૂપ
रूपगर्विता: રૂપગર્વિતા રૂપ_અભિમાની
रूपाभिमानी: રૂપગર્વિતા રૂપ_અભિમાની
रेंवटाळ: રેતાળ રેતીલા રેતીવાળું
रेशमी: રેશમી સિલ્ક હીરાગળ રેશમી સુવાળું નરમ લીસું સિલ્કી
रोगी: રોગી બીમાર માંદું અસ્વસ્થ આજારી રોગવાળું રોગિષ્ઠ રોગિયું રુગ્ણ આર્ત
रोसाळ: રસદાર રસાળ રસભર્યું રસવાળું રસલ રસપૂર્ણ રસિક
लकलकीत: પ્રકાશમાન તેજસ્વી તેજોમય પ્રકાશતું ઉજ્જવલ ઉજ્જવલિત દીપ્તિપૂર્ણ આલોકિત ઉજ્જવળ ઊજળું પ્રકાશિત કાંતિમાન તેજસ્વી સાફ સ્વચ્છ સિત અવદાત દેદીપ્યમાન
लक्षवेदी: લક્ષ્યવેધી લક્ષવેધી લક્ષ્યવેધક
लक्षा_वसून_पयस: લક્ષ્યભ્રષ્ટ લક્ષ્યવિમુખ
लखपती: લખપતિ લાખોપતિ લક્ષપતિ
लखलखपी: ભપકાદાર
लखलखीचें: ભપકાદાર
लखलखीत: ભપકાદાર
लग्न_जाल्लें: વિવાહિત પરણેલું પરિણીત શાદીશુદા
लग्नाची: પરણેતર વિવાહિતા
लग्नाचें: વૈવાહિક વૈવાહ
लज_नाशिल्लो: નિર્લજ્જ બેશરમ નાગું નિર્મર્યાદ શરમ_વિનાનું લાજ_વગરનું બેશર્મ બેહયા નિલજ નકટું નિહંગ અપત બેમુરવ્વત લજ્જાહીન અલજ્જ નિહંગમ ત્રપાનિરસ્ત
लजेची: શરમજનક લજ્જાજનક શરમાવનારું શર્મનાક લજ્જાસ્પદ
लजेस्त: શરમાળ લજ્જાશીલ લજજાળુ લાજવાળું શરમાળ મુંહચોર
लज्जीत: લજ્જિત શરમિંદું લાજેલું શરમ_પામેલું ભોંઠું લજવાયેલું શરમાયેલું ઝંખવાણું_પડી_ગયેલું
लटकें: ખોટું જૂઠું અસત્ય મિથ્યા અસત્યતાપૂર્ણ મિથ્યાપૂર્ણ અસત અસત્ મૃષાવચન અલીક અવિદ્યમાન અમૂલક નિરાધાર અકારણ આધારશૂન્ય અપ્રમાણિક અપ્રામાણિક આધારહીન નિર્મૂલ સારહીન અનાધાર યથાર્થહીન આધારરહિત બનાવટી દેખાવટી ઉપરછલ્લું ઉપર_ઉપરથી સહેજ_સાજ દેખાવ-ડોળ
लटको: લુચ્ચું લુચ્ચુંલફંગું બદમાશ ખંધું લફંગું દોંગું કૂટકારક કૂટકાર
लडकें: ખોટા નકલી નકલરૂપ બનાવટી કૃત્રિમ પોકળ મિથ્યા જૂઠું જૂઠાણું પોલું
लडायेचीं: લડાકૂ જંગી
लडावू: લડાકૂ જંગી
लढाऊ: શૂરવીર યુધ્ધવીર રણવીર રણધીર રણશૂર લડવૈયો
लवचीक: લચકદાર નમ્ય નમનીય લવચીક નરમ સુનમ્ય મૃદુ સુનમ્ય
लश्करी: લશ્કરી સૈન્ય
लस्करी: લશ્કરી સૈન્ય
लांचखोर: રિશ્વતખોર લાંચિયું રુશવતખાઉ રિશ્વતી
लांब: લાંબું દીર્ઘ વિશાળ દીર્ઘકાય વિસ્તૃત પ્રણવ લાંબો લાંબુ મોટું
लांब-रुंद: લાંબું દીર્ઘ વિશાળ દીર્ઘકાય વિસ્તૃત પ્રણવ
लांब_काळाचें: ચિરકાલીન દીર્ઘકાલીન બદ્ધમૂલ
लाख: લાખ લક્ષ ૧૦૦૦૦૦ 100000
लाखाधीश: લખપતિ લાખોપતિ લક્ષપતિ
लागचें: પાસેનું નજીકનું જોડેનું સમીપનું નિકટતમ નિકટતર નિકટવર્તી સમીપી સંનિકટ સમીપવર્તી સન્નિહિત લગોલગ નિકટસ્થ આસન્ન
लागींचे: નજીકનું આસન્ન સંનિક્ટ
लागींचें: પાસેનું નજીકનું જોડેનું સમીપનું નિકટતમ નિકટતર નિકટવર્તી સમીપી સંનિકટ સમીપવર્તી સન્નિહિત લગોલગ નિકટસ્થ આસન્ન
लाचार: લાચાર વિવશ નિરુપાય નિર્વિકલ્પ નાઇલાજ વિકલ્પ_રહિત લાચાર વિવશ પરવશ પરાધીન પરતંત્ર નિરુપાય વ્યાકુળ વિહ્વળ નિરુપાય
लाजरें: શરમાળ લજ્જાશીલ લજજાળુ લાજવાળું
लाडावल्लो: સ્વચ્છંદી_છોકરો નિરંકુશ_છોકરો નિહંગ
लाबदिणें: લાભપ્રદ લાભદાયક લાભકારી ફાયદાકારક લાભકર લાભકર્તા લાભકારક ફાયદેમંદ ફાયદામંદ ગુણકારી ઉપયોગી હિતકારી મુફીદ અર્થકર
लाभहीण: ગેરલાભ લાભહીન અલાભ અલાભકર
लाभार्थी: લાભકર લાભદાયક ફાયદાકારક લાભાન્વિત
लाल: લાલ રાતું રોહિત સુર્ખ રક્ત-વર્ણ આરક્ત
लाशें_पडिल्लो: ડાઘવાળું દાગદાર
लाशेल्लो: ડાઘવાળું દાગદાર
लिकलिकीत: ચમકદાર ચળકતું તેજવાળું ચમકવાળું પ્રકાશિત ઝકાઝક ઉજ્જવલ તેજદાર શુક્ર
लिकलीकपी: ચમક્તો દમક્તો ઉજ્જવલ રોશન ઝગમગ દીપ્ત પ્રકાશવાન દ્ર્યુતિમાન કાંતિમાન
लिखीत: લિખિત લખેલું લેખિત લખેલ લિપિબદ્ધ અંકિત મકતૂબ લેખાકૃત અભિલિખિત લેખાંકિત કાગજી
लुकसाणदिणें: હાનિકારક નુકસાનકારક હાનિકર હાનિકર્તા હાનિકર્ત્તા અનર્થકારી અહિતકારી અહિતકર
लुकसाणाचें: ક્ષતિગ્રસ્ત
लुकसाणीचें: હાનિકારક નુકસાનકારક હાનિકર હાનિકર્તા હાનિકર્ત્તા અનર્થકારી અહિતકારી અહિતકર
लुकसाणीचो: ગેરલાભ લાભહીન અલાભ અલાભકર
लुप्त: લુપ્ત નાશ_પામેલું લોપાયેલું નષ્ટ નદારદ ગેબ અંતર્હિત ઉચ્છન્ન
लुळो: લુલું
लुळोपांगळो: અપંગ વિકલાંગ અશક્ત પાંગળું ખોડીલું
लेंवाळ: રેસાદાર રેષામય રોમલ રોમરાજિ
लोककल्याणकारी: લોકોપકારી લોકહિતૈષી લોકહિતવાદી લોકોપકારક
लोकप्रीय: લોકપ્રિય જનપ્રિય સર્વપ્રિય
लोकमान्य: લોકપ્રિય જનપ્રિય સર્વપ્રિય
लोकरी: ઊની આવિક ગરમ
लोकांमुखी: પ્રસિદ્ધ વિખ્યાત જનશ્રુત
लोकांमोगाळ: લોકપ્રિય જનપ્રિય સર્વપ્રિય
लोकांमौखीक: પ્રસિદ્ધ વિખ્યાત જનશ્રુત
लोकाचें: પારકું પરાયું બીજાનું ગેર પરકીય
लोकोपयोगी: લોકોપયોગી જનોપયોગી સર્વભોગ્ય
लोकोपेगी: લોકોપયોગી જનોપયોગી સર્વભોગ્ય
लोणयाचें: માખણ_જેવું લીસું
लोभी: સ્વાર્થી સ્વાર્થવાળું મતલબી સ્વાર્થપરાયણ ગરજુ અર્થી આત્મગ્રાહી એકલપેટું
लोळकें: મેલુ અસ્વચ્છ ખરાબ અપવિત્ર અશુધ્ધ ગંધારુ બગડેલું દૂષિત અવિમલ અનિર્મલ અવિશુધ્ધ અશુચિ મ્લાન મલિન ગંદુ
लोळिल्लें: મેલુ અસ્વચ્છ ખરાબ અપવિત્ર અશુધ્ધ ગંધારુ બગડેલું દૂષિત અવિમલ અનિર્મલ અવિશુધ્ધ અશુચિ મ્લાન મલિન ગંદુ
ल्हव: હલકું હળવું તુનક નાજુક
ल्हव_ल्हव: મંદ ધીમું ધીરું થોડું મંથર સુસ્ત
ल्हवपीक: ધીમું મંદ હલકું મૃદુ આછું હળવું
ल्हान: કનિષ્ઠ અવર અનુજ અનુજન્મા કનિષ્ઠ લઘુ
ल्हारांचो: તરંગિત તરંગી લહેરાળું ઊર્મિલ
वंगाळ: ધમધૂસર
वंचीत: વંચિત રહિત
वंदनीय: વંદનીય પૂજ્ય આદરણીય પૂજનીય અભિવંદનીય નમ્ય નમનીય પ્રણમ્ય વંદ્ય અભિવંદ્ય
वंशाचो: વંશીય કુળોત્પન્ન
वंशावळीचें: આનુવંશિક પૈતૃક બાપીકું વારસાગત કુલક્રમાગત પેઢીઉતાર વંશપરંપરાગત મૌરૂસી પેઢીધર
वंशी: વંશીય કુળોત્પન્ન
वक्र: બેડોળ કડોળ અડોળ કદરૂપું બેઢંગ અણઘડ કઢંગું ભદ્દુ વક્રાંગ
वखदी: ઔષધીય
वजन_काडिल्लें: જોખેલું માપિત માપેલું
वजन_केल्लें: જોખેલું માપિત માપેલું
वजनदार: ભારે વજનદાર વજની બોઝલ પીવર
वणटीचें: દીવાલી
वनवासी: વનવાસી આરણ્યક અરણ્યવાસી વની
वनस्पतीहीण: વેરાન ઉજ્જડ વનસ્પતિહીન
वयर_आयिल्लो: ઊગતું ઉદિત ઊગેલું
वयर_दिल्लो: ઉપરોક્ત ઉપર_કહેલું ઉપર્યુક્ત પૂર્વે_કહેવામાં_આવેલું
वयरसकयल: અસમતોલ ઉબડ-ખાબડ અસમતળ વિષમ_પ્રમાણ
वयले: ઊંચું ઉચ્ચ ઉત્તમ શ્રેષ્ઠ ઉન્નત
वयलें: ઊંચું ઉચ્ચ ચડિયાતું ઉમદા બુલંદ મોટું ઉતુંગ પ્રાંશુ
वयलो: ઉપરોક્ત ઉપર_કહેલું ઉપર્યુક્ત પૂર્વે_કહેવામાં_આવેલું
वयल्या_कुळांतलो: ખાનદાની કુલીન_વર્ગ ઉદાત્ત_વર્ગ અમીરશાહી અમીરપણું અભિજાત
वयल्यावयलें: બનાવટી દેખાવટી ઉપરછલ્લું ઉપર_ઉપરથી સહેજ_સાજ દેખાવ-ડોળ
वयस्क: વયસ્ક ઉંમરલાયક બાલિગ
वरिश्ठ: વૃદ્ધ ઘરડું વડીલ વધેલું જૈફ બુઢ્ઢું મોટેરું વયોવૃદ્ધ
वरी: જેવું સરખું સરિખુ સમ
वर्ग: સમકક્ષ સરખું સમાન તુલ્ય સમતુલ્ય બરોબર જેવડું
वर्जीत: મનાઈ બંધી અટકાવેલું પ્રતિબંધિત અંકુશ વર્જ્ય વારિત
वर्ज्य: મનાઈ બંધી અટકાવેલું પ્રતિબંધિત અંકુશ વર્જ્ય વારિત
वर्णनीय: વર્ણનીય વર્ણ્ય આલેખ્ય અભિધેય
वर्णीत: વર્ણિત ચિત્રિત નિરૂપિત
वर्तमान: વર્તમાન સાંપ્રત અભૂત વિદ્યમાન
वर्तमान_काळ: સાંપ્રત વર્તમાનકાલીન તત્કાલીન સામયિક સમયોચિત નિયતકાલિક
वर्सभराच्यो: બારમાસી વર્ષસ્થાયી સદાબહાર
वर्सुकी: એકવર્ષીય
वलें: ભીનું લીલું ભેજવાળું પલળેલું આર્દ્ર તર આપ્લાવિત તરબોળ
वळखीचें: ખબર અવગત જાણેલું જ્ઞાત પરિચિત વાકેફ પ્રતીત અવભાસિત જાણીતું પ્રજ્ઞાત પરિજ્ઞાત વિજ્ઞાત
वळखीचो: પરિચિત ઓળખીતું રુબરુ
वळेरेंत: ક્રમિક ક્રમાનુસાર ક્રમપૂર્વક ક્રમબદ્ધ ક્રમસર અનુક્રમિક અનુક્રમવાર શૃંખલાબદ્ધ શૃંખલિત કડીબંધ અનુપૂર્વ
वश_केला_असो: વશ્ય
वशिल्लें: વસ્તી આબાદી ગુલજાર
वशीकृत: વશીકૃત વશીભૂત અભિભૂત
वसंत_काळाचें: વાસંતી વસંતી વાસંતિક વાસંતક વસંતકાલીન
वसंतकाळीन: વાસંતી વસંતી વાસંતિક વાસંતક વસંતકાલીન
वसतीघरवासी: છાત્રાલય છાત્રાવાસ
वसाड: નિર્વાસિત અનિવાસિત ઉજડેલું અવાસિત બિનઉપજાઉ અફળદ્રુપ નિટર
वांकडें: ત્રાંસું વાંકુંટેઢુ આડું કતરાતું
वांकडो: વક્રાંગ વાંકું વક્ર ટેડું વળેલું વાંકવાળું વાંકું-ચુકું કુંચિત બંક બંકિમ વામ
वांकडो-तिकडो: વાંકું વક્ર ટેડું વળેલું વાંકવાળું વાંકું-ચુકું કુંચિત બંક બંકિમ વામ
वांकडोतिकडो_वचपी: વક્રગામી
वांगडी_आशिल्लो: મિત્રવાળુ સમિત્ર
वांगडें: બેડોળ કડોળ અડોળ કદરૂપું બેઢંગ અણઘડ કઢંગું ભદ્દુ
वांयगण: રવીપાક
वांयग्या_कोराचें: જાંબલી જામલી
वाकडें: ઝૂકવું નમવું
वाचपायोग्य: પાઠ્ય પઠનીય પઠ્ય અધ્યેય
वाचाळ: વાચાળ વાતોડિયું બહુબોલું બટકબોલું
वाचीक: પાઠ્ય પઠનીય પઠ્ય અધ્યેય
वाट_पळोवपी: પ્રતીક્ષિત
वाठारी: પ્રાદેશિક આંચલિક
वाडोवपी: વર્ધક વૃદ્ધિકર વૃદ્ધિકારી સંવર્ધક પોષક પુષ્ટિકર
वादग्रस्त: વિવાદાસ્પદ વિવાદિત વિવાદાસ્પદ તકરારી વિવાદયુક્ત વિવાદગ્રસ્ત
वादाचें: વિવાદાસ્પદ વિવાદિત વિવાદાસ્પદ તકરારી વિવાદયુક્ત વિવાદગ્રસ્ત
वादास्पद: વિવાદાસ્પદ
वानप्रस्थाश्रमी: વાનપ્રસ્થાશ્રમી વાનપ્રસ્થી
वानप्रस्थी: વાનપ્રસ્થાશ્રમી વાનપ્રસ્થી
वानरी: વાનરી કાપેય
वापराचें: ઉપયોગી ખપનું કામનું અર્થકર
वापरिल्लें: પ્રયુક્ત પ્રયોજિત ઉપભુક્ત વ્યવહૃત
वायट: દુરાશય ખોટો કુવિચારી બદનિયત મેલુ અસ્વચ્છ ખરાબ અપવિત્ર અશુધ્ધ ગંધારુ બગડેલું દૂષિત અવિમલ અનિર્મલ અવિશુધ્ધ અશુચિ મ્લાન મલિન ગંદુ નીચ ઘટિયા હીન નિકૃષ્ટ અધમ હલકું નઠારું તુચ્છ ક્ષુદ્ર મ્લેચ્છ પોચ નીચમાં_નીચ અધમાધમ અધમતમ અત્યંત_અધમ સૌથી_હલકું પ્રતિકૂળ વિરુદ્ધ ઊલટું ખિલાફ અગવડકારક ખિલાફ અસૂત વામ વિપરીત ખરાબ બૂરું નઠારું ભૂંડું અયોગ્ય અનુચિત ભ્રષ્ટ વાહિયાત બદ અપ્રિય અયોગ અવદ અવિહિત બદતર દગાબાજ દગલબાજ પ્રપંચી ધૂર્ત ચાલબાજ શાતિર વિશ્વાસઘાતી શઠ હોશિયાર વક્રગામી કિતવ કૈવત પ્રતારક ચંટ વક્રગામી દ્વિભાવ કપટી
वायट_उलोवपी: કટુભાષી અપ્રિયવાદી
वायट_करपी: દુષ્કર્મી કુકર્મી અપકર્મી ખલ અકર્મી બદકાર
वायट_गूण: દુર્ગુણી દુર્ગુણથી_ભરેલુ દુર્ગુણવાળું અગુણી અવગુણવાળું
वायट_चिंतपी: અકલ્યાણ_કામી અશુભેચ્છક અનર્થદર્શી અશુભચિંતક
वायट_वेव्हारी: દુર્વ્યવહારી દુર્વર્તનશીલ અસદાચારી અશીલ શીલરહિત અશીલવાન
वायट_वेसनी: દુર્વ્યસની કુટેવી વ્યસની બંધાણી
वायट_सभावाचो: કુબુદ્ધિ બદમિજાજી મિજાજી બદમિઝાજ તુંડમિજાજી
वायटकार: રોગી બીમાર માંદું અસ્વસ્થ આજારી રોગવાળું રોગિષ્ઠ રોગિયું રુગ્ણ આર્ત
वायेचें: બાદી અજીર્ણ બાદી
वारें_घोळपी: હવાદાર
वासनाहीण: કામહીન નિષ્કામ અનાસક્ત વાસનાહીન નિર્મમ વિરક્ત
वासाचें: સુગંધિત સુવાસિત સુગંધીદાર ખુશબોદાર ખુશ્બૂદાર સુરભિત આમોદિત
वास्तवीक: વાસ્તવિક યથાર્થ સાચું અસલી ખરેખરું વાજબી સાચેસાચું સાચમાચ મૂળ ખરું
वाहक: વાહી વાહિની વાહિકા
विंगड_विंगड: વિવિધ બહુવિધ બહુ_પ્રકારનું બહુ_પ્રકારે અનેક_રીતે
विकपाच्यो: વેચાઉ વિક્રેય પણ્ય બિકાઉ
विकल्पी: વૈકલ્પિક મરજિયાત ઐચ્છિક વિકલ્પવાળું
विकसीत: પ્રગતિમાન અગ્રગત વિકસિત સુવિકસિત ઉન્નત મુકુલિત વિકચ અભ્યુદિત ઉન્નત
विकासकर्तो: પ્રગતિશીલ અગ્રગામી પુરોગામી અગ્રદર્શી
विकासशील: વિકાસશીલ ઉન્નતિશીલ પ્રગતિશીલ અભ્યુત્થાયી
विकृत: ખરાબ દૂષિત ગંદું વિકૃત બગડેલું વિકારી અપભ્રંશ અપભ્રંશિત
विक्रमी: પ્રતાપી પ્રતાપશાળી પ્રતાપવાળું વિક્રાંત
विक्राळ: પ્રચંડ ભયાનક ભયંકર બિહામણું ડરામણું બીકવાળું વિકરાળ ઘોર ભીષણ ભયાવહ ઉગ્ર રૌદ્ર રુદ્ર મહાચંડ કરાલ ખૂંખાર રૌરવ વિષમ દારુણ તામ
विक्रेच्यो: વેચાઉ વિક્રેય પણ્ય બિકાઉ
विखा_बगर: વિષહીન વિષરહિત અવિષ
विखाचें: ઝેરી ઝેરીલું વિષયુક્ત વિષમય વિષાલુ વિષમય
विखारी: ઝેરી ઝેરીલું વિષયુક્ત વિષમય વિષાલુ વિષમય વિષધર ઝેરીલો વિષવાળું ઝહેરીલો ઝેરી
विखाळ: ઝેરી ઝેરીલું વિષયુક્ત વિષમય વિષાલુ વિષમય વિષધર ઝેરીલો વિષવાળું ઝહેરીલો ઝેરી
विख्यात: વિશ્વવિખ્યાત લોકપ્રસિદ્ધ જગવિખ્યાત જગજાહેર વિશ્વપ્રસિદ્ધ જગપ્રસિદ્ધ
विचलीत: અશાંત શાંતિરહિત અસ્થિર ઉદ્વિગ્ન વ્યગ્ર તોફાની ચંચળ આતુર ઉત્કંઠિત અવ્યવસ્થિત ક્ષુબ્ધ ડહોળાયેલું અવકંપિત બેચિત્ત બેધ્યાન આલોલ
विचार_करपाचें: ચિંતનીય વિચારણીય લક્ષ્ય વિચાર્ય ચિંત્ય અનુશીલનીય અવધેય
विचार_केल्लें: વિચારિત વિચારેલું ચિતેલું ધારેલું
विचार_जाल्लें: વિચારિત વિચારેલું ચિતેલું ધારેલું
विचारशुन्य: અવિચારી વિચારહીન વિચારશૂન્ય
विचारहीण: અવિચારી વિચારહીન વિચારશૂન્ય
विचारी: ચિંતનીય વિચારણીય લક્ષ્ય વિચાર્ય ચિંત્ય અનુશીલનીય અવધેય
विचारीक: વિચારપૂર્વક વૈચારિક વિચારાત્મક બુદ્ધિસિદ્ધ યુક્તિપૂર્ણ
विचित्र: અસ્વાભાવિક કૃત્રિમ અકુદરતી અપ્રાકૃતિક અનૈસર્ગિક અપ્રાકૃત વિસ્મયકારી આશ્ચર્યકારક વિસ્મયકારક વિલક્ષણ વિચિત્ર
विजयी: સફળ કામયાબ કૃતાર્થ સિદ્ધ સાર્થક કૃતકૃત્ય સફળતા
विजातीय: વિજાતીય વિજાતિ પરજાતીય ભિન્ન_જાતીય
विज्ञानीक: વૈજ્ઞાનિક
विटिल्लें: ઊબાયેલું બેજાર કંટાળી_ગયેલું ઉકતાઈ_ગયેલું ઉકતાયેલું ઉબાઈ_ગયેલું
विदेशी: વિદેશી પરદેશી દેશાવરી વિલાયતી અન્યદેશીય અજનવી અજનબી વિદેશી પરદેશી વિલાયતી અન્યદેશીય દેશાવરનું
विद्रूप: કુરૂપ કદરૂપું બેડોળ બદસૂરત બદશિક્લ વરવું ભદ્દું અરૂપ ભદેસ ભદેસિલ અનગઢ અપાટવ અવરૂપ અરૂપ વિરૂપ ખરાબ દૂષિત ગંદું વિકૃત બગડેલું વિકારી અપભ્રંશ અપભ્રંશિત
विद्वत्तापूर्ण: વિદ્વત્તાપૂર્ણ પાંડિત્યપૂર્ણ
विद्वान: વિદ્વાન જ્ઞાનવાન પંડિત જ્ઞાની વિબુધ જ્ઞાતા વિદ્વત વેત્તા ભિજ્ઞ
विधिचें: કાનૂની કાયદેસર જાયજ યોગ્ય વાજબી યથાર્થ ઉચિત મુનાસિબ વિધિમાન્ય
विधीलिखीत: વિધિવશ પ્રારબ્ધાધીન પ્રારબ્ધવશ પૂર્વ_નિશ્ચિત
विनम्र: વિનમ્ર નમ્રભાવી નમ્ર વિનયી પ્રણત વિનયશીલ અવાગ્ર નિભૃત
विनयी: પ્રમાણિક ઈમાનદાર વિશ્વાસપાત્ર ઈમાની ઋજુ સત્યપર સત્યપરાયણ નિષ્કપટ નિખાલસ સાચું ખરૂં
विनाशक: વિનાશક નાશક નાશકારક વિનાશકારી વિનાશી વિનાયક ગણપતિ ગણેશ ગજાનન વોલોપક અપાય
विनाशी: વિનાશક નાશક નાશકારક વિનાશકારી વિનાશી વિનાયક ગણપતિ ગણેશ ગજાનન વોલોપક અપાય
विनोदी: વિનોદી વિનોદક દિલ્લગીબાજ વિનોદપ્રિય મશ્કરા મજાકિયું હાસ્યપૂર્ણ હાસ્યપ્રદ હાસ્યજનક
विपक्षी: વિપક્ષીય વિરુદ્ધ_પક્ષનું સામા_પક્ષનું પ્રતિપક્ષી
विपक्षीय: વિપક્ષીય વિરુદ્ધ_પક્ષનું સામા_પક્ષનું પ્રતિપક્ષી
विभागणी: વિભાજિત વિભક્ત વિભાગાયેલું અલગ જુદું છૂટું ભેદિત પરિચ્છિન્ન
विभागी: પ્રાદેશિક આંચલિક
विभुशीत: વિભૂષિત અલંકૃત અલંકૃત વિભૂષિત ભૂષિત આભૂષિત અલંકારિક અભિમંડિત સજ્જિત અલંકિત આભરિત
विमूख: લક્ષ્યભ્રષ્ટ લક્ષ્યવિમુખ
वियोगी: વિરહી વિયોગી વિજોગી
विरक्त: સંન્યાસી ચતુર્થાશ્રમી સંન્યસ્તાશ્રમી વૈરાગી વેરાગી વૈરાગ્યયુક્ત બાવો સાધુ સત્પુરુષ વિરક્ત
विरळ: અઘન આછું પાંખું વિરલ વિરલા કોઇ-કોઇ કોઇક_જ
विरही: વિરહી વિયોગી વિજોગી
विरहीण: નિર્વીર વીર્યહીન
विरुद्ध: વિપરીત અવળું ઊલટું વિરુદ્ધ પ્રતિકૂલ વિરોધી વિલોમ પ્રતિલોમ પ્રતીપ પ્રતિકૂળ ઊંધું અપસવ્ય ઊલટું ઊંધું અવળું વિપરીત વિરુદ્ધ અન્યથા
विरोधा_बवगरचें: નિર્વિઘ્ન અવિરોધ
विरोधा_विणें: નિર્વિઘ્ન અવિરોધ
विरोधी_पक्ष: વિરોધી દુશ્મન પ્રતિપક્ષી સામાવાળિયો પ્રતિવાદી પક્ષકાર હરીફ
विलक्षण: વિસ્મયકારી આશ્ચર્યકારક વિસ્મયકારક વિલક્ષણ વિચિત્ર
विलासी: કામુક ઇચ્છુક વિષયી કામી લંપટ કામાસક્ત વિલાસી વિષયાસક્ત ભોગી કામચારી વ્યભિચારી કામકૂટ છિનાળવો અનુક અભિક અભીક વિલાસી ભોગવિલાસી ઐયાશ એશઆરામી રંગીન
विवश: લાચાર વિવશ પરવશ પરાધીન પરતંત્ર નિરુપાય વ્યાકુળ વિહ્વળ નિરુપાય
विवादास्पद: વિવાદાસ્પદ
विवाहीत: વિવાહિત પરણેલું પરિણીત શાદીશુદા
विवीध: અનેક સંખ્યાબંધ બહુ એકાધિક વિવિધ ઘણી અનેકાનેક
विवेकी: વિવેકી વિચારવાન સમજદાર જ્ઞાની વિવેકવાળું સમજુ સભ્ય
विशाचें: ઝેરી ઝેરીલું વિષયુક્ત વિષમય વિષાલુ વિષમય
विशारी: ઝેરી ઝેરીલું વિષયુક્ત વિષમય વિષાલુ વિષમય વિષધર ઝેરીલો વિષવાળું ઝહેરીલો ઝેરી
विशाळ: વિશાળ વિશાળકાય વિરાટ ભવ્ય અઝીમ મહા
विशाळकाय: મહાકાય કદાવર અતિકાય વિશાળકાય ભીમકાય વિકરાળ બૃહત્કાય
विशीं: વિષયક સંબંધી સંબંધવાળું અન્વયી અનુષંગી સંયુક્ત
विशेश: વિશિષ્ટ ખાસ અસાધારણ અસામાન્ય વિશેષ ખાસ અનોખું લોકોત્તર અલૌકિક
विश्वविजेतो: વિશ્વવિજયી વિશ્વવિજેતા દિગ્વિજયી જગવિજયી
विश्वासघातकी: દગાબાજ નમકહરામ વિશ્વાસઘાતી ગદ્દાર બેવફા દગાબાજ
विश्वासी: વિશ્વાસુ વિશ્વાસપાત્ર વિશ્વાસી વિશ્વાસ_કર્તા
विसंगत: અનુચિત અસંગત વિસંગત અયોગ્ય અઘટિત અજુગતું નામુનાસિબ ગેરવાજબી
विसरिल्लें: વિસ્મૃત ભુલાયેલું અસ્મરણીય પ્રસ્મૃત
विसावो: વીસમું ૨૦મું 20મું
विस्कळ: અઘન આછું પાંખું
विस्कळीत: અસ્તવ્યસ્ત અવ્યવસ્થિત ગેરવ્યવસ્થિત. વિસ્થાપિત સ્થાનભ્રષ્ટ હટાવેલી
विस्तीर्ण: વ્યાપક વિશાળ પરિવ્યાપક સર્વવ્યાપ્ત વિસ્તીર્ણ
विस्थापीत: વિસ્થાપિત સ્થાનભ્રષ્ટ હટાવેલી
विस्फारीत: વિસ્ફારિત પહોળું ફાટેલું
विस्वासघातकी: દગાબાજ દગલબાજ પ્રપંચી ધૂર્ત ચાલબાજ શાતિર વિશ્વાસઘાતી શઠ હોશિયાર વક્રગામી કિતવ કૈવત પ્રતારક ચંટ વક્રગામી દ્વિભાવ કપટી
विस्वासू: વિશ્વાસુ વિશ્વાસપાત્ર વફાદાર ભરોસાપાત્ર વિશ્વસનીય ખાતરી_લાયક
वीर: વીર બહાદુર શૂર શૂરવીર બલવાન બળવાન પરાક્રમી દિલાવર વિભુ બંકો
वीस: વીસ ૨૦ 20
वेंचिल्ली: નિયુક્ત નિમાયેલું નીમેલું નીમેલ નિયત મુકરર નિયોજિત નિમાયેલ
वेंचिल्लें: ગોઠવવું સ્વચ્છ_કરવું સુઘડ_કરવું ચૂંટાયેલ ચયિત ચયનિત ચુનિંદા ચૂંટાયેલું ચૂંટાયેલ નિર્વાચિત
वेगळी: અસ્વાભાવિક કૃત્રિમ અકુદરતી અપ્રાકૃતિક અનૈસર્ગિક અપ્રાકૃત
वेगळे: અલગ અલગ-અલગ જુદું છૂટું અસમ વિષમ ભિન્ન અનમેલ અસમાન પૃથક્ વિભિન્ન અતુલ્ય અયુગ અમિલ અસંબદ્ધ
वेगळें: વિપરીત અવળું ઊલટું વિરુદ્ધ પ્રતિકૂલ વિરોધી વિલોમ પ્રતિલોમ પ્રતીપ પ્રતિકૂળ ઊંધું અપસવ્ય
वेगळेंवेगळें: વિવિધ બહુવિધ બહુ_પ્રકારનું બહુ_પ્રકારે અનેક_રીતે
वेगवान: ઝડપી દ્રુતગામી દ્રુતગતિ
वेगहीण: સ્થિર અચલિત અગતિ અયાન
वेगाचे: પ્રચંડ ઉગ્ર પ્રખર આકરું પ્રબળ જબરું જબ્બર પ્રબલ તેજ તીવ્ર તીક્ષ્ણ કડા અમંદ દુર્દમ
वेगाचें: ગતિશીલ ગતિમાન ગતિવંત ગતિવાળું વેગીલું વેગવાળું ઝડપી ગતિવાળું ફરતું જંગમ ભમતું અસ્થિર ચંચળ અધ્રુવ હાલતું તોફાની બેકાબૂ ધાંધલિયું હુલ્લડખોર નિરંકુશ
वेगान: તીવ્ર વેગીલું તેજ દ્રુત ઉડતું
वेदज्ञ: વેદજ્ઞ નિગમી
वेदतज्ञ: વેદજ્ઞ નિગમી
वेदपंडीत: વેદજ્ઞ નિગમી
वेदशास्त्री: વેદજ્ઞ નિગમી
वेदांचें: વૈદિક વેદીય આર્ષ
वेदीक: વૈદિક વેદીય આર્ષ
वेपाराचें: વ્યાપારિક વ્યાપારિય વાણિજ્યિક વ્યવસાયિક પેશાવર
वेपारीक: વ્યાપારિક વ્યાપારિય વાણિજ્યિક વ્યવસાયિક પેશાવર
वेळ_पाळपी: સમયપાલક સમયસાવધ
वेळ_पाळिनासपी: લેટ_લતીફ સમય_અપાલન
वेळार: સમયોચિત સમયાનુકૂલ સામયિક અવસરોચિત કાલોચિત
वेवसायाचें: વ્યાપારિક વ્યાપારિય વાણિજ્યિક વ્યવસાયિક પેશાવર
वेवसायीक: વ્યાપારિક વ્યાપારિય વાણિજ્યિક વ્યવસાયિક પેશાવર
वेवस्थीत: વ્યવસ્થિત ઠીક વિન્યસ્ત સુવ્યવસ્થિત સારી_વ્યવસ્થાવાળું સારી_રીતે_ગોઠવેલું વ્યવસ્થાપૂર્વકનું નિયમિત નિયમબદ્ધ
वेव्हारी: વ્યવહારુ દુનિયાદાર વ્યવહાર_કુશળ સખ્ત આકરું ઉગ્ર નિર્દય ગરમ_સ્વભાવનું
वेश्टिल्लो: ઢંકાયેલું આચ્છાદિત છવાયેલું સંતાડેલું ઢાંકેલું સંવૃત આવૃત આવરેલું અપિહિત
वेश्यागामी: વ્યભિચારી વેશ્યાગામી રંડીબાજ ઐયાશ ઐયાશી
वेसनी: દુર્વ્યસની કુટેવી વ્યસની બંધાણી
वैचारीक: વિચારપૂર્વક વૈચારિક વિચારાત્મક બુદ્ધિસિદ્ધ યુક્તિપૂર્ણ
वैतनीक: વૈતનિક પગારદાર દરમાયાદાર ભૃતક કર્મકર
वैभवशाली: ધનાઢ્ય ધની અમીર ધનવાન માલદાર ધનવંત દોલતમંદ વૈભવશાળી વૈભવશાલી વૈભવવાળું સંપન્ન માલામાલ સમૃદ્ધ ઐશ્વર્યવાન સંપત્તિવાન ખુશહાલ પૈસાદાર બહુધન જરદાર
वैयक्तीक: અંગત વ્યક્તિગત વૈયક્તિક નિજી
वैरपणाचो: વેરભર્યુ શત્રુતા અદાવત અટસ_ઘૃણા
वैरी: શત્રુપૂર્ણ શત્રુયુક્ત
वैष्णव: વૈષ્ણવ
व्यक्त: અભિવ્યક્ત સ્પષ્ટ સ્ફુટ_કરેલું જાહેર પ્રકટ વ્યક્ત અભિવ્યંજિત જાહિર વિદિત
व्यक्तीगत: અંગત વ્યક્તિગત વૈયક્તિક નિજી
व्यभिचारी: વ્યભિચારી છિનાળવું દુરાચારી બહારચલું અનાચારી જારી છિનાળું દુશ્ચરિત દુરાચરણી દુશ્ચરિત્ર બદચલન કામી કામુક અય્યાશ વિષયાસક્ત અન્યગ અન્યગામી જનાખોર નાડીછૂટ રંડીબાજ ઇશ્કબાજ પારદારિક છિનાળ વ્યભિચારિણી જારિણી ચરિત્રહીન કુલટા
व्यस्त: વ્યસ્ત
व्याकूळ: આતુર આકળું અધીરૂં ઉતાવળું વ્યાકુળ વ્યગ્ર ઉત્કંઠિત કાતર અધીર વ્યગ્ર ગાભરું વિહ્વળ બેબાકળું બહાવરું ગભરું બાવરું બેકલ બેચૈન બેતાબ વિહવળ વિકલ બેકરાર અધીરજ અધૈર્ય અધૈર્યવાન
व्याख्या_केल्ल्यो: વ્યાખ્યાયિત પરિભાષિત
व्यापक: વ્યાપક વિશાળ પરિવ્યાપક સર્વવ્યાપ્ત વિસ્તીર્ણ
व्यायामी: કસરતી વ્યાયામી કસાયેલું
व्हड: મહાન મોટુ વડુ ઉંચુ શ્રેષ્ઠ મૂર્ધન્ય ઉદાત્ત માનનીય પૂજય વંદનનીય આદરણીય ઉત્કૃષ્ટ અસાધારણ મહત્વનું વિશાળ વિશાળકાય વિરાટ ભવ્ય અઝીમ મહા વિકરાળ દારુણ ભયાનક લાંબું દીર્ઘ વિશાળ દીર્ઘકાય વિસ્તૃત પ્રણવ જ્યેષ્ઠ અગ્રજ વરિષ્ઠ અગ્રજન્મા અગ્રજાત મોટું પુરોજન્મા મોટા જયેષ્ઠ વડું
व्हड-मनाचो: ઉદાર દરિયાદિલ ખૂબ_ઉદાર દિલદાર અકૃપણ પ્રવણ અકૃપણ ઉદારચિત્ત
व्हड_आंकडो: સંખ્યાબંધ બહુસંખ્ય બહુસંખ્યક
व्हड_काळजाचो: ઉદાર દરિયાદિલ ખૂબ_ઉદાર દિલદાર અકૃપણ પ્રવણ અકૃપણ ઉદારચિત્ત
व्हड_मनाचें: મહામન મહામના
व्हडलें: જ્યેષ્ઠ અગ્રજ વરિષ્ઠ અગ્રજન્મા અગ્રજાત મોટું પુરોજન્મા મોટા જયેષ્ઠ વડું
व्हड्याभोंवडेचें: નાવ્ય નાકાગમ્ય નૅવિગેબલ
व्हांवतें: વહેતું પ્રવાહિત પ્રવાહી વહ્યા_કરતું ગતિશીલ ગતિવંત પ્રવાહમય અવિરત અસ્ખલિત
व्हांवपी: વહેતું પ્રવાહિત પ્રવાહી વહ્યા_કરતું ગતિશીલ ગતિવંત પ્રવાહમય
शंग्रह_करी_सारक्यो: સંગ્રહિત અર્જનીય સંગ્રહણીય સંગ્રાહ્ય
शंबरावें: સોમું
शक्तीहीण: કમજોર દુર્બળ દુર્બળ નિર્બલ નિર્બળ અબલ અપ્રબલ બલહીન અવીર અસક્ત અસહાય લાચાર પરાધીન નિરાશ્રય શક્તિહીન અલ્પબલ અવીર નામર્દ
शक्य: સંભવ સંભવિત શક્ય શક્યતા સંભાવિત મુમકિન
शत्रुहीण: અજાતશત્રુ શત્રુહીન શત્રુવિહીન અરિહીન અભૂતશત્રુ
शब्दाचें: શાબ્દિક મૌખિક
शब्दाडंबराचें: શબ્દાડંબરપૂર્ણ શબ્દાડંબરયુક્ત
शरण_आयिल्लो: શરણાગત શરણે_આવેલું આશરે_આવેલું
शरणागत: શરણાગત શરણે_આવેલું આશરે_આવેલું
शरीरहीण: અશરીર અશરીરી વિદેહ અદેહ શરીરહીન અદેહ અનંગ અતનુ શરીરવિહીન અપિંડી પિંડરહિત
शर्मेची: શરમજનક લજ્જાજનક શરમાવનારું શર્મનાક લજ્જાસ્પદ
शस्त्रधारी: સશસ્ત્ર શસ્રસજ્જ શસ્ત્રધારી હથિયારબંધ
शस्त्रहीन: નિ શસ્ત્રહીન નિશસ્ત્ર
शांत: સૌમ્ય સુશીલ શાંત સૌમ્ય સુશીલ શાંત સાલસ સુજન સજ્જન ગંભીર ધીર ઠરેલ શાંત સૌમ્ય અચંચળ સ્થિર દૃઢ અડગ સહનશીલ મંદ શાંત પ્રશાંત નિરુદ્વિગ્ન અવિકલ અવ્યાકુલ સ્વસ્થ અવ્યગ્ર અનાકુલ અક્ષુબ્ધ સ્થિરચિત્ત શાંત સ્થિર પ્રશાંત અચંચલ ધીર ગંભીર અમત્ત અક્રોધી ક્રોધહીન શાંત શીતલ ટાઢું ઠંડું
शांती_आवडपी: શાંતિપ્રિય શાંતિપ્રેમી
शांतीपूर्ण: શાંતિપૂર્ણ શાંતિમય
शांतीप्रीय: શાંતિપ્રિય શાંતિપ્રેમી
शाकभक्ष्यी: શાકાહારી વનસ્પતિભક્ષક નિરામિષાહારી વનસ્પત્યાહારી
शाकाहारी: શાકાહારી વનસ્પતિભક્ષક નિરામિષાહારી વનસ્પત્યાહારી
शाक्त: શાક્ત
शाखा: ઘટાદાર ડાળીદાર
शाणो: દૂરદર્શી દીર્ઘદ્રષ્ટા દૂરદૃષ્ટિવાળું દીર્ઘદર્શી અગમબુદ્ધિ દુરંદેશી
शापोती: ધૃષ્ટ હિંમતવાન ઉદ્ધત નિડર ઉચ્છૃંખલ ઉછાંછળું અવિવેકી હઠીલું સ્વચ્છંદી
शाब्दीक: શાબ્દિક મૌખિક
शारांतले: શહેરી નગર_વાસી નગર_નિવાસી અગ્રામ્ય
शारिरीक: શરીરી દેહધારી દેહી શરીરવાળુ અંગધારી શરીરધારી દેહવાન જીવાત્મા
शारी: શહેરી નગર_વાસી નગર_નિવાસી અગ્રામ્ય શહેરી નાગરિક શહેરનું પૌર
शाश्वत: અમર અવિનાશી નિત્ય અક્ષર સનાતન અક્ષય શાશ્વત અનાશ અનાશવાન અનાશ્ય અભંગુર અચ્યુત અભંગ અવિગત અવિગત અમરણીય અમૃતાક્ષર અનપાય શાશ્વત નિત્ય અવિનાશી સનાતન ચિરસ્થાયી અકાલ અનંત વિભુ અરિષ્ટ અવ્યય અચ્યુત અવિનશ્વર અનાશી અયોનિ કાલાતીત
शासकी: કારોબારી વહીવટી સરકારી શાસકીય
शास्त्रीय: શાસ્ત્રીય
शास्वत: કાયમનું હમેશનું સનાતન સદાનું અવિનાશી શાશ્વત અમર અક્ષય નિત્ય
शिंगां_नाशिल्लें: બેશિંગું શિંગડા_વગરનું
शिंगाबगरचें: બેશિંગું શિંગડા_વગરનું
शिंदुरी: કેશરી કેસરી ભગવું કેસરીયું જાફરાની
शिंपडिल्लें: વેરાવું ફેલવું પ્રસરવું ફાલવું પ્રકિર્ણ વિકીર્ણ
शिंपिल्लें: સિંચેલું છાંટેલું સિંચિત સિક્ત સેચિત ઉક્ષિત ભીંજવેલ અભિષિક્ત
शिंयाळें: શીયાળાનું શીતકાલીન
शिकिल्लें: શિક્ષિત ભણેલું સાક્ષર પ્રાજ્ઞ
शिक्षणीक: શૈક્ષણિક તાલીમી ઇલ્મી
शिक्षीत: શિક્ષિત ભણેલું સાક્ષર પ્રાજ્ઞ
शिटूक: દૂરદર્શી દીર્ઘદ્રષ્ટા દૂરદૃષ્ટિવાળું દીર્ઘદર્શી અગમબુદ્ધિ દુરંદેશી સ્ફૂર્તિલું સ્ફૂર્તિવાળું તેજ ચુસ્ત અશિથિલ
शिटूक.: ચાલાક ચતુર કાબેલ હોશિયાર નિપુણ પ્રવીણ હોશિયાર કુશળ નિષ્ણાત સમજુ બુદ્ધિશાળી પ્રગલ્ભ આગર દક્ષ
शिडशिडीत: દૂબળો-પાતળો દુબળો દુર્બળ કૃશોદર ક્ષીણ કૃશ પાતર અર્ભક
शितळ: શીતળ ઠંડું શીતલ ટાઢું શીત અનુષ્ણ અતપ્ત ઠંડું શીતળ ટાઢું શાંત શીતલ ટાઢું ઠંડું શાંતિપૂર્ણ શાંતિમય
शिमा_रक्षक: સીમારક્ષક સીમાપાલ
शिमांकीत: સીમાંકન સીમાબદ્ધ સીમિત સીમાયુક્ત સસીમ પરિમિત અવચ્છિન્ન પરિચ્છિન્ન
शिमीत: સીમિત પરિસીમિત મર્યાદિત સીમાબદ્ધ સમર્યાદ સીમિત સીમાબદ્ધ મર્યાદિત નિયત નિર્ણીત મર્યાદાવાળું હદવાળું
शिल्लक: બાકી બકાયા દાતવ્ય દેય બચેલું બચેલું-ખુચેલું વધ્યું-ઘટ્યું અવિષ્ટ અવશેષ વધેલું બાકી_રહેલું બાકી ખૂટતું શેષ અધૂરૂં અપૂર્ણ
शिवराक: શાકાહારી નિરામિષ માંસરહિત અનામિષ વેજિટેરિયન શાકાહારી વનસ્પતિભક્ષક નિરામિષાહારી વનસ્પત્યાહારી
शिश्ट: સભ્ય ભદ્ર શીલ શાલીન સુશીલ ગુણવાન આચારવાન અનવર
शिस्त_नाशिल्लो: અસંયમી અનિગ્રહી
शिस्तीची: અનુશાસનિક અનુશાસનીય
शींगां_आशिल्लें: શિંગડાવાળું શિંગડાદાર વિષાણી શૃંગી
शीत: ઠંડું ટાઢું
शीम_रक्षक: સીમારક્ષક સીમાપાલ
शीलवान: ચરિત્ર્યવાન શીલવતી સાધ્વી ચરિત્રવતી સદાચારિણી
शुद्ध: શુદ્ધ ચોખ્ખું અસલી અસલ વિશુદ્ધ ખરુ અમિશ્રિત ખાલિસ નિર્મળ નિર્મલ વિમલ વિમળ શુદ્ધ સાફ સ્વચ્છ પવિત્ર સાફ-સુથરું વિશુદ્ધ ચોખ્ખું અમલ પાવિત અમલિન અમ્લાન અપંકિલ શુક્ર અવદાત સિત શુદ્ધ ખરું સાચું આસલી ચોખ્ખું વિશુદ્ધ પરિશોધિત સુધારેલું વિશોધિત પરિશુદ્ધ
शुभ_चिंतक.: હિતેચ્છુ હિતૈષી શુભેચ્છક હિતચિંતક શુભચિંતક
शूर: વીર બહાદુર શૂર શૂરવીર બલવાન બળવાન પરાક્રમી દિલાવર વિભુ બંકો
शेंदुरी: સિંદૂરી સિંદૂરિયું
शेणलेलो: ભૂલા_પડવું ભૂલાં_ભમવાં
शेणिल्लें: ખોવાયેલ ગુમ લાપતા
शेणिल्लो: ભૂલા_પડવું ભૂલાં_ભમવાં
शेपडेचें: પુછડિયું પુચ્છલ દુમદાર
शेळें: વાસી બગડેલું પર્યુષિત
शेष: બાકી બકાયા દાતવ્ય દેય
शैव: શૈવ શૈવી પાશુપત
शोकहीण: શોકરહિત શોકહીન વિશોક અશોક અવસાદહીન નિરવસાદ
शौकीन: વિલાસી ભોગવિલાસી ઐયાશ એશઆરામી રંગીન
श्रवणीय: શ્રવણીય કર્ણગમ્ય શ્રાવ્ય શ્રોતવ્ય શ્રવણીય શ્રાવ્ય શ્રોતવ્ય
श्रीमंत: ધનાઢ્ય ધની અમીર ધનવાન માલદાર ધનવંત દોલતમંદ વૈભવશાળી વૈભવશાલી વૈભવવાળું સંપન્ન માલામાલ સમૃદ્ધ ઐશ્વર્યવાન સંપત્તિવાન ખુશહાલ પૈસાદાર બહુધન જરદાર
श्रुंगारीत: સજ્જિત ભૂષિત શણગારેલું
श्रेष्ठ: મહાન મોટુ વડુ ઉંચુ શ્રેષ્ઠ મૂર્ધન્ય ઉદાત્ત માનનીય પૂજય વંદનનીય આદરણીય ઉત્કૃષ્ટ અસાધારણ મહત્વનું
स_बोटांकार: છંગુ
संकटग्रस्त: સંકટગ્રસ્ત આપદાગ્રસ્ત વિપદાગ્રસ્ત અયુક્ત
संकटनाशक: સંકટમોચન સંકટનાશન સંકટનિવારણ સંકટહર્તા સંકટ_નાશક
संकटनाशी: સંકટમોચન સંકટનાશન સંકટનિવારણ સંકટહર્તા સંકટ_નાશક
संकटमय: સંકટપૂર્ણ સંકટગ્રસ્ત સંકટયુક્ત સંકટતા વિપત્તિકર
संकटाचें: સંકટપૂર્ણ સંકટગ્રસ્ત સંકટયુક્ત સંકટતા વિપત્તિકર
संकलीत: સંગ્રહીત સંચિત સંકલિત સાંકળેલ
संकल्पीत: સંકલ્પિત ઇચ્છિત ધારેલું
संगणकाचें: કમ્પ્યૂટરનું સંગણકીય
संगणकी: કમ્પ્યૂટરનું સંગણકીય
संग्रहणीय: સંગ્રહિત અર્જનીય સંગ્રહણીય સંગ્રાહ્ય
संग्रहीत: સંગ્રહીત સંચિત સંકલિત સાંકળેલ
संघटीत: સંઘટિત એકત્રિત સંગઠિત
संतुश्ट: સંતોષી ધૈર્યશીલ ધીરજવાન ધીર
संदिसादू: તકવાદી તકસાધુ અવસરવાદી
संपादनीय: સંપાદનીય
संबंदीं: વિષયક સંબંધી સંબંધવાળું અન્વયી અનુષંગી સંયુક્ત
संबंदीत: સંબંધિત સંબંધિ સંબંધવાળું સંબદ્ધ જોડાયેલું યુક્ત
संबोधक: વક્તા સંબોધક સંબોધન_કર્તા
संभव: સંભવ સંભવિત શક્ય શક્યતા સંભાવિત મુમકિન
संमोहीत: સંમોહિત મોહિત
संयमी: સંયમી સંયત નિયમી સંયમશીલ પરહેજગાર પરહેજીગાર નિગ્રહી સંયમી જીતેંદ્રિય ઇંદ્રિયનિગ્રહી
संयुक्त: સંયુક્ત જોડાયેલું યુક્ત સંબદ્ધ સંયોજિત જોડેલ યોજેલ મેળવેલ મળેલું સંધાયેલ અનુષંગિક અભિન્ન અવસિત અવિભક્ત અપદાંતર
संवगडी_आशिल्लो: મિત્રવાળુ સમિત્ર
संवसार_जिखपी: વિશ્વવિજયી વિશ્વવિજેતા દિગ્વિજયી જગવિજયી
संवसारी: ગૃહસ્થ ગૃહસ્થાશ્રમી સંસારી
संवसारीक: લૌકિક દુન્યવી સાંસારિક સંસારી જાગતિક ઇહલૌકિક
संवेदनशीळ: લાગણીશીલ સંવેદનશીલ
संवेदनाहारी: નિશ્ચેતક સંવેદનાહારક
संशयी: સંદિગ્ધ સંદેહયુક્ત શકમંદ સંશયગ્રસ્ત શંકિત
संशोधक: આવિષ્કારક આવિષ્કર્તા ખોજકર્તા આવિષ્કારકર્તા આવિષ્કારી શોધકર્તા
संस्कृतीक.: સાંસ્કૃતિક સંસ્કૃત-સંબંધી
सकयल_दिल्लें: નિમ્નલિખિત નિમ્નાંકિત નિમ્નોક્ત
सकयलो: નીચું નિમ્ન અતુંગ નિભૃત અનુચ્ચ અનુન્નત અનૂર્ધ્વ
सकयल्ल्या__कुळाचें: નિમ્ન_કુલીન નિમ્ન_વંશીય
सकलें: મામૂલી નગણ્ય તુચ્છ સામાન્ય જેવું-તેવું નાચીજ હલકું પામર અનુદાત્ત ક્ષુદ્ર
सक्तीचें: અનિવાર્ય જરુરી આવશ્યક પરમાવશ્યક
सक्रीय: સક્રિય ક્રિયાશીલ ક્રિયાયુક્ત સકર્મક
सक्षम: સમર્થ બળવાન જોરાવર શક્તિશાળી શક્તિમાન બળવાળું સબળ બળિયું સામર્થ્યવાન સશક્ત શક્તિવાળું સબળું
सख्खें: સહોદર સગું પોતાનું નિજી નિજનું અંગતનું જાતનું પંડનું સ્વકીય પોતીકું
सख्खो: સ્વકીય પંડનું જાતનું પોતીકું પોતાનું.
सगलें: સંપૂર્ણ આખું પૂરેપૂરૂ સમગ્ર સઘળું તમામ બધું પરિપૂર્ણ આદ્યાંત
सगल्या_गुणांनी_भरिल्लो: સર્વગુણસંપન્ન સદ્ગુણી સર્વગુણી
सगल्यांक_खबर_आशिल्लें: જગજાહેર સર્વજ્ઞાત
सच्चरित्री: ચરિત્ર્યવાન શીલવતી સાધ્વી ચરિત્રવતી સદાચારિણી
सजिल्लें: સજ્જિત ભૂષિત શણગારેલું
सजिल्लो: સજ્જિત
सज्जन: સજ્જન સદ્ગૃહસ્થ સભ્ય નેક સદ્ગુણી શીલવાન શરીફ અશઠ
सडसडीत: સ્વસ્થ નીરોગી તંદુરસ્ત સેહત સારું આરોગ્ય વ્યાધિ_રહિત નિરામય અનામય ફિટ અગદ સારું અરોગી સેહતમંદ રોગરહીત ચંગુ વ્યાધિહીન
सणसणीत: મક્કમ સશકત પ્રબળ તગડું
सत_उलोवपी: સત્યવાદી સત્યભાષી સત્યવક્તા
सतत: અવિરત સતત અવિશ્રાન્ત ચાલુ નિરંતર લગાતાર અશ્રાંત
सतरंगी: સપ્તરંગી સતરંગી
सतरा: સત્તર ૧૭ 17
सतर्क: સ્ફૂર્તિલું સ્ફૂર્તિવાળું તેજ ચુસ્ત અશિથિલ જાગૃત સભાન ચૈતન્ય
सतर्क.???????????: સચેત સાવધ સાવધાન સતર્ક સજાગ ખબરદાર હોશિયાર
सत्कर्मी: સત્કર્મી સુકર્મી
सत्तर: સિત્તેર ૭૦ 70
सत्ते_खाला: આધીન તાબે અધીન
सत्ते_तळा: આધીન તાબે અધીન
सत्यनिश्ठ: સત્યનિષ્ઠ સત્યવાન સત્યવ્રત
सत्यभाशी: સત્યવાદી સત્યભાષી સત્યવક્તા
सत्यवादिनी: સત્યવાદિની સત્યવાદી સત્યવતી સત્યભાષિણી
सत्यवादी: સત્યવાદી સત્યભાષી સત્યવક્તા સત્યનિષ્ઠ સત્યવાન સત્યવ્રત
सदळ: શિથિલ ઢીલા
सदां__खातीरचें: કાયમનું હમેશનું સનાતન સદાનું અવિનાશી શાશ્વત અમર અક્ષય નિત્ય
सदाचरणी: ચરિત્ર્યવાન શીલવતી સાધ્વી ચરિત્રવતી સદાચારિણી
सदाचारी: નેકદિલ પ્રામાણિક સદાશય
सद्चरित्री: ચરિત્ર્યવાન શીલવતી સાધ્વી ચરિત્રવતી સદાચારિણી
सद्वेव्हारी: સદાચારી સદ્વ્યવહારી
सधवा_भशेनचें: સાધુઓ_જેવું
सनातन: શાશ્વત નિત્ય અવિનાશી સનાતન ચિરસ્થાયી અકાલ અનંત વિભુ અરિષ્ટ અવ્યય અચ્યુત અવિનશ્વર અનાશી અયોનિ કાલાતીત
सनाथ: સનાથ
सपाट: સમતલ સમતળ સપાટ બરાબર હમવાર લેવલ
सप्तरंगी: સપ્તરંગી સતરંગી
सभावीक: સ્વાભાવિક સ્વભાવસિદ્ધ સહજ સ્વભાવગત
सभ्य: સભ્ય ભદ્ર શીલ શાલીન સુશીલ ગુણવાન આચારવાન અનવર
सम: સમાન સરખું જેવું સરખું તુલ્ય સમ બરોબર યોગ્ય સરિસ સરીખું અનુહાર અવિષમ એકસરખું જેવું સરખું સરિખુ સમ
समकालीन: સામયિક કાલિક અવસરીય સમકાલીન સમકાલિક સમસામયિક
समजिकायचें: મળતાવડું મિલનસાર સામંજસ્યપૂર્ણ મેળપૂર્ણ
समजूतदार: વિવેકી વિચારવાન સમજદાર જ્ઞાની વિવેકવાળું સમજુ સભ્ય
समजूतदारपणाचें: મળતાવડું મિલનસાર સામંજસ્યપૂર્ણ મેળપૂર્ણ
समरुपी: પ્રતિરૂપી સમાંતર અદલોઅદલ એકરૂપ એકાત્મક સમરૂપ
समर्थीत: સમર્થિત સ્વીકૃત માન્ય સ્વીકારેલું અનુમોદિત
समवयस्क: સમવયસ્ક સમ_વયસ્ક સમોવડિયા સરખી_ઉંમરના હમઉમ્ર
समांतर: સમાંતર સમાનાંતર
समाजीक: સામાજિક
समाधानी: સમાધાનીત ઉકલેલું સમાધાન્ય સમાધેય
समाधिस्त: સમાધિસ્થ
समाधिस्थ: સમાધિસ્થ બ્રહ્મલીન સમાધિત
समान: જેવું સરખું સરિખુ સમ સમાંતર સમાનાંતર
समान_पिरायेचे: સમવયસ્ક સમ_વયસ્ક સમોવડિયા સરખી_ઉંમરના હમઉમ્ર
समाप्त: સમાપ્ત પૂરું ખતમ ખત્મ પૂર્ણ સંપૂર્ણ સંપન્ન તમામ નિષ્પાદિત અવસિત અશેષ
समाही: છમાસિક અર્ધવાર્ષિક છ_માસિક
समृद्ध: સમૃદ્ધ સંપન્ન ગુણસંપન યુક્ત ઋદ્ધ અવસિત
समृद्धिदिणें: સમૃદ્ધિમાન સંપન્ન આબાદ ઐશ્વર્યશાળી ઐશ્વર્યશાલી
समेटाचें: અનુબદ્ધ અનુબંધિત
सम्मानीत: સન્માનિત સંમાન માનદાન સત્કાર
सम्राट: ચક્રવર્તી સમ્રાટ એકાધિપતિ સર્વેશ્વર સર્વેશ
सय__केल्ली: સહીવાળું હસ્તાક્ષર_કરેલ હસ્તાક્ષરિત દસ્તખતી
सरकटें: સરીસૃપ
सरकारी: કારોબારી વહીવટી સરકારી શાસકીય
सरपटें: સરીસૃપ
सरळ: ઉકેલી_નાખવું ઉકેલવું સરળ સહજ આસાન સુગમ સહેલું અવિકટ સ્વાભાવિક કુદરતી અકૃત્રિમ નૈસર્ગિક સહજ પ્રાકૃતિક બોધ્ય બોધગ્મ સરળ સુગમ સુબોધ આસાન સુગમ્ય સરળ સરલ સીધું ભોળું નિખાલસ નિષ્કપટી સીધું-સાદું ભલું-ભોળું અવક્ર પ્રાંજલ ઋજુ સુવિધાજનક અનુકૂળતાવાળું સુવિધાપૂર્ણ આસાન સહેલું સરળ નિવારણીય નિવાર્ય સીધું સરળ સપાટ પાંસરું સમતલ અવક્ર
सरींचें: પાસેનું નજીકનું જોડેનું સમીપનું નિકટતમ નિકટતર નિકટવર્તી સમીપી સંનિકટ સમીપવર્તી સન્નિહિત લગોલગ નિકટસ્થ આસન્ન
सर्गेस्त: મૃત મૂએલું મૃતક મુડદું શબ વૈકુંઠવાસી પરલોકવાસી સ્વર્ગવાસી સ્વર્ગીય સ્વર્ગસ્થ મરહૂમ દિવંગત અપગત
सर्वगुणी: સર્વગુણસંપન્ન સદ્ગુણી સર્વગુણી
सर्वगूणसंपन्न: સર્વગુણસંપન્ન સદ્ગુણી સર્વગુણી
सर्वश्रेश्ट: ઉત્તમ શ્રેષ્ઠ ઉત્કૃષ્ટ અનમોલ ઉમદા પ્રશસ્ત નાયાબ વિરલ અનન્ય પ્રશસ્ય અવ્વલ આકર આગર
सर्वांग: સર્વાંગ પૂર્ણકાય
सर्वाहारी: સર્વભક્ષી સર્વભોગી
सळसळीत: ગરમાગરમ ધગધગતું
सवकाश: મંદ ધીમું ધીરું થોડું મંથર સુસ્ત
सवकास: મંદ ધીમું ધીરું થોડું મંથર સુસ્ત
सवती: સાવકો ઓરમાન વૈમાત્ર વૈમાત્રેય સાવકો પરાયો
सवाय: સસ્તું સોંઘું અલ્પમૂલ્ય
सशस्त्र: સશસ્ત્ર શસ્રસજ્જ શસ્ત્રધારી હથિયારબંધ
सस्तन: જરાયુજ ગર્ભજ
सहज: સરળ સહજ આસાન સુગમ સહેલું અવિકટ સ્વાભાવિક કુદરતી અકૃત્રિમ નૈસર્ગિક સહજ પ્રાકૃતિક સુવિધાજનક અનુકૂળતાવાળું સુવિધાપૂર્ણ આસાન સહેલું સરળ નિવારણીય નિવાર્ય
सहन_करपी: સહિષ્ણુ સહનશીલ ગમખ્વાર ખામોશ
सहयोगी: સહયોગી સાથી મદદનીશ મદદગાર સહાયક અસિસ્ટંટ
सांगपा_सारकी: કથનીય કથ્ય વાચ્ય વક્તવ્ય અભિધેય
सांगि_सारकी: કથનીય કથ્ય વાચ્ય વક્તવ્ય અભિધેય
सांचिल्लें: બંધિયાર સ્થિર મંદ જડ સ્થાયી નિઃસ્તબ્ધ
सांठिल्लें: બંધિયાર સ્થિર મંદ જડ સ્થાયી નિઃસ્તબ્ધ
सांड: ખૂંટિયો આખલો
सांमंतकाळीन: સામંતશાહી સામંતકાલીન
सांसठ: છાસઠ ૬૬ 66
साक्षर: શિક્ષિત ભણેલું સાક્ષર પ્રાજ્ઞ
साक्षात: સાક્ષાત સાક્ષાત્ સાકર મૂર્તિમંત આકારવાન આકારયુક્ત
साक्षिदार: સાક્ષી પ્રત્યક્ષદર્શી અનુભાવી ગવાહ શાહેદ
साठ: સાંઠ ૬૦ 60
सात.: સાત સપ્ત ૭ 7
सातरंगी: સપ્તરંગી સતરંગી
सातोळें: સાતમાસી
सादरीकरणाचें: મંચનીય મંચ્ય ભજવવા_તોગ્ય
सादरीत: ભજવેલું મંચિત અભિમંચિત
सादारण: મામૂલી નગણ્ય તુચ્છ સામાન્ય જેવું-તેવું નાચીજ હલકું પામર અનુદાત્ત ક્ષુદ્ર સામાન્ય સાધારણ મધ્યમ સાદું કામચલાઉ હંગામી મામૂલી અવિશેષ સર્વસામાન્યતા અવિશિષ્ટ નિરપવાદ અપવાદશૂન્ય અબાધ
सादूर: સચેત સાવધ સાવધાન સતર્ક સજાગ ખબરદાર હોશિયાર
सादें: મામૂલી નગણ્ય તુચ્છ સામાન્ય જેવું-તેવું નાચીજ હલકું પામર અનુદાત્ત ક્ષુદ્ર સુવિધાજનક અનુકૂળતાવાળું સુવિધાપૂર્ણ આસાન સહેલું સરળ
सादें.: સીધું સરળ સપાટ પાંસરું સમતલ અવક્ર
सादो: સરળ સરલ સીધું ભોળું નિખાલસ નિષ્કપટી સીધું-સાદું ભલું-ભોળું અવક્ર પ્રાંજલ ઋજુ
साधनयुक्त: સાધનસંપન્ન સાધનપૂર્ણ સાધનયુક્ત
साधनसंपन्न: સાધનસંપન્ન સાધનપૂર્ણ સાધનયુક્ત
साधनहीण: સાધનહીન સાધનવિહીન
साधनां_नाशिल्लें: સાધનહીન સાધનવિહીન
साधवी: ચરિત્ર્યવાન શીલવતી સાધ્વી ચરિત્રવતી સદાચારિણી
साध्य: ચિકિત્સ્ય સાધ્ય ઉપચાર્ય નિવાર્ય નિવારણીય
सानुलें: લઘુકાય નાનુ નાનું ઠીંગણું વામન વામણું બાંઠિયું વામનજી બઠકું ઠીંગણો
साफ: સ્પષ્ટ ખુલ્લું સ્ફુટ જાહેર પરિશોધિત સુધારેલું વિશોધિત પરિશુદ્ધ
सामकें_गरजेचें: જરૂરી અત્યાવશ્યક અપરિહાર્ય
सामको: પાકો પાક્કો સંપૂર્ણ પરિપૂર્ણ ન્યૂનતા_વિનાનું ખામી_વિનાનું નિષ્ણાત પારંગત યથાર્થ દક્ષ
सामको_उणो: બહું_ઓછું અત્યલ્પ ઘણું_થોડું જરાક અતિઅલ્પ સ્વલ્પ
सामवेदी: સામવેદીય સામવેદિક
सामान्य: સામાન્ય સાધારણ મધ્યમ સાદું કામચલાઉ હંગામી મામૂલી અવિશેષ સર્વસામાન્યતા અવિશિષ્ટ સામાન્ય સામૂહિક સાર્વજનિક સમુદાયનું સામટું સામુદાયિક નિરપવાદ અપવાદશૂન્ય અબાધ
सामुहीक: સામાન્ય સામૂહિક સાર્વજનિક સમુદાયનું સામટું સામુદાયિક
सारकें: સમાન સરખું જેવું સરખું તુલ્ય સમ બરોબર યોગ્ય સરિસ સરીખું અનુહાર અવિષમ એકસરખું સમાન સરખું જેવું તુલ્ય સરીખું બરોબર સમરૂપ અનુરુપ સવર્ણ એક_સરખું એક_જેવું સુવ્યવસ્થિત સારી_વ્યવસ્થાવાળું સારી_રીતે_ગોઠવેલું વ્યવસ્થાપૂર્વકનું સમાંતર સમાનાંતર
सारको: પાકો પાક્કો સંપૂર્ણ પરિપૂર્ણ ન્યૂનતા_વિનાનું ખામી_વિનાનું નિષ્ણાત પારંગત યથાર્થ દક્ષ જેવું સરખું સરિખુ સમ
सार्थक: ચરિતાર્થ સાર્થક કૃતકૃત્ય કૃતાર્થ સફળ
सार्वभौमीक: સાર્વભૌમિક સાર્વભૌમ સર્વદેશીય સાર્વજની
साव: સભ્ય ભદ્ર શીલ શાલીન સુશીલ ગુણવાન આચારવાન અનવર પ્રમાણિક ઈમાનદાર વિશ્વાસપાત્ર ઈમાની ઋજુ સત્યપર સત્યપરાયણ નિષ્કપટ નિખાલસ સાચું ખરૂં
सावत्र: સાવકો ઓરમાન વૈમાત્ર વૈમાત્રેય સાવકો પરાયો
सावध: સચેત સાવધ સાવધાન સતર્ક સજાગ ખબરદાર હોશિયાર
सावधी: સાવધિક અવધિયુક્ત
सावळें: શ્યામ શ્યામળ
सावळेचें: છાંયાદાર
सावळो: અશ્વેત કાળું
सासणा_खातीरचें: કાયમનું હમેશનું સનાતન સદાનું અવિનાશી શાશ્વત અમર અક્ષય નિત્ય
साहित्यप्रेमी: સાહિત્યપ્રેમી સાહિત્યરસિક
साहित्यमोगी: સાહિત્યપ્રેમી સાહિત્યરસિક
सिद्ध: સાબિત સિદ્ધ પ્રમાણિત પુરવાર
सुंदर: સુંદર ખૂબસૂરત રૂપાળું મનોહર સુશોભિત મોહક મજેનું દેખાવડું કૂટડું રળિયામણું લલિત રૂપવાન રૂપવંત મનહર કમનીય પાકીઝા છબીલું સોહન અભિજાત સુડોલ અભિરૂપ લાવણ્યમય સોહામણું શોભીતું સુહાવનું સરસ ખુશનૂમા
सुकडें: દૂબળો-પાતળો દુબળો દુર્બળ કૃશોદર ક્ષીણ કૃશ પાતર અર્ભક ક્ષીણકાય સુકલકડી દૂબળુંપાતળું નબળુંપાતળું
सुकिल्लें: ઠૂંઠું સૂકું
सुकुमार: મૃદુલ કૂણું સુંવાળું નરમ મુલાયમ કોમળ નાજુક સુકુમાર
सुकें: દૂબળો-પાતળો દુબળો દુર્બળ કૃશોદર ક્ષીણ કૃશ પાતર અર્ભક સૂકું શુષ્ક ખુશ્ક કોરૂં અનાર્દ સૂકું
सुक्षीम: અતિસૂક્ષ્મ અત્યંત_બારીક સૂક્ષ્મ બારીક ઝીણું ક્ષુદ્ર
सुक्ष्म: અતિસૂક્ષ્મ અત્યંત_બારીક
सुख: સુખી ખુશહાલ સુખમય સુખિયારું સુખિયું
सुखदिणी: સુખકારક સુખદ સુખદાયી સુખકર સુખદાયક
सुखाची: સુખકારક સુખદ સુખદાયી સુખકર સુખદાયક
सुखाळ: સુખકારક સુખદ સુખદાયી સુખકર સુખદાયક
सुखी: સુખી ખુશહાલ સુખમય સુખિયારું સુખિયું
सुगंधीत: સુગંધિત સુવાસિત સુગંધીદાર ખુશબોદાર ખુશ્બૂદાર સુરભિત આમોદિત
सुगरण: કાબેલ હોશિયાર ચતુર પ્રવીણ સુઘડ
सुचरित्री: ચરિત્ર્યવાન શીલવતી સાધ્વી ચરિત્રવતી સદાચારિણી
सुटसुटीत: સુડોળ સુગઠિત ઘાટીલું નમણું સુઘડ
सुतलावपी: ઉઠાઉગીર ઉચક્કો ઠગ લુચ્ચો બદમાશ
सुती: સુતરાઉ
सुदारिल्लो: પ્રગતિમાન અગ્રગત
सुदारीत: પ્રગતિમાન અગ્રગત અલંકૃત પરિષ્કૃત માર્જિત સ્વચ્છ શુદ્ધ પરિમાર્જિત
सुनिश्चीत: સુનિશ્ચિત સુનિર્ધારિત સુનિર્ણીત સુનિયત અવારણ
सुपरिचीत: સુપરિચીત
सुपाच्य: સુપચ્ય સહજ_પાચ્ય હલકું પથ્ય નરમ લઘુપાક
सुपीक: ફળદ્રુપ રસાળ ઉપજાઉ ઉર્વર
सुप्रसिद्ध: સુપ્રસિદ્ધ પ્રસિદ્ધ સુવિખ્યાત સુખ્યાત ખ્યાત જાણીતું પંકાયેલું પ્રખ્યાત મશહૂર
सुफी: સૂફી
सुबेज: નફ્ફટ ઉદ્ધત ધીટ અવિનયી અસભ્ય ધૃષ્ટ ઢીઠ ધૃષ્ટ હિંમતવાન ઉદ્ધત નિડર ઉચ્છૃંખલ ઉછાંછળું અવિવેકી હઠીલું સ્વચ્છંદી
सुरक्षीत: રક્ષિત સંરક્ષિત સલામત સંવૃત
सुरवातीचें: આરંભિક પ્રારંભિક પ્રાથમિક આરંભનું શરૂઆતનું આરંભમાણ
सुरू_आशिल्लें: ચલિત ચળેલું સ્થાનભ્રષ્ટ ગતિમાન ગતિમંત
सुलक्षण: સુલક્ષણ સુલક્ષણું સુલક્ષ
सुलभ: ગમનીય ગમ્ય સરળ સહજ આસાન સુગમ સહેલું અવિકટ સુલભ સુસાધ્ય સુપ્રાપ સુપ્રાપ્ય
सुलिखीत: સુલિખિત સ્પષ્ટ_લિખિત
सुवादाचें: સ્વાદિષ્ટ લહેજતદાર સ્વાદુ
सुवादीक: સ્વાદિષ્ટ લહેજતદાર સ્વાદુ સ્વાદિષ્ટ સ્વાદુ રોચક_સ્વાદવાળું સારું લહેજતદાર લિજ્જતદાર લહેજતવાળું
सुवार्थी: સ્વાર્થી સ્વાર્થવાળું મતલબી સ્વાર્થપરાયણ ગરજુ અર્થી આત્મગ્રાહી એકલપેટું
सुवासहीण: ગંધહીન વાસહીન ગંધરહિત નિર્ગંધ
सुवासाचें: સુગંધિત સુવાસિત સુગંધીદાર ખુશબોદાર ખુશ્બૂદાર સુરભિત આમોદિત
सुवासीक: સુગંધીદાર સુગંધિત ગંધિત વાસયુક્ત મહેકતા
सुशिक्षीत: શિક્ષિત ભણેલું સાક્ષર પ્રાજ્ઞ
सुशील: સદ્ગુણી નીતિમાન શુદ્ધ_ચારિત્ર્યવાળું તત્ત્વનિષ્ઠ સુશીલ સગુણો ગુણકારી શિષ્ટાચારી સદાચારી સચ્ચરિત
सुशेगाद: આળસુ મંદ આળસવાળું સુસ્ત એદી ધીરૂં ધીમું અજગર વાહી શિથિલ નિરુદ્યોગી નિરુદ્યમ અપાવટ આળસયુક્ત શિથિલ ઉદ્યમરહિત અવ્યવસાયી આરામપ્રિય અપ્રગલ્ભ
सुसंस्कृत: ઉદાર ઉદાત્ત ઉમદા ઉદારવાદી નમ્ર પ્રવણ
सुसेगाद: શાંત પ્રશાંત નિરુદ્વિગ્ન અવિકલ અવ્યાકુલ સ્વસ્થ અવ્યગ્ર અનાકુલ અક્ષુબ્ધ
सुस्त: આળસુ મંદ આળસવાળું સુસ્ત એદી ધીરૂં ધીમું અજગર વાહી શિથિલ નિરુદ્યોગી નિરુદ્યમ અપાવટ આળસયુક્ત શિથિલ ઉદ્યમરહિત અવ્યવસાયી આરામપ્રિય અપ્રગલ્ભ
सूखदिणें: સુખદાયી આનંદપ્રદ અનંદદાયક આનંદદાયી આનંદકારી આનંદકર હર્ષદાયક સુખકર નંદક
सूरहीण: બેસૂરું બસૂરું કર્કશ વિરોધી વિસંવાદી
सेगीत: અવિરત સતત અવિશ્રાન્ત ચાલુ નિરંતર લગાતાર અશ્રાંત
सेवनाचें: સેવ્ય સેવનીય સેવિત સેવેલું;_સેવાયેલું
सेवीत: સેવિત સેવ્ય
सैनिकी: લશ્કરી સૈન્ય
सैन्य: લશ્કરી સૈન્ય
सैमीक: પ્રાકૃતિક કુદરતી નૈસર્ગિક પ્રાકૃત પ્રકૃત અકૃત્રિમ સ્વાભાવિક સ્વાભાવિક કુદરતી અકૃત્રિમ નૈસર્ગિક સહજ પ્રાકૃતિક
सैल: શિથિલ ઢીલા
सोंपूंक_नाशिल्लें: અધૂરું અપૂર્ણ બાકી ઊણું અડધું અસમાપ્ત અધૂરૂં અસંપન્ન અસિદ્ધ અધકચરું અનવસિત અનિષ્પન્ન
सोंपे: સુલભ સુસાધ્ય સુપ્રાપ સુપ્રાપ્ય
सोंपें: ગમનીય ગમ્ય બોધ્ય બોધગ્મ સરળ સુગમ સુબોધ આસાન સુગમ્ય સુવિધાજનક અનુકૂળતાવાળું સુવિધાપૂર્ણ આસાન સહેલું સરળ નિવારણીય નિવાર્ય
सोंपेपणाचें: સુવિધાજનક અનુકૂળતાવાળું સુવિધાપૂર્ણ આસાન સહેલું સરળ
सोंपो: સરળ સહજ આસાન સુગમ સહેલું અવિકટ
सोंशीक: સહિષ્ણુ સહનશીલ ગમખ્વાર ખામોશ
सोकिल्लें: અવશોષિત શોષિત
सोकून_घेतिल्लें: અવશોષિત શોષિત
सोप्पाचें: સમાપ્ત સમાપ્તિ સમાપવું
सोबीत: સુંદર ખૂબસૂરત રૂપાળું મનોહર સુશોભિત મોહક મજેનું દેખાવડું કૂટડું રળિયામણું લલિત રૂપવાન રૂપવંત મનહર કમનીય પાકીઝા છબીલું સોહન અભિજાત સુડોલ અભિરૂપ લાવણ્યમય
सोशीक: સહ્ય સહનીય સહનક્ષમ
सोसूंक_जायना_अशें: અસહ્ય અસહનીય અસહ નાગવાર દુ દુસ્સહ અપ્રસહ્ય
सौम्य: સૌમ્ય સુશીલ શાંત
स्तुतीपाठक: પ્રશંસક વખાણનાર
स्थानीक: સ્થાનિક સ્થાનીય પ્રાદેશિક તળપદું આંચલિક
स्थापणूक_करी_सारकें: સ્થાપનીય સ્થાપ્ય પ્રતિપાદનીય સંસ્થાપનીય
स्थापी_सारकें: સ્થાપનીય સ્થાપ્ય પ્રતિપાદનીય સંસ્થાપનીય
स्थापीत: સંસ્થાપિત સ્થાપેલું અધિષ્ઠિત સ્થાપિત
स्थायीक: વસ્તી આબાદી ગુલજાર
स्थालांतरीत: પ્રવાસી પ્રોષિત
स्थावर: અચળ દૃઢ સ્થિર ગતિહીન અચલ સ્થાવર અચર વિભુ સ્થાવર અચલ સ્થિર
स्थीर: સ્થિર અચલિત અગતિ અયાન અચળ દૃઢ સ્થિર ગતિહીન અચલ સ્થાવર અચર વિભુ સ્થિર સ્થાયી અચેષ્ટ નિશ્ચલ અડગ અચળ અચલ અટલ ધ્રુવ નિશ્વળ નિશ્વિત અવિચલ અડોલ દૃઢ અટળ નિત્ય સ્થાવર અચલ સ્થિર
स्थूल: જાડો સ્થૂળ સ્થૂળકાય ભારે ધીંગો પીવર
स्नेही: સ્નેહી નેહી
स्पश्ट: સ્પષ્ટ ખુલ્લું સ્ફુટ જાહેર
स्पश्टवादी: સ્પષ્ટવક્તા સ્પષ્ટભાષી
स्फूर्तहीण: નિરુત્સાહ નિરુત્સાહી નિરુત્સાહિત હતોત્સાહ હતોત્સાહિત અનુત્સાહ અપ્રગલ્ભ
स्फूर्तीदायक: સ્ફૂર્તિદાયક સ્ફૂર્તિપ્રદ સ્ફૂર્તિ_આપનારું
स्वखोसयेचें: સ્વૈચ્છિક મરજિયાત
स्वच्छ: પરિશોધિત સુધારેલું વિશોધિત પરિશુદ્ધ
स्वजातीय: સજાતીય સ્વજાતિય સ્વજાતિ સવર્ણ નાતીલું
स्वतंत्र: સ્વતંત્ર સ્વાધીન આઝાદ આજાદ અનન્યાશ્રિત અનધીન અનાયત્ત અનિર્બંધ અપરતંત્ર
स्वता_कमयिल्लें: સ્વાર્જિત સ્વોપાર્જિત સ્વસંપાદિત સ્વકષ્ટાર્જિત
स्वता_जोडिल्लें: સ્વાર્જિત સ્વોપાર્જિત સ્વસંપાદિત સ્વકષ્ટાર્જિત
स्वता_मेळयिल्लें: સ્વાર્જિત સ્વોપાર્જિત સ્વસંપાદિત સ્વકષ્ટાર્જિત
स्वताचें: અંગત ખાનગી નિજી પોતાનું વ્યક્તિગત અંગનું સ્વકીય
स्वदेशी: સ્વદેશી દેશી દેશીય દેશજ
स्वनिर्भर: આત્મનિર્ભર સ્વાવલંબી સ્વનિર્ભર
स्वपक्षी: સ્વપક્ષીય સ્વપક્ષી આપણું
स्वभावीक: સ્વાભાવિક સ્વભાવસિદ્ધ સહજ સ્વભાવગત
स्वशिक्षीत: સ્વશિક્ષિત
स्वाभावीक: સ્વાભાવિક કુદરતી અકૃત્રિમ નૈસર્ગિક સહજ પ્રાકૃતિક
स्वाभिमानहीण: અસ્વમાની અસ્વાભિમાની
स्वाभिमानी: સ્વાભિમાની સ્વમાની આત્મસંમાની આત્માભિમાની ખુદ્દાર
स्वार्थी: સ્વાર્થાંધ
स्वावलंबी: સ્વાવલંબી સ્વાશ્રયી સ્વાવલંબી સ્વાશ્રયી આત્માવલંબી આત્મનિર્ભર સ્વાવલંબી સ્વનિર્ભર
स्विकार_करी_सारकें: સ્વીકાર્ય સ્વીકારણીય અંગીકાર્ય ગ્રાહ્ય ગ્રહણીય
स्विकारपा_सारकें: સ્વીકાર્ય સ્વીકારણીય અંગીકાર્ય ગ્રાહ્ય ગ્રહણીય
स्विकारिल्ली: માન્ય બહાલી મંજૂર સ્વીકૃત પાસ મંજૂર અભ્યુપગત સ્વીકારેલું
स्विकारिल्लें: સ્વીકૃત સ્વીકાર્ય અંગીકાર્ય અંગીકૃત સ્વીકારેલ આત્મીકૃત આદત્ત ગૃહીત આશ્રુત
स्विकारूंक_नाशिल्लें: અસ્વીકૃત નામંજૂર નાકબૂલ
स्विकृत: માન્ય સ્વીકૃત સ્વીકારેલું
हक्क_आशिल्लो: અધિકારિક અધિકારી હકદાર હક્કદાર દાવાદાર
हजर: હાજર ઉપસ્થિત ઉપસ્થિત મોજૂદ રજૂ પ્રસ્તુત વિદ્યમાન અવસ્થિત
हट्टी: દુરાગ્રહી જિદ્દી જક્કી જીદી મમતી હઠીલું હઠી હઠીલું જિદ્દી જીદી અભિનિવેશી આગ્રહી મતાગ્રહી
हडपिल्लें: જપ્ત ખાલસા કુર્ક
हरवें: કાચું અપક્વ અપરિપક્વ કાચું અપક્વ અપરિપક્વ
हलकट: કટુભાષી બદજબાન બદજબાં આડુંઅવળું ઊલટુંસૂલટું ગટરપટર
हलकें: ધીમું મંદ હલકું મૃદુ આછું હળવું
हलको: હલકું હળવું તુનક નાજુક
हळडुवें: પીળું પીત કપિંજલ પીત અવદાત
हळू: ધીમું મંદ હલકું મૃદુ આછું હળવું
हळू_हळू: મંદ ધીમું ધીરું થોડું મંથર સુસ્ત
हवादार: હવાદાર
हसतमूख: પ્રસન્નમુખ પ્રસન્નવદન
हांडेकार: ધનાઢ્ય ધની અમીર ધનવાન માલદાર ધનવંત દોલતમંદ વૈભવશાળી વૈભવશાલી વૈભવવાળું સંપન્ન માલામાલ સમૃદ્ધ ઐશ્વર્યવાન સંપત્તિવાન ખુશહાલ પૈસાદાર બહુધન જરદાર
हांशाक_म्हारग: હાસ્ય
हांशाचें: હાસ્ય
हांश्यास्पद: હાસ્યાસ્પદ હાસ્યપાત્ર ટીખળી રમૂજી
हांसकुरें: હાસ્યાસ્પદ હાસ્યપાત્ર ટીખળી રમૂજી
हांसमूख: હસમુખું આનંદી ખુશમિજાજી
हांसयाळें: હાસ્યાસ્પદ હાસ્યપાત્ર ટીખળી રમૂજી
हांसरें: હસમુખું આનંદી ખુશમિજાજી
हांसोवपी: હાસ્યપૂર્ણ હાસ્યપ્રદ હાસ્યજનક
हांस्यहीण: હાસ્યહીન
हाचे_सारको: આવું આના_જેવું આ_જાતનું આ_પ્રમાણેનું
हाडकुळें: હાડપિંજર અસ્થિમય હાડકાંમય દૂબળો-પાતળો દુબળો દુર્બળ કૃશોદર ક્ષીણ કૃશ પાતર અર્ભક ક્ષીણકાય સુકલકડી દૂબળુંપાતળું નબળુંપાતળું
हाडांचें: અસ્થિમય હાડકાંમય અસ્થિ_નિર્મિત
हात_जोडिल्लो: અંજલિ અંજલિ_બધ્ધ અંજલિબંધન અંજલિકર્મ નમસ્કાર પ્રણામ
हात_मारपी: ઉઠાઉગીર ઉચક્કો ઠગ લુચ્ચો બદમાશ
हाता_खालचें: આધીન અધીન તાબેદાર વશ તાબે માતહત અમુખ્ય
हारिल्लो: પાછળ_રહેવું પાછળ_પડવું પ્રતિગત પરાજિત પરાસ્ત પરભૂત વિજિત હારેલું હરાવેલું
हालत: લથડિયાં_ખાતું લથડતું ડગમગતું
हालपी: હલતું હાલતું-ડોલતું ડોલાયમાન આંદોલિત ડોલતું ઝૂલતું
हाल्मिखुशाल: ખુશમિજાજી જિંદાદિલ હસમુખું રસિક વિનોદી દિલ્લગીબાજ વિનોદપ્રિય
हावरट: લાલચુ ધનલોભી લોભી લોલુપ કુમુદ
हावरें: લાલચુ ધનલોભી લોભી લોલુપ કુમુદ
हावेसाचें: ઇચ્છાન્વિત ઇચ્છાધીન કામનાવાળું સકામ ઇચ્છિત ઇષ્ટ ઇચ્છેલું વાંછિત અભિલાષક અભિલાષી ઇચ્છુક મનોવાંછિત અભિવાંછિત અભિપ્રેત કમનીય અભીષ્ટ
हासयाळें: હસમુખું આનંદી ખુશમિજાજી
हास्य: હાસ્ય
हिंदुस्थानी: ભારતીય હિન્દુસ્તાની હિંદી હિંદુસ્તાની
हिंसक: હિંસક ઘાતક ખાટકી કસાઈ આતતાયી નૃશંસ ઝાલિમ અત્યાચારી જાલિમ
हितकारी: કલ્યાણકારી મંગળકારી હિતકારી ગુણકારી મંગલકારક કલ્યાણમય કલ્યાણપ્રદ ઇષ્ટકર
हिमटो: કંજૂસ કૃપણ પાજી બખીલ લોભિયો મખ્ખીચૂસ સોમ રંક કુમુદ ચીકણું ચિંગૂસ
हिवाळी: શીયાળાનું શીતકાલીન
हीणपणाचें: નીચમાં_નીચ અધમાધમ અધમતમ અત્યંત_અધમ સૌથી_હલકું
हुंपूंक_जायनाशिल्लो: અગમ્ય અપારગમ્ય અપાર દુસ્તર અગમ
हुंवारग्रस्त: પૂરગ્રસ્ત પૂર-પીડિત પૂર-પિડિત
हुंवारान_पिडेस्त: પૂર-પિડિત
हुनहुनीत: ગરમાગરમ ધગધગતું તપ્ત ઊનું તપેલું ગરમ તપુ પ્રતપ્ત
हुमेल्ली: રેબઝેબ પ્રસ્વેદિત
हुशार: યોગ્ય લાયક કાબેલ સમર્થ અભિજાત ઉદાત્ત બુદ્ધિમાન બુદ્ધિશાળી હોશિયાર સમઝદાર સમઝુ અક્કલમંદ શાણું ડાહ્યું હોશિયાર કુશળ બુદ્ધિમંત મેઘાવી મતિમંત અમૂઢ મતિમાન દાનિશમંદ પાટવિક પટુ આકિલ આકેલ સારું ઉત્તમ ઉત્તમતર શ્રેષ્ઠ બહેતર ઠીક બેટર સ્ફૂર્તિલું સ્ફૂર્તિવાળું તેજ ચુસ્ત અશિથિલ ચાલાક ચતુર કાબેલ હોશિયાર નિપુણ પ્રવીણ હોશિયાર કુશળ નિષ્ણાત સમજુ બુદ્ધિશાળી પ્રગલ્ભ આગર દક્ષ
हुसक्यामेकळें: નિશંક બેફિકર આશંકાહીન સંશયહીન
हुसक्यामेकळो: નિશ્ચિંત બેફિકર નચિંત નિષ્ફિકર બેપરવા ચિંતામુક્ત બેફિકર_નફિકરું આઝાદ
हुस्को: ચિંતિત ચિંતાવાળું ફિકરવાળું ચિંતાગ્રસ્ત ફિકરમંદ
हुस्क्याचें: ચિંતાજનક ચિંતાજન્ય ગંભીર ચિંતાકુલ નાજુક ચિંતાગ્રસ્ત ચિંતાવશ ચિંતાશીલ
हून: ગરમ ઉષ્ણ તપ્ત ઊનું તપેલું ગરમ તપુ પ્રતપ્ત ગરમ
हे_तरेचो: આવું આના_જેવું આ_જાતનું આ_પ્રમાણેનું
हे_सारको: આવું આના_જેવું આ_જાતનું આ_પ્રમાણેનું
हेडगें: ભ્રમણશીલ રખડુ યાયાવર રમતારામ અતિચારી
हेर: અન્ય બીજું પરાયું ઈતર
हेरगिरीचें: જાસૂસી છૂપી_બાતમી_લાવવાનું_કામ
होंवरेंत_रावपी: ગુફાવાસી કંદરાવાસી
