190: एकशेनव्वद
21: एकवीस
27: सत्तावीस
300: तीनशे
53: त्रेपन्न
6: सहा
68: अडुसष्ट
79: एकुणऐंशी एकुणअशी एकुणैशी
अंकीत: लिखित लिहिलेला लेखी अंकित
अंगरक्षक: रक्षक रक्षणकर्ता
अंडज: अंडज
अंतरयामी: null
अंतरवक्र: बहिर्वक्र
अंतरीम: अंतरिम
अंतर्गत: आतील आतला आतचा अंतर्गत अंतःस्थ अंतःस्थित अंतर्-
अंतर्निश्ट: 
अंतर्वक्र: बहिर्वक्र अंतर्वक्र
अंदेल्लें: रोखलेला कुंठित
अंधश्रद्धाळू: अंधश्रद्ध अंधविश्वासू
अंधूक: धूसर अस्पष्ट पुसट अंधूक धुरकट धुकट
अंयशांवें: ऐंशीवा
अंयशीं: ऐंशी
अंशीक: आंशिक अंशासंबंधी अंशविषयक अंशाविषयीचा अंशाशी_संबंधित अंशासंबंधीचा
अकथनीय: न_सांगण्याजोगा
अकर्मक: अकर्मक
अकर्मी: अकर्ता
अकल्पीत: अकल्पनीय
अकल्याणकारी: अकल्याणकारक अनिष्ट अशुभ अहितकारी अनहितकारी
अकस्मात: आकस्मिक अकल्पित अचानक
अकारण: विनाकारण अकारण निष्कारण उगा व्यर्थ
अकार्यक्षम: निकामी
अकाळीक: अकालज अकालिक
अकुळीन: कुलहीन हीनकुळी कमजात कमअस्सल
अकूशळ: अकुशल अप्रवीण अदक्ष
अकृत: न_केलेला अरचित बिगडलेला
अकृतज्ञ: कृतघ्न निमकहराम बेईमान हरामखोर
अकृत्य: अकरणीय
अक्षम्य: अक्षम्य
अक्षय: शाश्वत नित्य अविनाशी अनश्वर चिरंतन अक्षय अक्षर अमर चिरंजीव
अखंड: अभेद्य अभेदनीय न_तुटणारा न_मोडणारा अभंजनशील सलग बिनजोडाचा अभंग
अखंडीत: अभंजनीय अखंडनीय अभंग अखंड अक्षुण्ण अविभक्त अविभाजित अखंड
अखाद्य: न_खाण्याजोगा
अखेरच्या: शेवटचा अंतिम अखेरचा चरम अंत्य
अग्निशामक: अग्निशामक
अग्नीचें: आग्नेय
अग्नीमुखी: अनलमुख
अग्नीशामक: शामक
अग्रगामी: पुरोगामी
अग्रणी: आघाडीचा अग्रभागीचा
अग्राह्य: अग्राह्य अग्रहणीय
अग्रेसर: अग्रेसर
अघटीत: अघटित
अघारी: अघरी
अचंचळ: अविचल दृढ अढळ ठाम
अचंबीत: असामान्य असाधारण अलौकिक लोकोत्तर लोकविलक्षण विलक्षण अनन्यसाधारण चकित आश्चर्यचकित अचंबित विस्मयचकित विस्मित स्तिमित अवाक
अचकीत: आकस्मिक अकल्पित अचानक
अचल: स्थिर स्थावर अचल अचल निश्चल स्थिर अढळ दृढ अविचल
अचेतन: जड अचेतन भौतिक निष्क्रिय
अजय: अजिंक्य अजेय
अजरंवर: अमर मृत्यूरहित चिरंजीव दीर्घायु चिरंजीव चिरायु औक्षवंत औक्षवान आयुष्यमान दीर्घजीवी चिरंजीवी
अजरबॅजानी: आझरबैजानी आझरबैजानी
अजरामर: चिरतरुण अजर
अजाण: अज्ञेय अविवेकी अविचारी असमंजस विवेकशून्य विचारशून्य आततायी अनभिज्ञ
अजातशत्रू: अजातशत्रू
अजाप: सूर्याचा
अजापाचें: अभूतपूर्व अपूर्व अनोखा वैशिष्ट्य_असलेला वैशिष्ट्यपूर्ण
अजापीत: अनपेक्षित आकस्मिक अकल्पित अनाहूत चकित आश्चर्यचकित अचंबित विस्मयचकित विस्मित स्तिमित अवाक वैशिष्ट्य_असलेला वैशिष्ट्यपूर्ण
अजैत: अपराजित अजित अजिंक्य अजेय
अज्ञात: अज्ञात अपरिचित अनोळखी अज्ञात
अज्ञानी: अज्ञेय मूर्ख बावळा बावळट अज्ञानी मूढ जड मंद निर्बुद्ध मठ्ठ बेअक्कल शंख बिनडोक अडाणी ढ ठोंब्या अर्धवट बेअक्कली भोट
अज्ञेय: अज्ञेय
अटूट: घनिष्ठ जीवश्चकंठश्च जिवलग दाट गाढ दृढ जिवाभावाचा जिगरी अभंजनीय अखंडनीय न_तुटणारा न_मोडणारा अभंजनशील
अठरा: अठरा अठरावा
अठ्ठावन: अठ्ठावन्न
अठ्ठावनावें: अठ्ठावन्नावा
अठ्ठाविसावो: अठ्ठाविसावा
अठ्ठावीस: अठ्ठावीस
अठ्ठेचाळिसावें: अठ्ठेचाळिसावा
अठ्ठ्याण्णव: अठ्ठ्याण्णव
अडांगी: बेडर निडर
अडाणी: अकुशल अप्रवीण अदक्ष अशिक्षित अविद्य निरक्षर अक्षरशत्रू अक्षरशून्य अंगठेबहाद्दर अडाणी मूर्ख बावळा बावळट अज्ञानी मूढ जड मंद निर्बुद्ध मठ्ठ बेअक्कल शंख बिनडोक अडाणी ढ ठोंब्या अर्धवट बेअक्कली भोट ज्याला_कळले_नाही_असा ज्याला_समजले_नाही_असा
अडेचें: दिखाऊ कृत्रिम नाटकी भपकेबाज
अडेज: अडीच
अणकार_करपाचें: अनुवाद्य
अणकार_करपी: null
अणकार_करी_सारकें: अनुवाद्य अनुवाद_करण्याजोगा
अणकारक: null
अणकारपी: null
अणकाराचें: अनुवाद्य अनुवाद_करण्याजोगा
अणकारीत: अनुवादित भाषांतरित
अणभव: अनुभूत
अणभवशुन्य: अननुभवी नवखा नवा कच्चा
अणभवहीण: अननुभवी नवखा नवा कच्चा
अणभवी: अनुभवी अभिज्ञ जाणता अभ्यस्त माहितगार जाणणारा जाणकार ज्ञाता
अतंत्रीक: अतांत्रिक
अतिंद्रीय: अगोचर अतींद्रिय
अतिक्रमीत: लाटलेला हडपलेला बळकावलेला पचवलेला
अती: फार खूप अतोनात आतोनात पुष्कळ प्रचंड अपरिमित अतिशय गडगंज चिक्कार चिकार भरमसाट मुबलक विपुल मोप रगड रग्गड सज्जड भारी बखळ बहुत भरपूर भरमसाठ भलता भाराभर आत्यंतिक
अती_धाडशी: अतीच_साहसी अतीच_धाडसी जास्तच_साहसी जास्तच_धाडसी दुसाहसी
अतीरागिश्ट: संतप्त संतापलेला खवळलेला तप्त
अतुलनीय: अतुल अतुलनीय अतुल्य अजोड
अतुल्य: अतुल अतुलनीय अतुल्य अजोड
अतुळीत: वजन_न_केलेला न_जोखलेला न_तोललेला
अतूट: अभेद्य अभेदनीय न_तुटणारा पक्का अलग_न_राहणारा
अतृप्त: अतृप्त असमाधानी असंतुष्ट गती_न_मिळालेला
अत्तर_लायिल्लें: अत्तरादि_लावलेला
अत्याचारी: अन्यायी अनीतिचा अधर्मी अत्याचारी जुलमी अनाचारी अन्यायी
अत्याधुनीक: अत्याधुनिक
अत्युत्तम: अत्युत्तम
अथक: अक्लांत अथक अश्रांत
अथांग: अथांग अगाध सखोल गहन खोल
अदमासखर्चाचें: अंदाजपत्रकीय
अदमासाचें: अनुमानित अनुमित
अदाह्य: अदाह्य अदहनीय
अदीम: प्राचीनतम
अदृश्य: अदृश्य अदृष्ट
अद्वैत: अद्वैती
अधर्मी: अधार्मिक
अधाशिल्ले: null
अधाशी: लोभी लालची खवय्या
अधिकार: शासित प्रशासित अभिशासित अधिशासित
अधिकारहीण: अधिकार_नसलेला
अधिकारा_भायरें: अनधिकृत अधिकार_नसलेला
अधिकाराची: अधिकाराचा अधिकारी अधिकारयुक्त
अधिकारिकी: आधिकारिक
अधिकारी: हक्कदार अधिकारी
अधिकृत: आधिकारिक
अधीन: अधीन आधीन स्वाधीन अधीन_असलेला ताब्यात_असलेला वश_असलेला वश अवलंबून_असलेला आधीन अधीन
अधीनहीण: वश_न_होणारे
अधोगामी: अधोगामी
अध्यक्ष: अनुशास्ता
अध्यात्मज्ञानी: आध्यात्मज्ञाता ब्रह्मज्ञानी आध्यात्मज्ञानी सिद्ध
अनंत: असीम अनंत अपार अमर्याद निस्सीम अनन्वित
अनंताचो: अनंत अमर्याद अपरिमित अंतहीन अपार असीम निरवधि निरवधिक अपरंपार
अनधिकृत: अनधिकृत
अनपेक्षीत: अनपेक्षित आकस्मिक अकल्पित अनाहूत अनपेक्षित
अनभिप्रेत: अभिप्रेत_नसलेला अभिप्राय_नसलेला अभिप्राव_नसलेला अनभिप्रेत
अनमननासपी: माघार_न_घेणारा
अनमन्या_बगर: निःसंकोच
अनर्थकारी: अनर्थकारी अनर्थकारक
अनळंकृत: अनलंकृत साधे
अनवळखी: अज्ञात अपरिचित अनोळखी अज्ञात परका दुसरा बाहेरचा इतर
अनवाळें: सुरुवातीला_वापरलेला
अनसाचें: अननसाचा अननसासारखा
अनात्म: अनात्म
अनात्मदर्शी: बहिर्मुख
अनाथ: पोरका बेवारशी अनाथ असहाय निराश्रित निराधार अनाथ नाथहीन
अनादरीत: अनादृत
अनादी: अनादी सनातन
अनामी: अनामी अनामी
अनामीक: निनावी निनावी
अनासक्त: अनासक्त विरक्त उदासीन विरागी वीतराग
अनिंदनी: अनिंद्य
अनितीक: अनैतिक अवैध गैर
अनित्सूक: अजिज्ञासू जिज्ञासाहीन अनिच्छ निरिच्छ अनिच्छुक
अनियंत्रीत: अनियंत्रित अप्रमेय अपरिमित अमर्याद
अनियमीत: अनियमित अनिश्चित अनियत अनियमित नियमरहित
अनिर्णीत: अनिर्णीत
अनिर्धारीत: अनिश्चित
अनिर्मीत: अरचित
अनिश्चीत: अनिच्छित अनियमित अनिश्चित अनियत
अनुकंपीत: अनुगृहित
अनुकरण_करपी: अनुकरणशील
अनुकरणावपी: अनुकरणशील
अनुकरणीय: अनुकरणीय
अनुक्रमान: क्रमवार
अनुग्रहीत: अनुगृहित
अनुचीत: अनुचित अयोग्य गैर चुकीचा अशोभनीय अशिष्ट अप्रशस्त
अनुत्तीर्ण: अनुत्तीर्ण नापास
अनुदक: कोरडा शुष्क रखरखीत रूक्ष
अनुनासीक: अनुनासिक
अनुपकारादीक: अपकारी अपकारक
अनुपचारीक: अनौपचारिक
अनुपलब्ध: अनुपलब्ध अलभ्य
अनुपस्थीत: गैरहजर अनुपस्थित
अनुपेगी: निरुपयोगी टाकाऊ व्यर्थ अनुपयोगी अनुपयोग निष्फळ
अनुमतीत: परवानगी_मिळालेला अनुमती_मिळालेला अनुज्ञा_मिळालेला
अनुमतीप्राप्त: परवानगी_मिळालेला अनुमती_मिळालेला अनुज्ञा_मिळालेला
अनुमोदीत: समर्थित
अनुयायी: अनुयायी
अनुवंशीक: आनुवंशिक वंशपरंपरागत पिढीजात
अनुवादक: null
अनुवादपी: null
अनुवादीत: अनुवादित भाषांतरित
अनुशासक: अनुशास्ता
अनुशीक: लहान_भागाविषयीचा लहान_भागविषयक लहान_भागासंबंधीचा लहान_भागाशी_संबंधित लहान_अंशाविषयीचा लहान_अंशाविषयक लहान_अंशासंबंधीचा लहान_अंशाशी_संबंधित छोट्या_भागाविषयीचा छोट्या_भागविषयक छोट्या_भागासंबंधीचा छोट्या_भागाशी_संबंधित छोट्या_अंशाविषयीचा छोट्या_अंशाविषयक छोट्या_अंशासंबंधीचा छोट्या_अंशाशी_संबंधित लघु_भागाविषयीचा लघु_भागविषयक लघु_भागासंबंधीचा लघु_भागाशी_संबंधित लघु_अंशाविषयीचा लघु_अंशाविषयक लघु_अंशासंबंधीचा लघु_अंशाशी_संबंधित लघुभागाविषयीचा लघुभागविषयक लघुभागासंबंधीचा लघुभागाशी_संबंधित लघ्वांशाविषयीचा लघ्वांशविषयक लघ्वांशासंबंधीचा लघ्वांशाशी_संबंधित
अनुसरण_करपी: अनुकरणकरू
अनुसरपी: अनुकरणकरू
अनुसरून: अनुकूल फायदेशीर धार्जिणा सानुकूल अनुरूप
अनेक: अनेक पुष्कळ नाना कैक कित्येक कितीतरी बरेच विविध
अनैतीक: अनैतिक अवैध गैर
अन्य.: इतर अन्य दुसरा अवांतर
अन्याय_संबंदी: अन्यायविषयक
अन्यायपुर्ण: अन्याय्य
अन्यायी: अन्यायी अनीतिचा अधर्मी
अपंग: अपंग अधू विकलांग असमर्थ
अपंगूळ: अपंग अधू विकलांग अपंग अंगहीन काम_करण्यास_अयोग्य_असलेला काम_करण्यास_असमर्थ_असलेला
अपक्ष.: स्वतंत्र
अपक्षपाती: निष्पक्षपाती
अपठनीय: अवाचनीय
अपतीत: अपतित अच्युत
अपथ्य: कुपथ्य अहितकर स्वास्थ्यनाशक अस्वास्थ्यकारक
अपभ्रंश: वाईट खराब विकृत विकारग्रस्त बिघडलेला
अपभ्रंशीत: भ्रष्टित भ्रष्ट अपभ्रष्ट अपभ्रंशित
अपमान: अपमानित
अपमान_करपी: अपमानकर्ता
अपमानकर्तो: अपमानकर्ता
अपमानकारक: अपमान_करण्याजोगा
अपमानकारी: अपमानकारक अपमान_करण्याजोगा
अपमानाचें: अपमानकारक
अपरंपार: अप्रमेय अपरिमित अमर्याद
अपराजीत: अपराजित अजित
अपराधी: अपराधी गुन्हेगार दोषी गुन्हेगार गुन्हेगारी गुन्हेगारीविषयक गुन्हेगारीविषयीचा गुन्हेगारीसंबंधित गुन्हेगारीसंबंधीचा
अपरिपक्व: अपरिपक्व अप्रगल्भ
अपरिवर्तनशील: अपरिवर्तनीय
अपरिवर्तीत: अपरिवर्तित
अपरूप: अजोड बेजोड अप्रतिम अनुपम अतुलनीय अद्वितीय
अपरोक्त: अपरोक्ष_उच्चारला_गेलेला अपरोक्ष_बोलला_गेलेला अपरोक्ष_म्हटला_गेलेला
अपवादीत: अपवादात्मक तक्रार तकरार
अपवित्र: कच्चा अपक्व अपवित्र अमंगल अमंगळ पाप
अपसव्य: उजवा
अपहरण_केल्लें: अपहृत अपहरण_केलेला
अपात्र: अयोग्य अपात्र नालायक अकार्यक्षम निवडण्यास_अयोग्य
अपुज्य: पूजेत_वाहण्याजोगा_नसलेला पूजेसाठी_वाहण्याजोगा_नसलेला पूजेकरिता_वाहण्याजोगा_नसलेला पूजेत_न_वाहण्याजोगा पूजेसाठी_न_वाहण्याजोगा पूजेकरिता_न_वाहण्याजोगा पूजेत_वापरण्याजोगा_नसलेला पूजेसाठी_वापरण्याजोगा_नसलेला पूजेकरिता_वापरण्याजोगा_नसलेला पूजेत_न_वापरण्याजोगा पूजेसाठी_न_वापरण्याजोगा पूजेकरिता_न_वापरण्याजोगा
अपुण्य: पाप
अपुरबायेचें: लाडका आवडता
अपुरें: अपरिपूर्ण अपूर्ण अर्धा अर्धवट अधुरा अपुरा अपुरा कमी
अपूर्ण: अपरिपूर्ण अपूर्ण अर्धा अर्धवट अधुरा अपुरा अपुरा अपूर्ण अर्धवट
अपेक्षा_नासतना: अनपेक्षित आकस्मिक अकल्पित अनाहूत
अपेक्षीत: इच्छित अभिलाषित अभीष्ट अभीप्सित वांछित आकांशित इच्छिलेला ईप्सित अपेक्षणीय
अपेक्षे_भायलें: अनपेक्षित
अपेक्षेचें: अपेक्षित वांछित इच्छित सकाम साभिलाष
अपेशी: सदा_अयशस्वी सदा_अपयशी
अप्रकाशीत: अप्रकाशित
अप्रगट: अव्यक्त अव्यक्त
अप्रचलीत: चलनात_नसलेला अप्रचलित
अप्रतिकार: उपायशून्य अनुपाय ऋणबांधी अनुतराईशील अपरतावाशील
अप्रतिकारी: प्रतिकार_न_करणारा सूड_न_घेणारा
अप्रतिघात: अनाघ्रात इजा_न_झालेला
अप्रतिभा: प्रतिभाशून्य
अप्रतिश्ठीत: प्रतिष्ठा_नसलेला अप्रतिष्ठित
अप्रतीबंद: अबाध्य थांबवता_न_येण्याजोगा
अप्रतीम: अनेकांपैकी_एक
अप्रत्यक्ष: अप्रत्यक्ष वाकडा
अप्रभावी: प्रभावहीन प्रभावशून्य
अप्रभावीत: प्रभावित_न_झालेले अप्रभावित
अप्रमाणीक: लबाड फसव्या ठक लुच्चा लफंगा ठकबाज ठकसेन धूर्त अर्क भामटा पुराव्याने_सिद्ध_न_होणारा प्रमाणित_न_करता_येणारा
अप्रमाणीत: अप्रमेय असिद्ध
अप्रयोजक: अप्रासंगिक अप्रयोजक
अप्रवेश्य: अप्रवेश्य
अप्रसन्न: उदास खिन्न उदासीन
अप्रसिद्ध: अनाम अप्रसिद्ध
अप्राकृतीक: अनैसर्गिक
अप्राप्त: अप्राप्य अप्राप्त न_प्राप्त_झालेला
अप्रामाणीक: असभ्य अशिष्ट वाईट अभद्र ग्राम्य
अप्रासंगीक: अप्रासंगिक अप्रयोजक अप्रासंगिक प्रसंगानुचित
अप्रीय: नापसंत नावडता अप्रिय न_आवडलेला नापसंत नावडता अप्रिय
अफगाणी: अफगाणी अफगाणी
अफिमाचें_सेवन_करपी: अफीणबाज अफीमबाज
अफीम_घेवपी: अफीणबाज अफीमबाज
अबध्य: अवध्य मारण्यास_अयोग्य मारू_नये_असा अवधनीय अवध्य
अबादीत: अनाहत अक्षत
अबाध्य: अबाध्य थांबवता_न_येण्याजोगा
अबुद्ध: अविवेकी अविचारी असमंजस विवेकशून्य विचारशून्य आततायी
अबोल: अबोल
अब्ज: अब्ज
अभंग: अभंग
अभंगी: अभंगी
अभक्ष्य: अखाद्य अभक्ष्य अभोज्य न_खाण्याजोगा
अभलायकेवंत: अस्वास्थ्यकर अनारोग्यकर
अभागी: अभागी कमनशिबी करंटा दुर्दैवी हतभाग्य भाग्यहीन
अभिनंदीत: पूजिलेला वंदिलेला
अभिनयीत: अभिनीत
अभिप्राया_आड: अभिप्रेत_नसलेला अभिप्राय_नसलेला अभिप्राव_नसलेला अनभिप्रेत
अभिव्यक्त: अभिव्यक्त व्यक्त_केलेला प्रकट_केलेला जाहीर_केलेला उघड_केलेला अनावृत_केलेला
अभिशेक_केल्लें: अभिषिक्त
अभिशेक_घातिल्लें: अभिषिक्त
अभिशेकाचें: अभिषिक्त
अभिशेकीत: अभिषिक्त
अभेद्य: अभेद्य अभेदनीय निर्भेद्य
अभोज्य: अखाद्य अभक्ष्य अभोज्य
अभौतीक: नश्वर अशाश्वत अनित्य नाशवंत नाशिवंत विनाशी क्षणभंगुर क्षर
अभ्यसा_बगरचें: अभ्यास_न_करणारा
अभ्यासमोगी: अभ्यासी अध्ययनशील
अभ्यासहीण: अनभ्यस्त अभ्यास_न_करणारा
अभ्यासू: अभ्यस्त अभ्यासी अध्ययनशील अभ्यासात_व्यग्र
अभ्यासोपयोगी: सतत_अभ्यास_करण्याजोगा
अभ्रमीत: भ्रमरहित अभ्रांत भ्रांतिरहित
अमंगळ: अशुभ
अमर: शाश्वत नित्य अविनाशी अनश्वर चिरंतन अक्षय अक्षर अमर चिरंजीव अमर मृत्यूरहित चिरंजीव दीर्घायु चिरंजीव चिरायु औक्षवंत औक्षवान आयुष्यमान दीर्घजीवी चिरंजीवी
अमानवी: अमानुष पाशवी राक्षसी अलौकिक
अमानूश: अमानुष पाशवी राक्षसी
अमान्य: निषिद्ध अनुचित निषेधित त्याज्य वर्ज्य अविहित प्रतिषिद्ध हराम निषिद्ध
अमापीत: वजन_न_केलेला न_जोखलेला न_तोललेला
अमिश्रीत: विशुद्ध अमिश्र अमिश्रित
अमीट: कायमस्वरुपी शाश्वत चिरंतन चिरस्थायी स्थायी
अमुरपिकें: अर्धकच्चा
अमुर्त: निराकार अमूर्त निरवयव आकाररहित
अमुल्य: बहुमोल बहुमोली बहुमूल्य मौल्यवान अनमोल किमती किंमती अमोल अनमोल अमूल्य अमोल
अमूर्त: अगोचर अतींद्रिय अशारीर विदेह देहरहित निर्गुण
अमेरिकन: अमेरिकी
अमेरिकी: अमेरिकी
अयशस्वी: अपयशी अयशस्वी असफल सदा_अयशस्वी सदा_अपयशी
अयोग्य: अयोग्य अपात्र नालायक अकार्यक्षम अनुचित अयोग्य गैर चुकीचा अशोभनीय अशिष्ट अप्रशस्त प्रतिकूल विपरीत विषम निकामी
अरचीत: अरचित
अरबी: अरबी
अरमेनियायी: आर्मेनियन
अरसीक: अरसिक
अराजक: अराजक अराजकी निर्नायकीय
अराजपत्रीत: अराजपत्रित
अरुचीक: नीरस कंटाळवाणा सपक निरस रटाळ असार
अरूंद: अरुंद निरुंद चिंचोळा निमुळता
अरेखीत: अमर्यादीत अमर्याद असीम
अर्ज_केल्लें: अर्जदार
अर्जदार: अर्जदार
अर्थपूर्ण: अर्थपूर्ण
अर्थशास्त्राचें: अर्थशास्त्रीय
अर्थशास्त्रीय: अर्थशास्त्रीय
अर्थशुन्य: निरर्थक अर्थशून्य अर्थहीन व्यर्थ फोल वायफळ
अर्थहीन: निरर्थक अर्थशून्य अर्थहीन व्यर्थ फोल वायफळ
अर्थाचें: अर्थपूर्ण
अर्थीक: आर्थिक सांपत्तीक वित्तीय
अर्द: अर्धा निम्मा एकद्वितीयांश पन्नास_टक्का
अर्दउकतें: अर्धोन्मीलित
अर्दकच्चें: अर्धकच्चा
अर्दकुटिल्लें: अर्धबोबडा अरधबोबडा
अर्दकुटें: अपरिपूर्ण अपूर्ण अर्धा अर्धवट अधुरा अपुरा अपुरा अपूर्ण अर्धवट
अर्दपिकें: अर्धकच्चा
अर्दमेलो: अर्धमेला
अर्दवट: अपरिपूर्ण अपूर्ण अर्धा अर्धवट अधुरा अपुरा
अर्दवर्सुकी: सहामाही
अर्दवेळ: अंशकालीक अर्धवेळ
अर्दशिजिल्लें: कच्चा
अर्दुकुटें: अपरिपूर्ण अपूर्ण अर्धा अर्धवट अधुरा अपुरा
अर्पीत: अर्पिलेला
अर्भक: नवजात
अलंकृत: सन्मानित
अलबानियन: अल्बेनियन अल्बेनियन
अलभ्य: अप्राप्य
अलिखीत: अलिखित
अलोकीक: पारलौकिक परलोकातला
अलौकीक: अलौकिक
अल्प_काळीन: अल्पकालीन
अल्पआहारी: अल्पाहारी मिताहारी
अल्पप्राण: घोष सघोष
अल्पसंख्यांक: अल्पसंख्याक अल्पसंख्य
अल्पायुशी: अल्पायु अल्पायुषी अल्पायुष
अळंकारहीण: अनलंकृत साधे
अळंकारा_बगरचें: अनलंकृत साधे
अळंकारीत: अलंकृत सुशोभित विभूषित आभूषित सजलेला सजवलेला नटवलेला नटलेला
अवगुणी: निर्गुणी निर्गुण गुणरहित गुणविरहित गुणहीन
अवताराचें: अवतारी
अवतारी: अवतारी अवतारी
अवतारीत: अवतीर्ण
अवतीर्ण: अवतीर्ण
अवध्य: अवध्य
अवयस्क: अल्पवयस्क अल्पवयीन लहान पोरवयाचा पोरसवदा
अवर्णनी: अपार प्रचंड पारावार_नसलेला
अवर्णनीय: अवर्णनीय अवर्ण्य शब्दातीत निरूपणीय अनिर्वचनीय अनिर्वाच्य
अवश: वश_न_होणारे अवश्य
अवाचनीय: वाचण्याजोगा_नसलेला
अविकारी: अव्यय अक्षय शाश्वत
अविकृत: मूळ_स्वरूपातील प्राकृत अनाघ्रात
अविचारी: निरर्थकमग्न
अविचारीक: विचार_न_करण्याजोगा अविचारित
अविज्ञानीक: अवैज्ञानिक अवैज्ञानिक
अविवाहीत: लग्न_न_झालेली अविवाहित
अविश्वासी: अविश्वासी अविश्वासूक अविश्वासू
अविश्वासू: अविश्वसनीय अविश्वासू
अवेवस्थीत: अव्यवस्थित विस्कळीत अस्ताव्यस्त
अवेव्हारी: व्यवहारशून्य व्यवहरज्ञानशून्य अव्यवहारी
अवेव्हारीक: न_वापरलेला कोरा
अव्यक्त: अव्यक्त अनुच्चारित
अव्यय: अव्यय अक्षय शाश्वत
अव्यस्त: मोकळा रिकामा फावला
अशक्त: दुबळा दुर्बल निर्बल कमकुवत तकलादू कमजोर नाजूक कच्चा तकलादू अबला कृश हडकुळा रोड बारीक किडकिडीत लुकडा वाळलेला
अशक्य: असंभवनीय असंभाव्य अशक्य दुरापास्त असाध्य असाध्नीय
अशांत: चंचल अस्थिर चंचलचित्त चंचळ चलितचित्त लहरी
अशिक्षीत: अशिक्षित अविद्य निरक्षर अक्षरशत्रू अक्षरशून्य अंगठेबहाद्दर अडाणी
अशिमांकीत: अमर्यादीत अमर्याद असीम
अशीम: असीम अनंत अपार अमर्याद निस्सीम अनन्वित
अशीर: अरुंद निरुंद चिंचोळा निमुळता तंग घट्ट आवळ अडस
अशुद्ध: कच्चा अपक्व हिणकस हिणकट मिश्रित भेसळीचे घाणेरडा अस्वच्छ गलिच्छ घाण मलिन गचाळ गदळ अशुद्ध अशुद्ध चूक
अशूभ: अशुभ अकल्याणकारक अनिष्ट अशुभ अहितकारी अनहितकारी
अशे_तरेचो: null
अशें-तशें: क्षुल्लक कःपदार्थ नगण्य क्षुद्र तुच्छ पामर मामुली
अश्टांगी: अष्टांगी
अश्र्वारोही: घोडेस्वार
अश्लील: अश्लील अचकट_विचकट घाणेरडा वाह्यात अश्लील अचकटविचकट घाणेरडा वाह्यात
असंख्य: असंख्य अगणित अगण्य अपरिमित अमेय
असंतुश्ट: अतृप्त असमाधानी असंतुष्ट
असंतोशजनक: असमाधानकारक
असंबंदीत: असंबद्ध विसंगत भलता
असंबंद्द: अप्रासंगिक प्रसंगानुचित
असंयमी: असंयमित असंयत
असंस्कृत: अपरिष्कृत
असत्य: खोटा खोटारडा असत्य चुकीचा
असत्यपणाचें: खोटा खोटारडा असत्य चुकीचा
असफळ: अपयशी अयशस्वी असफल निरर्थक निष्फळ
असभावीक: अस्वाभाविक असामान्य
असभ्य: असभ्य अशिष्ट वाईट अभद्र ग्राम्य
असमंजस: ज्याला_कळले_नाही_असा ज्याला_समजले_नाही_असा
असमक्ष: अप्रत्यक्ष
असमजिकाय: असमंजस
असमजुतदार: अविवेकी अविचारी असमंजस विवेकशून्य विचारशून्य आततायी
असमतल: उंचसखल खाबडखुबड
असमाजीक: असामाजिक
असमाधानी: न_सुटलेला
असमृद्धिदिणें: असमृद्धीप्रद अकल्याणकारी
असलें: तसा
असलो: null
असहनशील: असहिष्णू
असहमत: असहमत मतविहीन तात्पर्याविरुद्ध आशयाविरुद्ध
असहाय्य: असह्य असहनीय सोसेनासे दुःसह
असादारण: असामान्य खास विशेष असाधारण
असाध्य: असाध्य असाध्नीय असाध्य
असामान्य: असामान्य खास विशेष असाधारण
असुरी: आसुरी
असुसंस्कृत: असभ्य अशिष्ट वाईट अभद्र ग्राम्य
असैमीक: अनैसर्गिक
असोच: null
अस्कळीत: अव्यवस्थित विस्कळीत अस्ताव्यस्त
अस्तंती: पाश्चात्त्य पाश्चिमात्य पश्चिमी पश्चिम
अस्ता-व्यस्त: विखुरलेली
अस्ताचें: अस्ताजवळचा अस्तासमीपचा अस्तानिकटचा
अस्ताव्यस्त: अव्यवस्थित विस्कळीत अस्ताव्यस्त
अस्तुरी: मादी मादा
अस्तुरेचें: बायकी
अस्थायी: तात्पुरता
अस्थावर: जंगम चल चर
अस्थीमय: हाडाचा अस्थिचा अस्थिमय
अस्थीर: गतिशील गतिमान चंचल अस्थिर अचपळ चंचळ
अस्पर्शीत: अस्पृष्ट
अस्पश्ट: अस्पष्ट धूसर अस्पष्ट पुसट अंधूक धुरकट धुकट
अस्पृश्य: अस्पृश्य
अस्वस्थ: उद्विग्न अशांत उदास खिन्न विषण्ण दुश्चित अस्वस्थ बेचैन विमनस्क
अस्विकृत: अस्वीकृत नामंजूर
अस्सल: खरा चोख अस्सल शुद्ध निर्भेळ निके चोखट खरे शुद्ध अस्सल
अहंकारी: अभिमानी अहंकारी घमेंडी घमेंडखोर मग्रूर गर्विष्ठ अहंमन्य ताठर उन्मत्त दर्पी अविनयशील अनम्र
अहिंसक: अहिंसक अहिंस्र
अहिंसावादी: अहिंसावादी
आंकरिल्लें: अंकुरित पल्लवित
आंकवार: अविवाहित लग्न_न_झालेली अविवाहित कुमारी अनाघ्रात
आंगाचे: विज्ञानसंगत
आंगीक: विज्ञानसंगत
आंटिल्ल्या_दुदाची: भाखड भाकड
आंतरदेशी: अंतर्देशीय देशांतर्गत देशातल्या_देशात
आंतरराज्य: अंतरराज्य
आंतरराष्ट्रीय: आंतरराष्ट्रीय
आंतरीक: आतील आतला आतचा अंतर्गत अंतःस्थ अंतःस्थित आंतर
आंतर्जातीय: आंतरवंशीय मिश्र
आंतर्राष्ट्रीय: आंतरराष्ट्रीय
आंधळो: आंधळा अंध नेत्रहीन दृष्टिहीन अंधळा
आंबट: आंबट अंबट
आंबट_गोड: आंबटगोड
आंवुळिल्ल्या: संकुचित आकुंचित
आकर्शक: रमणीय मोहक मनमोहक चित्ताकर्षक आकर्षक आकर्षक मोहक मनमोहक चित्ताकर्षक गोंडस दिसण्यात_सुंदर आकर्षणारा आकर्षक
आकर्शीत: आकर्षित आकृष्ट मोहित मुग्ध
आकलनीय: गणनीय परिमेय
आकस्मीक: आकस्मिक अकल्पित अचानक
आकाराचें: घडीव
आकाशी: आकाशी
आक्रमक: आक्रमक
आक्रमणकारी: आक्रमणकारी
आक्रांत: आक्रांत
आख्खें: अख्खा अखंड सबंध सलग परिपूर्ण
आगंतूक: ठराविक
आगळीक_करपी: बलात्कारी
आगळें: वेगळा निराळा भिन्न पृथक् अलग आगळा न्यारा विभिन्न वेगवेगळा
आगळो: अजोड बेजोड अप्रतिम अनुपम अतुलनीय अद्वितीय
आगामी: भावी भविष्यकालीन भविष्यातील आगामी पुढील पुढचा
आगीचें: आग्नेय
आग्रही: आग्रही निग्रही
आचारवान: सभ्य शिष्ट शालीन
आजापीत: असामान्य असाधारण अलौकिक लोकोत्तर लोकविलक्षण विलक्षण अनन्यसाधारण
आज्ञा_पाळपी: आज्ञाधारक
आज्ञाकारी: आज्ञाधारक
आज्ञापाळक: आज्ञाधारक
आठ: आठ अष्टम
आठ_कुशींचें: अष्टपैलू
आठ_म्हयन्यांचें: आठवळा
आठपट: आठपट
आठवड्याचें: साप्ताहिक
आठवें: आठवा अष्टम
आठसठ: अडुसष्ट
आठोळें: आठवळा
आठ्ठिसावें: अडतिसावा
आठ्ठीस: अडतीस
आडंबराचें: भपकेबाज
आडखळिल्लें: अडकलेला गुंतलेला गुंतागुंतीचा फसलेला
आडखळिल्लो: अडकलेला अवरुद्ध रोधलेला
आडनदर: उपेक्षित दुर्लक्षित उपेक्षणीय उपेक्ष्य
आडवादा_बगरचें: निरपवाद
आडवें-उबें: आडवातिडवा
आडवें-तिडवें: आडवातिडवा
आडवो: आडवा
आडी_मारिल्लें: रेखांकित रेखित
आतांचें: वर्तमान
आतिरिक्त: शिवाय सोडून अतिरिक्त व्यतिरिक्त
आतूर: आतुर अधीर उतावीळ उत्सुक उत्कंठित
आते: आते-
आत्मज्ञानी: आत्मज्ञानी योगी
आत्मदर्शी: आत्मज्ञानी योगी
आत्मनिर्भर: स्वयंपूर्ण
आत्मविस्वासू: आत्मविश्वासू
आत्म्या_विशींचें: आत्म्याविषयीचा आत्माविषयक आत्म्यासंबंधीचा आत्म्याशी_संबंधित
आदखळीचे: बिकट कठीण खडतर दुर्गम गहन
आदर्श: आदर्श अनुकरणीय
आदलें: जर्जर जीर्ण झिरझिरीत पूर्वीचा गतकालीन
आदलो: पूर्वीचा आधीचा अगोदरचा मागचा पहिला जुना
आदारहीण: आधार_नसलेला टेका_नसलेला आधार_न_दिलेला टेका_न_दिलेला आधारहीत
आदारहीन: निराधार अनाधराधार
आदारा_बगर: निराधार अनाधराधार
आदारा_बगरचें: आधार_नसलेला टेका_नसलेला आधार_न_दिलेला टेका_न_दिलेला आधारहीत
आदारीत: आश्रित
आदिवासी: जनजातीय
आदी: इत्यादी
आधीन: आधीन अधीन
आधुनीक: आधुनिक सद्यःकालीन वर्तमान
आध्यात्मीक: आध्यात्मिक अध्यात्मिक
आनंद_दिवपी: संतोषजनक
आनंददायी: आनंददायक आनंददायी सुखद सुखकारक सुखदायी सुखदायक सुखप्रद आल्हादकारक आल्हादक तोषक रंजक
आनंददिणें: संतोषजनक
आनंदी: प्रसन्नचित्त आनंदी खुशमिजाज उत्साही
आनंदीत: आनंदमय उल्हासपूर्ण आनंदपूर्ण उल्हासमय सानंद सोल्हास प्रसन्न आनंदित आनंदी आल्हादित प्रफुल्लित मुदित प्रमुदित खुश मनोरंजित
आनिकूय: इतर अन्य आणखी दुसरा
आनीक: इतर अन्य आणखी दुसरा
आनीक_कोणूय: इतर अन्य आणखी दुसरा
आनुश्ठानीक: अनुष्ठानसंबंधी
आपखोसयेचें: स्वांतःसुखाय स्वतःसाठी स्वतःकरता आपल्यासाठी
आपणायिल्ली: मंजूर मंजूरीप्राप्त
आपणायिल्लें: अंगीकृत स्वीकालरेला पत्करलेला
आपयिल्लें: संबोधित उद्दिष्ट उद्देशिलेले
आपरोसहीण: निःसत्त्व
आपलें: खाजगी खासगी व्यक्तिगत वैयक्तिक स्वीय
आपल्या_पक्षाचो: स्वपक्षीय
आपसांतलें: परस्पर
आपसुवार्थी: स्वार्थी मतलबी आपमतलबी आप्पलपोट्या आप्पलपोटा
आपार: अप्रमेय अपरिमित अमर्याद
आपेक्षीक: सापेक्ष
आफडीचें: ऋतुमती रजस्वला ऋतुस्नात
आफडूंक_नाशिल्लें: अस्पृष्ट अस्पृष्ट अस्पर्शित
आफताबी: उन्हात_शिजवलेला
आफ्रिकी: आफ्रिकी
आबुझाद: विचलित स्थानभ्रष्ट चळलेला
आबूज: गोंधळलेला घाबरलेला
आबूझ: विचलित स्थानभ्रष्ट चळलेला
आभारी: कृतज्ञ आभारी ऋणी
आभुशीत: अलंकृत सुशोभित विभूषित आभूषित सजलेला सजवलेला नटवलेला नटलेला
आम: सामान्य मध्यम साधारण बरा ठीक
आमंत्रीत: आमंत्रित निमंत्रित
आमल: तेजाबी
आमिझाद: मैत्रीपूर्ण
आम्लाचें: आम्ल
आम्लीक: आम्ल आम्लीय
आयकपा_सारको: श्राव्य
आयकुपा_सारकें: श्रवणीय श्राव्य ऐकण्याजोगा ऐकण्यासारखा ऐकण्यालायक ऐकणीय
आयकूंक_नाशिल्ली: अश्रुत
आयचो_काळ: वर्तमानकालीन सद्यकालीन सध्याचा हल्लीचा आताचा आत्ताचा वर्तमानकाळाबाबतचा वर्तमानकाळाचा वर्तमानकाळाविषयीचा वर्तमानकाळविषयक वर्तमानकाळासंबंधीचा वर्तमानकालाबाबतचा वर्तमानकालाचा वर्तमानकालाविषयीचा वर्तमानकालविषयक वर्तमानकालासंबंधीचा सद्यकालाबाबतचा सद्यकालाचा सद्यकालाविषयीचा सद्यकालविषयक सद्यकालासंबंधीचा सद्यकाळाबाबतचा सद्यकाळाचा सद्यकाळाविषयीचा सद्यकाळविषयक सद्यकाळासंबंधीचा सध्याबाबतचा सध्याचा सध्याविषयीचा सध्यासंबंधीचा
आयच्या_काळांतलें: आधुनिक सद्यःकालीन वर्तमान
आयताकार: आयताकृती आयताकार
आयरिश: आयरिश
आयातीत: आयात_केलेला आयातित
आयिल्लें: बाहेर_पडलेला
आयिल्लो: आलेला आगत
आयुर्वेदीक: आयुर्वेदिक आयुर्वेदीय आयुर्वेदाचा आयुर्वेदाविषयीचा आयुर्वेदविषयक आयुर्वेदासंबंधीचा आयुर्वेदाशी_संबंधित
आयोजीत: आयोजित
आरंभहीण: अनादी सनातन
आरक्षीत: आरक्षित राखीव राखलेला
आरतें_परतें: null
आरमेनियी: आर्मेनियन
आराधक: उपासक
आरामदिणी: आरामदायी आरामदायक सुखकारक सुखदायी
आरास: सजावटी
आरूढ: आरूढ
आरोग्याक_बरें: स्वास्थ्यकर स्वास्थ्यदायी स्वास्थ्यप्रद आरोग्यदायी आरोग्यप्रद आरोग्यकर
आरोपमुक्त: अपराधमुक्त दोषमुक्त
आरोपी: आरोपी
आर्थीक: आर्थिक सांपत्तीक वित्तीय
आलमपेड्ड्यार: रिकामटेकडा उडाणटप्पू निरुद्योगी
आलायतें: शिवाय सोडून अतिरिक्त व्यतिरिक्त
आल्मीखुशाल: निःशंक निर्धास्त निर्भ्रांत शंकारहित
आळशी: आळशी सुस्त ढम्म मंद निष्क्रीय आळसट ढिला मैंद
आवटें: मूर्ख बावळा बावळट अज्ञानी मूढ जड मंद निर्बुद्ध मठ्ठ बेअक्कल शंख बिनडोक अडाणी ढ ठोंब्या अर्धवट बेअक्कली भोट वेडा पागल खुळा येडा पिसा भ्रमिष्ट खुळचट
आवटो: लहरी छांदीष्ट झक्की वेडा येडा पिसा वेडापिसा पागल
आवडना_अशें: अरुच
आवडनाशिल्लें: नापसंत नावडता अप्रिय न_आवडलेला नीरस कंटाळवाणा सपक निरस रटाळ असार अरुच
आवडीचें: इच्छित अभिलाषित अभीष्ट अभीप्सित वांछित आकांशित इच्छिलेला ईप्सित आवडता आवडीचा मनपसंत पसंतीचा प्रिय प्रिय आवडता चवदार रुचकर
आवरणहीण: अनावृत उघडा अनाच्छादित
आवर्तक: आवर्ती
आवेगपूर्ण: आवेशपूर्ण
आशावादी: आशावादी आशावंत आशावादी
आशियायी: आशियाई
आशेखोर: लोभी लालची
आशेचें: सकाम साभिलाष खवय्या
आशेभगत: लोभी लालची
आशेल्ले: null
आशेल्लो: लालचावलेला लालचेल खूप_लालचावलेला उत्कंठित आशाळभूत
आश्चर्य: सूर्याचा
आश्चर्याचें: अभूतपूर्व अपूर्व अनोखा
आश्रमहीण: अनाश्रमी आश्रमहीन
आश्रमा_बगरचें: अनाश्रमी आश्रमहीन
आश्वस्त: आश्वासित
आसक्त: अनुरक्त मोहित लुब्ध आकृष्ट लट्टू लोलुप फिदा आसक्त आशक
आसपतीचें: सांपत्तिक
आसपाविल्लें: अनुस्यूत
आसपावीत: समन्वयित
आसा: स्थित
आसामी: आसामी आसामबाबतचा आसामचा आसामविषयीचा आसामविषयक आसामसंबंधीचा आसामशी_संबंधित आसामी आसामी
आस्ट्रियायी: ऑस्ट्रियन
आस्तीक: आस्तिक
आस्पाविल्ले: अंतर्भूत समाविष्ट समाहित
आहाराचें: खाद्य भोज्य भक्ष्य ग्राह्य खाण्याजोगा
आहारी: आहारसंबंधी आहारविषयक
इंग्रजी: इंग्रजी इंग्लिश इंग्रजी इंग्लंडाविषयीचा इंग्लंडविषयक इंग्लंडाशी_संबंधित इंग्लंडासंबंधीचा
इंग्लीश: इंग्रजी इंग्लंडाविषयीचा इंग्लंडविषयक इंग्लंडाशी_संबंधित इंग्लंडासंबंधीचा
इंग्लेज: इंग्रजी इंग्लिश इंग्रजी इंग्लंडाविषयीचा इंग्लंडविषयक इंग्लंडाशी_संबंधित इंग्लंडासंबंधीचा
इंद्रधोणू: इंद्रधनुषी
इंद्रीयगम्य: इंद्रियगम्य इंद्रियगोचर इंद्रियग्राह्य इंद्रियसंवेद्य गोचर
इंद्रीयगोचर: इंद्रियगम्य इंद्रियगोचर इंद्रियग्राह्य इंद्रियसंवेद्य गोचर
इकरा: अकरा एकादश
इकरावें: अकरावा
इक्कें: इतका एवढा
इजिप्ती: इजिप्ती
इटाली: इटालियन
इटालीयन: इटलीयाई इटलीय इटालियन
इतकें: इतका एवढा
इतलें: समान सारखा सम सदृश सदृश्य एकरूप इतका एवढा
इतिहासीक: ऐतिहासिक
इत्शीक: वैकल्पिक ऐच्छिक पर्यायी
इत्शीत: ऐच्छिक
इत्साहीण: निरिच्छ इच्छारहित निराकांक्ष अनिच्छ निरिच्छ अनिच्छुक
इत्सीत: इच्छित अभिलाषित अभीष्ट अभीप्सित वांछित आकांशित इच्छिलेला ईप्सित
इत्सुक: इच्छुक अभिलाषी
इत्सूक: सकाम साभिलाष
इबाडिल्लें: सडका नासका कुजका
इबाडिल्लो: वाईट खराब विकृत विकारग्रस्त बिघडलेला
इराणी: इराणी इराणी
इर्शेन_भरिल्लें: द्वेषपूर्ण
इल्लें: कमी थोडा थोडासा थोडका अल्प अल्पसा मोजका किंचित किंचितसा जरा जरासा थोडाथोडका अल्पस्वल्प
इल्लेशें: अत्यल्प
इशान्यी: 
इश्कोलाचें: शालेय विद्यालयीन
इश्टागत: मनमिळाऊ मैत्रीपूर्ण
इश्टाबगरचो: मित्र_नसलेला मित्रहीन
इश्टाविरयतचो: मित्र_नसलेला मित्रहीन
इश्वर_बगरचें: अनीश
इश्वरहीण: अनीश
इश्वरी: ईश्वरी दैवी ईश्वरी
इश्वरीदेणें: ईश्वरदत्त देवदत्त
इस्लामी: मुसलमानी इस्लामी
इहलोकीक: ऐहिक इहलौकिक लौकिक सांसारिक इहलोकीय इहलोकातील
ईश्वरवादी: आस्तिक
ईश्वरी: ईश्वरदत्त देवदत्त
उंचलो: वरील
उंचल्या_कुळातलो: उच्चकुलीन खानदानी घरंदाज जातिवंत कुलीन अभिजात
उंचवटो: null
उंचेलें: उंच उत्तुंग उन्नत उच्च
उकतायिल्लें: अभिव्यक्त व्यक्त_केलेला प्रकट_केलेला जाहीर_केलेला उघड_केलेला अनावृत_केलेला
उकतें: अनावृत उघडा अनाच्छादित प्रकट खुला उघड_झालेला उघडा खुला खुला
उकतेपणीचें: अनावृत्त अनावर्ती
उकतो: नग्न नागडा विवस्त्र निर्वस्त्र अनावृत नागवा नंगा नागडाउघडा उघडानागडा वस्त्रहीन
उकत्या_हाताचें: उदार दानी
उगडास_नाशिल्लें: अपुरा अपुरा_रचलेला
उगडें: अनावृत उघडा अनाच्छादित
उग्रवादी: अतिरेकी दहशतवादी
उचांबळ: उद्विग्न अशांत उदास खिन्न विषण्ण दुश्चित अस्वस्थ बेचैन विमनस्क आतुर अधीर उतावीळ उत्सुक उत्कंठित
उचांबळीत: चंचल अस्थिर अचपळ चंचळ
उचीत: नैतिक नीतियुक्त सुसंगत उचित योग्य साजेसा अनुरूप फक्कड शुद्ध यथोचित
उच्च: वरिष्ठ
उच्चारिल्लें: उच्चारित
उजबेकी: उझबेकी उझबेकी
उजळ: पांढरा श्वेत धवल शुभ्र सफेत सफेद तेजस्वी तेजःपुंज तेजोमय सतेज उज्ज्वल उजळ तेजस प्रकाशमान दीप्तिमान देदीप्यमान कांतिमान शोभायमान उज्ज्वलित प्रकाशमय पाणीदार तेजवान तेजवंत
उजवाडायिल्लें: प्रकाशित
उजवें: उजवा
उजू: प्रामाणिक इमानदार चोख सालस साळसूद निःकपट
उजो_पालोवपी: शामक अग्निशामक
उज्याचें: आग्नेय
उठवणेचें: अडेलतट्टू अडेल
उडपी: उडणारा
उडयिल्लें: उधळलेला फेकलेला पाडलेला
उडिया: ओरिसी ओडिसी ओरिसी ओडिसी
उणे_पिरायेचें: अल्पायु अल्पायुषी अल्पायुष
उणें: अपुरा कमी कमी थोडा थोडासा थोडका अल्प अल्पसा मोजका किंचित किंचितसा जरा जरासा थोडाथोडका अल्पस्वल्प डावा
उणें_उलोवपी: मितभाषी अबोल अल्पभाषी अल्पभाष मुखस्तंभ
उणें_केल्लें: पदच्युत बडतर्फ
उणें_जाल्लें: स्वस्त
उण्या_आयुश्याचें: अल्पायु अल्पायुषी अल्पायुष
उण्यांतउणें: किमान कमीतकमी
उतरांखेळाचो: एकटा सडा एकाकी
उतरांचें: भविष्यकाळात_होणारा
उताणें: उताणा सुलट उलथा
उतावळें: उतावळा उतावीळ अधीर घायकुत्या
उतावळो: चंचल अस्थिर अचपळ चंचळ
उत्कृश्ट: चांगला
उत्कृश्ठ: सर्वोत्कृष्ट सर्वश्रेष्ठ
उत्तम: उत्तम उत्कृष्ट झकास फर्मास फर्डा चांगला
उत्तरकाळीन: उत्तरकालीन
उत्तरदायी: जबाबदार उत्तरदायी
उत्तरी: हात_नसलेला थोटा
उत्तीर्ण: उत्तीर्ण सफल पास यशस्वी
उत्तेजक: प्रक्षोभक भडकवणारा उत्तेजक
उत्तेजीत: उत्तेजित गरम
उत्पन्न: उत्पादित तयार ओडिसी
उत्पादक: उत्पादक
उत्पादीत: उत्पादित उत्पादिलेला
उत्पादीत_जाल्लें: उत्पादित तयार
उत्सर्जीत: उत्सर्जित
उत्साहपूर्ण: उत्साहपूर्ण उत्साही
उत्साहहीण: अजिज्ञासू जिज्ञासाहीन
उत्साही: उत्साही दमदार जोरदार जोमदार आवेशपूर्ण आवेशयुक्त भावनाप्रधान अवसानयुक्त
उत्सुक: जिज्ञासू चौकस
उथळ: उथळ अनाप्लुत
उदक_भरशिल्लें: पांचट
उदका_कोराचें: राजावर्तच्या_रंगाचा
उदकांतली: जलीय
उदकाचें: पांचट
उदकाभरवण: जलाच्छादित जलगत
उदकाळ: पाण्याचा पांचट पाणथळ
उदय_जाल्लो: उदित
उदार: उदारमतवादी परमतसहिष्णुतावादी उदार कनवाळू मोठ्या_मनाचा विशाल_ह्रदयाचा उदार_मनाचा उसना उधारीवरचा उधारीवरील उसनवारीचा उसनवारीवरील
उदारें: उताणा सुलट उलथा
उदेंती: पूर्व
उदेल्लो: उदित
उद्घाटीत: उद्धाटित
उद्देगी: निरलस अनलस
उद्धट: बेडर निडर
उद्येगीक: औद्योगिक
उद्येगीकरण: उद्योगप्रधान
उध्वस्त: नष्ट नेस्तनाबूत नेस्तनाबूद जमीनदोस्त उद्ध्वस्त नामशेष बरबाद उध्वस्त पडकी उधळलेला अस्ताव्यस्त
उनी: लोकरी गरम
उन्नत: विकसित
उन्नतीकारक: उन्नतिकारक उत्कर्षप्रद वृद्धिकारक अभिवृद्धिकारक प्रगतिपर विकासपर
उपकारादीक: उपकर्ता उपकारकर्ता
उपकारी: कृतज्ञ आभारी ऋणी कृतार्थ कृतकृत्य
उपचार_केल्लें: उपचारित
उपचारा_बगरचें: अनुपचारित
उपदेश_करपी: उपदेशक उपदेष्टा
उपदेशक: उपदेशक उपदेष्टा
उपदेशी: उपदेशक उपदेष्टा
उपद्रवी: उपद्रवी
उपभोगी: उपभोग्य
उपयुक्त: सुसंगत उचित योग्य साजेसा अनुरूप फक्कड
उपयोगी: उपयोगी उपयुक्त कामाचा
उपरांतचें: नंतरचा पुढचा पुढील
उपरो: null
उपस्थीत: उपस्थित हजर हाजिर
उपाट: फार खूप आतोनात अतोनात पुष्कळ प्रचंड अपरिमित अतिशय गडगंज चिक्कार चिकार भरमसाट मुबलक विपुल मोप रगड रग्गड सज्जड भारी बखळ बहुत भरपूर भरमसाठ भलता भाराभर आत्यंतिक जास्त अधिक जास्ती अदम्य दुर्दम्य भरपूर खूप भरलेला
उपाड्यांत_घातिल्लें: ओतीव
उपाधीत: सन्मानित
उपाशी: अनाहारी
उपाशीं: उपाशी
उपासक: उपासक
उपासमारो: भुकेकंगाल भुकेबंगाल
उपेक्षा: उपेक्षणीय उपेक्ष्य
उपेक्षित: तिरस्कृत उपेक्षित
उपेक्षीत: उपेक्षित दुर्लक्षित उपेक्षित
उपेगाचें: फलप्रद लाभकारी लाभदायक फायदेशीर फलदायी किफायतशीर फलद्रूप
उपेगी: योग्य लायक समर्थ सक्षम पात्र काबील उपयोगी उपयुक्त कामाचा व्यवहार्य व्यावहारिक शक्य
उपोश्णकटीबंधीय: दुसर्‍याचा परक्याचा परका
उप्तादीत: उत्पादित तयार
उप्राशिल्लें: समागत समोर_उभा_राहिलेला समोर_उपस्थित_झालेला समोर_येऊन_पोहोचलेला समोर_आलेला समोर_असलेला
उप्रासपी: उद्भवित कार्यभूत_झालेला
उबें: उभा खडा
उबें_केल्लें: रचित कृत विरचित निर्मित रचलेला
उबेवपी: तरंगता तरंगणारा
उबो: उभा
उभयचर: उभयचर
उमजणेचें: हृदयंगम
उमथें: पालथा उपडा उलटा
उमेदी: प्रसन्न आनंदित आनंदी आल्हादित प्रफुल्लित मुदित प्रमुदित खुश प्रसन्नचित्त आनंदी खुशमिजाज मनोरंजित उत्साही उत्साहपूर्ण उत्साही
उमेदी_बगरचें: अजिज्ञासू जिज्ञासाहीन
उरफाटे: उलट उलटा विरुद्ध
उरफाटें: विपरीत विरुद्ध उफराटा
उरफाटो_चलपी: प्रतिगामी
उरफाट्या_काळजाचो: पाषाणहृदयी निर्दय कठोर निष्ठुर वज्रहृदयी दयाशून्य क्रूर दयाहीन निर्मोही
उरबेवंत: दमदार जोरदार जोमदार आवेशपूर्ण आवेशयुक्त भावनाप्रधान अवसानयुक्त
उरमट: ताठर कोठोर
उरिल्लें: न_लोटलेला उरलेला बाकी शिल्लक उर्वरित अवशिष्ट उरलेली राहिलेला उर्वरित बाकी थांबलेला
उरिल्लें_रीण: देय
उर्दू: उर्दू
उर्बेभरीत: null प्रेरित
उर्मट: उद्धट असभ्य उर्मट बेपर्वा धृष्ट अशिष्ट अविनयशील अप्रशस्त अभद्र आगाऊ बेडर निडर
उलट_सुलट: null
उलटें: उलट उलटा विरुद्ध
उलटें_सुलटें: भंकस
उलयतें: बोलता
उलयिल्लें: उच्चारित
उलोवपी: बोलका बोलका
उल्लेखनीय: उल्लेखनीय लिहिण्याजोगा लेखनीय लेख्य
उल्लेखीत: उल्लेखित कथित निर्दिष्ट
उशीर: उशीराचा
उशीर_जाल्लें: null
उश्टायिल्लें: खाल्लेला
उश्टें: उष्टा उच्छिष्ट उष्टा उपभुक्त
उश्ट्याचें: उष्टा उच्छिष्ट उष्टा उपभुक्त
उश्ण: उष्ण गरम उष्म तप्त तापलेले ऊन उबदार गरम उष्ण
उश्णकटिबंधी: उष्णकटिबंधीय
ऊंच: उंच उत्तुंग उन्नत उच्च वरचा उच्च
ऊंच_इमारतीचें: उंच_इमारतींचा
एक: एक
एक_करोड: कोटी करोड
एक_चतुर्तांश: एक_चतुर्थांश चतुर्थांश चौथा
एक_तृतियांश: एक_तृतीयांश
एकछत्र: एकछत्री
एकटें: एकटा एकाकी सडा सडाफटिंग एकांडा
एकट्याचें: एकतर्फी
एकठांय: एकत्रित जमा गोळा एकत्र संघटित एकीकृत एकीभूत
एकतर्फी: एकदिशीय एकतर्फी एकतर्फी
एकतायपूर्ण: एकसंध
एकतिसावें: एकतिसावा
एकतीस: एकतीस
एकतोंडी: एकमुखी
एकत्र: एकत्रित जमा गोळा एकत्र
एकत्रीत: एकसंध एकत्रित जमा गोळा एकत्र एकीकृत एकीभूत
एकदम: आनंदी प्रसन्नचित्त
एकनिश्ठ: एकनिष्ठ
एकमुखी: एकमुखी
एकमुळी: एकटा सडा एकाकी
एकमुळें: एकलकोंडा माणूसघाणा
एकरुपी: एकसमान एकसारखा हुबेहूब समरूप तंतोतंत_सारखे
एकलें: एक एकटा एकाकी सडा सडाफटिंग एकांडा
एकलें-दुकलें: एक_दोन एकटादुकटा
एकलेंच: एकुलता एकुलताएक एकचएक
एकल्याचें: एकतर्फी
एकवंशी: एकावंशांतील एकवंशीय
एकवटिल्लें: एकत्रित जमा गोळा एकत्र
एकवटीत: संघटित
एकविसावें: एकविसावा
एकवीस: एकवीस
एकशिवडी: एकेरी
एकशें_णव्वद: एकशेनव्वद
एकशें_पंच्यात्तर: पावणेदोनशे एकशे_पंचाहत्तर
एकसठ: एकसष्ठ
एकसठावें: एकसष्ठावा
एकसारकें_येवपी: नेहमीचा
एकसुरी: एकटा सडा एकाकी
एकसुरें: एकलकोंडा माणूसघाणा एकटा एकाकी सडा सडाफटिंग एकांडा
एकांत: निर्जन विजन सुनसान मनुष्यविहीन
एकांतवासी: एकांतात_राहणारा
एकांतहीण: अनिर्जन सुनसान_नसलेला गजबजलेला
एकाक्षरी: हिब्रू हिब्रवी हिब्रूविषयीचा हिब्रूविषयक हिब्रूसंबंधीचा हिब्रूशी_संबंधित
एकाग्र: केंद्रित
एकाच_काळांतलें: सामयिक
एकार्थी: एकार्थी
एकावडो: एकेरी
एकावन: एकावन्न
एकावनावें: एकावन्नावा
एकासारकें: एकसारखा एकरूप सारखा समरूप समान
एकुणअंयशीं: एकुणऐंशी एकुणअशी एकुणैशी
एकुणचाळिसावें: एकोणचाळिसावा
एकुणचाळीस: एकोणचाळीस
एकुणणव्वद: एकोणनव्वद
एकुणतिसावो: एकोणतिसावा
एकुणतीस: एकोणतीस
एकुणपन्नास.: एकोणपन्नास
एकुणपन्नासावें: एकोणपन्नासावा
एकुणसत्तर: एकोणसत्तर
एकुणसाठ: एकोणसाठ
एकुणसाठावें: एकोणसाठावा
एकुणीस: एकोणीस एकोणिसावा
एकुलगें: एकलकोंडा माणूसघाणा
एकुलतें: एकलकोंडा माणूसघाणा
एकूच: एकुलता एकुलताएक एकचएक
एकूलगी: एकटा सडा एकाकी
एकूलयी: एकटा सडा एकाकी
एके_वटेनचें: एकतर्फी
एकेचाळिसावें: एकेचाळिसावा एकेचाळावा
एकेचाळीस: एकेचाळीस एकेचाळ एकेताळीस एकेताळ
एकोडें: एकपदरी एकेरी
एक्याण्णव: एक्याण्णव
एक्याण्णवावें: एक्याण्णवावा
एक्यात्तर: एकाहत्तर एकेहत्तर एकेहात्तर
एक्यात्तरावें: एकाहत्तरावा
एण्डोरी: अँडोराचा
एतिहासीक: ऐतिहासिक
ऑफिसरा_भशेन: अधिकार्‍यासारखा
ऑफिसाचें: अधिकार्‍याचा
ऑस्ट्रियन: ऑस्ट्रियन
ऑस्ट्रेलियायी: ऑस्ट्रेलियाई ऑस्ट्रेलियायी
ओंपिल्लें: समर्पित अर्पित अर्पिलेला
ओंविल्लें: ओवलेला गुंफलेला
ओगोत_जाल्लें: null
ओग्गी: निःशब्द शांत
ओजस्वी: तेजस्वी ओजस्वी तेजःपुंज
ओडलायणें: आकर्षक मोहक मनमोहक चित्ताकर्षक गोंडस दिसण्यात_सुंदर आकर्षणारा आकर्षक
ओपेरासांव_केल्ले: प्रत्यारोपित
ओपेरासावीं: शस्त्रक्रियेचा
ओबड_धोबड: खरबरीत खडबडीत खरखरीत चरबट
ओबडधोबड: उंचसखल खाबडखुबड
ओमथें: पालथा उपडा उलटा
ओरिया: ओरिसी ओडिसी
ओलें: आर्द्र ओला दमट
ओवळें: पारोसा पारोशी
औपचारीक: औपचारिक
औरस: औरस
कंजूस: कंजूस कंजूष कृपण कद्रू चिक्कू कवडीचुंबक चिकट
कंठ्य: कंठ्य
कंपमान: कापरा कंपित थरथरणारा कंपायमान
कंपीत: कापरा कंपित थरथरणारा कंपायमान
कंपुचियन: ख्मेर
कंबोडियन: ख्मेर
कचेरीक: कार्यालयीन
कचेरेचें: कार्यालयीन
कच्चें: कच्चा अपक्व अपरिपक्व कच्चा अपक्व कच्चा कच्चा न_तासलेला
कच्छी: कच्छी
कट्टर: बिघडलेला नादुरुस्त कट्टर
कट्टरवादी: अंधश्रद्ध अंधविश्वासू
कट्ट्या_विणें: आवरणहीन
कट्ट्याचें: कवचधारी
कठीण: बिकट कठीण खडतर दुर्गम गहन कूट गहन दुर्ज्ञेय कठीण मुश्कील कठीण अवघड अनाकलनीय दुराकलनीय कठीण अवघड अबोधनीय अबोध्य सूक्ष्म
कठोर: निर्दय निर्दयी कठोर क्रूर निष्ठुर निर्गृण हृदयशून्य पाषाणहृदयी कर्कश कर्णकटू कर्णकर्कश बेमुरवत बेमुरवती बेमुर्वत बेमुर्वती
कडक: कुशाग्र तल्लख प्रखर दारुण घोर भयंकर दुःसह कडक कडक गंभीर
कडकडीत: गरमगरम कढत ऊनऊन गरमागरम कडकडीत
कडयिल्लें: तप्त अभितप्त
कडें: लठ्ठ
कडेनचें: जवळचा नजीकचा निकटवर्ती
कणखर: तीव्र राजेशाही ऐश्वर्यपूर्ण ऐश्वर्यसंपन्न वैभवी
कणिल्ली: खणलेला खणून_ठेवलेला
कणीक: रवाळ दाणेदार कणदार
कथनीय: सांगण्याजोगा कथ्य
कदें: जाड जाडा जाडजूड लठ्ठ स्थूल
कनवाळू: दयाळू कृपाळू दरावंत दयावान दयाशील दयार्द्र कृपावंत सहृदयी दीनदयाळ
कनिश्ट: कनिष्ठ
कनिश्ठ: लहान बारका पाठचा धाकटा अनुज
कन्नड: कर्नाटकी कर्नाटक कन्नड कानडी
कपटी: कपटयुक्त कपटी कपटी कुविचारी कावेबाज कुटिल कपटी ढोंगी खोटा लुच्चा धोकेबाज कपटी चालू धूर्त पाताळयंत्री
कफल्लक: गरीब निर्धन अकिंचन द्रव्यहीन दरिद्री रंक खंक तुटपुंजा
कबलातीचें: ठरवलेला
कबाब_खावपी: कबाब_खाणारा
कबाब_विकपी: कबाबविक्या
कमजोर: अबला
कमयिल्लें: कमावलेला मिळवलेला संपादित प्राप्त
कमी: अपुरा कमी कमी थोडा थोडासा थोडका अल्प अल्पसा मोजका किंचित किंचितसा जरा जरासा थोडाथोडका अल्पस्वल्प डावा
कमी_उलोवपी: मितभाषी अबोल अल्पभाषी अल्पभाष मुखस्तंभ
कम्युनिस्ट: साम्यवादी साम्यवादी कम्युनिस्ट साम्यवादाविषयीचा साम्यवादविषयक साम्यवादाशी_संबंधित साम्यवादासंबंधीचा
कर_आशिल्लो: करपात्र
करंगळी: सर्वात_लहान कनिष्ठ
करणारो: कर्ता
करपाचें: करण्यायोग्य करण्याजोगा करण्यालायक
करपी: कर्ता कारक
करमुक्त: करमुक्त
करयुक्त: करपात्र
कराराचें: ठरवलेला
करी_सारकें: करण्यायोग्य करण्याजोगा करण्यालायक
करूंक_नाशिल्लें: न_केलेला
करूंकनाशिल्लें: बिगडलेला
कर्कश: कर्कश कर्णकटू कर्णकर्कश
कर्तव्याची_जाण_नाशिल्लें: कर्तव्य_ठाऊक_नसलेला कर्तव्य_न_जाणणारा
कर्तो: कर्ता कारक
कर्नाटकी: कानडी कानडा कर्नाटकी
कर्मकांडी: कर्मठ कर्मनिष्ठ
कर्मनिश्ठ: कामसू बहुकार्यक
कलंकीत: कलंकित बदनाम डागाळलेला कलंकी
कलम: कलमी
कलात्मक: कलात्मक
कलापूर्ण: कलात्मक
कलावंतीण: कलावंत
कलावती: कलावंत
कल्पनेंतलें: काल्पनिक कल्पित अवास्तविक
कल्पीत: कपोलकल्पित
कल्याणकारी: कल्याणकारी हितकारक फायदेशीर लाभदायक हितकर श्रेयस्कर इष्ट उपकारक
कळवळप: दयार्द्र सदय दयाळू
कळाव: उशीराचा
कळाव_जाल्लें: null
कवच_घाल्लें: चिलखतधारी बखतर्‍या
कवचधारी: चिलखतधारी बखतर्‍या
कवचाळ: कठीण कवचधारी
कशाय_कशें: null
कशे_तरेचें: कसा
कशें: कसा
कश्टकरी: मेहनती परिश्रमी कष्टाळू कामसू श्रमी खपती
कश्टदिणें: कष्टदायक
कश्टाची: दुःखद दुःखदायक दुःखकारक कटू खेदजनक दुःखमय
कश्टी: कष्टी दुःखी
कसरती: कमावलेला
कसलें: कसा
कस्तुरी_कोराचें: कस्तूरीच्या_रंगाचा
कस्तुरीत: कस्तूरी_मिसळलेला
कांटयारें: काटेरी
कांटे_नाशिल्लें: निष्कंटक
कांटेहीण: निष्कंटक
कांट्याबगरचें: निष्कंटक
कांठा_वयलें: तटस्थ तटस्छ तटस्त
कांठाचें: कडा_असलेला काठ_असलेला
कांतिमान: तेजस्वी तेजःपुंज तेजोमय सतेज उज्ज्वल उजळ तेजस प्रकाशमान दीप्तिमान देदीप्यमान कांतिमान शोभायमान उज्ज्वलित प्रकाशमय पाणीदार तेजवान तेजवंत
कांतीमय: तेजस्वी ओजस्वी तेजःपुंज
कांय: अनेक पुष्कळ नाना कैक कित्येक कितीतरी बरेच विविध कमी थोडा थोडासा थोडका अल्प अल्पसा मोजका किंचित किंचितसा जरा जरासा थोडाथोडका अल्पस्वल्प लहान_भागाविषयीचा लहान_भागविषयक लहान_भागासंबंधीचा लहान_भागाशी_संबंधित लहान_अंशाविषयीचा लहान_अंशाविषयक लहान_अंशासंबंधीचा लहान_अंशाशी_संबंधित छोट्या_भागाविषयीचा छोट्या_भागविषयक छोट्या_भागासंबंधीचा छोट्या_भागाशी_संबंधित छोट्या_अंशाविषयीचा छोट्या_अंशाविषयक छोट्या_अंशासंबंधीचा छोट्या_अंशाशी_संबंधित लघु_भागाविषयीचा लघु_भागविषयक लघु_भागासंबंधीचा लघु_भागाशी_संबंधित लघु_अंशाविषयीचा लघु_अंशाविषयक लघु_अंशासंबंधीचा लघु_अंशाशी_संबंधित लघुभागाविषयीचा लघुभागविषयक लघुभागासंबंधीचा लघुभागाशी_संबंधित लघ्वांशाविषयीचा लघ्वांशविषयक लघ्वांशासंबंधीचा लघ्वांशाशी_संबंधित काही थोडा
कांयच: विरळा
काकुटी: सहानुभूती_बाळगणारा
कागदी: कागदावर_लिहिलेला कागदी कागदाचा कागदी
कागाळ: तक्रार तकरार
कागाळकार: तक्रारखोर तक्रार्‍या तक्रारी
काचाबूल: गोंधळलेला घाबरलेला
काजराचें: वैवाहिक
काजळ_घातिल्ले: काजळभरला काजळयुक्त काजळाचा
काजळाचे: काजळभरला काजळयुक्त काजळाचा
काजारी: विवाहित परिणित
काटू: कंजूस कंजूष कृपण कद्रू चिक्कू कवडीचुंबक चिकट
काटूक: कंजूस कंजूष कृपण कद्रू चिक्कू कवडीचुंबक चिकट
काठियावाडी: काठियावाडी
काडपी: निवारक
काडिल्लें: पदच्युत बडतर्फ
काणो: काणा एकाक्ष
कातरिल्लें: कापलेला
कातीचो: त्वचा चर्म
कात्र्यांचें: पेच_असलेला
कादंबरीक: कादंबरीत_वर्णन_करण्यायोग्य
कादयेचे: तुरुंगाचा
कान_फोडपी: कर्कश कर्णकटू कर्णकर्कश
कानडी: कानडी कानडा कर्नाटकी कर्नाटक कन्नड कानडी
कापरा_कोराचें: कापराच्या_रंगाचा
कापराचें: कापराचा कापराच्या_वासासारखा
कापरें: संकोचणारा
कापिल्लें: कापलेला
कापूंक_नाशिल्लें: न_कापलेला न_कपलेला
काबार: समाप्त खलास उध्वस्त पडकी उधळलेला अस्ताव्यस्त
काबीज: लाटलेला हडपलेला बळकावलेला पचवलेला
काबुली: काबुली काबुली काबुली
काम_करपी: कामचलाऊ जुजबी
कामचोर: कामचुकार चुकारतट्टु कामचोर कामचुकारू कामचुकवू कामचुकव्या चुकार
कामनेचें: सकाम साभिलाष इच्छित अभिलाषित अभीष्ट अभीप्सित वांछित आकांशित इच्छिलेला ईप्सित
कामसू: निरलस अनलस
कामहीण: कामहीन वासनाहीन निष्काम कामरहित
कामाचें: कामचलाऊ जुजबी
कायदेशीर: न्यायपूर्ण न्यायसंगत न्यायोचित
कायद्याचें: वैध कायदेशीर कायदेविषयक
कायम: पक्की कायमची
कायरोचें: अदाह्य अदहनीय
कारक: कारक
कारण_नासतना: विनाकारण अकारण निष्कारण उगा व्यर्थ
कारणा_बगर: विनाकारण अकारण निष्कारण उगा व्यर्थ
कारबारी: कामसू व्यवहार्य व्यावहारिक शक्य
कारस्थानी: कुटिल कपटी ढोंगी खोटा लुच्चा
कार्यकारी: बदली
कार्यरत: कार्यान्वित सक्रिय क्रियाशील
कार्यालयीन: कार्यालयीन कार्यालयीन
कालजयी: अमर मृत्यूरहित चिरंजीव
काल्पनीक: काल्पनिक कल्पित अवास्तविक कपोलकल्पित
काळ_सोंपिल्लें: मुदत_उलटलेला
काळखी: अंधारा
काळजांतल्यान: हार्दिक मनापासूनचा
काळजाक_लागपी: भावपूर्ण भावनापूर्ण मर्मस्पर्शी हृदयस्पर्शी
काळजाथावन: हार्दिक मनापासूनचा
काळजेचें: चिंताजनक
काळींगकार: धनाढ्य धनवान श्रीमंत समृद्ध सधन धनवंत धनिक तालेवार
काळीज_चिरपी: हृदयविदारक हृदयद्रावक
काळीज_पिंजपी: विदारक
काळें: काळा कृष्ण
काळें_कुळकुळीत: काळाकुळकुळीत काळाजर्द काळाशार काळाकिट्ट काळाकुट्ट काळाकभिन्न काळाढोंण काळाढुस्स काळाठिक्कर काळाजहर काळाभोर
काळो: काळा अश्वेत
काव्यात्मक: काव्यात्मक
काशीचें: बनारसी
काश्मिरी: काश्मीरी काश्मीरी कश्मीरी काश्मीरी
कासादोर: शिकारी शिकारी
कास्तिसांवाचें: गहन दुर्ज्ञेय
किंकोत: उपेक्षणीय उपेक्ष्य
किक्के: किती केवढा
किजिली: भांडखोर भांडकुदळ कजाग भांडकुदळ दंगेखोर
किटभक्षी: कीटकभक्षक
किडकिडीत: हाडकुळा अशक्त वाळलेला रोडावलेला क्षीण रोड बारीक शिडशिडीत सडसडीत रोड लुकडा काटकुळा हडकुळा फाटका वाळकुडा वाळलेला किरकोळ हडकुळा हडक्या हडकलेला काडीपैलवान कृश हडकुळा रोड बारीक किडकिडीत लुकडा वाळलेला
किडकिडें: तकलादू कमजोर नाजूक कच्चा तकलादू
किडेल्लें: किडलेला
किण्ण: नीरव निःशब्द
कितले: किती केवढा
कितल्योश्योच: अनेक पुष्कळ नाना कैक कित्येक कितीतरी बरेच विविध
किमती: किंमती महागडा महाग मौल्यवान
किरंगळी: सर्वात_लहान कनिष्ठ
किरकिरो: चिडचिडा चिडखोर चिडका
किरकोळ: फुटकळ किरकोळ फुटकर सटरफटर बारीकसारीक लहानसहान किरकोळ फुटकळ लहान-सहान
किसमिसाचें: बेदाण्याची किसमिशीची खिसमिशीची बेदान्याची किसमिशी खिसमिशी बेदाण्याची किसमिशीची खिसमिशीची बेदान्याची किसमिशी खिसमिशी
किसमीश_कोराचें: किशमिशी खिसमिशी
कुकुलें: लहान चिमुकला छोटा चिमणा छोटा
कुचकामी: उपायरहित निरुपाय
कुचकुचीत: घनदाट दाट सघन घनघोर गच्च गर्द घोर निबिड गुडूप
कुटील: कुटिल कपटी ढोंगी खोटा लुच्चा अनाकलनीय दुराकलनीय
कुटुंबहीण: सडा सडाफटिंग सडाधस सडेधोस कुटुंबहीन कुटुंब_नसलेला
कुटुंबीक: घरगुती घरचा कौटुंबिक कुटुंबाचा कुटुंबाविषयीचा कुटुंबविषयक कुटुंबासंबंधीचा कुटुंबाशी_संबंधित पैतृक कुटुंबवत्सल
कुडके_जाल्लें: नष्ट नेस्तानाबूद जमिनदोस्त उद्ध्वस्त नामशेष बरबाद
कुडीचें: शारीरिक
कुडीचो: देहधारी
कुड्डो: आंधळा अंध नेत्रहीन दृष्टिहीन अंधळा
कुड्डो_विस्वासू: अंधश्रद्ध अंधविश्वासू
कुतर्की: तर्कटी तर्कट
कुतां_काडपी: छिद्रान्वेषी
कुपथ्य: कुपथ्य अहितकर स्वास्थ्यनाशक अस्वास्थ्यकारक
कुपां_नाशिल्लें: निरभ्र स्वच्छ अभ्ररहित मेघहीन मेघरहित निर्मेघ
कुपां_बगरचें: निरभ्र स्वच्छ अभ्ररहित मेघहीन मेघरहित निर्मेघ
कुपां_विरयत: निरभ्र स्वच्छ अभ्ररहित मेघहीन मेघरहित निर्मेघ
कुपांवीण: निरभ्र स्वच्छ अभ्ररहित मेघहीन मेघरहित निर्मेघ
कुपात्र: अपात्र नालायक
कुपाळ: अभ्राच्छादित मेघाच्छादित ढगाळ
कुपोशीत: कुपोषित
कुप्रसिद्द: कुख्यात बदनाम कुप्रसिद्ध
कुमारिका: कुमारी अनाघ्रात
कुमारी: कुमारी अनाघ्रात
कुरकुरीत: खुसखुशीत कुरकुरीत खस्ता
कुरूप: कुरूप
कुळपरंपरा: घराण्याचा खानदानाचा कुलाचा कुळाचा घराण्याविषयीचा खानदानाविषयीचा कुलाविषयीचा कुळाविषयीचा घराणेविषयक खानदानविषयक कुलविषयक कुळविषयक घराण्यासंबंधीचा खानदानासंबंधीचा कुलासंबंधीचा कुळासंबंधीचा घराण्याशी_संबंधित खानदानाशी_संबंधित कुलाशी_संबंधित कुळाशी_संबंधित
कुळवंत: कुलीन कुलवान कुलवंत
कुळाची_परंपरा: घराण्याचा खानदानाचा कुलाचा कुळाचा घराण्याविषयीचा खानदानाविषयीचा कुलाविषयीचा कुळाविषयीचा घराणेविषयक खानदानविषयक कुलविषयक कुळविषयक घराण्यासंबंधीचा खानदानासंबंधीचा कुलासंबंधीचा कुळासंबंधीचा घराण्याशी_संबंधित खानदानाशी_संबंधित कुलाशी_संबंधित कुळाशी_संबंधित
कुळीन: कुलीन कुलवान कुलवंत
कुविख्यात: कुख्यात बदनाम कुप्रसिद्ध
कुशळ: प्रवीण निपुण हुशार कुशल जाणता पारंगत जाणकार निष्णात तज्ज्ञ तरबेज वाकबगार हातखंडा पटाईत तज्ञ फरडा विशारद कसबी योग्य लायक समर्थ सक्षम पात्र काबील
कुशिल्लें: किडलेला सडका नासका कुजका
कुशीक: च्युत
कुशीक_काडिल्लें: अपसृत अपसारित बाजूला_काढलेला
कुशीक_केल्लें: अपसृत अपसारित
कुशीकचें: जवळचा नजीकचा निकटवर्ती
कुसकें: सडका नासका कुजका
कुसयिल्लें: किण्वित
कूट: कूट
कूडहीण: विदेह देहरहित अशरीर
कूपाळू: दयाळू कृपाळू दरावंत दयावान दयाशील दयार्द्र कृपावंत सहृदयी
कूळहीण: कुलहीन हीनकुळी कमजात कमअस्सल कुलहीन
कृतघ्न: कृतघ्न निमकहराम बेईमान हरामखोर
कृतज्ञ: कृतज्ञ आभारी ऋणी
कृतार्थ: कृतार्थ कृतकृत्य
कृत्रीम: दिखाऊ कृत्रिम नाटकी
कॅथोलीक: कॅथलिक
केंद्रीत: केंद्रित
केंद्रीय: केंद्रीय
केर्रेक: लहरी छांदीष्ट झक्की
केल्लें: केलेला
केशरी: केशरी
केसरी: भगवा शेंदरी कुसुंबी
केस्तांवी: दंगेखोर
केस्ताळ: भांडकुदळ
कैदी: तुरूंगात_ठेवलेला
कोंकणी: कोंकणी कोकणी कोकणी कोकणी
कोंगरे: कुरळा
कोंडिल्लें: रोखलेला कुंठित
कोंबरेल्लें: अंकुरित पल्लवित
कोट्याधीश: कोट्याधीश करोडपती
कोडू: कडू कडवा कडवट कटू
कोडू_काजरो: कडूजहर कडूविख्ख कडूविख कडूजहर कडूविख्ख कडूविख
कोडू_वीख: कडूजहर कडूविख्ख कडूविख
कोनश्यांचें: 
कोनी: 
कोनीय: 
कोप्रकार: देणेकरी देणेदार धनको ऋणदाता
कोमल: मऊ मृदू कोमल नरम मुलायम मृदुल अरूवार
कोमलांगिनी: कोमलांगी
कोमेल्ले: अंकुरित अंकुर_आलेला मोड_आलेला
कोरियन: कोरियन कोरियाई कोरियाई कोरियन
कोरियी: कोरियन कोरियाई कोरियाई कोरियन
कोरी: कोरा
कोरें: कोरा
कोलंबियी: कोलंबियायी कोलंबियाई
कोल्हापुरी: कोल्हापुरी
कोसळिल्लें: पडका
क्रमान: क्रमवार
क्रियाशीळ: सक्रिय क्रियाशील
क्रिस्ती: कॅथलिक
क्रुर: निर्दय निर्दयी कठोर क्रूर निष्ठुर निर्गृण हृदयशून्य पाषाणहृदयी
क्रूर: अत्याचारी जुलमी अनाचारी अन्यायी
क्रोएशियन: क्रोएशियाई क्रोएशियन क्रोएशियाई क्रोएशियन
क्षणजिवी: नश्वर अशाश्वत अनित्य नाशवंत क्षर
क्षणभंगूर: नश्वर अशाश्वत अनित्य नाशवंत क्षर
क्षणीक: अल्पकालीन
क्षमा: क्षम्य
क्षमायोग्य: क्षम्य
क्षमावान: क्षमावंत क्षमावान क्षमाशील
क्षमाशीळ: क्षमावंत क्षमावान क्षमाशील
क्षम्य: क्षम्य
क्षय_रोगी: क्षयरोगी
क्षीण: हडकुळा हडक्या हडकलेला काडीपैलवान कृश हडकुळा रोड बारीक किडकिडीत लुकडा वाळलेला
क्षुद्र: कुलहीन हीनकुळी कमजात कमअस्सल
क्षुद्र_कुळाचें: खालच्या_वर्गाचा
क्षेत्रीय: प्रादेशिक राज्यस्तरीय
क्षेपक: क्षेपक क्षेप्ता
क्षेपणक: क्षेपक क्षेप्ता
क्षेम: मंगल शुभ
खंडक: खंडन_करणारा
खंडणीय: तुटण्याजोगा
खंडाचें: द्वीपकल्पीय द्वीपकल्पाची
खंडी: महाद्वीपीय
खंडीत: रद्द नामंजूर खंडित भग्न तुटलेला भंगलेला मोडलेला
खंडीय: द्वीपकल्पीय द्वीपकल्पाची
खंतदिणी: दुःखद दुःखदायक दुःखकारक कटू खेदजनक
खंती: निराश हताश खिन्न उदास
खंतीची: दुःखद दुःखदायक दुःखकारक कटू खेदजनक दुःखमय
खंबीर: अविचल दृढ अढळ ठाम न_नमलेला
खगोली: खगोलीय
खटखटीत: कडक टणक कठीण निबर करकरीत
खटारी: खटारा
खडतर: बिकट कठीण खडतर दुर्गम गहन
खडबडीत: उंचसखल खाबडखुबड खरबरीत खडबडीत खरखरीत चरबट
खड्डो: टकला टक्कलमाथ्या खल्वाट हजामत_केलेला
खणखणीत: किंकरा
खणपी: खोदणारा खोदक खणणारा खणक उत्खाता उत्खनक
खतखतीत: गरमगरम कढत ऊनऊन गरमागरम कडकडीत तापलेला तप्त
खतेवल्लें: डागील डागेल डागलेला
खनीज: खनिज
खबर_आशिल्लें: ज्ञात माहित ठाऊक विदित विज्ञात अवगत जाणलेला
खबर_नाशिल्लें: अज्ञात
खबरेपत्र: दैनिक
खर: अदम्य दुर्दम्य कुशाग्र तल्लख प्रखर दारुण घोर भयंकर दुःसह मजबूत भक्कम पक्का दणकट कर्कश कर्णकटू कर्णकर्कश दमदार जोरदार जोमदार आवेशपूर्ण आवेशयुक्त भावनाप्रधान अवसानयुक्त तीव्र गंभीर बेमुरवत बेमुरवती बेमुर्वत बेमुर्वती किंकरा
खर_बुद्दीचें: कुशाग्रमती कुशाग्रबुद्धी
खरकटें: उष्टा उपभुक्त
खरखरीत: कोरडा
खरसाणीचे: प्रबळ प्रबल
खरी: खरे शुद्ध अस्सल वास्तविक वास्तव वास्तवातील वास्तवातला यथार्थ खरा खराखुरा खरोखरीचा
खरें: सत्य खरा यथार्थ वास्तव शुद्ध सच्चा खराखुरा असली स्वच्छ खरा चोख अम्लान सचोटीचा
खरो: प्रामाणिक इमानदार चोख सालस साळसूद निःकपट
खर्चीक: अपव्ययी उधळ्या उधळखोर खर्चीक खर्चक खर्चाळू उडाऊ उधळमांडक्या
खर्व: null
खळबळीत: सनसनाटीखोर
खळान_भरिल्लें: पिष्ठसत्त्वयुक्त
खांपें: प्रवीण निपुण हुशार कुशल जाणता पारंगत जाणकार निष्णात तज्ज्ञ तरबेज वाकबगार हातखंडा पटाईत तज्ञ फरडा विशारद कसबी
खाकी: खाकी
खाजगी: खाजगी खासगी व्यक्तिगत वैयक्तिक स्वीय खाजगी खासगी व्यक्तिगत वैयक्तिक
खाजराचें: खजूराचा खजुरासारखा
खाणा_बगरचें: विनाआहारी शून्याहारी
खादाड: खादाड अधाशी
खाद्य: खाद्य भोज्य भक्ष्य ग्राह्य खाण्याजोगा
खानदानी: पैतृक
खापो: दिग्गज
खायलें: क्षुल्लक कःपदार्थ नगण्य क्षुद्र तुच्छ पामर मामुली अधीन आधीन स्वाधीन अधीन_असलेला ताब्यात_असलेला वश_असलेला वश अवलंबून_असलेला ठेंगणा कमी_उंचीचा खालचा
खायलो: निंच लहान
खायल्या_कुळाचें: कुलहीन हीनकुळी कमजात कमअस्सल खालच्या_वर्गाचा
खारट: खारट खारे क्षारसंबंधित
खारें: खारट खारे
खालचें: खालचा निम्न
खालते_मानेचें: अधोमुख अधोवदन अधोमुखी
खाला_दिल्लें: खालील
खाली: रिकामा रिक्त रिता मोकळा रिकामा वापरात_नसलेला
खाल्लें: लाटलेला
खावंक_नाशिल्लें: न_खाललेला
खावगें: खादाड अधाशी
खावपाचें: खाद्य भोज्य भक्ष्य ग्राह्य खाण्याजोगा
खाशेलें: विशिष्ट विवक्षित विशिष्ट
खाश्या: सख्खा
खाश्श्या: स्वकीय आपला
खास: विशिष्ट विवक्षित असामान्य खास विशेष असाधारण विशेष खास
खिणयाळें: अल्पकालीन
खिसेकापो: null
खीणयाळें: नश्वर अशाश्वत अनित्य नाशवंत क्षर
खुटें: फिका फिक्का फिक्कट
खुनी: खुनी
खुळो: वेडा येडा पिसा वेडापिसा पागल
खूब: अनेक पुष्कळ नाना कैक कित्येक कितीतरी बरेच विविध जास्त अधिक जास्ती भरपूर खूप भरलेला
खूब_कोडू: कडूजहर कडूविख्ख कडूविख
खूब_चड: फार खूप आतोनात अतोनात पुष्कळ प्रचंड अपरिमित अतिशय गडगंज चिक्कार चिकार भरमसाट मुबलक विपुल मोप रगड रग्गड सज्जड भारी बखळ बहुत भरपूर भरमसाठ भलता भाराभर आत्यंतिक
खूब_पिकिल्लें: अविकलेला अतिपक्व
खेंचर: खेचर नभोगामी
खेदहीण: शोकरहित शोकहीन विषादरहित शोकग्रस्त शोकाक्रांत दुःखरहित
खेरीज: वेगळा निराळा भिन्न पृथक् अलग आगळा न्यारा विभिन्न वेगवेगळा
खेळीमेळीचें: मनमिळाऊ
खोजो: नपुंसक षंढ
खोटे: खोटा नकली
खोटें: खोटारडा खोटा खोटारडा असत्य चुकीचा निराधार पोकळ तथ्यहीन
खोटो: कपटी कुविचारी कावेबाज
खोडपी: खंडन_करणारा
खोडून_काडपी: खंडन_करणारा
खोल: गहन खोल खोल
खोशये_बगरचें: असमाधानकारक
खोशी: प्रसन्न आनंदित आनंदी आल्हादित प्रफुल्लित मुदित प्रमुदित खुश प्रसन्नचित्त आनंदी खुशमिजाज मनोरंजित
खोस_दिना_अशें: असमाधानकारक
खोस_दिवपी: संतोषजनक
खोसदिणें: आनंददायक आनंददायी सुखद सुखकारक सुखदायी सुखदायक सुखप्रद आल्हादकारक आल्हादक तोषक रंजक रमणीय मोहक मनमोहक चित्ताकर्षक आकर्षक संतोषजनक
खोसयाळें: आनंदमय उल्हासपूर्ण आनंदपूर्ण उल्हासमय सानंद सोल्हास
ख्यास्तपात्र: null दंडनीय
ख्यास्ती_बगरचें: अदंडित
ख्यास्ती_विणें: अदंडित
गंदाचें: चंदनाच्या_रंगाचा
गंदीत: सुवासित सुगंधित सुगंधिक
गंवां_कोराचें: गव्हाळ गव्हाळा
गंवाळ: गव्हाळ गव्हाळा
गच्च: घनदाट दाट सघन घनघोर गच्च गर्द घोर निबिड गुडूप
गच्च_वाडिल्लें: झुडपासम झाडीसारखा झाडीसम झाडोर्‍यासम झाडौलीसारखा
गजबजिल्लें: गोंधळाचा गतिमान गतिशील धावपळीचा ?
गटखळ: दुष्कर कठीण अवघड
गडखळ: दुष्कर कठीण अवघड
गडगडपी: भरभराट_झालेला भरभराटीस_आलेला वाढता
गडद: भडक गडद गहिरा गर्द
गडबडें: उतावळा उतावीळ अधीर घायकुत्या
गडबडो: चंचल अस्थिर अचपळ चंचळ
गणतंत्री: लोकशाही प्रजासत्ताक
गणनीय: गणनीय परिमेय
गण्य: गणनीय परिमेय
गतिशील: वेगवान
गतिहीण: अचल निश्चल स्थिर अढळ दृढ अविचल
गतीचें: गतिशील गतिमान
गतीशील: गतिशील गतिमान
गतीहीण: थांबलेला
गदगदीत: गदगदलेला
गद्यात्मक: गद्यात्मक
गप: निःशब्द शांत
गरगरीत_वाडिल्लें: झुडपासम झाडीसारखा झाडीसम झाडोर्‍यासम झाडौलीसारखा
गरजू: गरजू गरजवंत गरजू गरजवंत
गरजे_भायर: अनावश्यक
गरजेचें: आवश्यक जरुरीचा गरजेचा अनिवार्य अपरिहार्य
गरजेवंत: गरजू गरजवंत गरजू गरजवंत
गरम: उष्ण गरम उष्म तप्त तापलेले ऊन लोकरी गरम उबदार गरम गरम तापलेला तप्त
गरमागरम: गरमगरम कढत ऊनऊन गरमागरम कडकडीत
गरीब: गरीब निर्धन अकिंचन द्रव्यहीन दरिद्री रंक खंक तुटपुंजा
गर्भनिरोधक: गर्भनिरोधक
गर्भीत: निहित
गर्भेस्त: गरोदर गर्भार गर्भारशी गर्भवती पोटुशी गाभण
गर्वहीण: निरहंकारी निरभिमानी नम्र विनयी विनयशील निगर्वी
गर्विश्ट: अभिमानी अहंकारी घमेंडी घमेंडखोर मग्रूर गर्विष्ठ अहंमन्य ताठर उन्मत्त अभिमानी अहंकारी घमेंडी घमेंडखोर मग्रूर गर्विष्ठ अहंमन्य ताठर उन्मत्त दर्पी अविनयशील अनम्र
गवाय: प्रत्यक्षदर्शी
गांजपी: गुणगुणारा
गांजा_पियेवपी: गांजेकस
गांजाचें_सेवन_करपी: गांजेकस
गांधीवादी: गांधीवादी गांधीवादी गांधीवादाबाबतचा गांधीवादाविषयीचा गांधीवादविषयक गांधीवादाशी_संबंधित गांधीवादासंबंधीचा
गांवगिरी: ग्रामीण
गांवगिरे: गावकरी
गांवटी: पाळीव
गाड: गडद गहिरा गर्द पक्की
गाढ: घट्ट दाट
गायब: अदृश्य अदृष्ट
गार्फ: कलमी
गाळाचें: विलासी विषयलोलुप विषयासक्त विषयी भोगलोलुप भोगासक्त विषयलंपट
गिड्डो: ठेंगणा ठेंगू गिड्डा बुटका खुजा वामनमूर्ती
गिन्यानी: विद्वान सुविद्य व्यासंगी ज्ञानी पंडित माहितगार जाणणारा जाणकार ज्ञाता
गिमाळ्याचो: उन्हाळ्याचा
गिरायक: घेणेकरी
गिरेस्त: धनी धनाढ्य धनवान श्रीमंत समृद्ध सधन धनवंत धनिक तालेवार
गिळिल्लें: ग्रस्त ग्रसित
गुंगेचें: बधिरक बधिरकारी
गुंथिल्ले: ओवलेला गुंफलेला
गुंथिल्लें: लागलेला कार्यरत
गुजराती: गुजराती गुजरातचा गुजरातविषयीचा गुजरातविषयक गुजरातसंबंधीचा गुजरातशी_संबंधित गुजराथी गुजराती
गुजराथी: गुजराथी गुजराती
गुठल्यांचें: गोळे_असेलेला
गुणकारक: प्रभावी प्रभावशाली परिणामकारक उपयुक्त प्रभावशाली_असलेला
गुणगुणपी: गुंजारवयुक्त
गुणग्राहक: गुणग्राहक गुणाग्राही
गुणग्राही: गुणग्राहक गुणाग्राही
गुणयुक्त: गुणवत्तायुक्त
गुणरहीत: गुणविरहित गुणहीन
गुणवंत: गुणी सद्गुणी गुणवंत गुणवान
गुणवत्तायुक्त: गुणवत्तायुक्त
गुणी: गुणी सद्गुणी गुणवंत गुणवान गुणवान गुणवंत गुणसंपन्न
गुन्यांवकार: अपराधी गुन्हेगार दोषी
गुन्यांवकारी: गुन्हेगारी गुन्हेगारीविषयक गुन्हेगारीविषयीचा गुन्हेगारीसंबंधित गुन्हेगारीसंबंधीचा गुन्हेगारी अपराधी
गुन्यांवी: गुन्हेगारीविषयक गुन्हेगारीविषयीचा गुन्हेगारीसंबंधित गुन्हेगारीसंबंधीचा
गुन्यावंकार: गुन्हेगार
गुपीत: गोपनीय गौप्य गोप्य गुप्त खाजगी खासगी अंतस्थ अंतःस्थ गूढ रहस्यमय निहित
गुप्त: गोपनीय गौप्य गोप्य गुप्त खाजगी खासगी अंतस्थ अंतःस्थ
गुबगुबीत: मांसल मांसाळ मासाळ मासल मासाळा
गुरवार: गरोदर गर्भार गर्भारशी गर्भवती पोटुशी गाभण
गुरुकूलवासी: अंतेवासी
गुरू_नाशिल्लें: निगुरा निर्‍या गुरुहीन
गुरूहीण: निगुरा निर्‍या गुरुहीन
गुलाबाचें: गुलाबी
गुलाबी: गुलाबी
गुलाम: खुशामदी खुशामती तोंडपुज्या स्तुतिपाठक खुशमस्कर्‍या
गुल्ल: तल्लीन गर्क मग्न निमग्न गुंग दंग गढलेला रममाण तन्मय तद्रूप चूर मश्गुल रत लागलेला कार्यरत व्यग्र
गुळगुळीत: गुळगुळीत
गूढ: गोपनीय गौप्य गोप्य गुप्त खाजगी खासगी अंतस्थ अंतःस्थ कूट गूढ रहस्यमय निहित
गृहोपयोगी: गृहोपयोगी
गेल्लें: जप्त पाठवलेला रवाना
गेल्लो: निघालेला
गैरहजर: गैरहजर अनुपस्थित
गोंदळिल्लो: गोंधळलेला घाबरलेला
गोठिल्लें: गोठवलेला
गोड: गोड सुरेल मंजूळ सुमधुर मधुर गोड मधुर गोड
गोड_उलोवपी: मधुरभाषी
गोडभाशी: मधुरभाषी
गोथिक: गोथिय गोथिक गॉथिक
गोथीक: गॉथी गोथी
गोबर: स्वाहा भस्म भस्मीभूत
गोबरें: काळपट_राखाडी
गोरो: गोरा गौर उजळ गोरटा
गोरो_धवो: गोरा गौर उजळ गोरटा
गोल: गोल वर्तुळाकार गोलाकार गोलाकृती वर्तुळाकृती वर्तुळ गोल वाटोळा वर्तुळाकार
गौण: गौण दुय्यम गौण 
गौरवपूर्ण: गौरवपूर्ण
गौरवशीळ: गौरवपूर्ण
ग्रंथिकी: पुस्तकी
ग्रस्त: पीडित गांजलेला दुःखित रंजलेला त्रस्त दुःखी ग्रस्त
ग्रिनलॅण्डी: ग्रीनलँडिक
ग्रीक: ग्रीसी युनानी ग्रीक ग्रीक
घट: घनिष्ठ जीवश्चकंठश्च जिवलग दाट गाढ दृढ जिवाभावाचा जिगरी अविचल दृढ अढळ ठाम निर्भय बेडर निडर धीट साहसी धाडसी बेधडक अकुतोभय भयरहित घन कडक मजबूत भक्कम पक्का दणकट सुन्न स्तब्ध निश्चल स्तंभित कडक टणक कठीण निबर करकरीत बरा ठीक
घट_काळजाचो: पाषाणहृदयी निर्दय कठोर निष्ठुर वज्रहृदयी दयाशून्य क्रूर दयाहीन निर्मोही
घटमूट: धट्टाकट्टा धष्टपुष्ट
घडयिल्लें: कपोलकल्पित रचित कृत विरचित निर्मित रचलेला
घडिल्लें: घडलेला झालेला
घडूंक_नाशिल्लें: अघटित
घणघणीत: किंकरा
घन: घन
घमेंडी: अभिमानी अहंकारी घमेंडी घमेंडखोर मग्रूर गर्विष्ठ अहंमन्य ताठर उन्मत्त अभिमानी अहंकारी घमेंडी घमेंडखोर मग्रूर गर्विष्ठ अहंमन्य ताठर उन्मत्त दर्पी अविनयशील अनम्र अक्कडबाज ऐटबाज अकडू कुर्रेबाज
घरगुती: घरगुती घरचा कौटुंबिक कुटुंबाचा कुटुंबाविषयीचा कुटुंबविषयक कुटुंबासंबंधीचा कुटुंबाशी_संबंधित पाळीव गृहोपयोगी
घरहीण: अनिकेत गृहहीन बेघर
घरावें: घरगुती घरचा कौटुंबिक कुटुंबाचा कुटुंबाविषयीचा कुटुंबविषयक कुटुंबासंबंधीचा कुटुंबाशी_संबंधित पाळीव
घसरड: निसरडा घसरडा
घसरिल्लें: स्वस्त
घाई_करपी: उतावळा उतावीळ अधीर घायकुत्या
घाडी: null
घाणयारें: घाणेरडा अस्वच्छ गलिच्छ घाण मलिन गचाळ गदळ अशुद्ध
घाणीचें: दुर्गंधयुक्त वासकट वाशेरा वासट घाणेरा वाशेळा
घातक: हिंसक हिंसात्मक
घातकी: हिंसक विश्वासघातकी बेईमान दगाबाज दगलबाज कपटी निमकहराम धोकेबाज कपटी चालू धूर्त पाताळयंत्री
घातमारें: धोकेबाज कपटी चालू धूर्त पाताळयंत्री
घातिल्लें: आरोपित
घामाचें: घाम_आणणारा
घामान_भिजिल्ली: घामाघूम घामेला
घामेल्ली: घामाघूम घामेला
घायाळ: जखमी घायाळ जायबंदी घायाळ जखमी विद्ध
घारशें: घारा?
घार्मिक: धार्मिक धर्मपरायण धर्मशील
घालप: घुळलेला
घालपा_सारकें: परिधानीय परिधेय घालण्याजोगा
घाळ: बेसावध असावध
घुमपी: गुणगुणारा
घुमें: घुमा घुम्या
घुवळी_वखदां: अफूचा आफूचा
घुवळीचें: बधिरक बधिरकारी मादक अमली
घुसपटिल्लें: अडकलेला गुंतलेला गुंतागुंतीचा फसलेला
घुसपलिल्लो: अडकलेला
घुसपल्लें: अडकलेला गुंतलेला गुंतागुंतीचा फसलेला
घुसपागोंदळ: गुंतागुंतीचा
घुस्पागोंदळाचें: गहन दुर्ज्ञेय
घुस्पूंक_नाशिल्लें: kkkk
घृणास्पद: घृणास्पद
घृणीत: घृणास्पद
घेरिल्लो: घेरलेला वेष्टित वेष्टलेला व्यापलेला
घेवपी: घेणेकरी
घोगरें: संकोचणारा
घोग्यांचो: मूसळधार
घोडदळ: घोडेस्वार
घोनें: मूर्ख बावळा बावळट अज्ञानी मूढ जड मंद निर्बुद्ध मठ्ठ बेअक्कल शंख बिनडोक अडाणी ढ ठोंब्या अर्धवट बेअक्कली भोट
घोर: गंभीर
घोळटी: प्रचलित रूढ चालू
घोळटें: बंजारा वणजारा भटका
घोळपी: द्राव्य विद्राव्य
घोळोवप: घुळलेला
घोशीत: घोषित
घोस्ताचें: आवडता आवडीचा मनपसंत पसंतीचा प्रिय
चंचळ: विचलित स्थानभ्रष्ट चळलेला चंचल अस्थिर अचपळ चंचळ चंचल अस्थिर चंचलचित्त चंचळ चलितचित्त लहरी
चंदनाचें: चंदनाचा
चंदनी: चंदनाचा चंदनाच्या_रंगाचा
चंदेरी: चांदणी
चकचकपी: चमचमणारा चमकणारा चकचकणारा चमकता चकाकता चमचमता झगमगता
चकचकीत: दीप्तिमान तेजस्वी कांतिमान स्वच्छ साफ उजळ उज्वल चमकदार
चक्रम: मूर्ख बावळा बावळट अज्ञानी मूढ जड मंद निर्बुद्ध मठ्ठ बेअक्कल शंख बिनडोक अडाणी ढ ठोंब्या अर्धवट बेअक्कली भोट लहरी छांदीष्ट झक्की वेडा येडा पिसा वेडापिसा पागल
चक्राचो: चक्रीय
चक्री: चक्रीय
चक्रीय: चक्रीय
चड: अनेक पुष्कळ नाना कैक कित्येक कितीतरी बरेच विविध जास्त अधिक जास्ती फार खूप अतोनात आतोनात पुष्कळ प्रचंड अपरिमित अतिशय गडगंज चिक्कार चिकार भरमसाट मुबलक विपुल मोप रगड रग्गड सज्जड भारी बखळ बहुत भरपूर भरमसाठ भलता भाराभर आत्यंतिक
चड_काळाचें: चिरकालिक दीर्घकालीन
चड_कोडो: कडूजहर कडूविख्ख कडूविख
चड_गरजेचें: अत्यावश्यक
चडशे: जास्तीत_जास्त अधिकाधिक
चडसो: अधिकांश
चडांत_चड: सर्वाधिक कमाल जास्तीत_जास्त अधिकाधिक
चडिल्लें: चढलेला
चतुर्भुजी: चतुर्भुज
चतूर: चपळ चटपटीत तरतरीत चतुर चलाख हुशार चाणाक्ष
चपळ: चतुर चलाख हुशार चाणाक्ष
चमचो: खुशामदी खुशामती तोंडपुज्या स्तुतिपाठक खुशमस्कर्‍या
चमत्कारी: चमत्कारी चमत्कारिक चमत्कृत अद्भुत विलक्षण अजब विस्मयजनक आश्चर्यकारक
चरम: परम चरम अंतिम अंत्य शेवटचा अखेरचा टोकाचा अंतीचा शेवटाला_पोचलेला अखेरीला_पोचलेला टोकाला_पोचलेला अंताला_पोचलेला
चराचर: चराचर स्थिरचर
चरित्रवान: सच्छील सच्चरित्र चारित्र्यसंपन्न चारित्र्यवान शीलवान शीलवंत सदाचारी
चरित्रहीण: व्यभिचारी चारित्र्यहीन चरित्रहीन
चर्चीत: चर्चित परिचर्चात्मक
चलणुकेंत_नाशिल्लो: चलनात_नसलेला अप्रचलित
चलणुकेची: प्रचलित रूढ चालू
चलपाचें: रस्त्यासारखा
चलपी: सुरू_केलेला चालू_असलेला पादचारी कामचलाऊ जुजबी पादचारी
चलयिल्लें: संचालित
चळवळें: फितुर
चवताळिल्लें: उन्मत्त मस्तवाल मत्त मस्तखोर
चवतिसावो: चौतिसावा
चवतीस: चौतीस
चवथें: चौथा चतुर्थ
चवदा: चौदावा
चवद्यांयशीं: चौर्‍याऐंशी
चवद्याण्णव: चौर्‍याण्णव
चवद्याण्णवावें: चौर्‍याण्णवावा
चवद्यात्तर: चौर्‍याहत्तर
चवपन: चौपन्न
चवपनावें: चौपन्नावा
चवसठ: चौसष्ट
चवसठावें: चौसष्टावा
चवेचाळिसावें: चवेचाळिसावा चव्वेचाळिसावा चवेताळिसावा चव्वेताळिसावा
चवेचाळीस: चव्वेचाळीस
चांदीचें: रुपेरी चांदीचा चांदीतला चांदीतील
चांद्र: चांद्र
चाटिल्लें: खाल्लेला
चाडयाळी: चुगलखोर चहाडखोर
चाडयो_करपी: चुगलखोर चहाडखोर
चान्नी: चांदणी
चामटो: कंजूस कंजूष कृपण कद्रू चिक्कू कवडीचुंबक चिकट
चामाराचें: निरुपयोगी अनावश्यक व्यर्थ बेकार फालतू रद्दी
चायनीस: चीनी चीनचा
चार: चार चौघे
चारचाकी: चौचाकी चार_चाकी
चारपट: चौपट चारपट
चारशेंवीस: लबाड फसव्या ठक लुच्चा लफंगा ठकबाज ठकसेन धूर्त अर्क भामटा
चारित्र्यवान: सच्छील सच्चरित्र चारित्र्यसंपन्न चारित्र्यवान शीलवान शीलवंत सदाचारी
चालंत: गतिशील गतिमान
चालक: वाहक
चालाक: चतुर चलाख हुशार चाणाक्ष
चालू: गतिशील गतिमान सुरू_केलेला चालू_असलेला कामुक लंपट कामी विषयी ज्वलंत
चाळिसावें: चाळिसावा
चाळीस: चाळीस
चाहतें: चाहता
चिंतनशील: मननशील चिंतनशील
चिंतनहीण: अचिंत्य अचिंतनीय
चिंतना_बगरचें: अचिंत्य अचिंतनीय
चिंतपाचें: विचारणीय विचार्य चिंतनीय चिंत्य लक्षणीय
चिंताजनक: चिंताजनक
चिंताहीण: विचार_न_करण्याजोगा
चिंतेबगरची: अविचारित
चिंतेस्त: चिंताग्रस्त चिंताक्रांत चिंतातुर सचिंत चिंतामग्न चिंतित चिंताकुल चिंतावलेला
चिकचिकीत: चिकट चिकचिकीत चिकचिकित
चिकट: चिकट चिकचिकीत चिकचिकित
चिकित्सा: चिकित्सेविषयक
चिकू_मारवाडी: कंजूस कंजूष कृपण कद्रू चिक्कू कवडीचुंबक चिकट
चिकें: कमी थोडा थोडासा थोडका अल्प अल्पसा मोजका किंचित किंचितसा जरा जरासा थोडाथोडका अल्पस्वल्प
चिखलामेकळें: बिनचिखलाचा
चिडचिडो: चिडचिडा चिडखोर चिडका
चिडिल्लें: पायदळी_आलेला
चिड्डयिल्लें: दमित
चितारिल्लें: चित्रित चित्रातील चित्रातला
चित्रमय: null
चित्रांकीत: चित्रांकित
चित्रायिल्लें: चित्रांकित चित्रित चित्रातील चित्रातला
चित्रीत: चित्रांकित अंकित वर्णिलेला वर्णित चित्रित प्रशंसिलेला चित्रित चित्रातील चित्रातला नक्षीदार
चिनी: चीनी चीनचा चीनी
चिन्हीत: अंकित
चिप्प_भिजील्लेंप: माखलेला भिजलेला
चिरंजिवी: चिरतरुण अजर
चिरंजीव: अमर मृत्यूरहित चिरंजीव दीर्घायु चिरंजीव चिरायु औक्षवंत औक्षवान आयुष्यमान दीर्घजीवी चिरंजीवी
चिरिल्लें: कापलेला
चिलखता_वीण: कवचहीन
चीनी: चीनी
चुंबकाचें: चुंबकीय कर्षुकीय
चुंबकी: चुंबकीय कर्षुकीय
चुकिल्लें: बिगडलेला
चुकीची: अनुचित अयोग्य गैर चुकीचा अशोभनीय अशिष्ट अप्रशस्त
चुकीचें: अशुद्ध चूक
चुट्टे_कोराचें: हिरवट हिरवा
चुरगळिल्ल्या: संकुचित आकुंचित
चुलत: चुलत
चेंचिल्लें: पायदळी_आलेला
चेंचिल्लो: null
चेंपिल्लें: पायदळी_आलेला
चेक: चेक चेकोस्लोवाकियाई
चेडी: व्यभिचारी
चेतन: जिवंत जीवित सजीव सचेतन जैव जिता
चेतनायुक्त: चेतन सचेतन
चैत्री: चैत्री
चोंचरें: तोतरा बोबडा तोतरा
चोंपिल्लें: हत
चोपनावें: चौपन्नावा
चोरपाचें: अपहार्य हिरावून_घेण्याजोगा
चोरिल्लें: चोरण्याजोगा लुटण्याजोगा लुटलेला अपह्रत चोरलेला अपह्रत बळकावलेला हिसकावलेला
चोवपन: चौपन्न
चोविसावें: चोविसावा
चोवीस: चोवीस
चौकस: पृच्छित
चौकोनी: चौकोनी चौकोणी
चौदा: चौदा
चौपट: चौपट चारपट
छंदबद्द: सयमक
छंदबद्ध: बद्ध
छंदी: व्यसनी चंगीभंगी छंदीफंदी
छत्तिसावें: छत्तिसावा
छत्रपती: छत्रपती छत्रधारी
छाप्पन: छप्पन्न
जंगम: चल जंगम चल चर
जंगली: वन्य जंगली रानटी जंगली वन्यतापूर्ण रानटी
जखमी: जखमी घायाळ जायबंदी घायाळ जखमी विद्ध
जखमे_विरयतचें: जखमी_न_झालेला
जगजयी: जगज्जेता विश्वविजयी
जगजाहीर: जगजाहीर सर्वश्रुत
जटाधारी: जटाधारी
जड: जड वजनदार भारी अवजड बोजड महत्त्वाचा मोठा वजनी
जडयिल्लें: null
जप_करपी: न_पाळलेला
जप_करिनासपी: जप_न_करणारा
जपानाचो: जपानी
जपानी: जपानी जपानी जपानी
जपूंक_जायनाशिल्लें: अजाप न_जपता_येणारा न_जपता_येण्याजोगा
जप्त: जप्त
जप्त_केल्लें: जप्त सरकारजमा
जप्पी: न_पाळलेला
जमनींतलें: भूमिगत
जमातीचें: जातीजमातीचा जमातीचा
जयी: यशस्वी सफल सफळ
जरतारी: जरतारी
जर्जर: मरणासन्न मरणाधीन
जर्मन: जर्मन जर्मन
जलचर: जलचर
जलस्थलचर: उभयचर
जलहीण: कोरडा शुष्क रखरखीत रूक्ष
जल्म_घेतिल्लें: जन्मलेला
जल्म_घेवंकना_असो: अजन्मा
जल्मजात: जन्मसिद्ध
जल्मल्लें: जन्मलेला
जल्मसिद्ध: जन्मसिद्ध जन्मजात
जल्मा_सावन: जन्मसिद्ध
जल्मांध: जन्मांध
जल्माक_आयिल्लें: जन्मलेला
जल्मीत: जन्मलेला
जल्मूक_नाशिल्लो: अजन्मा
जांबळें: जांभळा वांगी
जागरूक: जागा जागृत जागता जागरूक
जागृत: जागा जागृत जागता
जागे: जागरूक
जागें: जागा जागृत जागता
जाणकार: अनुभवी अभिज्ञ जाणता विद्वान सुविद्य व्यासंगी ज्ञानी पंडित सर्वज्ञ सर्ववेत्ता माहितगार जाणणारा जाणकार ज्ञाता
जाणटी: वृद्ध
जाणटें: वृद्ध म्हातारा वयस्कर वयोवृद्ध बुडगा
जाणपी: ज्ञेय
जाणा_आशिल्लें: ज्ञात माहित ठाऊक विदित विज्ञात अवगत जाणलेला
जाणा_जाल्लें: माहितगार जाणणारा जाणकार ज्ञाता
जाणाजाल्लें: ज्ञात माहित ठाऊक विदित विज्ञात अवगत जाणलेला
जातहीण: अजाती जातिरहित
जातिभायरें: जाति_बहिष्कृत जातिभ्रष्ट जातिबाह्य
जाती_बगरचो: अजाती जातिरहित
जाती_भितरलें: सजातीय
जाती_विशींचें: जातीय
जातीचें: जातीय
जातीवाचक: सामान्य
जापसालदार: जबाबदार उत्तरदायी
जाफरानी: केशरी
जाफराबादी: जाफराबादी
जाबाबदार: जबाबदार उत्तरदायी
जाम: अक्षम
जाम_जाल्लें: क्लांत दमलेला थकलेला भागलेला शिणलेला श्रमविकल
जायत_सावन: जन्मसिद्ध
जायत्यो: अनेक पुष्कळ नाना कैक कित्येक कितीतरी बरेच विविध
जाल्लें: केलेला घडलेला झालेला
जाळयेचें: जाळीदार सच्छिद्र जाळीवाला
जाळीदार: जाळीदार सच्छिद्र जाळीवाला
जावन_गेल्लें: घडलेला झालेला
जावायी: जावानीज जावानीज
जाहीर: प्रकट खुला अभिव्यक्त व्यक्त_केलेला प्रकट_केलेला जाहीर_केलेला उघड_केलेला अनावृत_केलेला
जिक्के: जेवढा जेव्हढा जितका जितपत
जिखिल्लें: जिंकण्याजोगा जेय जिंकलेला जित
जिखिल्लो: विजयी विजेता जेता
जिज्ञासु: जिज्ञासू चौकस
जिज्ञासू: पृच्छित
जितके: जेवढा जेव्हढा जितका जितपत
जितले: जेवढा जेव्हढा जितका जितपत
जिती: ज्वलंत
जितेंजागतें: जीवंत चैतन्यपूर्ण
जितेंद्री: जितेंद्रिय
जितो: जिवंत जीवित सजीव सचेतन जैव जिता चेतन सचेतन
जिद्दी: हट्टी जिद्दी जितखोर
जिवंत: जिवंत जीवित सजीव सचेतन जैव जिता जीवंत चैतन्यपूर्ण
जिवघेणें: मारक घातक नाशकारक
जिवी: ज्वलंत
जिवीत: जिवंत जीवित सजीव सचेतन जैव जिता
जिवें: जीवंत चैतन्यपूर्ण
जिवो: जिवंत जीवित सजीव सचेतन जैव जिता चेतन सचेतन
जीण_वाडोवपी: भाजलेले शेकलेले परतलेले
जीर्ण: जीर्ण मोडकळीस_आलेला
जुंव्याचें: द्वीपीय
जुगारी: अनादर_करणारा
जुनी: खटारा
जुनें: जर्जर जीर्ण झिरझिरीत
जुल्मी: अत्याचारी जुलमी अनाचारी अन्यायी
जुळें: जुळा जुवळ जावळा
जुवळीं: जुळा
जुवळें: जुळा जुवळ जावळा
जुवान: तरुण तरणा जवान
जेझू_विशीं: ईसाविषयक ईसाई मसीही
जेवणा_बगरचें: विनाआहारी शून्याहारी
जेवपाचें: खाद्य भोज्य भक्ष्य ग्राह्य खाण्याजोगा
जेश्ठ: अग्रज ज्येष्ठ वडील मोठा थोरला
जैतवंत: जिंकण्याजोगा जेय यशस्वी सफल सफळ
जैतीवंत: विजयी विजेता जेता
जैनी: जैन जैनधर्मी
जैवीक: जैविक
जॉर्जियायी: जार्जियन जॉर्जियन
जोखप: भेद्य
जोडिल्लें: संलग्न करपात्र आदेय पाठभेदीय पाठभेदाविषयीचा पाठभेदविषयक पाठभेदाशी_संबंधित पाठभेदासंबंधीचा कमावलेला मिळवलेला संपादित प्राप्त
जोडूंक_नाशिल्लें: सुटा
ज्ञानहीण: मूर्ख बावळा बावळट अज्ञानी मूढ जड मंद निर्बुद्ध मठ्ठ बेअक्कल शंख बिनडोक अडाणी ढ ठोंब्या अर्धवट बेअक्कली भोट
ज्ञेय: ज्ञेय
ज्वलंत: ज्वलंत
झगझगीत: दीप्तिमान तेजस्वी कांतिमान भडकदार चमकदार
झगडपी: भांडखोर भांडकुदळ कजाग
झगडाळ: भांडखोर भांडकुदळ कजाग भांडकुदळ
झगडाळू: दंगेखोर
झगडूल: भांडखोर भांडकुदळ कजाग
झगड्याचें: विवादास्पद
झणझणीत: खरमरीत झणझणीत सडेतोड
झरनासपी: न_पडणारा
झरयिल्लें: रटाळ
झांकपी: तोंडबडव्या तोंडफटाल्या
झिपरे: झिपरा झाबरा
झिरझिरिल्ली: जर्जर जीर्ण झिरझिरीत
झिरमिरीत: पातळ तलम
झिळींचें: झुडपासम झाडीसारखा झाडीसम झाडोर्‍यासम झाडौलीसारखा
झुजाचें: null
झुजारी: योद्धा वीर लढवय्या झुंजार
झेंपें: मूर्ख बावळा बावळट अज्ञानी मूढ जड मंद निर्बुद्ध मठ्ठ बेअक्कल शंख बिनडोक अडाणी ढ ठोंब्या अर्धवट बेअक्कली भोट
झेताचो: अक्कडबाज ऐटबाज अकडू कुर्रेबाज
झेमें: मूर्ख बावळा बावळट अज्ञानी मूढ जड मंद निर्बुद्ध मठ्ठ बेअक्कल शंख बिनडोक अडाणी ढ ठोंब्या अर्धवट बेअक्कली भोट
झेमेड्डो: मिचक्या मिचमिच्या मिचकावणारा
झेलांतलो: हिमज
झेलाचें: बर्फाळ बर्फाच्छादित
झोंपांचें: झुडपासम झाडीसारखा झाडीसम झाडोर्‍यासम झाडौलीसारखा
झोडिल्लें: हत
टकटक: अनिमिष अनिमेष
टकलू: हजामत_केलेला
टकलो: टकला टक्कलमाथ्या खल्वाट
टणक: मजबूत भक्कम पक्का दणकट
टवटवीत: अम्लान टवटवीत प्रफुल्ल ताजे
टायप_केल्लें: टंकलिखित
टाळपी: संयमी निग्रही
टाळूं_येना: अटळ
टिकाकार: निंदक
टिकेसयतचें: टीकेसहित
ट्युनिशियायी: ट्यूनीशियाचा
ट्युनीशी: ट्युनिस
ठगो: लुच्चा लफंगा लबाड नीच पाजी हलकट बदमाश
ठिपक्यांचें: कबरा ठिपकेदार रंगीबेरंगी
डच: डच डच
डाळंबा_कोराचें: डाळिंबी
डेनमार्की: डॅनिश डॅनिश
ढोंगी: ढोंगी दांभिक लबाड पाखंडी
णव: नऊ
णवपट: नऊपट
णववें: नववा
णव्याण्णवावें: नव्याण्णवावा
णव्वद: नव्वद
णव्वदावें: एकोणनव्वदावा नव्वदावा
तंतूमय: तंतुमय
तंत्रांविशींचें: तांत्रिक तंत्राचा तंत्राविषयीचा तंत्रविषयक तंत्रासंबंधीचा तंत्राशी_संबंधित
तंत्राबगरचें: अतांत्रिक
तंत्रीक: तांत्रिक तंत्राचा तंत्राविषयीचा तंत्रविषयक तंत्रासंबंधीचा तंत्राशी_संबंधित
तंदुरी: तंदुरी
तकलेंतलें: काल्पनिक कल्पित अवास्तविक
तकलेचें: मेंदूचा मेंदवी मेंदूविषयीचा मेंदूविषयक मेंदूसंबंधीचा मेंदूशी_संबंधित
तटस्थ: तटस्थ निष्पक्ष निष्पक्षपाती त्रयस्थ
तडी_वयलें: तटस्थ तटस्छ तटस्त
तड्डकी: खोटारडा
तत्कालीक: तत्काळचा ताबडतोबीचा
तत्काळीन: तत्कालीन तात्कालिक
तत्पर: तयार तय्यार तत्पर सज्ज
तत्पुरते: तात्पुरता
तत्वज्ञानी: दार्शनिक तत्त्वज्ञानी वैशेषिकी वैशेषिकाचा
तथाकथीत: नाममात्र
तथ्यपूर्ण: null
तपस्वी: तापस
तपाची: अग्निज
तपाचें: तपाने_उत्पन्न
तपाशिल्लें: अवलोकित पाहिलेला तपासलेला परीक्षित
तपासणी: चिकित्सेविषयक
तमीळ: तामिळ तमिळ तमिळ
तयार: तयार तय्यार रेडिमेड तयार तय्यार तत्पर सज्ज
तयार_करूंक_नाशिल्लें: अरचित
तयार_केल्लें: रचित कृत विरचित निर्मित रचलेला
तयार_जाल्लें: उत्पादित तयार
तरंगपी: तरंगता तरंगणारा
तरणें: तरुण तरणा जवान
तरबेज: प्रशिक्षित
तर्कहीण: अतर्क्य
तर्का_बगरचें: अतर्क्य
तर्र: प्यायलेला
तळा_बगरचें: बिनबुडाचा
तळ्यांत_जावपी: तलावात_होणारा
तळ्यांतलें: तलावात_होणारा
तळ्याचें: तलावाचा
तशाक_तशें: हुबेहूब
तांकिवंत: महाबळी
तांकीवंत: शक्तिशाली बलवान शक्तिमान शक्तिवान शक्तिवंत बलशाली जबर बलाढ्य बलवंत
तांत्रीक: null
तांबडो: लाल तांबडा
तांबशेल्लें: लाली_आलेला यशामुळे_आनंदित_झालेला
तांबसो: null
तांबूस: null
ताकतिकेन: जलद वेगवान द्रुत
ताकतीक_करपी: उतावळा उतावीळ अधीर घायकुत्या
ताचे_खेरीज: शिवाय सोडून अतिरिक्त व्यतिरिक्त
ताचे_बगर: शिवाय सोडून अतिरिक्त व्यतिरिक्त
ताचे_भायर: शिवाय सोडून अतिरिक्त व्यतिरिक्त
ताचे_शिवाय: शिवाय सोडून अतिरिक्त व्यतिरिक्त
ताजी: ज्वलंत
ताजें: ताजा ताजे हिरवागार हिरवा
ताजें_टवटवीत: ताजातवाना टवटवीत
ताजो: अम्लान टवटवीत प्रफुल्ल
ताठ: न_नमलेला
तात्काळीचें: ताबडतोबीचा तत्काळ_झालेला
तानेल्लें: तहानलेला
तापट: क्रुद्ध संतप्त रागावलेला संतापलेला चिडलेला कोपित कुपित क्रोधायमान कोपायमान कोपाविष्ट रागीट रागिष्ट संतापी तापट कोपिष्ट अंगर कडक जहाल
तापिल्लें: तापलेला तप्त गरम तापलेला तप्त
ताब्यांत: आधीन अधीन
तामसी: तमोगुणी तामसी तामसगुणी
तामसीक: तमोगुणी तामसी तामसगुणी
तामीळ: तामिळ तमिळ तमिळ
तारणहार: पोशिंदा पालनकर्ता
तारपी: पोशिंदा पालनकर्ता
तारवटी: जहाजाचा
तारहीण: बिनतारी
तारे_बगरचें: बिनतारी
तार्कीक: तर्कगम्य बुद्धिग्राह्य तर्कसंगत तर्कशुद्ध तर्काधिष्ठित सयुक्तिक
ताळतंत्राबगरचें: असंयमित असंयत
तिकतीकपी: चमचमणारा चमकणारा चकचकणारा
तिक्कें: तितका तेवढा तितुका
तिक्ष्ण: कुशाग्र तल्लख प्रखर
तिखट: तिखट जहाल
तिख्याचें: पोलादी पोलादाचा पोलादी बळकट मजबूत कणखर दणकट
तिगाय: तिघे
तितकें: तितका तेवढा तितुका
तितलें: तितका तेवढा तितुका
तिनचाकी: तिचाकी
तिनशें: तीनशे
तिप्पट: तिप्पट
तिबक्यांचें: कबरा ठिपकेदार रंगीबेरंगी
तिबेटी: तिबेटी तिबेटचा तिबेटी तिबेटी
तिमाही: तिमाही त्रैमासिक
तिरंगी: तिरंगा
तिरकटी: कटुभाषी
तिरपें: चकणा काणा तिरळा
तिरशें: चकणा काणा तिरळा
तिरसट: कडवट कटू
तिरसुवादीक: कटुभाषी
तिरायत: परका दुसरा बाहेरचा इतर
तिरायताचें: परकीय
तिव्र: कुशाग्र तल्लख प्रखर तीव्र
तिसरें: तिसरा तृतीय
तिसावें: तिसावा
तीख: तिखट जहाल कडवट कटू किंकरा
तीग: तिघे
तीगजाण: तिघे
तीन: तीन
तीन_दिसांचें_शेळें: एकोणसत्तरावा
तीन_पडींचें: तीनपेडी त्रिपेडी
तीनपडी: तीनपेडी त्रिपेडी
तीनमाही: तिमाही त्रैमासिक
तीनरंगी: तिरंगा
तीस: तीस
तुंबिल्लें: स्थिर अप्रवाही
तुंबिल्लो: अवरुद्ध रोधलेला
तुकुतुकू: अनिमिष अनिमेष
तुमचें: आपला
तुर्कस्थानी: तुर्कस्तानी तुर्क तुर्की
तुर्की: तुर्की तुर्कस्तानी तुर्क तुर्की तुर्की
तुलनात्मक: तुलनात्मक तौलनिक
तुळात्मक: तुलनात्मक तौलनिक
तुळे_भायरें: अमाप
तुश्ट: समाधानी
तुस्ततोखणायेचें: प्रशंसित प्रशंसलेला
तुस्तेचें: पूजिलेला वंदिलेला
तृतीय: तिसरा तृतीय
तृप्त: तृप्त संतुष्ट तुष्ट
तेंगशेचें: उंच उत्तुंग उन्नत उच्च
तेजपूर्ण: तेजस्वी तेजःपुंज तेजोमय सतेज उज्ज्वल उजळ तेजस प्रकाशमान दीप्तिमान देदीप्यमान कांतिमान शोभायमान उज्ज्वलित प्रकाशमय पाणीदार तेजवान तेजवंत
तेजस्वी: तेजस्वी तेजःपुंज तेजोमय सतेज उज्ज्वल उजळ तेजस प्रकाशमान दीप्तिमान देदीप्यमान कांतिमान शोभायमान उज्ज्वलित प्रकाशमय पाणीदार तेजवान तेजवंत तेजस्वी ओजस्वी तेजःपुंज
तेजहीण: निस्तेज तेजोहीन फिका कळाहीन कांतिहीन फिकट म्लान प्रभाहीन निष्प्रभ
तेजाबी: तेजाबी
तेत्तिसावो: तेहेतिसावा
तेत्तीस: तेहेतीस
तेमकाचें: उंच उत्तुंग उन्नत उच्च
तेरा: तेरा त्रयोदश
तेरावें: तेरावा
तेलकट: तेलकट तेलकट तेलगट तेलकटी स्निग्ध तेलाचा तेलाविषयीचा तेलविषयक तेलासंबंधीचा तेलाशी_संबंधित
तेलगू: तेलुगू तेलगू तेलुगू तेलूगू तेलुगू तेलगू
तेलाचें: स्निग्ध तेलाचा तेलाविषयीचा तेलविषयक तेलासंबंधीचा तेलाशी_संबंधित
तेलुगू: तेलुगू तेलगू तेलुगू तेलूगू तेलुगू तेलगू
तेविसावें: तेविसावा
तेवीस: तेवीस
तेवेचाळिसावें: त्रेचाळिसावा
तेवेचाळीस: त्रेचाळीस
तोंकाचें: उंच उत्तुंग उन्नत उच्च अणकुचीदार टोकदार तीक्ष्ण
तोंकाळ: अणकुचीदार टोकदार तीक्ष्ण
तोंड_परतिल्लें: पराङ्मुख विमुख
तोंड_फिरयिल्लें: पराङ्मुख विमुख
तोंडपाठ: पाठ मुखोद्गत तोंडपाठ मुखपाठ कंठस्थ कंठगत
तोंडा_वयलें: आसन्न
तोंडाचें: चेहर्‍याचा चेहर्‍याशी_संबंधित
तोंडी: तोंडी मौखिक वाचिक
तोखणायेचे: प्रशंसनीय स्तुत्य वाखाणण्याजोगे प्रशंसापात्र स्पृहणीय
तोखणायेचें: पूजिलेला वंदिलेला प्रशंसित प्रशंसलेला
तोडीचो: तोडीचा
तोतरें: तोतरा बोबडा तोतरा
तोलाचें: महत्त्वाचा मोठा वजनी
त्या_काळा_वयलें: तात्कालिक
त्या_काळाची: तत्कालीन
त्या_काळावयली: तत्कालीन
त्यागिल्लें: परित्यक्त
त्यागी: त्यागी
त्याज्य: त्याज्य
त्रस्त: पीडीत त्रस्त -ग्रस्त पीडित सतावणूकग्रस्त सतावलेला ग्रस्त
त्रासदिणी: दुःखद दुःखदायक दुःखकारक कटू खेदजनक
त्रासदिणें: कष्टदायक
त्रासाची: दुःखमय
त्रासिल्लो: पीडीत त्रस्त -ग्रस्त
त्रासीक: दुःखी कष्टी दुःखित पीडित व्यथित आर्त
त्रिकोणाकार: त्रिकोणी
त्रिकोणी: त्रिकोणी
त्रिबुनालीन: न्यायविषयक न्यायसंबंधी
त्रेप्पन: त्रेपन्न
त्रेप्पनावें: त्रेपन्नावा
त्रेसठ: त्रेसष्ट
त्रेसठावो: त्रेसष्टावा
त्र्यांयशीं: त्र्याऐंशी
त्र्याण्णव: त्र्याण्णव
त्र्याण्णवावें: त्र्याण्णवावा
त्र्यात्तर: त्र्याहत्तर
त्र्यात्तरावें: त्र्याहत्तरावा
त्वचेचो: त्वचा चर्म
थंड: सौम्य कोमल_स्वभावाचा शांत सुस्वभावी सुशील सद्वर्तनी गंभीर शांत स्थिर गार थंड शीतल गारट शीत गार थंड थंड शांत शीत शांत शांतिपूर्ण शांतिमय सुन्न थंड शीत
थकपाचें: थकविणारा टेक_आणणारा थकवा_आणणारा दमविणारा
थकिल्लें: क्लांत दमलेला थकलेला भागलेला शिणलेला श्रमविकल
थकूंक_नाशिल्लें: अक्लांत
थपकटें: सपाट समतल
थपथपिल्लें: माखलेला भिजलेला चिंब माखलेला भिजलेला
थपथपीतप: माखलेला भिजलेला
थरांचें: स्तरयुक्त थरयुक्त
थरावीक: सीमित मोजका माफक बेताचा ठरावीक ठरलेला निश्चित नियत निर्धारित
थरिल्ली: निर्णीत
थळावें: देशी देशज स्थानिक देशज
थळीय: भूचर
थांबिल्ली: गतिहीन स्थिर
थांबिल्लें: थांबलेला रोखलेला कुंठित
थायां_पडपी: दृश्यमान दृग्गोचर दृष्टिगोचर
थायी: थाई थाई थाई
थारनासतना: अनवरत अविरत अविश्रांत निरंतर
थारायिल्लें: ठराविक ठरलेला निश्चित नियत निर्धारित ठराविक
थारायिल्ल्या: सीमांकित सीमित
थारावीक: पक्का निश्चित नक्की
थीर: अविचल दृढ अढळ ठाम गंभीर शांत स्थिर अविचल दृढ अढळ ठाम न_नमलेला स्थिर स्थावर अचल
थीर_चित्ताचो: स्थिरचित्त शांत स्थिर धीराचा
थोक: ठोक
थोटें: पांगळा लंगडा पांगूळ अपंग पायमोडका तुटका
थोडे_भितर: संक्षिप्त
थोडें: कमी थोडा थोडासा थोडका अल्प अल्पसा मोजका किंचित किंचितसा जरा जरासा थोडाथोडका अल्पस्वल्प काही थोडा
थोडें_उलोवपी: मितभाषी अबोल अल्पभाषी अल्पभाष मुखस्तंभ
थोडोसो: लहान_भागाविषयीचा लहान_भागविषयक लहान_भागासंबंधीचा लहान_भागाशी_संबंधित लहान_अंशाविषयीचा लहान_अंशाविषयक लहान_अंशासंबंधीचा लहान_अंशाशी_संबंधित छोट्या_भागाविषयीचा छोट्या_भागविषयक छोट्या_भागासंबंधीचा छोट्या_भागाशी_संबंधित छोट्या_अंशाविषयीचा छोट्या_अंशाविषयक छोट्या_अंशासंबंधीचा छोट्या_अंशाशी_संबंधित लघु_भागाविषयीचा लघु_भागविषयक लघु_भागासंबंधीचा लघु_भागाशी_संबंधित लघु_अंशाविषयीचा लघु_अंशाविषयक लघु_अंशासंबंधीचा लघु_अंशाशी_संबंधित लघुभागाविषयीचा लघुभागविषयक लघुभागासंबंधीचा लघुभागाशी_संबंधित लघ्वांशाविषयीचा लघ्वांशविषयक लघ्वांशासंबंधीचा लघ्वांशाशी_संबंधित
दंग: व्यग्र
दंडीत: दंडित
दक्षिणी: परोक्ष अदृश्य अदृष्ट
दक्षिणे_वटेन: दक्षिणावर्ती दक्षिणावर्त
दडपी: लपणारा
दडोवपी: लपवणारा
दणकट: पीळदार कसलेला भरदार आटीव मजबूत दणगट
दणकेबाज: जोरदार
दत्तक: दत्तक
दबदबीत: सरबरीत आसट
दयाळू: दयाळू कृपाळू दरावंत दयावान दयाशील दयार्द्र कृपावंत सहृदयी
दयेस्त: दयाळू कृपाळू दरावंत दयावान दयाशील दयार्द्र कृपावंत सहृदयी सहानुभूती_बाळगणारा
दर: प्रत्येक एकेक
दर_एक: प्रत्येक एकेक
दरबारी: दरबारी
दर्याचें: समुद्री सागरी समुद्रबाबतचा सागराबाबतचा समुद्राचा सागराचा समुद्राविषयीचा सागराविषयीचा समुद्रविषयक सागरविषयक समुद्रासंबंधीचा सागरासंबंधीचा समुद्राशी_संबंधित सागराशी_संबंधित
दर्यायी: समुद्री सागरी समुद्रीय
दर्शनशास्त्रीय: दार्शनिक दर्शनाबाबतचा दर्शनाचा दर्शनाविषयीचा दर्शनविषयक दर्शनासंबंधीचा दर्शनशास्त्रीय दर्शनशास्त्राबाबतचा दर्शनशास्त्राचा दर्शनशास्त्राविषयीचा दर्शनशास्त्रविषयक दर्शनशास्त्रासंबंधीचा दर्शनाशी_संबंधित दर्शनशास्त्राशी_संबंधित
दर्शनीय: प्रेक्षणीय दर्शनीय
दलीत: दलित पददलित दलित
दळडिरो: गरीब निर्धन अकिंचन द्रव्यहीन दरिद्री रंक खंक दलित
दळिद्रो: गरीब निर्धन अकिंचन द्रव्यहीन दरिद्री रंक खंक
दांडगट: पीळदार कसलेला भरदार आटीव मजबूत दणगट
दांतयाळी: दंतुर दंताळ दंताळा
दांतयें: दन्त्य दंत्य दंत_विषयक
दांतोळी: दंतुर दंताळ दंताळा
दांतोळें: दन्त्य दंत्य दंत_विषयक
दाखयिल्लें: उद्देशिलेला
दाग_आशिल्लें: डागील डागेल डागलेला
दागा_विरयत: डागरहित
दागिल्लें: डागील डागेल डागलेला
दाट: घनदाट दाट सघन घनघोर गच्च गर्द घोर निबिड गुडूप घनदाट दाट सघन घनघोर गच्च गर्द घोर निबिड गुडुप घट्ट दाट
दातयाळें: दातेरी
दातरांचें: दातेरी
दादलेपणाचें: पुरुषी पुरषी
दादलो: नर
दानवी: राक्षसी
दानवीर: दानशूर
दानशूर: दानशूर उदार दाता दानवीर दानशील दानशूर
दानी: दानशूर उदार दाता दानवीर दानशील दानशूर
दार्शनीक: दार्शनिक तत्त्वज्ञानी दार्शनिक दर्शनाबाबतचा दर्शनाचा दर्शनाविषयीचा दर्शनविषयक दर्शनासंबंधीचा दर्शनशास्त्रीय दर्शनशास्त्राबाबतचा दर्शनशास्त्राचा दर्शनशास्त्राविषयीचा दर्शनशास्त्रविषयक दर्शनशास्त्रासंबंधीचा दर्शनाशी_संबंधित दर्शनशास्त्राशी_संबंधित
दावें: डावा सव्य
दिकाहीण: दिशाहीन
दिक्षीत: दीक्षित
दिखावटी: वरकरणी वरपांगी औपचारिक दिखाऊ औपचारिक भपकेबाज
दिखावू: देखणा राजबिंडा
दिग्गज: दिग्गज दिग्गज null
दिनवाशी: कृतज्ञ आभारी ऋणी
दिल्लें: उपलब्ध प्राप्त मिळलेला दिलेले वितरित वाटलेला वाटणी_केलेला वाटून_टाकलेला अर्पिलेला
दिवंक_नाशिल्लें: अनावृत्त
दिवंगत: मृत दिवंगत गतप्राण मेलेला
दिवपाचें: येणारा मिळणारा बाकी_असलेला
दिवाणी: दिवाणी
दिवाळखोर: दिवाळखोर नादार
दिव्य: पारलौकिक परलोकातला स्वर्गीय स्वर्ग्य दिव्य
दिशाहीण: दिशाहीन
दिश्टी_पडपी: दृश्यमान दृग्गोचर दृष्टिगोचर
दिसपी: दृश्यमान दृग्गोचर दृष्टिगोचर
दिसाळें: दैनिक
दीन: दयनीय
दीनदयाळू: दीनदयाळ
दीर्घ: दीर्घ
दीर्घ_काळाचें: चिरकालिक दीर्घकालीन
दुंदर_पानांचें: सुपर्णी सुपर्ण
दुकाळिल्लो: पाणवलेला अश्रुपूर्ण डबडबलेला
दुखदिणें: कष्टदायक
दुखापती_बगरचे: अनाहत अक्षत
दुखावल्लें: जखमी घायाळ जायबंदी
दुख्खदिणी: दुःखद दुःखदायक दुःखकारक कटू खेदजनक
दुख्खहीण: शोकरहित शोकहीन विषादरहित शोकग्रस्त शोकाक्रांत दुःखरहित
दुख्खाची: दुःखद दुःखदायक दुःखकारक कटू खेदजनक दुःखमय
दुख्खी: शोकाकुल दुःखी दुःखित असुखी शोकग्रस्त दुःखी कष्टी दुःखित पीडित व्यथित आर्त कष्टी दुःखी
दुचाकी: दुचाकी
दुडवांकार: धनाढ्य धनवान श्रीमंत समृद्ध सधन धनवंत धनिक तालेवार
दुतर्फी: दुतर्फा दुतोंडी
दुतोंडी: दुतोंडी दुतोंड्या दुतोंडा दुतोंडा दुतोंडी
दुदाचो: दूधपिता
दुदारू: दुभती दुधाळू दुधड
दुदाळ: दुधाळ
दुधारी: दुधारी दुधार
दुपटें: दुप्पट दुपट डबल
दुबळी: अबला
दुबळें: दुबळा दुर्बल निर्बल कमकुवत कृश हडकुळा रोड बारीक किडकिडीत लुकडा वाळलेला
दुबळो: अक्षम
दुबावा_बगरचो: असंदिग्ध निःसंदिग्ध निःशंक स्पष्ट साफ स्वच्छ निःसंदेह निर्भ्रांत
दुबावा_विरयत: असंदिग्ध निःसंदिग्ध निःशंक स्पष्ट साफ स्वच्छ निःसंदेह निर्भ्रांत निश्चित ठाम निःसंकोच निःसंदेह_असणारा संदेहहीन असंशायात्मक निःसंशायात्मक
दुबावी: संशयी शंकेखोर संशयखोर शंकाळू भ्रमिष्ट संभ्रांत गडबडलेला घोटाळलेला
दुबावीत: साशंक शंकित संशयित साशंक शंकित
दुभती: दुभती दुधाळू दुधड
दुयेंती: रोगग्रस्त व्याधिग्रस्त आजारी दुखणाईत रुग्णाईत दुखणेकरी रोगट
दुरंगी: दुरंगी
दुरदर्शिकायहीण: अदूरदृष्टी अदूरदर्शी
दुरदर्शी: दूरदर्शी दीर्घदर्शी दीर्घदृष्टी
दुरुस्त: चांगला ठीक दुरुस्त ठीकठाक व्यवस्थित तंदुरूस्त
दुर्गूण: दुर्गुणी अवगुणी
दुर्जन: दुष्ट दुर्जन असाधू खल
दुर्बोध: दुर्बोध क्लिष्ट
दुर्भागी: अभागी कमनशिबी करंटा दुर्दैवी हतभाग्य भाग्यहीन
दुर्मीळ: बिकट कठीण खडतर दुर्गम गहन दुर्लभ दुर्मीळ
दुशीत: दूषित प्रदूषित खराब
दुश्ट: दुष्ट दुर्जन असाधू खल
दुसरे_जातीचें: आंतरजातीय विजातीय
दुसरें: द्वितीय दुसरा पुढचा पुढील
दुसर्‍यांचेर_आदारून: परावलंबी
दुसर्‍यांच्या_कुडक्यांचेर_जगपी: आधुनिक नवा नवीन नूतन अर्वाचीन अद्यतन
दुसर्‍यांच्या_जिवार_जगपी: आधुनिक नवा नवीन नूतन अर्वाचीन अद्यतन
दुसर्‍याचें: परकीय
दुस्मानकेचो: खुनशी शत्रूभावयुक्त
दुस्मानहीण: अजातशत्रू
दुस्मानी: सशत्रू शत्रू_असलेला
दुस्वाशी: घृणा_करणारा दुष्ट दुर्जन असाधू खल
दुस्वासी: null
दूझ: बारा
दूद_पियेवपी: दूधपिता
दूर: दूरस्थ दूरचा लांबचा सुदूर अंतरावरचा अंतरावरील
दूरचें: दूरस्थ दूरचा लांबचा सुदूर अंतरावरचा अंतरावरील
दृढ: अविचल दृढ अढळ ठाम
दृश्टियुक्त: डोळस
दृश्टिहीण: आंधळा अंध नेत्रहीन दृष्टिहीन अंधळा
देंवणेचें: अधोगामी
देंवतें: स्वस्त अधोगामी उताराचा ढाळाचा
देंवयिल्लें: पदच्युत बडतर्फ
देखघेणे: आदर्श अनुकरणीय
देखणें: सुंदर देखणा सुरेख रूपवान
देगणाचें: उताराचा ढाळाचा
देगे_वयलें: तटस्थ तटस्छ तटस्त
देगेचें: जवळचा नजीकचा निकटवर्ती
देड: दीड
देड_पटीचें: null
देडीचें: null
देणें: येणारा मिळणारा बाकी_असलेला
देण्याचें: देण्याजोगा
देवा_बगरचें: अनीश
देवाचें: दैवी
देवादेणें: ईश्वरदत्त देवदत्त
देशद्रोही: देशद्रोही राष्ट्रद्रोही
देशभक्त: देशभक्त
देशी: देशी देशीय देशी देशज स्थानिक देशज
देशी.: देशी राष्ट्रीय स्वदेशी
दैववादी: दैववादी
दैवी: ईश्वरी दैवी दैवी ईश्वरी दैविक दैवी दैविक ईश्वरी ईश्वरदत्त देवदत्त देवार्पित देवतेला_वाहिलेला देवतेला_अर्पिलेला देवतेला_अर्पित ईश्वराला_वाहिलेला ईश्वराला_अर्पिलेला ईश्वराला_अर्पित ईश्वरार्पित ईशार्पित
दोंगराळ: डोंगरकरी डोंगरी पहाडी डोंगराळ डोंगरट डोंगरवट पहाडी पहाडी पहाडावर_आढळणारा
दोंगरी: डोंगराळ डोंगरट डोंगरवट पहाडी
दोगूय: दोन्ही उभय
दोट्टी: दुहेरी
दोट्टें: दुप्पट दुपट डबल
दोतर्फी: दुतर्फा
दोन: दोन
दोन_कुडक्यांचें: दोन_तुकड्यांचा
दोन_तोंडांचें: दुतोंडी दुतोंड्या दुतोंडा दुतोंडा
दोन_पटी: दुप्पट दुपट डबल
दोन_पांयांचें: द्विपाद
दोन_माळ्यांचें: दुमजली
दोनखणी: दुखणी दोन_खणी
दोनपांयी: द्विपाद
दोनभागी: दुखणी दोन_खणी
दोनमाळी: दुमजली
दोनरंगी: दुरंगी
दोनूय: दोन्ही उभय
दोळ्याचें: डोळ्याचा
दोशमुक्त: अपराधमुक्त दोषमुक्त
दोशी: अपराधी गुन्हेगार दोषी निंदनीय निंद्य गर्हणीय गर्ह्य
द्रव: द्रव पातळ
द्रवीत: द्रवित
द्राक्षा_भशेन: द्राक्षी
द्राक्षांचें: द्राक्षाचा
द्राक्षाच्या_रंगाचें: द्राक्षी
द्राक्षाळ: द्राक्षी
द्विधाग्रस्थ: दुग्ध्यात_असलेला
धंदेकार: व्यवहारी व्यवहारदक्ष व्यवहारनिपुण व्यवहारकुशल
धंद्याचें: व्यावसायिक
धडधाकट: पीळदार कसलेला भरदार आटीव मजबूत दणगट धट्टाकट्टा धष्टपुष्ट
धडपडो: उपद्रवी
धडाकेबाज: जोरदार
धनलोभी: धनलोभी धनलुब्ध
धनवान: धनी
धनसुवार्थी: धनलोभी धनलुब्ध
धनी: धनी धनाढ्य धनवान श्रीमंत समृद्ध सधन धनवंत धनिक तालेवार
धन्य: कृतार्थ कृतकृत्य कृतार्थ कृतकृत्य धन्य
धन्यवादी: कृतज्ञ आभारी ऋणी
धरपी: धारी
धर्मकुड्डें: धर्मांध
धर्मनिरपेक्ष: धर्मनिरपेक्ष धर्मातीत
धर्मनिश्ट: धार्मिक धर्मपरायण धर्मशील
धर्मांध: धर्मांध
धर्मार्थ: धर्मार्थ
धर्मिक: धार्मिक धर्मपरायण धर्मशील
धर्मीक: धार्मिक
धवें: पांढरा श्वेत धवल शुभ्र सफेत सफेद
धवो: गोरा गौर उजळ गोरटा
धा: दहा
धा_आनी_आठ: अठरावा
धा_आनी_चार: चौदावा
धा_आनी_पांच: पंधरावा पंध्रावा
धांपिल्लो: आच्छादित आच्छ्न्न झाकलेले व्यापलेले
धांवडायिल्लें: पदच्युत बडतर्फ बहिष्कृत
धांवपी: पळणारा धावणारा पळत_असलेला धावत_असलेला
धाकटो: धाकटा सर्वात_लहान वयात_सर्वात_लहान
धाकलो: लहान बारका पाठचा धाकटा अनुज
धाडशी: धैर्यवान धिराचा साहसी धाडसी हिम्मतवान धीट बहाद्दर निधडा
धाडसाचें: साहसी साहसिक साहसपूर्ण
धाडसी: साहसी साहसिक साहसपूर्ण
धाडिल्लें: पाठवलेले धाडलेला प्रेषित पाठवलेला रवाना
धातूचें: धातुविषयक
धात्वीय: धातुविषयक
धादोशी: समाधानी
धादोस: तृप्त संतुष्ट तुष्ट
धार_आशिल्लें: धारदार तीक्ष्ण
धार_गेल्लें: बोथट मंद घासकाटू घासकटाऊ
धार_पडिल्लें: बोथट मंद घासकाटू घासकटाऊ
धारण_करपी: धारी
धारदार: धारदार तीक्ष्ण तीक्ष्ण
धारावाहीक: अनुक्रमाने_येणारा अनुक्रमाने_असणारा क्रमिक क्रमाने_येणारा क्रमाने_शेजारचा क्रमाने_लगेचचा क्रमानुवर्ती मालिकेतील_लगतचा
धारी: धारी
धारेचें: धारदार तीक्ष्ण तीक्ष्ण
धार्मीक: धार्मिक
धावें: दहावा दशम
धिमें: मंद धीमा संथ हळू संथगती मंदगती
धिरिश्ट: धैर्यवान धिराचा
धीट: धैर्यवान धिराचा साहसी धाडसी हिम्मतवान धीट बहाद्दर निधडा
धील: शिथिल लुळा लुला लापट ढिला
धुंवराळ: धूसर अस्पष्ट पुसट अंधूक धुरकट धुकट
धुक्याचें: धूसर अस्पष्ट पुसट अंधूक धुरकट धुकट
धुल्लाचें: धुळमय
धुळकट: धूळ_लागलेला धूळीत_माखलेला धुळमय
धुवंक_नाशिल्लें: अधुपा अधुवा
धोणूधारी: धनुर्धर धनुर्धारी तिरंदाज कोदंडधारी
धोदेल: जाड जाडा जाडजूड लठ्ठ स्थूल
धोनयो: खादाड अधाशी
ध्यानमग्न: ध्यानस्थ ध्यानमग्न
ध्यानी: ध्यानी ध्यानस्थ ध्यानमग्न
ध्यानेस्त: ध्यानस्थ ध्यानमग्न
ध्रुवाचें: ध्रुवीय
ध्रुवीय: ध्रुवीय
नकल_करपी: नक्कल्या नकल्या
नकली: दिखाऊ कृत्रिम नाटकी देखणा राजबिंडा नक्कल्या नकल्या
नकसूद: नाजूक
नकारात्मक: नकारात्मक नकारार्थी
नकारार्थी: नकारार्थी नकारात्मक
नक्षिदार: कोरीव
नक्षीकाम_केल्लें: नक्षीदार
नखरेबाज: नखरेबाज नखरेल नखराळ
नगरवासी: शहरी नगरवासी नागर
नगरी: शहरी नागरी नागर शहराचा शहराविषयीचा शहरविषयक शहरासंबंधीचा नगराबाबतचा नगराचा नगराविषयीचा नगरविषयक नगरासंबंधीचा शहराशी_संबंधित नगराशी_संबंधित
नगरेंतले: शहरी नगरवासी नागर
नग्न: नग्न नागडा विवस्त्र निर्वस्त्र अनावृत नागवा नंगा नागडाउघडा उघडानागडा वस्त्रहीन
नटयिल्लें: सुशोभित
नटिल्लो: सजलेला नटलेला साजश्रुंगारित
नटोवणी: सजावटी
नडणी: रानटी जंगली
नतमस्तक: नतमस्तक
नदर_आशिल्लो: डोळस
नदरेक_पडपी: दृश्यमान दृग्गोचर दृष्टिगोचर
नपुसक: नपुंसक षंढ
नमळायेचो: न_मस्तवलेला
नमस्कार_करि_सारकें: वंदनीय
नमस्कार_करी_सारकें: प्रणम्य
नम्र: शांत
नर: नर
नरभक्षक: नरभक्षक
नरभक्षी: नरभक्षक
नरम: सौम्य कोमल_स्वभावाचा शांत लवचीक लवका लवकीरा लवलवीत मऊ मृदू कोमल नरम मुलायम मृदुल अरूवार
नवनिर्मीत: नवनिर्मित
नवलकाणीक: कादंबरीत_वर्णन_करण्यायोग्य
नवशिकें: नवशिका नवखा नवा नवीन कच्चा
नवशिक्षीत: नवशिका नवखा नवा नवीन कच्चा
नविनीकरणी: नूतनीकरणक्षम नूतनीकरण_झालेले
नवी: नवनिर्मित
नवीन: नवीन नवा नूतन अभिनव नव
नवे: नवीन नवा नूतन अभिनव नव
नवेंच_शिकिल्लें: नवशिका नवखा नवा नवीन कच्चा
नवो: आधुनिक सद्यःकालीन वर्तमान
नशिलें: मदमस्त नशीला मादक
नशीबवान: भाग्यवान नशीबवान भाग्यवंत भाग्यशाली सुदैवी सुदेव लकी
नशेचें: मादक अमली मदमस्त नशीला मादक
नशेबाज: नशाखोर नशाबाज
नश्ट: नष्ट नेस्तनाबूत नेस्तनाबूद जमीनदोस्त उद्ध्वस्त नामशेष बरबाद उध्वस्त पडकी उधळलेला अस्ताव्यस्त
नश्टो: घृणा_करणारा मत्सरी
नश्वर: नश्वर अशाश्वत अनित्य नाशवंत क्षर
नसाय_करपी: मत्सरी
नसायहीण: निर्मत्सर मत्सरहीन
नसायें: मत्सरी null
नस्तार: नकारात्मक नकारार्थी
नांगरणे_विरयत: न_नांगरलेला
नांगरूंक_नाशिल्लें: न_नांगरलेला
नांमाबगरचें: निनावी
नांवा_पुरतें: नाममात्र
नांवाचें: नामक नामा नामधारक नाममात्र
नांवाजतो: प्रसिद्ध विख्यात प्रख्यात ख्यातनाम नावाजलेला नामांकित सुविख्यात सुप्रसिद्ध नाणावलेला ख्यात नामवंत बडा
नांवादीक: प्रसिद्ध विख्यात प्रख्यात ख्यातनाम नावाजलेला नामांकित सुविख्यात सुप्रसिद्ध नाणावलेला ख्यात नामवंत बडा
नाउमेदी: अजिज्ञासू जिज्ञासाहीन
नाककात्रें: नकटा
नाककापें: नकटा
नाकयें: अनुनासिक नासिक्य
नाका_जावपाचें: थकविणारा टेक_आणणारा थकवा_आणणारा दमविणारा
नाकाजाल्लें: अनावश्यक अद्वातद्वा वेडेवाकडे भलतेसलते अचकटविचकट
नाखूश: अप्रसन्न नाखूश असंतुष्ट नाराज रुष्ट .दुःखी
नाखोशयेचें: असमाधानकारक
नागडो: नग्न नागडा विवस्त्र निर्वस्त्र अनावृत नागवा नंगा नागडाउघडा उघडानागडा वस्त्रहीन
नागमोडें: महिरपी
नागोवणेचें: बळकावलेला हिसकावलेला
नागोवणो: लुच्चा लफंगा लबाड नीच पाजी हलकट बदमाश लुटारू चोर
नाचपी: खेळ_करून_दाखवणारा नाचणारा
नाजूक: कोमलांग तकलादू कमजोर नाजूक कच्चा तकलादू नाजूक
नाटकी: दिखाऊ कृत्रिम नाटकी औपचारिक नाट्यविषयक नाटकीय नाटकी नाट्यपूर्ण नाट्यमय
नापसंतीचें: नापसंत नावडता अप्रिय
नापास: अनुत्तीर्ण नापास
नापीक: नापीक पडीत पडीक बरड
नाबाद: दुखापत_न_झालेला नाबाद
नामंजुर: संमत_न_झालेला
नामंजूर: अस्वीकृत नामंजूर
नामक: नामक नामा नामधारक
नामनेचे: जगप्रसिद्ध जगद्विख्यात विश्वविख्यात
नामनेचो: प्रसिद्ध विख्यात प्रख्यात ख्यातनाम नावाजलेला नामांकित सुविख्यात सुप्रसिद्ध नाणावलेला ख्यात नामवंत बडा
नामर्द: नपुंसक षंढ
नामांकीत: नामांकित
नामी: नामक नामा नामधारक
नायट्रीक: नायट्रिक
नारंगी: नारिंगी नारंगी
नालायक: अयोग्य अपात्र नालायक अकार्यक्षम रिकामटेकडा उडाणटप्पू निरुद्योगी निकामी
नावडटें: नापसंत नावडता अप्रिय न_आवडलेला
नावडीचें: नापसंत नावडता अप्रिय
नावाडगें: खट्याळ खोडकर बंड द्वाड वांड वात्रट वाह्यात दांडगा अवखळ
नावाडगो: कुख्यात बदनाम कुप्रसिद्ध
नावेश: लुप्त लोपलेला
नाशक: विध्वंसक विनाशकारी संहारक विनाशक प्रभावी
नाशवंत: नश्वर अशाश्वत अनित्य नाशवंत क्षर
नासीक: नासिक्य
नास्तीक: नास्तिक निरीश्वरवादी
निंदक: निंदक
निंदा_करपी: निंदक
निंदात्मक: निंदात्मक निंदेवर_आधारित निंदेने_युक्त
निंदेस्त: निंदनीय निंद्य गर्हणीय गर्ह्य
निखर्व: निखर्व
निखळपी: वेगळा_होणारा तुटणारा
निग्रही: संयमी स्पष्टवक्ता निर्भीड
नितळ: निरभ्र स्वच्छ अभ्ररहित मेघहीन मेघरहित निर्मेघ स्पष्ट साफ स्वच्छ सुस्पष्ट स्वच्छ पवित्र निर्मळ निर्मल चखोट साफ विशुद्ध
नितीक: वैध कायदेशीर नीतिमान स्वच्छ खरा चोख अम्लान सचोटीचा
नितीकतायपूर्ण: नैतिक नीतियुक्त
नितीपूर्ण: नैतिक नीतियुक्त
निद्रागत: झोपलेला निद्रित निद्रामग्न निद्रिस्त सुप्त निजलेला निद्राधीन
निनावी: निनावी
निपक्ष: तटस्थ निष्पक्ष निष्पक्षपाती त्रयस्थ
निपुत्रीक: निपुत्रिक निपुत्र निपुत्रीक निपुत्रिक निपुत्री पुत्रहीन निपुत्र निपुत्रीक निपुत्रिक निपुत्री
निपूण: प्रवीण निपुण हुशार कुशल जाणता पारंगत जाणकार निष्णात तज्ज्ञ तरबेज वाकबगार हातखंडा पटाईत तज्ञ फरडा विशारद कसबी योग्य लायक समर्थ सक्षम पात्र काबील
निबर: निर्दय निर्दयी कठोर क्रूर निष्ठुर निर्गृण हृदयशून्य पाषाणहृदयी निर्भय बेडर निडर धीट साहसी धाडसी बेधडक अकुतोभय भयरहित कडक कडक पाषाणहृदयी निर्दय कठोर निष्ठुर वज्रहृदयी दयाशून्य क्रूर दयाहीन मजबूत भक्कम पक्का दणकट कडक टणक कठीण निबर करकरीत बेमुरवत बेमुरवती बेमुर्वत बेमुर्वती निर्मोही
निमंत्रण: आमंत्रित निमंत्रित
निमसरकारी: निमसरकारी
निमाणें: चरम अंतिम अंत्य शेवटचा अखेरचा टोकाचा अंतीचा शेवटाला_पोचलेला अखेरीला_पोचलेला टोकाला_पोचलेला अंताला_पोचलेला
निमाणो: धाकटा सर्वात_लहान वयात_सर्वात_लहान
निमाण्या: शेवटचा अंतिम अखेरचा चरम अंत्य
नियंत्रीत: नियंत्रित
नियमीत: नियमबद्ध
नियाळात्मक: आलोचनात्मक
नियाळिल्लें: अवलोकित पाहिलेला
नियुक्तीत: नियुक्त नेमस्त
नियोजीत: ठराविक
निरंकूश: निरंकुश बेलगाम बेबंद
निरंहकारी: निरहंकारी निरभिमानी नम्र विनयी विनयशील निगर्वी
निरक्षर: अशिक्षित अविद्य निरक्षर अक्षरशत्रू अक्षरशून्य अंगठेबहाद्दर अडाणी
निरपराध: अदंडनीय अदंड्य
निरपराधी: निरपराध निरपराधी निर्दोष निर्दोषी
निरपेक्ष: निरपेक्ष अपेक्षाविरहित
निरभिमानी: निरहंकारी निरभिमानी नम्र विनयी विनयशील निगर्वी
निरर्थक: भंकस निरर्थक अर्थशून्य अर्थहीन व्यर्थ फोल वायफळ
निरशेल्लें: वैफल्यग्रस्त
निरस: अरसिक
निराकार: निराकार अमूर्त निरवयव आकाररहित अशारीर विदेह देहरहित निर्गुण
निरादार: निराधार अनाधराधार आधार_नसलेला टेका_नसलेला आधार_न_दिलेला टेका_न_दिलेला आधारहीत
निराधार: असहाय निराधार अगतिक निराधार पोकळ तथ्यहीन निराधार अनाथ असहाय्य निराश्रित
निरावासीत: निर्वासित
निराश्रीत: निराश्रित निराधार
निराहार: उपाशी विनाआहारी शून्याहारी
निरीश्वरवादी: नास्तिक निरीश्वरवादी
निरुत्तर: निरुत्तर गप्प
निरुत्साही: अजिज्ञासू जिज्ञासाहीन
निरुपायी: निरुपाय निरुपायी निरुपाई उपाय_नसलेला अनुपाय
निरुपेगी: निरुपयोगी टाकाऊ व्यर्थ अनुपयोगी अनुपयोग निष्फळ
निरूपयोगी: उपायरहित निरुपाय
निरोगी: निरोगी निकोप निरामय रोगमुक्त
निर्गुणी: निर्गुणी निर्गुण गुणरहित
निर्गूण: निर्गुण निर्गुणी गुणातीत
निर्जन: निर्जन विजन सुनसान मनुष्यविहीन एकटा एकाकी सडा सडाफटिंग एकांडा
निर्जल: निर्जला निर्जल
निर्जळ: कोरडा शुष्क रखरखीत रूक्ष
निर्जाप: निरुत्तर गप्प
निर्जीव: निर्जीव अचेतन जड अचेतन भौतिक
निर्णय_जाल्ली: निर्णीत
निर्णया_बगरचें: अनिर्णीत
निर्णायक: निर्णायक
निर्णीत: निर्णीत
निर्दयी: निर्दय निर्दयी कठोर क्रूर निष्ठुर निर्गृण हृदयशून्य पाषाणहृदयी निर्मोही
निर्देशीत: निर्दिष्ट
निर्दोश: निरपराध निरपराधी निर्दोष निर्दोषी निर्दोष दोष_नसलेला
निर्बंध: पाईक नियमित_वागणारा
निर्बळ: अक्षम दुबळा दुर्बल निर्बल कमकुवत
निर्बळा: अबला
निर्भय: निर्भय बेडर निडर धीट साहसी धाडसी बेधडक अकुतोभय भयरहित
निर्भेळ: खरा चोख अस्सल शुद्ध निर्भेळ निके चोखट स्वच्छ पवित्र निर्मळ निर्मल चखोट साफ
निर्मळ: स्वच्छ पवित्र निर्मळ निर्मल चखोट साफ
निर्माण_केल्लें: रचित कृत विरचित निर्मित रचलेला
निर्माणकर्तो: कर्ता सर्जक सृजक स्रष्टा रचनाकार सर्जनकार सृजनकार सर्जनकर्ता सृजनकर्ता
निर्मातो: कर्ता सर्जक सृजक स्रष्टा रचनाकार सर्जनकार सृजनकार सर्जनकर्ता सृजनकर्ता
निर्मिल्लें: रचित कृत विरचित निर्मित रचलेला
निर्मीत: रचित कृत विरचित निर्मित रचलेला
निर्यात: निर्यातीत
निर्यात_करपी: निर्यातकरी निर्यातक
निर्याती: निर्यातकरी निर्यातक
निर्लज्ज: निर्लज्ज निलाजरा लज्जाहीन बेशरम कोडगा निसुगा निःसंकोची निसंकोची निस्संकोची
निर्लोभी: निर्लोभी
निर्वासीत: निर्वासित
निर्विवाद: निर्विवाद विवादस्पद_नसलेला वाद_नसलेला
निर्विवादीत: वादातीत
निर्वेसनी: निर्व्यसनी
निर्शेल्लें: उदास खिन्न उदासीन
निर्शेवप: निराश हताश खिन्न उदास
निलंबीत: पदच्युत बडतर्फ
निळसार: निळा
निळें: निळा
निवडिल्ली: नियुक्त नेमस्त
निवडिल्लें: निवडक वेचक शेलका निवडलेला निवडून_आलेला
निवळ: स्वच्छ पवित्र निर्मळ निर्मल चखोट साफ स्वच्छ साफ उजळ उज्वल विशुद्ध
निवळावपी: निवारक
निवारक: निवारक निवारक
निवृत्तीवेतना_विशींचें: निवृत्तीवेतनविषयक निवृत्तीवेतनाविषयीचा निवृत्तीवेतनाशी_संबंधित निवृत्तीवेतनासंबंधीचा
निव्वळ: स्पष्ट साफ स्वच्छ सुस्पष्ट
निशस्त्र: निःशस्त्र शस्त्रहीन
निशाचर: निशाचर रात्रिंचर
निशाणे_बगर: सही_न_केलेला
निशाणे_विरयत: सही_न_केलेला
निशिद्ध: हराम निषिद्ध
निशुल्क: निःशुल्क मोफत फुकट विनाशुल्क विनामूल्य चकटफू
निश्कपट: स्वच्छ पवित्र निर्मळ निर्मल चखोट साफ
निश्कपटी: प्रामाणिक इमानदार चोख सालस साळसूद निःकपट
निश्कलंक: निर्दोष दोष_नसलेला
निश्काम: निष्काम
निश्क्रीय: निष्क्रिय
निश्चींत: निश्चिंत चिंतारहित चिंतामुक्त काळजीमुक्त
निश्चीत: अटळ ठराविक ठरलेला निश्चित नियत निर्धारित पक्का निश्चित नक्की
निश्टूर: निर्दय निर्दयी कठोर क्रूर निष्ठुर निर्गृण हृदयशून्य पाषाणहृदयी
निश्ठावान: निष्ठावान
निश्ठाहीण: निष्ठाहीन
निश्पाप: स्वच्छ पवित्र निर्मळ निर्मल चखोट साफ निष्पाप अनघ निरपराध निरपराधी निर्दोष निर्दोषी
निश्प्राण: निर्जीव अचेतन
निश्फळ: निरर्थक निष्फळ निष्काम
निसंकोच: निःसंदेह_असणारा संदेहहीन असंशायात्मक निःसंशायात्मक
निसंकोची: निःसंकोची निसंकोची निस्संकोची
निसरटी_(निसट्टी): निसरडा घसरडा
निसुवार्थ: निस्वार्थ
निस्तेज: म्लान कोमेजलेला कळाहीन निस्तेज फिका फिक्का मलूल निस्तेजस्क निःसत्त्व सत्त्वहीन सत्त्वरहित
निस्वार्थी: निःस्वार्थ स्वार्थहीन निःस्वार्थी निरपेक्ष
नीच: निकृष्ट हीन अधम हलका वाईट भिकार भुक्कड कुत्सिक निकृष्ट हीन अधम हलका वाईट भिकार भुक्कड कुत्सिक
नीच_कुळाचें: खालच्या_वर्गाचा
नुतनीकरणी: नूतनीकरणक्षम नूतनीकरण_झालेले
नेटाचें: प्रबळ प्रबल
नेटाचो: अक्कडबाज ऐटबाज अकडू कुर्रेबाज
नेटान: जलद वेगवान द्रुत
नेणटें: अल्पवयस्क अल्पवयीन लहान पोरवयाचा पोरसवदा
नेणार: अकुशल अप्रवीण अदक्ष अविवेकी अविचारी असमंजस विवेकशून्य विचारशून्य आततायी निरागस अनभिज्ञ
नेपाळी: नेपाळी नेपाळी
नेम_पाळपी: नियमबद्ध शिस्तबद्ध
नेमणूक_केल्लें: अधिकृत
नेमा_प्रमाणें: विहित उचित
नेमान: नियमबद्ध
नेमाळें: दैनिक
नेमिल्लें: अधिकृत पदस्थ
नेमी: नियमबद्ध शिस्तबद्ध नेमस्त नियमित
नेमीत: विहित उचित
नैसर्गीक: नैसर्गिक प्राकृतिक
नॉर्वेयी: नार्वेजियन नॉर्वेजियन
नोंदणी: नोंदणीकृत
नोंदिल्लें: नोंदविलेला नोंदलेला भरलेला
नोंदीत: नोंदणीकृत नोंदविलेला नोंदलेला भरलेला
न्याय_करपी: न्यायी न्यायनिष्ठ
न्यायकरतो: न्यायी न्यायनिष्ठ
न्यायालयीन: न्यायविषयक न्यायसंबंधी
न्यायी: न्यायी न्यायनिष्ठ
न्हयकार: नकारात्मक नकारार्थी
न्हयकारपी: नाकारणारा
न्हयकारी: ऋणात्मक ऋण नकारार्थी नकारात्मक
न्हावंक_नाशिल्लें: पारोसा पारोशी
न्हिदखुरो: निद्राळू निद्रालु झोपाळू झोपाड निद्राशील निद्राकांत निद्राकुल निद्राग्रस्त निद्रातुर निद्रान्वित मिचक्या मिचमिच्या मिचकावणारा
न्हिदिल्लें: झोपलेला निद्रित निद्रामग्न निद्रिस्त सुप्त निजलेला निद्राधीन
न्हिदेभायरें: अनिद्रिस्त
न्हिदेस्त: निद्राळू निद्रालु झोपाळू झोपाड निद्राशील निद्राकांत निद्राकुल निद्राग्रस्त निद्रातुर निद्रान्वित मिचक्या मिचमिच्या मिचकावणारा
न्हिद्राळू: निद्राळू निद्रालु झोपाळू झोपाड निद्राशील निद्राकांत निद्राकुल निद्राग्रस्त निद्रातुर निद्रान्वित
न्हिद्रो: मिचक्या मिचमिच्या मिचकावणारा
न्हीदमग्न: झोपलेला निद्रित निद्रामग्न निद्रिस्त सुप्त निजलेला निद्राधीन
न्हेसपा_सारकें: परिधानीय परिधेय घालण्याजोगा
न्हेसपाचें: घालण्याजोगा
पंचभुजांचें: कोरडा
पंचभुजी: कोरडा
पंचभुतांचें: भौतिक पंचभूतिक
पंचरंगी: पंचरंगी
पंचविसावें: पंचविसावा
पंचवीस: पंचवीस
पंचावन: पंचावन्न
पंचेचाळिसावें: पंचेचाळिसावा
पंचेचाळीस: पंचेचाळीस
पंच्यांयश्यावें: पंच्याऐंशीवा पंच्याशीवा
पंच्याण्णव: पंचाण्णव
पंच्याण्णवावें: पंचाण्णवावा
पंच्यात्तर: पंचाहत्तर
पंच्यात्तरावें: पंचाहत्तरावा
पंच्यायशीं: पंचाऐंशी
पंजाबी: पंजाबी पंजाबी पंजाबी पंजाबी
पंडीत: बुद्धिमान बुद्धिमंत बुद्धिवान हुषार अक्कलवान विद्वान सुविद्य व्यासंगी ज्ञानी पंडित
पंथ: सांप्रदायिक
पंथीय: सांप्रदायिक
पंदरा: पंधरा पंधरावा पंध्रावा
पकदस्त: जड वजनदार भारी अवजड बोजड राजेशाही ऐश्वर्यपूर्ण ऐश्वर्यसंपन्न वैभवी
पक्कें: पक्का निश्चित नक्की
पक्को: कट्टर
पक्षपाती: पाठीराखा कैवारी पक्षपाती पक्षपाती
पगारी: वेतनी
पचकळ: तोंडबडव्या तोंडफटाल्या
पचकें: अळणी सपक फिके
पचनाशिल्लें: जड
पचपचीत: चिकट चिकचिकीत चिकचिकित
पचपी: हलका
पचिल्लें: पचलेला
पच्छतापी: पस्तावणारा अनुतापी अनुतप्त
पटेकार: गप्पिष्ट थापाड्या बाताड्या गप्पी
पठाणी: पठाणी
पठारी: पठारी मैदानी
पडकें: पडका
पडबिंबीत: प्रतिबिंबित
पडमूर: कृतघ्न निमकहराम बेईमान हरामखोर
पडिल्लें: पडका उदास खिन्न उदासीन स्वस्त
पतिव्रता: पतिव्रता सती अव्यभिचारिणी
पथी: पथ्य_पाळणारा पथ्याने_राहणारा
पदचारी: पादचारी
पदव्युत्तर: स्नातकोत्तर
पद्यात्मक: छंदोबद्ध
पनवतीचो: अधोगत पतित
पन्नास: पन्नास
पन्नासावें: पन्नासावा
पयलींचें: जर्जर जीर्ण झिरझिरीत
पयलींचो: पूर्वीचा आधीचा अगोदरचा मागचा पहिला जुना
पयलें: प्रथम पहिला
पयशेकार: धनाढ्य धनवान श्रीमंत समृद्ध सधन धनवंत धनिक तालेवार
पयश्यांची: आर्थिक सांपत्तीक वित्तीय
पयस: दूरस्थ दूरचा लांबचा सुदूर अंतरावरचा अंतरावरील वंचित अव्हेरी
पयसचें: दूरस्थ दूरचा लांबचा सुदूर अंतरावरचा अंतरावरील दूरचा लांबचा सुदूर
पयसुल्लें: दूरस्थ दूरचा लांबचा सुदूर अंतरावरचा अंतरावरील दूरचा लांबचा सुदूर
परकें: परका दुसरा बाहेरचा इतर
परक्याचें: परकीय
परजळपी: चमचमणारा चमकणारा चकचकणारा
परजळीत: दीप्तिमान तेजस्वी कांतिमान
परजातीचें: आंतरजातीय विजातीय
परजिवी: परजीवी
परत-परत_येवपी: नेहमीचा
परत_घेतिल्लो: पुनर्नियुक्त
परत_दिल्लो: पुनर्नियुक्त
परतायिल्लें: परतवलेला
परतिल्लें: परतवलेला
परतुपाचें: परतीचा परतीचा परतीविषयीचा परतीविषयक परतीसंबंधीचा परतीशी_संबंधित
परतूंक_नाशिल्लें: अनावृत्त
परतें: विपरीत विरुद्ध उफराटा उलट उलटा विरुद्ध पालथा उपडा उलटा
परतेचें: परतीचा परतीचा परतीविषयीचा परतीविषयक परतीसंबंधीचा परतीशी_संबंधित
परदेशी: विदेशी परदेशी भिन्नदेशीय विदेशी परदेशी परराष्ट्रीय इतर_देशाचा इतर_देशाविषयीचा इतर_देशासंबंधीचा इतर_देशाशी_संबंधित
परम: परम चरम अंतिम अंत्य शेवटचा अखेरचा टोकाचा अंतीचा शेवटाला_पोचलेला अखेरीला_पोचलेला टोकाला_पोचलेला अंताला_पोचलेला
परमळीत: सुवासिक सुगंधी सुवासित सुगंधित सुगंधिक
परमार्थी: यथार्थ_तत्त्व_शोधणारा
परलोकी: पारलौकिक परलोकातला
परलोकीक: पारलौकिक परलोकातला
परसुवादीन: इतरांवर_विश्वास_ठेवणारा
पराधीन: पराधीन परस्वाधीन परतंत्र गुलाम अंकित परवश
परावलंबी: परावलंबी आश्रित परजीवी
परासक्त: अन्यासक्त परासक्त
परिचीत: ज्ञात माहित ठाऊक विदित विज्ञात अवगत जाणलेला
परिणामकारक: प्रभावी प्रभावशाली परिणामकारक उपयुक्त प्रभावशाली_असलेला प्रभावी परिणामकारक परिणामकारी
परिणामी: उद्भवित कार्यभूत_झालेला
परित्यागी: त्याज्य
परिपक्व: अनुभवी अभिज्ञ जाणता पिकलेला तयार पक्व परिपक्व
परिपूर्ण: संपन्न भरलेला परिपूर्ण
परिभाशीत: स्पष्ट_केलेले व्याख्या_केलेले
परिमाणीत: परिमेय
परिवर्तन: बदलेला परिवर्तन_झालेला सुधारेला
परिवर्तनशील: परिवर्तनशील परिवर्तनीय
परिवर्तीत: वाढवलेला मोठे_केलेला
परिवारांतलें: घरगुती घरचा कौटुंबिक कुटुंबाचा कुटुंबाविषयीचा कुटुंबविषयक कुटुंबासंबंधीचा कुटुंबाशी_संबंधित
परिवारीक: कुटुंबवत्सल
परिसिमीत: सीमांकित सीमित
परोपकारी: परोपकारी
पर्यायहीण: उपायरहित निरुपाय
पर्यायी: वैकल्पिक ऐच्छिक पर्यायी समानार्थी पर्यायवाची
पर्यावरणी: पर्यावरणीय
पर्शियन: इराणी इराणी
पळपी: पळपुटा पळपुट्या पळपट्या पळपटा
पळपुटो: पळपुटा पळपुट्या पळपट्या पळपटा
पळयिल्लें: अवलोकित पाहिलेला हरणीय हरण्याजोगा हरण_करण्याजोगा परिचित पूर्व_परिचित ज्ञात अभिज्ञात
पळून_गेल्लो: सेवेपासून_पळालेला सेवेपासून_विमुख_झालेला सेवा_सोडून_पळालेला अपसृत
पळोवपा_सारकें: प्रेक्षणीय दर्शनीय
पवित्र: पवित्र पावन
पसंतीचें: प्रिय आवडता
पसरायिल्लें: पसरलेला पसरवलेला फैलवलेला प्रसारित
पसरिल्लें: स्थलांतरित स्थानच्युत विखुरलेला विखरलेला
पसून: -निर्मित -जन्य -ज
पस्तिसावें: पस्तिसावा
पस्तीस: पस्तीस
पांखां_बगरचें: अपक्ष
पांच: पाच पंच-
पांच_पटीचें: पाच_पट
पांचपट: पाच_पट
पांचरंगी: पंचरंगी
पांचवें: पाचवा
पांय_ओडपी: अपकर्षक
पांयां_पड_सारकें: प्रणम्य
पांसठ: पासष्ठ
पांसठावें: पासष्टावा
पाकिस्तानी: पाकिस्तानी
पाखंडी: ढोंगी दांभिक लबाड पाखंडी
पाखाट्यांविरयत: अपक्ष
पाचक: हलका
पाचवें: हिरवा हिरवागार हिरवा
पाचवेंचार: हिरवागार हिरवागार
पाचारिल्लें: संबोधित उद्दिष्ट उद्देशिलेले
पाझरप: दयार्द्र सदय दयाळू
पाठ्य: वाचनीय वाचण्याजोगा पठनीय
पाड: घाणेरडा अस्वच्छ गलिच्छ घाण मलिन गचाळ गदळ अशुद्ध अमुक अमुकअमुक अमका तमुक तमुकतमुक तमका वाईटतर
पाड_जाल्लें: सडका नासका कुजका
पाडिल्लें: पाडलेला
पाडें: घाणेरडा अस्वच्छ गलिच्छ घाण मलिन गचाळ गदळ अशुद्ध
पाडो: घृणा_करणारा
पाण: पाण्याचा
पाणाविल्लो: पाणवलेला अश्रुपूर्ण डबडबलेला
पाणिनी: पाणिनीय
पाणिनीचें: पाणिनीय
पातकी: पाप
पातयेवणें: विश्वसनीय विश्वासपात्र विश्वासार्ह प्रामाणिक विश्वासू खात्रीलायक सचोटीचा
पातळ: विरळ विरल पांचट पातळ द्रव पातळ थुलथुलीत पातळ तलम
पातळिल्लें: विखुरलेला विखरलेला -व्यापी -व्याप्त व्याप्त_असलेला व्यापून_राहिलेला
पात्र: सत्पात्र योग्य लायक पात्र
पानगळी: पानझडीचा
पानझडी: पानझडीचा
पानाळ: सपर्ण
पापहीण: निष्पाप अनघ
पापी: पापी पातकी अधम पतित पापकर्मी
पारखुपी: दूरदर्शी दीर्घदर्शी दीर्घदृष्टी
पारदर्शक: पारदर्शक
पारदर्शी: पारदर्शक
पारपांरीक: पारंपरिक परंपरागत
पारस्पारीक: परस्पर
पार्थी: पार्थी
पार्थीव: पार्थिव
पालक: पोशिंदा पालनकर्ता
पालविल्लें: थंड शांत
पालवी: गौण
पालेल्लें: अंकुरित पल्लवित
पाळपी: पोशिंदा पालनकर्ता
पाळिल्लें: पाळीव
पाव: पाव एक_चतुर्थांश चतुर्थांश चौथा
पावणे_दोनशें: पावणेदोनशे एकशे_पंचाहत्तर
पावन: कृतार्थ कृतकृत्य धन्य
पावयिल्लें: फेडलेला
पावली_घालपी: पादचारी
पावली_मारपी: पादचारी
पावसा_विणें: न_बरसणारा
पावसा_विरयत: न_बरसणारा
पावसाळी: पावसाळी
पावूण: पाऊण
पाशाणी: खडकाळ दगडधोंड्यांचा तेलतूपविरहित स्नेहकविरहित
पाशुपत: शिव शैव
पाश्चात्य: पाश्चात्त्य पाश्चिमात्य
पाश्च्यात्य: पश्चिमी पश्चिम
पास: उत्तीर्ण सफल पास यशस्वी संमत
पिंजकें: फाटका
पिंजिल्लें: फाटकातुटका फाटका
पिकसावं: चिंताग्रस्त चिंताक्रांत चिंतातुर सचिंत चिंतामग्न चिंतित चिंताकुल चिंतावलेला
पिकाळ: सुपीक उपजाऊ पिकाऊ सुपीक
पिकिल्लें: पिकलेला तयार पक्व
पिकें: पिकलेला तयार पक्व
पिचो: वेडा येडा पिसा वेडापिसा पागल
पिडिल्लें: पीडित सतावणूकग्रस्त सतावलेला
पिडिल्लो: पीडीत त्रस्त -ग्रस्त
पिडीत: पीडित गांजलेला दुःखित रंजलेला त्रस्त दुःखी
पिडेस्त: रोगग्रस्त व्याधिग्रस्त आजारी दुखणाईत रुग्णाईत दुखणेकरी रोगट दुःखी कष्टी दुःखित पीडित व्यथित आर्त ग्रस्त
पितारिल्लें: चित्रित चित्रातील चित्रातला
पितारीत: चित्रित चित्रातील चित्रातला
पित्ताचें: पैत्तिक
पिनिल्लें: फाटका
पियेनासपाचें: अपेय
पिशें: वेडा पागल खुळा येडा पिसा भ्रमिष्ट खुळचट
पिसांट: मूर्ख बावळा बावळट अज्ञानी मूढ जड मंद निर्बुद्ध मठ्ठ बेअक्कल शंख बिनडोक अडाणी ढ ठोंब्या अर्धवट बेअक्कली भोट
पिसाट: वेडा येडा पिसा वेडापिसा पागल
पिसावल्लें: उन्मत्त मस्तवाल मत्त मस्तखोर
पिसो: लहरी छांदीष्ट झक्की
पिस्त्या_कोराचें: पिस्ताई
पुजक: उपासक
पुजनीय: पूजनीय पूज्य पूजार्ह
पुजपा_सारकी: पूजनीय पूज्य पूजार्ह
पुजारी: उपासक
पुज्य: पूजनीय पूज्य पूजार्ह पूज्यनीय पूजार्ह पूज्य वंद्य सन्माननीय
पुण्य: मंगल शुभ
पुण्यवान: पुण्यवान पुण्यवंत पुण्यशील
पुण्यहीण: पाप
पुण्यात्मो: पुण्यवान पुण्यवंत पुण्यशील
पुत्र_वत्सल: वत्सल
पुत्रवान: पुत्रवान
पुनरावृत्तीचें: निवृत्तीवेतनविषयक निवृत्तीवेतनाविषयीचा निवृत्तीवेतनाशी_संबंधित निवृत्तीवेतनासंबंधीचा
पुनरुक्त: पुनरुक्त
पुनर्नियुक्ती: पुनर्नियुक्त
पुरक: पूरक
पुराणीक: पौराणिक
पुरातात्वीक: पौरातत्त्विक पौरातात्त्विक पुरातात्त्विक पुरातत्त्वाबाबतचा पुरातत्त्वाविषयीचा पुरातत्त्वविषयक पुरातत्त्वासंबंधीचा पुरातात्त्विक
पुराय: आनंदी प्रसन्नचित्त संपूर्ण सबंध अख्खा पूर्ण साद्यन्त पुरेपूर समग्र अख्खा अखंड सबंध सलग सगळा अखिल संपूर्ण सर्व सबंध अख्खा आख्खा उभा समग्र समस्त सारा अवघा तमाम भरपूर खूप परिपूर्ण
पुरुशी: पुरुषी पुरषी
पुरूश: नर
पुरो: पुरेसा गरजेपुरता
पुरो_जाल्लें: क्लांत दमलेला थकलेला भागलेला शिणलेला श्रमविकल
पुरो_जावपाचें: थकविणारा टेक_आणणारा थकवा_आणणारा दमविणारा
पुर्तगाली: पोर्तुगीज
पुर्तुगेझ: पोर्तुगीज
पुर्वापार: पैतृक
पुर्विल्लें: प्राचीन पुरातन जुना जुनाट आर्ष पूर्वीचा गतकालीन
पुर्विल्लो: पूर्वीचा आधीचा अगोदरचा मागचा पहिला जुना
पुश्ट: बलवर्धक शक्तिवर्धक
पुश्टीक: पौष्टिक पोषक
पुसट: अस्पष्ट धूसर अस्पष्ट पुसट अंधूक धुरकट धुकट
पुस्तकाकार: पुस्तकाच्या_आकाराचा
पुस्तकी: पुस्तकी
पूत_आशिल्लो: पुत्रवान
पूर्ण: संपूर्ण सबंध अख्खा पूर्ण साद्यन्त पुरेपूर समग्र अख्खा अखंड सबंध सलग सगळा अखिल संपूर्ण सर्व सबंध अख्खा आख्खा उभा समग्र समस्त सारा अवघा तमाम परिपूर्ण
पूर्णप्रभावीत: पूर्णपणे_प्रभावित
पूर्वी: पूर्व
पृश्ठ: मागचा मागला मागील पाठीमागचा
पृश्ठांकीत: पृष्ठांकित
पेंवपी: तरणपटू
पेज: तोंडबडव्या तोंडफटाल्या
पेझाद: शक्तिशाली बलवान शक्तिमान शक्तिवान शक्तिवंत बलशाली जबर बलाढ्य बलवंत
पेटयिल्लें: जळता
पेटिल्लें: हत
पेय: पेय पिण्यायोग्य
पेयहीण: अपेय
पेशीपुंजुल्याचें: पेशीय
पॉझिट्रॉन: धन धनात्मक
पॉलिशा_बगरचें: न_तासलेला
पोंग: कुबडा कुबड्या
पोंदलें: खालचा
पोकळ: पोकळ रिकामा रिता
पोको: पोकळ रिकामा रिता
पोजडें: अश्लील अचकट_विचकट घाणेरडा वाह्यात अश्लील अचकटविचकट घाणेरडा वाह्यात
पोटभर: पोटभर
पोटयो: खादाड अधाशी
पोटसरें: सरीसृप सरपटणारा
पोटाचें: उदरीय उदरांत्रीय
पोर: संकरित अनौरस जारज अकरमाशी अकरमाशा अक्करमाशी अक्करमाशा हरामजादा
पोरणें: जर्जर जीर्ण झिरझिरीत प्राचीन पुरातन जुना जुनाट आर्ष पूर्वीचा गतकालीन गेलेला
पोल: पोकळ रिकामा रिता
पोलिशी: पोलंडी पोलिश
पोलो: पोकळ रिकामा रिता
पोशिल्लें: पाळीव
पोशेगवाली: वस्त्र_घातलेला कपडे_घातलेला
पोसकें: दत्तक
पोसपी: पोशिंदा पालनकर्ता
प्रकाशी: प्रकाशक
प्रकाशीत: प्रकाशित प्रकाशमान तेजोमय देदीप्यमान उज्ज्वल उज्ज्वलित तेजस तेजाने_युक्त
प्रक्षेपक: मारा_करणारा फेकणारा
प्रखर: कुशाग्र तल्लख प्रखर
प्रगट: अभिव्यक्त व्यक्त_केलेला प्रकट_केलेला जाहीर_केलेला उघड_केलेला अनावृत_केलेला उघड_झालेला
प्रगतिशील: विकसित
प्रगती_केल्लो: प्रगत पुरोगामी पुढारलेला अग्रेसर
प्रगतीकर्तो: प्रगती_करणारा
प्रचलीत: सुरू_केलेला चालू_असलेला प्रचलित रूढ चालू
प्रचारीत: प्रचारित
प्रजातंत्री: लोकशाही प्रजासत्ताक
प्रजातंत्रीक: प्रजासत्ताक
प्रतापी: null
प्रतिगामी: प्रतिगामी
प्रतिद्वंद्वी: प्रतिस्पर्धी
प्रतिपादीत: प्रतिपाद्य
प्रतिभावान: प्रतिभावंत प्रतिभाशाली प्रतिभावान प्रतिभासंपन्न
प्रतिभाशाली: प्रतिभावंत प्रतिभाशाली प्रतिभावान प्रतिभासंपन्न
प्रतिरुपी: एकसमान एकसारखा हुबेहूब समरूप तंतोतंत_सारखे
प्रतिश्ठीत: प्रतिष्ठित सन्माननीय आदरणीय संभावित मातबर मातब्बर माननीय प्रतिष्ठित मातब्बर सुप्रतिष्ठित आदरणीय माननीय सन्माननीय संभावित मातबर
प्रतिस्पर्धक: प्रतिस्पर्धी
प्रतीसर्तक: प्रतिस्पर्धी
प्रत्यक्ष: इंद्रियगम्य इंद्रियगोचर इंद्रियग्राह्य इंद्रियसंवेद्य गोचर डोळ्यासमोरील डोळ्यादेखतचा प्रत्यक्ष
प्रत्येक: प्रत्येक एकेक
प्रथम: प्रथम पहिला
प्रदर्शनी: प्रदर्शनीय
प्रदर्शीत: प्रदर्शित प्रदर्शित दाखवलेला
प्रदुशीत: दूषित प्रदूषित दूषित प्रदूषित खराब
प्रदेशीक: प्रांतिक प्रांतीय
प्रधान: मुख्य प्रधान
प्रभावकारी: प्रभावी परिणामकारक परिणामकारी
प्रभावशाली: प्रभावशाली
प्रभावशुन्य: प्रभावहीन प्रभावशून्य
प्रभावहीण: प्रभावहीन प्रभावशून्य प्रभावहीन प्रभावशून्य
प्रभावी: प्रभावशाली प्रभावी प्रभावशाली परिणामकारक उपयुक्त प्रभावशाली_असलेला प्रभावी परिणामकारक परिणामकारी
प्रभावीत: प्रभावित
प्रमाणीक_वेव्हारी: सदवर्तनी सुस्वभावी
प्रमाणीत: प्रमाणित प्रमाणित सिद्ध शाबीत
प्रमाणें: अनुकूल फायदेशीर धार्जिणा सानुकूल अनुरूप समान सारखा सम सदृश सदृश्य एकरूप
प्रमेयी: साध्य सिद्धनीय सिद्धतास्वरूप सिद्धताकारक
प्रयत्नशील: प्रयत्नशील उद्यमी उद्यमशील प्रयत्नवंत उद्योगी उद्योगशील प्रयत्नवान
प्रवासी: स्थलांतरी स्थलांतरीय
प्रवाहीत: अनुक्रमाने_येणारा अनुक्रमाने_असणारा क्रमिक क्रमाने_येणारा क्रमाने_शेजारचा क्रमाने_लगेचचा क्रमानुवर्ती मालिकेतील_लगतचा
प्रवेशीत: प्रविष्ट शिरलेला घुसलेला
प्रशंसक: प्रशंसक
प्रशस्त: भव्य शानदार आलिशान प्रशस्त
प्रशासनीक: प्रशासकीय शासकीय
प्रशिक्षीत: प्रशिक्षित
प्रश्नसुचक: प्रश्नार्थक
प्रश्नार्थी: प्रश्नार्थक
प्रसन्न: प्रसन्न आनंदित आनंदी आल्हादित प्रफुल्लित मुदित प्रमुदित खुश
प्रसन्नचित्त: प्रसन्नचित्त आनंदी खुशमिजाज
प्रसन्नमूख: प्रसन्नमुख प्रसन्नवदन
प्रसारीत: ध्वनिक्षेपित
प्रसिद्ध: प्रसिद्ध विख्यात प्रख्यात ख्यातनाम नावाजलेला नामांकित सुविख्यात सुप्रसिद्ध नाणावलेला ख्यात नामवंत बडा जगप्रसिद्ध जगद्विख्यात विश्वविख्यात
प्रस्तावीत: प्रस्तुत सदर सदरहू
प्रस्तुतीकरणाचें: null
प्रांतीय: प्रांतिक प्रांतीय
प्राकृतीक: नैसर्गिक प्राकृतिक
प्राचीन: प्राचीन पुरातन जुना जुनाट आर्ष
प्राज्ञी: विदुषी पंडिता
प्राणघातक: मारक घातक नाशकारक
प्राथमीक: प्राथमिक प्रारंभिक
प्रादेशीक: प्रांतिक प्रांतीय
प्राप्त: हस्तगत प्राप्त
प्राप्त_केल्लें: उपलब्ध प्राप्त मिळलेला
प्रामाणीक: विश्वसनीय विश्वासपात्र विश्वासार्ह प्रामाणिक विश्वासू खात्रीलायक सचोटीचा null प्रामाणिक इमानदार चोख सालस साळसूद निःकपट सत्प्रवृत्त नेक
प्रायोजीत: प्रायोजित
प्रारब्दवादी: दैववादी
प्रार्थनीय: प्रार्थनीय
प्रासंगीक: प्रासंगिक
प्रीयभाशी: मधुरभाषी
प्रेमपूर्ण: चिक्कार खूप रग्गड
प्रेममय: चिक्कार खूप रग्गड
प्रेमासक्त: प्रेमासक्त अनुरक्त अनुरागी आसक्त
प्रेमी: प्रेमिक
प्रेरक: प्रेरणादायी प्रेरक
प्रेरणा_दिवपी: प्रेरणादायक
प्रेरणादायक: प्रेरणादायक
प्रेरणास्पद: प्रेरणादायक
प्रेरीत: प्रेरित
प्रेशीत: पाठवलेले धाडलेला प्रेषित
प्रोत्साहीत: null
प्रौढ: परिपक्व
फकत: फक्त केवळ निव्वळ निवळ नुसता नुस्ता नुस्था निस्ता केवल
फकीर: तुटपुंजा
फटकळ: तोंडाळ फटकळ स्पष्टवक्ता
फटकिरें: खोटारडा खोटा खोटारडा असत्य चुकीचा
फटकीरपणाचें: खोटा खोटारडा असत्य चुकीचा
फटाश्यो_मारपी: गप्पिष्ट थापाड्या बाताड्या गप्पी
फटींग: खोटारडा निराधार पोकळ तथ्यहीन लबाड फसव्या ठक लुच्चा लफंगा ठकबाज ठकसेन धूर्त अर्क भामटा असभ्य अशिष्ट वाईट अभद्र ग्राम्य लुच्चा लफंगा लबाड नीच पाजी हलकट बदमाश बेईमान अप्रामाणिक बेइमानी बेमान धोकेबाज कपटी चालू धूर्त पाताळयंत्री
फटीचें: खोटा खोटारडा असत्य चुकीचा कपोलकल्पित मिथ्या
फटोवणेचें: बळकावलेला हिसकावलेला
फडफडीत: अम्लान टवटवीत प्रफुल्ल ताजे
फरारी: भगोडा पळपुट्या
फळदिणें: फलप्रद
फळपी-फुलपी: भरभराट_झालेला भरभराटीस_आलेला वाढता
फळां_दिवपी: फळ_देणारा
फळां_नाशिल्ले: फलहीन
फळां_लागपी: फळ_देणारा
फळां_लागिल्लें: फळदार फळांनी_लगडलेले
फळांचें: फळदार फळांनी_लगडलेले
फळादीक: यशस्वी सफल सफळ
फांकिल्लें: विखुरलेला विखरलेला
फांफार्रांव: उद्धट चढेल अशिष्ट उद्दाम अविनयशील धृष्ट उर्मट
फाकिवंत: प्रसिद्ध विख्यात प्रख्यात ख्यातनाम नावाजलेला नामांकित सुविख्यात सुप्रसिद्ध नाणावलेला ख्यात नामवंत बडा
फाटलें: मागचा मागला मागील पाठीमागचा नंतरचा
फाटलो: पूर्वीचा आधीचा अगोदरचा मागचा पहिला जुना
फाटल्या: गेलेला
फाटल्यान: वाकडा
फाटल्यानचें: अपरोक्ष_उच्चारला_गेलेला अपरोक्ष_बोलला_गेलेला अपरोक्ष_म्हटला_गेलेला
फाटीं_उरिल्लो: मागे_पडलेला मागे_राहिलेला null
फाटीं_सरनासपी: अपरावर्ती न_परतणारा माघार_न_घेणारा
फाटीचें: खोटा नकली
फातरा_काळजाचो: पाषाणहृदयी निर्दय कठोर निष्ठुर वज्रहृदयी दयाशून्य क्रूर दयाहीन
फाफडिल्लें: पसरलेला पसरवलेला फैलवलेला प्रसारित
फाफशिल्लें: विखुरलेला विखरलेला
फामाद: प्रसिद्ध विख्यात प्रख्यात ख्यातनाम नावाजलेला नामांकित सुविख्यात सुप्रसिद्ध नाणावलेला ख्यात नामवंत बडा सुप्रसिद्ध सुविख्यात सुख्यात जगप्रसिद्ध जगद्विख्यात विश्वविख्यात
फायदो_खावपी: नफेखोर
फायद्याचें: फलप्रद लाभकारी लाभदायक फायदेशीर फलदायी किफायतशीर फलद्रूप
फारायल्लें: चोरलेला अपह्रत
फारायिल्लें: हरणीय हरण्याजोगा हरण_करण्याजोगा
फारावपी: लुटारू चोर
फाराविल्लो: अडकलेला
फारीक_करूंक_नाशिल्लें: न_भरलेला
फारीक_करून_घेतिल्लें: भरलेला
फारीक_केल्लें: फेडलेला
फालतू: भंकस निरुपयोगी टाकाऊ व्यर्थ अनुपयोगी अनुपयोग निष्फळ निकृष्ट हीन अधम हलका वाईट भिकार भुक्कड कुत्सिक अनावश्यक निरर्थक अर्थशून्य अर्थहीन व्यर्थ फोल वायफळ अद्वातद्वा वेडेवाकडे भलतेसलते अचकटविचकट
फाळीक_लागिल्लो: मरणासन्न मरणाधीन
फावोशी: null
फावोशें: अनुकूल फायदेशीर धार्जिणा सानुकूल अनुरूप सुसंगत उचित योग्य साजेसा अनुरूप फक्कड योग्य उचित माफक यथायोग्य योग्य लायक पात्र अनुकूल
फिकें: रंगहीन फिका
फिटफिटें: तकलादू कमजोर नाजूक कच्चा तकलादू
फिन: बुद्धिमान बुद्धिमंत बुद्धिवान हुषार अक्कलवान
फिनलॅण्डी: फिनी फिनिश
फिरकेचें: पेच_असलेला
फिलिपीनी: पिलिपिनो
फिल्मी: चित्रपटातील चित्रपटातला चित्रपटी चित्रपटीय
फिशाल: योग्य लायक समर्थ सक्षम पात्र काबील बुद्धिमान बुद्धिमंत बुद्धिवान हुषार अक्कलवान
फिशाळ: माहितगार जाणणारा जाणकार ज्ञाता
फीट: तंग घट्ट आवळ अडस नीट_होणारा मापाचा व्यवस्थित_बसणारा नीट_होणारा मापशीर ठीकठाक व्यवस्थित तंदुरूस्त
फुकट: निःशुल्क मोफत फुकट विनाशुल्क विनामूल्य चकटफू
फुक्याचें: वायफळ
फुक्याचें_खावपी: फुकट्या फुकटा फुकटखोर
फुटिल्लें: फाटलेला
फुटीर: असंघटित
फुटें: फिका फिक्का फिक्कट
फुडलें: पुढचा पुढील
फुडलो: पुढील पुढचा समोरचा समोरील आघाडीचा अग्रभागीचा
फुडल्या: आगामी पुढील
फुडाराचें: भावी भविष्यकालीन भविष्यातील आगामी पुढील पुढचा
फुलां_बगरचें: अपुष्प
फुलांचें: फुले_देणारा फुलकारी
फुलांनी_भरिल्लें: पुष्पित
फुलिल्लें: उमललेला विकसित उमललेला फुललेला सपुष्प
फुलूंक_नाशिल्लें: मुका न_उमललेला अपुष्पित न_फुललेला न_बहरलेला
फुश्यारी_मारपी: गप्पिष्ट थापाड्या बाताड्या गप्पी
फॅल: अनुत्तीर्ण नापास
फेसाळ: फेसाळ फेसयुक्त
फॉरेन: विदेशी परदेशी परराष्ट्रीय इतर_देशाचा इतर_देशाविषयीचा इतर_देशासंबंधीचा इतर_देशाशी_संबंधित
फोडपी: तुकडे_करणारा
फोर्त: मजबूत भक्कम पक्का दणकट बरा ठीक
फोलगी: अपव्ययी उधळ्या
फोल्गी: अपव्ययी उधळ्या उधळखोर खर्चीक खर्चक खर्चाळू उडाऊ उधळमांडक्या विलासी सुखासीन सुखलोलुप विषयलोलुप विषयासक्त भोगलोलुप भोगासक्त विषयलंपट सुखासक्त विलासासीन विलासासक्त विलासलोलुप विषयी विषयासीन
फौजी: लष्करी फौजी
फ्राक: दुबळा दुर्बल निर्बल कमकुवत
फ्रान्सी: फ्रेंच
फ्रेंच: फ्रेंच फ्रेंच
फ्रेन्च: फ्रेंच फ्रेंच
बंगाली: बंगाली बंगाली बांगला बंगाली
बंजारा: बंजारा वणजारा भटका
बंडखोर: फितुर
बंद: अवरुद्ध रोधलेला बंद लावलेला
बंद_केल्लें: थांबलेला
बंदखणीचे: तुरुंगाचा
बंदिस्त: बंदीवान
बंदो: खुशामदी खुशामती तोंडपुज्या स्तुतिपाठक खुशमस्कर्‍या
बकासूर: खादाड अधाशी
बकें: बारीक शिडशिडीत सडसडीत रोड लुकडा काटकुळा हडकुळा फाटका वाळकुडा वाळलेला किरकोळ हडकुळा हडक्या हडकलेला काडीपैलवान
बचत_केल्लें: साठवलेला राखलेला
बडबडे: वाचाळ बडबड्या बोलघेवडा बोलका मुखर
बडबडें: गप्पिष्ट गपाड्या गप्पी बाताड्या
बडबडेचें: भंकस
बडबडो: तोंडबडव्या तोंडफटाल्या
बडयिल्लें: हत
बडाय_मारपी: गप्पिष्ट थापाड्या बाताड्या गप्पी
बडीची: पैतृक
बडीचें: आनुवंशिक वंशपरंपरागत पिढीजात
बत्तिसावें: बत्तिसावा
बत्तीस: बत्तीस
बदनामिकारक: निंदात्मक निंदेवर_आधारित निंदेने_युक्त
बदल: बदलेला परिवर्तन_झालेला सुधारेला
बदलनासपी: अपरिवर्तनीय
बदलपी: परिवर्तनशील परिवर्तनीय
बदली_केल्लो: बदली_झालेला स्थानांतरित
बदामी: बदामी
बदिस्त: बद्ध
बद्‍दल: विषयक संबंधी सबंधीत
बनारसी: बनारसी
बनावट: वरकरणी वरपांगी औपचारिक दिखाऊ दिखाऊ कृत्रिम नाटकी कपोलकल्पित
बरयल्लें: कागदावर_लिहिलेला
बरयल्लो: लिखित लिहिलेला लेखी
बरी: उत्तम उत्कृष्ट झकास फर्मास फर्डा खूप_मोठा भला_मोठा
बरे_वळखीचो: सुपरिचित
बरें: चांगला भला श्लील साध्य चवदार रुचकर चविष्ट स्वादिष्ट सुरस लज्जतदार दिव्य चांगला
बरें_जायना__अशें: असाध्य
बरें_मागपी: हितचिंतक शुभचिंतक हितैषी
बरो: सज्जन भद्र सत्प्रवृत्त सद्वर्तनी चांगला सरस बरा ठीक
बरोबर: योग्य उचित माफक यथायोग्य शुद्ध
बरोवन_दवरपा_सारकें: लिहिण्याजोगा लेखनीय लेख्य
बर्फाळ: बर्फाळ बर्फाच्छादित हिमज बर्फमय हिमाच्छादित
बर्मी: म्यानमारी ब्रह्णदेशी ब्रह्मदेशीय ब्रह्मदेशीचा ब्रह्मदेशाचा ब्रह्मी म्यान्मारी ब्रह्णदेशी ब्रह्मदेशीय ब्रह्मदेशीचा ब्रह्मदेशाचा ब्रह्मी ब्रह्मी
बर्‍या_कुळाचें: कुलीन कुलवान कुलवंत
बर्‍या_घराण्यांतलें: कुलीन कुलवान कुलवंत
बलदंड: बाहुबली
बलात्कारी: बलात्कारी
बल्ल: जाड जाडा जाडजूड लठ्ठ स्थूल
बळकट: पीळदार कसलेला भरदार आटीव मजबूत दणगट
बळजबरी_करपी: बलात्कारी
बळवर्धक: बलवर्धक शक्तिवर्धक
बळादीक: शक्तिशाली बलवान शक्तिमान शक्तिवान शक्तिवंत बलशाली जबर बलाढ्य बलवंत
बळिश्ट: शक्तिशाली बलवान शक्तिमान शक्तिवान शक्तिवंत बलशाली जबर बलाढ्य बलवंत मजबूत भक्कम पक्का दणकट पीळदार कसलेला भरदार आटीव मजबूत दणगट महाबळी
बशिल्लें: स्थानापन्न बसलेला विराजमान आरूढ
बसयिल्लें: null
बहिर्दृश्टी: बहिर्मुख
बहिर्मूख: बहिर्मुख
बहिश्कृत: बहिष्कृत बहिष्कृत वाळीत_टाकलेला
बांदिल्लें: रचित कृत विरचित निर्मित रचलेला
बाकी: देय
बाकीचें: उरलेला बाकी शिल्लक उर्वरित अवशिष्ट उरलेली राहिलेला उर्वरित बाकी
बागवल्लें: नम्र वाकलेला लवलेला अवनत ओणवा
बाजारांतलें: बाजारी
बाजाराचें: बाजारी
बाजारी: बाजारी
बाजिराव: रंगेल
बात्तर: बहात्तर
बाद: रिकामटेकडा उडाणटप्पू निरुद्योगी अमुक अमुकअमुक अमका तमुक तमुकतमुक तमका
बाद_जावंक_नाशिल्लें: दुखापत_न_झालेला
बादीत: बिघडलेला नादुरुस्त
बापायचें: पैतृक
बापोल: चुलत
बायजणपणाचे: बायकी जनानी
बायलांचें: बायकी बायकी जनानी
बायलाडे: बायकी जनानी
बारा: बारा
बारामाही: बारामाशी बारामाशी
बारावें: बारावा
बारीक: बारीक शिडशिडीत सडसडीत रोड लुकडा काटकुळा हडकुळा फाटका वाळकुडा वाळलेला किरकोळ हडकुळा हडक्या हडकलेला काडीपैलवान सूक्ष्म बारीक इवला बारीक कृश हडकुळा रोड बारीक किडकिडीत लुकडा वाळलेला छोटा लहान
बारीक-सारीक: किरकोळ फुटकळ लहान-सहान
बारीकसाणीचें: सूक्ष्मदर्शी सूक्ष्मद्रष्टा सूक्ष्मदृष्टीचा
बाळंटेर: एकुलता एकुलताएक
बाळक: नवजात
बावन: बावन्न
बावनावें: बावन्नावा
बाविल्लें: निस्तेज तेजोहीन फिका कळाहीन कांतिहीन फिकट म्लान प्रभाहीन निष्प्रभ म्लान कोमेजलेला कळाहीन निस्तेज फिका फिक्का मलूल निस्तेजस्क उदास खिन्न उदासीन कोमेजलेला वाळक्या सुकलेले
बावीस: बावीस
बावीसावें: बाविसावा
बाशें: शिळा शिळेपाका
बासठ: बासष्ट
बासठावें: बासष्टावा
बाह्य: बाह्य बाहेरचा बाहेरील
बिंधास्त: खुशालचेंडू
बिकट: प्रतिकूल विपरीत विषम कठीण अवघड
बिनकांटयारें: निष्कंटक
बिनपावशी: न_बरसणारा
बियांचें: बिजाळ बियाळ
बियाळ: बिजाळ बियाळ
बी: इत्यादी
बीन: इत्यादी
बीन_विखारी: बिनविषारी
बीनतारी: बिनतारी
बीनपगारी: बिनपगारी
बीनविरोध: प्रतिकारशून्य
बुडकुलो: लठ्ठ
बुडा_विरयत: बिनबुडाचा
बुडिल्लें: जलाच्छादित जलगत
बुडिल्लो: अस्तंगत मावळलेला अस्त
बुदवंत: बुद्धिजीवी बुद्धिमान बुद्धिमंत बुद्धिवान हुषार अक्कलवान विद्वान सुविद्य व्यासंगी ज्ञानी पंडित
बुद्दिजिवी: बुद्धिजीवी
बुद्दीक: बौद्धिक
बुद्दीहीण: मतिमंद
बुन्यादीक: NULL
बुरकाचें: सछिद्र छिद्रमय
बुरशें: घाणेरडा अस्वच्छ गलिच्छ घाण मलिन गचाळ गदळ अशुद्ध अश्लील अचकट_विचकट घाणेरडा वाह्यात अश्लील अचकटविचकट घाणेरडा वाह्यात
बुराकाची: सछिद्र सच्छिद्र छिद्रमय जाळीदार
बुलेट_प्रूफ: गोळीरोधी
बे: दोन
बेकायदेशीर: अवैध बेकायदा बेकायदेशीर नियमबाह्य गैरकायदेशीर
बेकार: निरुद्योगी रिकामटेकडा उडाणटप्पू निरुद्योगी मोकळा रिकामा फावला बेकार बेरोजगार
बेकारलवडी: रिकामटेकडा उडाणटप्पू निरुद्योगी
बेगडी: वरकरणी वरपांगी औपचारिक दिखाऊ दिखाऊ कृत्रिम नाटकी देखणा राजबिंडा औपचारिक भपकेबाज
बेगीन: जलद वेगवान द्रुत
बेघर: निवासी अनिकेत गृहहीन बेघर
बेचव: अळणी सपक फिके
बेचाळिसावें: बेचाळिसावा
बेचाळीस: बेचाळीस
बेचैन: उद्विग्न अशांत उदास खिन्न विषण्ण दुश्चित अस्वस्थ बेचैन विमनस्क
बेजार: अप्रसन्न नाखूश असंतुष्ट नाराज रुष्ट .दुःखी निराश हताश खिन्न उदास
बेजोड: सलग बिनजोडाचा
बेताल: बेताल बेताल
बेदाग: डागरहित
बेधडक: निःसंकोची निसंकोची निस्संकोची
बेनुल्ल: आधुनिक नवा नवीन नूतन अर्वाचीन अद्यतन
बेपरवा: उपेक्षणीय उपेक्ष्य
बेपरवाय: बेपर्वा बेफिकीर हलगर्जी निष्काळजी
बेपर्वाय: मान_न_ठेवणारा किंमत_न_ठेवणारा
बेपर्वाहीत: उपेक्षित
बेफिकीर: खुशालचेंडू
बेबदड: दारुडा दारुड्या दारूबाज बेवडा मद्यपी प्यायलेला
बेबदो: नशाखोर नशाबाज दारुडा दारुड्या दारूबाज बेवडा मद्यपी दारुडा दारुड्या दारूबाज बेवडा मद्यपी प्यायलेला
बेमुदत: बेमुदत
बेयमान: कृतघ्न निमकहराम बेईमान हरामखोर बेईमान अप्रामाणिक बेइमानी बेमान
बेलगाम: बेलगाम बेलगामी
बेलरसी: बेलोरशियाई बेलोरशियन बेलोरशियन
बेल्जियन: बेल्जियन
बेल्जियमी: बेल्जियन बेल्जियमी
बेवारशी: पोरका बेवारशी अनाथ असहाय निराश्रित निराधार बेवारशी बेवारशी बेवारस
बेशुद्ध: बेशुद्ध मुर्छित बेहोष सुन्न
बेसावध: बेसावध असावध
बेसूर: बेसूर बेताल
बोंडें: मूर्ख बावळा बावळट अज्ञानी मूढ जड मंद निर्बुद्ध मठ्ठ बेअक्कल शंख बिनडोक अडाणी ढ ठोंब्या अर्धवट बेअक्कली भोट
बोटी_वयलें: जहाजाचा
बोडको: निष्पर्ण
बोधक: वाचक वाच्य मुख्य
बोध्य: सुबोध सोपा सुगम बाळबोध
बोलकें: बोलता वाक्पटू वाक्चतुर बोलका
बोलिवियाचें: बोलिव्हियन
बोलिवियायी: बोलिव्हियन
बोसनियन: बोसनियाई बोसनियाई
बौद्ध: बौद्ध
बौद्ध_धर्मावलंबी: बौद्ध
बौद्धीक: बौद्धिक
ब्यांयशीं: ब्याऐंशी
ब्याणव: ब्याण्णव
ब्याण्णवावें: ब्याण्णवावा
ब्रह्मज्ञानी: आध्यात्मज्ञाता ब्रह्मज्ञानी आध्यात्मज्ञानी सिद्ध
ब्रिटीश: ब्रिटिश इंग्रज इंग्लिश ब्रिटीश ब्रिटनी ब्रिटनचा
भंगीत: खंडित भग्न तुटलेला भंगलेला मोडलेला
भंगुर: ठिसूळ
भंयकर: भयंकर भयानक भीतीदायक भीषण भयावह भयाण भेसूर भयकारी भयकारक भीतिप्रद विकट भयपूर्ण भयसान भयोत्पादक घोर भेंसूर भेसूड भेसूंड फार खूप अतोनात आतोनात पुष्कळ प्रचंड अपरिमित अतिशय गडगंज चिक्कार चिकार भरमसाट मुबलक विपुल मोप रगड रग्गड सज्जड भारी बखळ बहुत भरपूर भरमसाठ भलता भाराभर आत्यंतिक
भंयभीत: भयभीत घाबरलेला भ्यालेला भयग्रस्त
भक्त: उपासक
भक्तवत्सल: भक्तवत्सल
भक्तिपूर्ण: भक्तिपूर्ण
भक्तीहीण: भक्तिहीन भक्तिशून्य
भक्ष्य: खाद्य भोज्य भक्ष्य ग्राह्य खाण्याजोगा
भगवें: कुसुंबी
भगवो: भगवा
भटकें: भटक्या भटकणारा उडाणटप्पू उनाड उनाडटप्पू
भटा_बगरचें: अब्रह्मण्य
भडक: प्रक्षोभक भडकवणारा उत्तेजक भडकदार चमकदार भडक
भड्डें: कमी_प्रतिचा खालच्या_प्रतिचा
भड्डो: रवाळ दाणेदार कणदार
भयंकर: दुष्कर बळावलेला
भयरो: बहिरा कर्णबधिर बधिर
भयांकृत: निर्दय निर्दयी कठोर क्रूर निष्ठुर निर्गृण हृदयशून्य पाषाणहृदयी भयंकर भयानक भीतीदायक भीषण भयावह भयाण भेसूर भयकारी भयकारक भीतिप्रद विकट भयपूर्ण भयसान भयोत्पादक घोर भेंसूर भेसूड भेसूंड
भयानक: आक्रमक भयंकर भयानक भीतीदायक भीषण भयावह भयाण भेसूर भयकारी भयकारक भीतिप्रद विकट भयपूर्ण भयसान भयोत्पादक घोर भेंसूर भेसूड भेसूंड
भरड: रवाळ दाणेदार कणदार
भरतकाम: नक्षीदार वेलबुट्टीदार वेलबुट्टीचा
भरदस्त: जड वजनदार भारी अवजड बोजड
भरपूर: फार खूप आतोनात अतोनात पुष्कळ प्रचंड अपरिमित अतिशय गडगंज चिक्कार चिकार भरमसाट मुबलक विपुल मोप रगड रग्गड सज्जड भारी बखळ बहुत भरपूर भरमसाठ भलता भाराभर आत्यंतिक जास्त अधिक जास्ती भरपूर खूप भरलेला
भरवण: -गत
भरशिल्लें: युक्त
भरिल्लें: संपन्न भरलेला परिपूर्ण फेडलेला युक्त भरलेला माखलेला भिजलेला चिंब भरलेला
भलायकेक_बरें: स्वास्थ्यकर स्वास्थ्यदायी स्वास्थ्यप्रद आरोग्यदायी आरोग्यप्रद आरोग्यकर
भलायकेवंत: निरोगी निकोप निरामय रोगमुक्त
भलें: चांगला भला
भव्य: महाकाय धिप्पाड अवाढव्य अगडबंब विशालकाय अजस्र अजस्त्र भीमकाय विशाल भव्य मोठा विशाल भव्य मोठा भव्य शानदार आलिशान प्रशस्त मोठा
भशेन: समान सारखा सम सदृश सदृश्य एकरूप सारखा तदनुरूप
भश्टें: ऋतुमती रजस्वला ऋतुस्नात
भस्म: स्वाहा भस्म भस्मीभूत
भांगरा_पसून_तयार_केल्ली: सोन्याचा सोन्यातला सोन्यातील सुवर्णाचा सुवर्णातला सुवर्णातील
भांगराची: सोन्याचा सोन्यातला सोन्यातील सुवर्णाचा सुवर्णातला सुवर्णातील
भांगराळें: सोनेरी सोनेरी
भागपी: विभाजक
भाग्यशाली: भाग्यवान नशीबवान भाग्यवंत भाग्यशाली सुदैवी सुदेव लकी
भाजिल्लें: आगीत_शिजलेला
भाट: प्रशंसक
भाटकारवादी: सरंजामशाहीविषयक सरंजामशाहीविषयीचा सरंजामशाहीसंबंधी सरंजामशाहीसंबंधीचा सरंजामशाहीवादी
भाटकारशायी: सरंजामशाहीविषयक सरंजामशाहीविषयीचा सरंजामशाहीसंबंधी सरंजामशाहीसंबंधीचा
भाटकारी: सामंती
भाटाबेंसाचे: सांपत्तिक
भाड्याच्यो: सशुल्क
भानगडींचें: भानगडीचा
भायर_आशिल्लें: ऋतुमती रजस्वला ऋतुस्नात
भायर_जाल्लें: ऋतुमती रजस्वला ऋतुस्नात
भायर_धाडिल्लें: निर्यातीत
भायर_सरिल्लें: बाहेर_पडलेला
भायराविल्लें: बहिष्कृत
भायरें: बहिष्कृत वाळीत_टाकलेला
भायलें: बाह्य बाहेरचा बाहेरील विदेशी परदेशी परराष्ट्रीय इतर_देशाचा इतर_देशाविषयीचा इतर_देशासंबंधीचा इतर_देशाशी_संबंधित परका दुसरा बाहेरचा इतर बाह्य वरील
भायलो: विदेशी परदेशी भिन्नदेशीय
भायल्याचें: परकीय
भारतीय: भारतीय हिंदुस्थानी
भारी: महत्त्वाचा मोठा वजनी
भाळावपी: मोहवणारा मोहक
भावपूर्ण: भावपूर्ण भावनापूर्ण मर्मस्पर्शी हृदयस्पर्शी
भाविल्लें: प्रिय आवडता
भावी: आगामी पुढील
भावीक: भक्तिपूर्ण उपासक
भावूक: भावुक सहृदय
भाशांतरकार: null
भाशांतरीत: अनुवादित भाषांतरित
भाशातंर_करपी: null
भाशीक: भाषाविषयक भाषिक भाषीय
भाशेचें: भाषाविषयक भाषिक भाषीय
भिकुड्डो: भ्याड भित्रा भेकड नेभळा शेळपट पुळचट भीरु
भिकुणा_कोराचें: ढेकणाच्या_रंगाचा
भिकुणांचें: ढेकूणग्रस्त ढेकूण_लागलेला ढेकणांनी_भरलेला
भिकुणाच्या_कोराचें: ढेकणाच्या_रंगाचा
भिजिल्लें: शिपलेला
भिजूड: भ्याड भित्रा भेकड नेभळा शेळपट पुळचट भीरु
भिडेस्त: लाजाळू लाजरा लाजराबुजरा संकोची लाजट लाजवट लज्जाशील संकोची बुजरा भिडस्त
भितरले: आतील आतला आतचा अंतर्गत अंतःस्थ अंतःस्थित आंतर
भितरें: संकोचणारा
भित्रो: भ्याड भित्रा भेकड नेभळा शेळपट पुळचट भीरु
भिन्नरुपी: भिन्नरूपी भिन्नरूप
भियेल्लो: भयभीत घाबरलेला भ्यायलेला भ्यालेला घाबरा घाबराघुबरा कातर भयग्रस्त भयातुर भयाकुल
भिरांकूळ: आक्रमक भयंकर भयानक भीतीदायक भीषण भयावह भयाण भेसूर भयकारी भयकारक भीतिप्रद विकट भयपूर्ण भयसान भयोत्पादक घोर भेंसूर भेसूड भेसूंड
भिल्ली: भिली
भिवकुरो: भ्याड भित्रा भेकड नेभळा शेळपट पुळचट भीरु
भिसाचें: झिपरा झाबरा
भुंयगत: भूमिगत
भुंयेंतलें: भूमिगत
भुकेल्लो: भुकेला भुकेलेला भुकेजलेला क्षुधित
भुकेस्त: भुकेला भुकेलेला भुकेजलेला क्षुधित भुकाळ भुकाळू
भुगोलीक: भौगोलिक भूगोलाचा
भुतकाळ: गेलेला
भुतकाळीन: गतकालीन भूतकालीन पूर्वकालीन
भुताचें: भूताचा
भुताटकेचें: भूताचा
भुतानी: भूतानी भूतानी भूतानी
भुमितीक: हिंसक हिंसात्मक हिंसापूर्ण हिंसायुक्त
भुमीगत: भूमिगत
भुरगें: अल्पवयस्क अल्पवयीन लहान पोरवयाचा पोरसवदा
भुरगेंपणाचें: बालिश पोरकट
भुरग्यांचें: बालीश लहान_मुलांचा
भुरळ_घालपी: मोहवणारा मोहक
भुलयणें: आकर्षक मोहक मनमोहक चित्ताकर्षक गोंडस
भुलोवपी: आकर्षक मोहक मनमोहक चित्ताकर्षक गोंडस मोहवणारा मोहक
भुसभुशीत: भुसभुशीत ठिसूळ
भूक_वाडोवपी: भूक_वाढवणारा
भेड्डो: बहिरा कर्णबधिर बधिर
भेदक: भेदक
भेदनीय: भेद्य
भेदपी: भेदक
भेदभाव_करपी: व्यवच्छेदक
भेदभावपूर्ण: पक्षपाती
भेदिल्ले: भेदलेला भेदित
भेदीत: भेदलेला भेदित
भेद्य: भेद्य
भेरो: बहिरा कर्णबधिर बधिर
भेळशेल्लें: शिळा शिळेपाका
भेसळीचें: हिणकस हिणकट मिश्रित भेसळीचे
भोंवपी: भटक्या भटकणारा उडाणटप्पू उनाड उनाडटप्पू
भोगसणी: क्षम्य
भोगी: कामुक लंपट कामी विषयी
भोगूंक_नाशिल्लें: न_भोगलेला अभोग
भोळो: सौम्य कोमल_स्वभावाचा शांत साधा भोळा सरळ साधाभोळा निष्कपट निष्कपटी
भोवगुणी: योग्य लायक समर्थ सक्षम पात्र काबील
भोवभाशीक: बहुभाषीय बहुभाषी
भोवमानीत: सत्कृत सत्कारित
भोवमानेस्त: आदरणीय सन्माननीय माननीय आदरार्ह null
भोवसंख्या: बहुसंख्य
भौतीक: भौतिक
भौशीक: जिल्हाविषयक
भ्रमिश्ट: वेडा पागल खुळा येडा पिसा भ्रमिष्ट खुळचट संभ्रमित
भ्रमीत: संभ्रमित
भ्रश्ट: भ्रष्ट पतित पथभ्रष्ट चळलेला ढळलेला
भ्रश्टाचारी: भ्रष्टाचारी
मंगल: मंगल शुभ
मंगलकारी: कल्याणकारी हितकारक फायदेशीर लाभदायक हितकर श्रेयस्कर इष्ट उपकारक
मंगोलियन: मंगोल मंगोलियाई मंगोलियन
मंगोलियायी: मंगोलियन
मंगोली: मंगोल मंगोलियाई
मंचनीय: null
मंजूर: मंजूर_झालेला मंजुरी_मिळालेला मान्यता_मिळालेला संमती_मिळालेला संमति_मिळालेला स्वीकृती_मिळालेला होकार_मिळालेला रुकार_मिळालेला मान्यात_प्राप्त_झालेला
मंत्र_मारिल्लें.: अभिमंत्रित
मंत्रीत: अभिमंत्रित
मंद: मंद धीमा संथ हळू स्तिमित संथगती मंदगती दुर्बळ दुर्बल मंद हळू बारीक सौम्य मंद धीमा संथ हळू संथगती मंदगती थंड
मंदबुद्दी: मंदमती
मंदमती: मंदमती
मंदावपी: मंदावलेला
मकदुनियायी: मॅसिडोनियन मॅसिडोनियन
मखमली: मखमली मखमली
मगधी: मघई
मग्न: लागलेला कार्यरत व्यग्र
मचमचीत: चवदार रुचकर चविष्ट स्वादिष्ट सुरस लज्जतदार मसालेदार चमचमीत खमखमीत
मजती: साहाय्यक उपकारक उपकर्ता
मजबूत: मजबूत भक्कम पक्का दणकट
मजेशीर: मजेदार गमतीचा मौजेचा मजादार मजेदार रंगतदार
मडील्लें: घडीव
मढयिल्लें: null
मढोवंक_नाशिल्लें: अनघड
मणिपुरी: मणिपुरी मणिपुरी
मणिपूरी: मणिपुरी
मताधिकारी: null
मतींतलें: काल्पनिक कल्पित अवास्तविक
मदलो: मधला
मदल्याकाळांतलें: मध्ययुगीन
मदांद: मदोन्मत्त उन्मत्त मस्तवाल मत्त मस्तखोर
मदेवर्ती: मध्यवर्ती मध्य अंतरिम
मद्यम_पिरायेचें: मध्यमवयस्क मध्यमवयीन प्रौढ
मद्रासी: मद्रासी
मधलें: मध्यम
मध्यकाळांतलें: मध्ययुगीन
मध्यकाळीन: मध्ययुगीन
मध्यम: मध्यम
मध्ययुगीन: मध्ययुगीन
मध्यवर्ती: मध्यवर्ती मध्य
मन_भुलोवपी: मनोहारी
मननशील: मननशील चिंतनशील
मनभुलयणी: रमणीय रम्य मनोहर सुरम्य मनोहारी विलोभनीय नितांतरम्य
मनभुलयणें: रमणीय मोहक मनमोहक चित्ताकर्षक आकर्षक मनोहारी
मनमानी: मनमाना मनाजोगा मनमानी
मनरिजवणेचें: मनोरंजक
मनशाउंचायेचें: माणुसभर_उंचीचा
मनसीक: बौद्धिक
मनाक_भुरळ_घालपी: मनोहारी
मनायेचें: निषिद्ध अनुचित निषेधित त्याज्य वर्ज्य अविहित प्रतिषिद्ध
मनीस_निर्मीत: मानवनिर्मित कृत्रिम
मनीसपण: चांगला भला
मनीसपणाचें: मानवी मानवीय
मनोगत: मनोगत
मनोविज्ञानीक: मनोविकारतज्ञ
मरगळिल्लें: मरतुकडा मरणा
मरचें_न्हय_असें: अवध्य
मरणा_उपरांत: मरणोत्तर
मरणा_धडेर_आशिल्लो: मरणासन्न मरणाधीन
मरणाक_तेंकिल्लो: मरणासन्न मरणाधीन
मरणासन्न: अर्धकच्चा
मरतकच: मरणोत्तर
मराठी: महाराष्ट्रीय महाराष्ट्रीयन मराठी महाराष्ट्रीय मराठी मराठी
मरूंक_पाविल्लें: मरतुकडा मरणा
मर्दानी: पुरुषी पुरषी
मर्मज्ञ: मर्मज्ञ मर्मवेत्ता
मर्यादीत: मितव्ययी काटकसरी सीमित मोजका माफक बेताचा ठरावीक ठरलेला निश्चित नियत निर्धारित सीमांकित सीमित संयत
मलेशियायी: मले
मल्ल्याळम: केरळी केरळाचा केरळचा मलयाळम् केरळीय
मल्ल्याळी: केरळी केरळाचा केरळचा मलयाळम् केरळीय
मळकें: घाणेरडा अस्वच्छ गलिच्छ घाण मलिन गचाळ गदळ अशुद्ध
मळबभेदी: गगनभेदी
मळबस्पर्शी: गगनचुंबी गगनचुंबित
मळबा_कोराचें: आकाशी
मळबांतलें: आकाशाविषयीचा आकाशविषयक आकाशासंबंधीचा आकाशातील आकाशातला आकाशाशी_संबंधित
मळबाक_तेंकपी: गगनचुंबी गगनचुंबित
मळाचें: मैदानी
मळ्यांचीं: मजली
मवशे: मावस
मशागत: पोसलेला
मसालेदार: मसालेदार
मसाल्याचें: मसालेदार चमचमीत खमखमीत
मस्तिल्लें: पायदळी_आलेला
मस्तें: खट्याळ खोडकर बंड द्वाड वांड वात्रट वाह्यात दांडगा अवखळ
महत्वाकांक्षी: महत्त्वाकांक्षी
महान: थोर श्रेष्ठ महान मोठा उदात्त
महाराष्ट्री: महाराष्ट्रीय महाराष्ट्रीयन
महाराष्ट्रीयन: महाराष्ट्रीय महाराष्ट्रीयन
मांडिल्लें: प्रतिपाद्य
माखिल्लें: माखलेला भिजलेला चिंब
मागणें_केल्लें: null
मागलें: मागचा मागला मागील पाठीमागचा
मागलो: पूर्वीचा आधीचा अगोदरचा मागचा पहिला जुना
मागिल्लें: null
मागीरचें: नंतरचा
माजी: माजी
माड्डिल्लें: पायदळी_आलेला
माणकुलें: लहान चिमुकला छोटा चिमणा छोटा
मातयेकोराचो: खाकी
मातयेभरवण: नष्ट नेस्तनाबूत नेस्तनाबूद जमीनदोस्त उद्ध्वस्त नामशेष बरबाद जमीनदोस्त भुईसपाट उध्वस्त उध्वस्त पडकी उधळलेला अस्ताव्यस्त
मातसो: अत्यल्प
मातिल्लें: झुडपासम झाडीसारखा झाडीसम झाडोर्‍यासम झाडौलीसारखा
मादक: मादक अमली मदमस्त नशीला मादक
मादी: मादी मादा
माध्यमीक: माध्यमिक
माननीय: null
मानपी: अनुयायी
मानवल्लें: प्रिय आवडता
मानवी: मानवी मानवीय
मानसीक: मानसिक
मानसुनी: मान्सूनी
मानादीक: null आदरणीय सन्माननीय माननीय आदरार्ह अभिनंदनीय null
मानिल्लें: विहित उचित
मानिल्लो: मानलेला धर्माचा
मानेस्त: अभिनंदनीय
मान्य: विहित उचित स्वीकृत मान्य -मान्य मान्यताप्राप्त संमत
मान्य_केल्ली: मंजूर मंजूरीप्राप्त
मापनीय: मापनीय
मापूंक_नाशिल्लें: न_मापलेला
माफ: क्षम्य
माफ_करी_सारकी: क्षम्य
माफी-बगरचो: अक्षम्य
मामे: मामे मामे
माया_नाशिल्लो: निर्मोही
मायावी: मायावी
मायेस्त: प्रेमळ मायाळू वत्सल कनवाळू स्नेहशील स्नेहाळ स्नेहाळू
मार_खाल्लेलें: हत
मारक: प्रभावी मारक जहाल_विष_उतरवणारा
मारकें: मारका मारकुटा
मारपाक_योग्य: वध्य वधार्ह वधनीय मारण्यास_योग्य
मारपी: मारक
मारवाडी: मारवाडी मारवाडी मारवाडी
मारिल्लें: हत
मारी_सारकें: वध्य वधार्ह वधनीय मारण्यास_योग्य
मारूंक_जायना_अशें: अवध्य
मार्गदर्शक: द्योतक
मार्मीक: मर्मज्ञ मर्मवेत्ता
मालकीचें: ताब्यातील अधिकारात_असलेला ताब्यात_असलेला
मालक्रियाद: खट्याळ खोडकर बंड द्वाड वांड वात्रट वाह्यात दांडगा अवखळ
मालदिवी: मालदीवी दिवेही
माळी: मजली
माळेचें: अनुक्रमाने_येणारा अनुक्रमाने_असणारा क्रमिक क्रमाने_येणारा क्रमाने_शेजारचा क्रमाने_लगेचचा क्रमानुवर्ती मालिकेतील_लगतचा
मावळिल्लो: अस्तंगत मावळलेला अस्त
मावशे: मावस
मावस: मावस मावस
मासहीण: कृश हडकुळा रोड बारीक किडकिडीत लुकडा वाळलेला
मासाळ: मांसल मांसाळ मासाळ मासल मासाळा दळदार गिरदार
मासाहारी: मांसाहारी सामिष
मासीक: मासिक
मिजो: अपान
मिजोरमाचें: अपान
मिटना__अशें: कायमस्वरुपी शाश्वत चिरंतन चिरस्थायी स्थायी
मिठाचें: क्षारसंबंधित
मित्रत्व: मनमिळाऊ
मिथ्या: मिथ्या
मिरीमिरी: रिमझिम
मिशयाळो: मिशाळ
मिशयेकार: मिशाळ
मिश्कील: विनोदी गमत्या रसिक
मिश्र: मिश्र मिश्रित संमिश्रित
मिस्तुराद: हिणकस हिणकट मिश्रित भेसळीचे मिश्र मिश्रित संमिश्रित
मिस्री: इजिप्ती
मीर्गाचें: पावसाळी
मुंजी: मुंज्या मुंजा
मुंबयकार: मुंबईकर
मुंबयचें: मुंबईचा
मुक्कामाचें: गन्तव्य जाण्याचे_ठिकाण
मुक्त: स्वतंत्र मोकळा मुक्त बंधनमुक्त बंधमुक्त विमुक्त स्वच्छंदी स्वच्छंद स्वतंत्र स्वेच्छाचारी
मुक्तछंद: निर्यमक मुक्त तकहीन
मुखार_येवपी: आगामी पुढील
मुखार_सरिल्लें: अग्रेसर
मुखारचें: समोरील समोरचा
मुखारचो: पुढील पुढचा समोरचा समोरील
मुखावयलो: पुढील पुढचा समोरचा समोरील आघाडीचा अग्रभागीचा
मुखेल: मुख्य प्रधान मूळ- स्वरग्रामीय स्वरग्रामी मुख्य प्राथमिक ठळक प्रमुख मुख्य प्रधान
मुखेली: पुढारी
मुख्य: स्वरग्रामीय स्वरग्रामी मुख्य प्रधान
मुख्यः2: मुख्य प्रधान मूळ-
मुगलायी: मुगलाई मुगलांसारखा
मुदयाळे: कुरळा
मुदलांतलें: स्थानिक देशज
मुनेल्लें: बोथट मंद घासकाटू घासकटाऊ
मुमुर्खें: अबोल
मुल्यवान: बहुमोल बहुमोली बहुमूल्य मौल्यवान अनमोल किमती किंमती अमोल
मुळावें: प्राथमिक प्रारंभिक
मुळाव्यो: NULL
मुसलमानी: मुसलमानी मुस्लिम इस्लामी
मुसळधार: मूसळधार
मुस्तिल्लें: पायदळी_आलेला
मूर्ख: मूर्ख बावळा बावळट अज्ञानी मूढ जड मंद निर्बुद्ध मठ्ठ बेअक्कल शंख बिनडोक अडाणी ढ ठोंब्या अर्धवट बेअक्कली भोट
मूर्त: साकार
मूळ: स्वरचित स्थानिक देशज
मृत: मृत दिवंगत गतप्राण मेलेला
मृदुभाशी: गोडबोल्या मधुरभाषी
मृदू: मऊ मृदू कोमल नरम मुलायम मृदुल अरूवार
मेंगें: मंद धीमा संथ हळू संथगती मंदगती
मेकळी: स्वच्छंदी स्वच्छंद स्वतंत्र स्वेच्छाचारी
मेकळें: स्वतंत्र रिकामा रिक्त रिता मोकळा मोकळा रिकामा फावला हलका मोकळा खुला
मेकळो: मोकळा मुक्त बंधनमुक्त बंधमुक्त विमुक्त
मेकळ्या_हाताचें: उदार दानी
मेघहीण: निरभ्र स्वच्छ अभ्ररहित मेघहीन मेघरहित निर्मेघ
मेजकेंच: संयत
मेजपा_योग्य: गणनीय परिमेय
मेजिनाशिल्लें: वजन_न_केलेला न_जोखलेला न_तोललेला
मेजी_सारक्यो: गणनीय परिमेय
मेजूंक_नाशिल्लें: न_मोजलेला
मेणा_सारकें: मेणासारखी
मेणाचें: मेणाचा
मेणाभशेनचें: मेणासारखी
मेले_उपरांत: मरणोत्तर
मेल्लें: मृत वाळलेला वाळके सुकलेले हत
मेल्लो: मृत दिवंगत गतप्राण मेलेला
मेळनाशिल्लें: अनुपलब्ध अलभ्य दुष्प्राप्य
मेळयिल्लें: कमावलेला मिळवलेला संपादित प्राप्त भरलेला
मेळविरयत: विजोड विसंगत
मेळिल्लें: हस्तगत प्राप्त युक्त 
मेळोवन_दिल्लें: उपलब्ध प्राप्त मिळलेला
मेळोवप: घुळलेला
मैत्री: मैत्रीपूर्ण
मैथिली: मैथिल मैथिल मैथिली
मैदानी: पठारी मैदानी
मोखप: भेद्य
मोगभरीत: चिक्कार खूप रग्गड
मोगाचें: लाडका आवडता
मोगाळ: प्रेमळ मायाळू वत्सल कनवाळू स्नेहशील स्नेहाळ स्नेहाळू
मोगासक्त: प्रेमासक्त अनुरक्त अनुरागी आसक्त
मोगी: प्रेमिक
मोटे: मोठा
मोटें: अग्रज ज्येष्ठ वडील मोठा थोरला जाड लठ्ठ जाडा स्थूल मोठा
मोटो: जाड जाडा जाडजूड लठ्ठ स्थूल
मोडकी: खटारा
मोडकें: जीर्ण मोडकळीस_आलेला
मोडको: ठेंगणा ठेंगू गिड्डा बुटका खुजा वामनमूर्ती
मोडण: वेडावाकडा वाकडातिकडा वाकडा
मोडणाचें: वळणदार
मोडवो: ठेंगणा ठेंगू गिड्डा बुटका खुजा वामनमूर्ती
मोडिल्लें: पडका खंडित भग्न तुटलेला भंगलेला मोडलेला जीर्ण मोडकळीस_आलेला उल्लंघित
मोतयाकोराचें: मोतिया मोतीया मोत्याचा
मोनें: मुका न_उमललेला अपुष्पित न_फुललेला न_बहरलेला निःशब्द शांत
मोनो: गप्प मुका
मोफत: निःशुल्क मोफत फुकट विनाशुल्क विनामूल्य चकटफू
मोलादीक: बहुमोल बहुमोली बहुमूल्य मौल्यवान अनमोल किमती किंमती अमोल अनमोल अमूल्य अमोल
मोल्डोवायी: मॉल्डेव्हियन मॉल्डेव्हियन
मोव: सौम्य कोमल_स्वभावाचा शांत लवचीक लवका लवकीरा लवलवीत मऊ मृदू कोमल नरम मुलायम मृदुल अरूवार तकलादू कमजोर नाजूक कच्चा तकलादू
मोसमी: मोसमी
मोहक: रमणीय मोहक मनमोहक चित्ताकर्षक आकर्षक दिसण्यात_सुंदर
मोहीत: अनुरक्त मोहित लुब्ध आकृष्ट लट्टू लोलुप फिदा आसक्त आशक मोहित मुग्ध
मौखीक: उच्चारित
मौनव्रती: मौनी मौनव्रती
म्यानमारी: म्यान्मारी ब्रह्णदेशी ब्रह्मदेशीय ब्रह्मदेशीचा ब्रह्मदेशाचा ब्रह्मी ब्रह्मी
म्हगेलो.: माझे
म्हजो: माझे
म्हत्वपूर्ण: महत्त्वपूर्ण
म्हत्वाचें: महत्त्वपूर्ण
म्हयनाळें: मासिक मासिक दरमाही
म्हयन्याचें: ऋतुमती रजस्वला ऋतुस्नात
म्हा: null
म्हाकाय: विशाल भव्य मोठा
म्हातारी: वृद्ध
म्हातारें: वृद्ध म्हातारा वयस्कर वयोवृद्ध बुडगा
म्हान: थोर श्रेष्ठ महान मोठा उदात्त null
म्हानगरीय: महानगरीय
म्हापद्म: पद्म
म्हापापी: महापापी महापातकी
म्हाप्राण: अघोष
म्हाबळादीक: महाबळी
म्हामुर्ख: महामूर्ख मूर्खशिरोमणी शंख
म्हारग: बहुमोल बहुमोली बहुमूल्य मौल्यवान अनमोल किमती किंमती अमोल महाग महागडा किमती किंमती मोलाचा किंमती महागडा महाग मौल्यवान महाग महागडा
म्हारगें: महाग महागडा
म्हालम्हातारी: वृद्ध
म्हालम्हातारें: वृद्ध म्हातारा वयस्कर वयोवृद्ध बुडगा
म्हावराक: मांसाहारी सामिष
म्हावीर: महावीर
म्हेळें: कच्चा अपक्व घाणेरडा अस्वच्छ गलिच्छ घाण मलिन गचाळ गदळ अशुद्ध
म्होंवाळ: गोड सुरेल मंजूळ सुमधुर मधुर गोड मधुर गोड
म्होंवाळ_उलोवपी: मधुरभाषी
यंत्रचलीत: स्वयंचलित यांत्रिक
यजुर्वेदी: यजुर्वेदी
यजुर्वेदीक: यजुर्वेदज्ञ यजुर्वेदी
यत्नशील: प्रयत्नशील उद्यमी उद्यमशील प्रयत्नवंत उद्योगी उद्योगशील प्रयत्नवान
यथार्थवादी: वास्तववादी
यमकाचें: सयमक
यशस्वी: विजयी विजेता जेता
यहुदी: यहूदी हिब्रू
यहुदी_भास: हिब्रू
याद__नाशिल्लें: अपुरा अपुरा_रचलेला
याद_उरपा_सारकी: स्मरणीय संस्मरणीय
याद_दिवपी: स्मरणीय
याददिण्यो: स्मरणीय
यादेस्त: स्मरणीय
युक्रेनी: युक्रेनियन युक्रेनियन
युनानी: ग्रीसी युनानी ग्रीक ग्रीक
युरेशियायी: यूरेशियाई
येवंक_नाशिल्लें: अप्राप्त न_प्राप्त_झालेला
येवंक_नाशिल्लो: न_आलेला न_पोहोचलेला
येवजिल्लें: ऐच्छिक
येवपी: भावी भविष्यकालीन भविष्यातील आगामी पुढील पुढचा
येशस्वी: यशस्वी सफल सफळ
योगी: आत्मज्ञानी योगी
योगीक: यौगिक
योग्य: योग्य लायक समर्थ सक्षम पात्र काबील अनुकूल फायदेशीर धार्जिणा सानुकूल अनुरूप ठराविक ठरलेला निश्चित नियत निर्धारित सत्पात्र सुसंगत उचित योग्य साजेसा अनुरूप फक्कड वैध कायदेशीर null योग्य उचित माफक यथायोग्य शुद्ध नेमका चपखल अनुकूल यथोचित
योग्य_वेळार: समयोचित समयानुसार प्रसंगानुसार
योजक: अल्बेनियाई
योजिल्लें: योजलेला नियोजित
योजीत: योजलेला नियोजित
योद्धो: योद्धा वीर लढवय्या झुंजार
यौगीक: संयुक्त
रंग-परिवर्तनशील: बदलता रंगाभासी
रंगकुड्डेपण: रंगांध
रंगयिल्लें: रंगवलेला रंगविलेला रंगलेपित रंगविलेपित
रंगहीण: रंगहीन
रंगांचो: रंगांचा रंगीत
रंगी: -वर्णीय -वर्णी वर्णाबाबतचा रंगाबाबतचा वर्णाचा रंगाचा वर्णाविषयीचा रंगाविषयीचा वर्णविषयक रंगविषयक वर्णासंबंधीचा रंगासंबंधीचा वर्णाशी_संबंधित रंगाशी_संबंधित
रंगीत: रंगारंग रंगलेला रंगवलेला
रक्तपिपासू: रक्त_पिणारा
रक्तवर्णी: लोहित लोहिवा
रक्तहीण: रक्तहीन रक्तविहिन
रक्ताचें: रक्ती रक्ताचा रक्ताविषयीचा रक्तविषयक रक्तासंबंधीचा रक्ताशी_संबंधित
रक्षक: रक्षक रक्षणकर्ता
रगत_नाशिल्लें: रक्तहीन रक्तविहिन
रगत_पियेवपी: रक्त_पिणारा
रचणार: कर्ता सर्जक सृजक स्रष्टा रचनाकार सर्जनकार सृजनकार सर्जनकर्ता सृजनकर्ता
रचनात्मक: विधायक
रचिल्लें: काल्पनिक कल्पित अवास्तविक रचित कृत विरचित निर्मित रचलेला
रचूंक_नाशिल्लें: अरचित
रणवीर: योद्धा वीर लढवय्या झुंजार
रणशूर: योद्धा वीर लढवय्या झुंजार
रथारूढ: रथी
रद्द: रद्द नामंजूर
रबरबीत: बिलबिलीत लिबलिबीत लबलबीत
रमणीय: रमणीय रम्य मनोहर सुरम्य मनोहारी विलोभनीय नितांतरम्य
रम्य: रमणीय रम्य मनोहर सुरम्य मनोहारी विलोभनीय नितांतरम्य सुंदर देखणा सुरेख रूपवान
रवांडायी: रूआंडन
रवांडी: रूआंडन रूआंडाचा
रवो: रवाळ दाणेदार कणदार
रशियन: रशियन रशियायी
रशीयन: रशियाई
रसहीण: नीरस रसहीन
रसात्मक: काव्यात्मक
रसाळ: रसाळ रसदार रसरशीत रसपूर्ण रसभरित
रसीक: रसिक आस्वादक
रस्ताद: बेवारशी
रस्त्याचें: वाटेचा
रहस्य: गूढ रहस्यमय
रांड: विधवा
राकेसी: आसुरी
राक्षसी: आसुरी राक्षसी
राखीव: आरक्षित राखीव राखलेला खास_वेळेसाठी_राखलेले
रागिश्ट: क्रुद्ध संतप्त रागावलेला संतापलेला चिडलेला कोपित कुपित क्रोधायमान कोपायमान कोपाविष्ट रागीट रागिष्ट संतापी तापट कोपिष्ट अंगर कडक जहाल
राजकारणाचे: राजकीय
राजकारणी: राजकीय
राजकी: राज्यविषयक राजकीय रियासताचा
राजनितीक: राजकीय
राजसी: राजसी राजाबाबतचा राजाविषयीचा राजाविषयक राजासंबंधीचा
राजस्थानी: राजस्थानी
राजाहीण: अराजक
राज्य: शासित प्रशासित अभिशासित अधिशासित
राज्य_पांवड्या_वयलें: प्रांतिक प्रांतीय
राज्यस्तरीय: प्रांतिक प्रांतीय
राज्या_विशींचें: राज्यविषयक राजकीय
राणटी: रानटी
रातचर: निशाचर रात्रिंचर
रानटी: वन्य जंगली रानटी रानटी जंगली रानातील जंगली वन्यतापूर्ण
रानवटी: वन्य जंगली रानटी रानटी जंगली रानातील जंगली वन्यतापूर्ण रानटी
रानवासी: वनवासी
राबित्याचें: वसलेला वसाहतीशी_संबंधित वासाहसिक
राबित्याच्यो: घरगुती कौटुंबिक
रावपी: वसलेला
राष्ट्रताये_संबंदी: बंद ठप्प थांबलेला
राष्ट्रद्रोही: देशद्रोही राष्ट्रद्रोही
राष्ट्रभक्त: देशभक्त
राष्ट्रीय: अंतर्देशीय देशांतर्गत देशातल्या_देशात राष्ट्रीय
रासायनीक: रासायनिक
रिकामी: रिकामा रिक्त रिता मोकळा रिकामा वापरात_नसलेला
रिकामें: मोकळा रिकामा फावला कोरा
रिटायर्ड: निवृत्त सेवानिवृत्त
रिणमुक्त: कर्जमुक्त ऋणमुक्त अनृणी उतराई
रितसर: सुव्यवस्थित
रीण_दिवपी: देणेकरी देणेदार धनको ऋणदाता
रीणकार: ऋणी
रीतसर: नियोजित व्यवस्था_लावलेला
रुंद: रुंद विस्तीर्ण विस्तृत आडवा चवडा
रुचीक: null
रुचीचें: null चवदार रुचकर
रुढिवादी: रूढिवादी
रुपांतरीत: रूपांतरित
रुपेरी: रुपेरी चांदीचा चांदीतला चांदीतील
रुप्याचें: रुपेरी चांदीचा चांदीतला चांदीतील
रुमानियन: रूमानियाई
रुमानी: रूमानियाई रूमानियन
रुसी: रशियाई रशियन रशियायी
रूक्ष: कोरडा शुष्क रखरखीत रूक्ष रुक्ष
रूच_नाशिल्लें: बेचव मिळमिळीत सपक
रूचीक: चवदार रुचकर चविष्ट स्वादिष्ट सुरस लज्जतदार
रूप_नाशिल्लें: कुरूप
रूपगर्विता: रूपगर्विता
रूपाभिमानी: रूपगर्विता
रेंवटाळ: रेताड वालुकामय वाळवंटीय मरूस्थलीय
रेखांकीत: रेखांकित रेखित
रेशमी: रेशमी रेशमी
रोगाणू_जीव: null
रोगाणूनाशक: जंतुनाशक
रोगी: रोगग्रस्त व्याधिग्रस्त आजारी दुखणाईत रुग्णाईत दुखणेकरी रोगट
रोमांचक: रोमांचक रोमहर्षक
रोमांचकारी: रोमांचक रोमहर्षक
रोमांचीत: रोमांचित रोमांचित पुलकित रोमहर्षित
रोसाळ: रसाळ
लंगडें: पांगळा लंगडा पांगूळ अपंग पायमोडका तुटका
लंबवत: लंब
लकलकीत: दीप्तिमान तेजस्वी कांतिमान स्वच्छ साफ उजळ उज्वल
लक्षवेदी: लक्ष्यवेधी लक्ष्यगामी
लक्समबर्गाचें: लक्सेंबर्गचा
लक्समबर्गी: लक्सेंबर्गचा लेट्सबुर्झ
लग्न_जाल्लें: विवाहित परिणित
लग्नाची: लग्नाचा
लग्नाचें: वैवाहिक
लज_नाशिल्लो: निर्लज्ज निलाजरा लज्जाहीन बेशरम कोडगा निसुगा
लजेची: लज्जास्पद
लजेस्त: लाजाळू लाजरा लाजराबुजरा संकोची लाजट लाजवट लज्जाशील संकोची बुजरा भिडस्त
लज्जीत: लज्जित शरमिंदा
लटकें: खोटा खोटारडा असत्य चुकीचा निराधार पोकळ तथ्यहीन वरकरणी वरपांगी औपचारिक दिखाऊ मिथ्या
लटको: लुच्चा लफंगा लबाड नीच पाजी हलकट बदमाश
लठ्ठ: जाड लठ्ठ जाडा स्थूल
लडकें: खोटा नकली
लढाऊ: योद्धा वीर लढवय्या झुंजार
लफड्याचें: भानगडीचा
लवचीक: लवचीक लवका लवकीरा लवलवीत
लश्करी: लष्करी
लस्करी: लष्करी
लांचखोर: लाचखाऊ लाचखोर चाटू लाचुंगा
लांडें: अपक्ष
लांब: मोठा लांब लांब दीर्घ
लांब-रुंद: मोठा लांब
लांब_काळाचें: चिरकालिक दीर्घकालीन
लाओ: लाओ लाओ
लाओशियन: लाओ
लाख: लाख लक्ष
लाखांनीं: लाखो लक्षावधी
लागचें: जवळचा नजीकचा निकटवर्ती
लागपी: किंकरा
लागिल्लें: लागलेला
लागीं_वचपी: पुढे_जाणारा
लागींचे: आसन्न
लागींचें: जवळचा नजीकचा निकटवर्ती
लागू: लागू
लाचार: उपायरहित निरुपाय हतबल असहाय्य विवश अगतिक लाचार
लाजरें: लाजाळू लाजरा लाजराबुजरा संकोची लाजट लाजवट लज्जाशील
लाजवर्दी: राजावर्तचा
लाठिमार: मोठा_दांडा_मारणारा
लाडाचें: लाडका आवडता
लातवियायी: लॅटव्हियन लेट लॅटव्हियन
लाब_कमवपी: नफेखोर
लाब_खावपी: नफेखोर
लाबदिणें: फलप्रद लाभकारी लाभदायक फायदेशीर फलदायी किफायतशीर फलद्रूप फलप्रद
लाभार्थी: नफा_मिळालेला
लायक: योग्य लायक पात्र
लायिल्लें: लागू लागलेला
लाल: लाल तांबडा
लाशें_आशिल्लें: डागील डागेल डागलेला
लाशेल्लें: डागील डागेल डागलेला
लिंगीक: लैंगिक
लिकलिकपी: चमकता चकाकता चमचमता झगमगता
लिकलिकीत: चमकदार
लिकलीकपी: चमचमणारा चमकणारा चकचकणारा
लिखीत: लिखित लिहिलेला लेखी कागदावर_लिहिलेला
लिथुनियायी: लिथ्युएनियन लिथ्युएनियन
लिपोवपी: लपवणारा
लिप्पी: लपणारा
लुकसाणग्रस्त: हानीग्रस्त
लुकसाणदिणें: अपायकारक हानिकारक अपकारक घातक हानिप्रद
लुकसाणाचें: बिघडलेला नादुरुस्त
लुकसाणीचें: अपायकारक हानिकारक अपकारक घातक हानिप्रद
लुटिल्लें: लुटलेला अपह्रत बळकावलेला हिसकावलेला
लुडबें: तोतरा बोबडा तोतरा
लुप्त: लुप्त लोपलेला
लुळो: थोटा
लुळोपांगळो: अपंग अधू विकलांग
लेबलाचें: व्यावसायिक_मुद्रा_असलेला
लेबली: व्यावसायिक_मुद्रा_असलेला
लेव: फिका
लेव_हळडुवें: फिकट_पिवळ्या_रंगाचा हलक्या_पिवळ्या_रंगाचा
लैंगीक: लैंगिक
लोक: जिल्हाविषयक
लोककल्याणकारी: लोकोपकारी
लोकतंत्रीक: प्रजासत्ताक
लोकप्रीय: लोकप्रिय
लोकमान्य: लोकप्रिय
लोकरी: लोकरी गरम
लोकशायी: प्रजासत्ताक
लोकशायेचें: लोकशाही प्रजासत्ताक
लोकांचें: जिल्हाविषयक
लोकांमोगाळ: लोकप्रिय
लोकाचें: परकीय
लोखंडाचें: लोखंडी
लोखंडी: लोखंडी
लोटांगण_घालपी: पाया_पडणारा
लोणयाचें: लोणीयुक्त लोण्याचा
लोभी: स्वार्थी मतलबी आपमतलबी आप्पलपोट्या आप्पलपोटा खवय्या
लोळकें: घाणेरडा अस्वच्छ गलिच्छ घाण मलिन गचाळ गदळ अशुद्ध
लोळिल्लें: घाणेरडा अस्वच्छ गलिच्छ घाण मलिन गचाळ गदळ अशुद्ध
ल्हव: हलका
ल्हव_ल्हव: मंद धीमा संथ हळू स्तिमित संथगती मंदगती
ल्हवपीक: हळू बारीक सौम्य
ल्हान: कनिष्ठ लहान बारका पाठचा धाकटा अनुज निरागस धाकटा सर्वात_लहान वयात_सर्वात_लहान छोटा लहान
ल्हान-सान: किरकोळ फुटकळ लहान-सहान
ल्हारांचो: तरंगयुक्त लाटयुक्त सतरंग सलाट लहरयुक्त सलहर
ल्हेंवेल्लें: खाल्लेला
वंचीत: वंचित
वंदनीय: वंदनीय
वंशावळीचें: आनुवंशिक वंशपरंपरागत पिढीजात
वक्र: बेडौल बेढब ओबडधोबड
वखदी: औषधी
वगत: उशीराचा
वजनदार: जड वजनदार भारी अवजड बोजड
वजनी: महत्त्वाचा मोठा वजनी
वट्ट: अख्खा अखंड सबंध सलग सगळा अखिल संपूर्ण सर्व सबंध अख्खा आख्खा उभा समग्र समस्त सारा अवघा तमाम
वत्सल: वत्सल
वनवासी: वनवासी
वनस्पतीहीण: उजाड वैराण
वयर_आयिल्लो: उदित
वयर_दिल्लो: उपरोक्त उपरिनिर्दिष्ट उपर्युक्त
वयरचो: वरील
वयरसकयल: उंचसखल खाबडखुबड
वयले: वरचा
वयलें: उंच उत्तुंग उन्नत उच्च बाह्य वरील
वयलो: उपरोक्त उपरिनिर्दिष्ट उपर्युक्त वरील
वयलो_सूर: मोठा
वयल्या_कुळांतलो: उच्चकुलीन खानदानी घरंदाज जातिवंत कुलीन अभिजात
वयल्याचाराचें: रुक्ष
वयल्यावयलें: वरकरणी वरपांगी औपचारिक दिखाऊ
वयस्क: प्रौढ
वयार_आयिल्लें: वयात_येणारी
वरसो: तोंड_केलेला
वरिश्ठ: वृद्ध म्हातारा वयस्कर वयोवृद्ध बुडगा वरिष्ठ
वरी: सारखा
वर्ग: समकक्ष सारखा तोडीचा बरोबरीचा
वर्जिल्लें: परित्यक्त
वर्जीत: निषिद्ध अनुचित निषेधित त्याज्य वर्ज्य अविहित प्रतिषिद्ध
वर्ज्य: निषिद्ध अनुचित निषेधित त्याज्य वर्ज्य अविहित प्रतिषिद्ध
वर्णना_बगरचें: अपार प्रचंड पारावार_नसलेला
वर्णनीय: सांगण्याजोगा सांगण्यालायक वर्णन_करण्याजोगा वर्णन_करण्यालायक वर्णनीय सांगण्यायोग्य वर्णन_करण्यायोग्य सांगावा_असा वर्णावा_असा
वर्णी: -वर्णीय -वर्णी वर्णाबाबतचा रंगाबाबतचा वर्णाचा रंगाचा वर्णाविषयीचा रंगाविषयीचा वर्णविषयक रंगविषयक वर्णासंबंधीचा रंगासंबंधीचा वर्णाशी_संबंधित रंगाशी_संबंधित
वर्णीत: वर्णिलेला वर्णित चित्रित प्रशंसिलेला
वर्तमान: वर्तमान
वर्तमान_काळ: वर्तमानकालीन सद्यकालीन सध्याचा हल्लीचा आताचा आत्ताचा वर्तमानकाळाबाबतचा वर्तमानकाळाचा वर्तमानकाळाविषयीचा वर्तमानकाळविषयक वर्तमानकाळासंबंधीचा वर्तमानकालाबाबतचा वर्तमानकालाचा वर्तमानकालाविषयीचा वर्तमानकालविषयक वर्तमानकालासंबंधीचा सद्यकालाबाबतचा सद्यकालाचा सद्यकालाविषयीचा सद्यकालविषयक सद्यकालासंबंधीचा सद्यकाळाबाबतचा सद्यकाळाचा सद्यकाळाविषयीचा सद्यकाळविषयक सद्यकाळासंबंधीचा सध्याबाबतचा सध्याचा सध्याविषयीचा सध्यासंबंधीचा
वर्सभराच्यो: बारामाशी
वर्साचें: -वर्षीय वर्षाचा
वर्सुकें: वार्षिक सालीना
वलें: आर्द्र ओला दमट
वळखीचें: ज्ञात माहित ठाऊक विदित विज्ञात अवगत जाणलेला परिचित पूर्व_परिचित ज्ञात अभिज्ञात
वळखीचो: परिचित ओळखीचा माहितीचा
वळणाचें: वळणदार
वळेरीत: सूचीतील सूचीतला सूचीमधील सूचीमधला यादीतील यादीमधला यादीमधील यादीतला सूचीबद्ध
वळेरेंत: क्रमवार
वशिल्लें: वसलेला
वशीकृत: वश
वसंत_काळाचें: वसंतकाळातील वसंतकालीन
वसंतकाळीन: वसंतकाळातील वसंतकालीन
वसणुकेचें: वसाहतीशी_संबंधित वासाहसिक राहण्यासाठीचा
वसाड: निर्वासित नापीक पडीत पडीक बरड
वस्तुनिश्ठ: वस्तुनिष्ठ
वांकडें: वाकडा तिरका तिरपा वक्र कडवट कटू वाकलेला लवलेला अवनत ओणवा
वांकडो: वेडावाकडा वाकडातिकडा वाकडा
वांकडो-तिकडो: वेडावाकडा वाकडातिकडा वाकडा
वांकिल्लें: वाकलेला लवलेला अवनत ओणवा
वांगडें: बेडौल बेढब ओबडधोबड
वांझ: वांझ वंध्या वांझोटी
वांटील्लें: वितरित वाटलेला वाटणी_केलेला वाटून_टाकलेला
वांटेकार: आतील आतला आतचा अंतर्गत अंतःस्थ अंतःस्थित अंतर्-
वांयग्या_कोराचें: जांभळा वांगी
वाकडें: नम्र
वाक्चतूर: वाक्पटू वाक्चतुर
वाचक: वाचक
वाचपा_योग्य: वाचनीय सुवाच्य
वाचपा_सारकें: वाचनीय सुवाच्य
वाचपायोग्य: वाचनीय वाचण्याजोगा पठनीय
वाचयिल्लें: साठवलेला राखलेला
वाचाळ: वाचाळ बडबड्या बोलघेवडा बोलका मुखर
वाचिल्लो: वाचलेला
वाचीक: वाचनीय वाचण्याजोगा पठनीय
वाच्य: वाच्य मुख्य
वाच्यनीय: वाचनीय सुवाच्य
वाटकुळें: गोल वर्तुळाकार गोलाकार गोलाकृती वर्तुळाकृती वर्तुळ गोल वाटोळा वर्तुळाकार
वाटायिल्लें: साठवलेला राखलेला
वाठारी: प्रादेशिक राज्यस्तरीय
वाडयिल्ली: वाढवलेला
वाडयिल्लें: विस्तारित
वाडिल्लें: वयात_येणारी वाढलेला
वाडोवपी: वाढणारा वर्धक
वातड: कडक टणक कठीण निबर करकरीत कोरडा
वातानुकुलक: वातानुकूलक
वातानुकुलीत: वातानुकूलित
वातावरणाचें: हवामानसंबंधीचा वातावरणीय
वातावरणी: हवामानसंबंधीचा वातावरणीय
वादग्रस्त: विवादास्पद वादग्रस्त विवाद्य
वादा_बगर: निर्विवाद विवादस्पद_नसलेला वाद_नसलेला
वादाचें: विवादास्पद वादग्रस्त विवाद्य
वादास्पद: विवादास्पद
वानस्पतीक: वनस्पतीय
वान्शे_विरयत: निरपेक्ष अपेक्षाविरहित
वापराचें: उपयोगी उपयुक्त कामाचा व्यवहार्य व्यावहारिक शक्य
वापरिल्लें: वापरलेला
वायट: कपटी कुविचारी कावेबाज घाणेरडा अस्वच्छ गलिच्छ घाण मलिन गचाळ गदळ अशुद्ध निकृष्ट हीन अधम हलका वाईट भिकार भुक्कड कुत्सिक निकृष्ट हीन अधम हलका वाईट भिकार भुक्कड कुत्सिक प्रतिकूल विपरीत विषम वाईट खराब धोकेबाज कपटी चालू धूर्त पाताळयंत्री वाईटतर वाईट घाणेरडा
वायट_करपी: दुष्कर्मी दुर्जन दुराचारी दुराचरणी अनाचारी
वायट_गूण: दुर्गुणी अवगुणी
वायट_मार्गान_मेळयिल्लें: लाटलेला
वायट_वेसनी: व्यसनी चंगीभंगी छंदीफंदी
वायटकार: रोगग्रस्त व्याधिग्रस्त आजारी दुखणाईत रुग्णाईत दुखणेकरी रोगट
वायेचें: वातूळ वातविकारविषयक वातविकारासंबंधीचा वातविकाराविषयीचा वातविकाराशी_संबंधित आकाशातील हवाई अवकाशीय हवेतील अवकाशातील अंतरिक्षातील
वारें_घोळपी: हवेशीर
वार्‍याचें: आकाशातील हवाई अवकाशीय हवेतील अवकाशातील अंतरिक्षातील
वासनाहीण: कामहीन वासनाहीन निष्काम कामरहित
वासाचें: सुवासिक सुगंधी
वास्तवीक: वास्तविक वास्तव वास्तवातील वास्तवातला यथार्थ खरा खराखुरा खरोखरीचा
वाहक: वाहिनी वाहक वाहक
विंगडविंगड: वेगवेगळा भिन्न-भिन्न
विकत_हाडिल्लें: विकत_घेतलेला खरेदी_केलेला
विकतें_घेतिल्लें: विकत_घेतलेला खरेदी_केलेला
विकपाच्यो: विकाऊ
विकल्पी: वैकल्पिक ऐच्छिक पर्यायी
विकसीत: प्रगत पुरोगामी पुढारलेला अग्रेसर विकसित
विकासकर्तो: प्रगती_करणारा
विकासशील: विकसनशील
विकृत: वाईट खराब विकृत विकारग्रस्त बिघडलेला
विक्रमी: null पराक्रमी विक्रमादित्याचा
विक्राळ: भयंकर भयानक भीतीदायक भीषण भयावह भयाण भेसूर भयकारी भयकारक भीतिप्रद विकट भयपूर्ण भयसान भयोत्पादक घोर भेंसूर भेसूड भेसूंड
विक्रेच्यो: विकाऊ
विखा_बगर: बिनविषारी
विखाचें: विषारी जहरी विखारी
विखारी: विषारी जहरी विखारी विषारी विषारी
विखाळ: विषारी जहरी विखारी विषारी विषारी
विख्यात: जगप्रसिद्ध जगद्विख्यात विश्वविख्यात
विचलीत: चंचल अस्थिर चंचलचित्त चंचळ चलितचित्त लहरी
विचार_करपाचें: विचारणीय विचार्य चिंतनीय चिंत्य लक्षणीय
विचारवंत: विचारी विचारशील
विचारशील: विचारी विचारशील
विचारशुन्य: विचारशून्य
विचारहीण: विचारशून्य अचिंत्य अचिंतनीय
विचारी: विचारणीय विचार्य चिंतनीय चिंत्य लक्षणीय
विचारीक: विचारपूर्ण विचारी विचारशील वैचारिक
विचित्र: अस्वाभाविक असामान्य जिज्ञासाजनक
विजयाभिलाशी: विजिगीषू जिगीषू
विजयी: यशस्वी सफल सफळ
विजातीय: आंतरजातीय विजातीय
विजेचें: विद्युतीय
विज्ञानीक: वैज्ञानिक शास्त्रीय
वितरायिल्लें: ध्वनिक्षेपित
वितळिल्लें: तप्त अभितप्त
विदेशी: विदेशी परदेशी भिन्नदेशीय विदेशी परदेशी परराष्ट्रीय इतर_देशाचा इतर_देशाविषयीचा इतर_देशासंबंधीचा इतर_देशाशी_संबंधित
विद्यालयीन: शालेय विद्यालयीन
विद्रूप: कुरूप वाईट खराब विकृत विकारग्रस्त बिघडलेला
विद्वत्तापूर्ण: विद्वत्तापूर्ण
विद्वान: विद्वान सुविद्य व्यासंगी ज्ञानी पंडित
विधवा: विधवा
विधानीक: कायदेशीर सनदशीर
विधिचें: वैध कायदेशीर
विधीलिखीत: दैवाधीन दैववश दैवानुरोधी दैवानुसारी दैवप्रधान
विनम्र: नम्र विनम्र विनयी विनयशील विनीत
विनयशील: नीतिमान
विनयी: प्रामाणिक इमानदार चोख सालस साळसूद निःकपट
विनाकारण: विनाकारण अकारण निष्कारण उगा व्यर्थ
विनाशक: विध्वंसक विनाशकारी संहारक विनाशक
विनाशी: विध्वंसक विनाशकारी संहारक विनाशक
विनोदी: विनोदी गमत्या रसिक
विभागणी: वेगळा निराळा विभक्त विभागित
विभागी: प्रादेशिक राज्यस्तरीय विभागीय
विभाजक: विभाजक
विभुशीत: सन्मानित अलंकृत सुशोभित विभूषित आभूषित सजलेला सजवलेला नटवलेला नटलेला
वियेतनामी: व्हिएतनामी व्हिएतनामी
वियोगी: विरही
विरक्त: विरक्त अनासक्त उदासीन विरागी
विरगळपी: द्राव्य विद्राव्य
विरनाशें: अद्राव्य अद्रावणीय अविद्राव्य अविघटनशील
विरनासपी: अद्राव्य अद्रावणीय अविद्राव्य अविघटनशील
विरपी: null
विरळ: विरळ विरल विरळा
विरही: विरही
विरुद्ध: विपरीत विरुद्ध उफराटा उलट उलटा विरुद्ध
विरोधा_बगरचें: प्रतिकारशून्य
विरोधी: विरोधात्मक विरोधिलेला विरोधी विरोधक
विरोधी_पक्ष: विरोधी
विरोधीत: विरोधित
विलक्षण: जिज्ञासाजनक
विलक्षणाचें: वैशिष्ट्य_असलेला वैशिष्ट्यपूर्ण
विलक्षीत: वैशिष्ट्य_असलेला वैशिष्ट्यपूर्ण
विलासी: कामुक लंपट कामी विषयी विलासी सुखासीन सुखलोलुप विषयलोलुप विषयासक्त भोगलोलुप भोगासक्त विषयलंपट सुखासक्त विलासासीन विलासासक्त विलासलोलुप विषयी विषयासीन
विलीन: -गत
विवश: हतबल असहाय्य विवश अगतिक लाचार
विवादास्पद: विवादास्पद
विवाहीत: विवाहित परिणित
विवीध: अनेक पुष्कळ नाना कैक कित्येक कितीतरी बरेच विविध
विवेकी: विवेकी समंजस शहाणा विवेकवंत
विशाचें: विषारी जहरी विखारी
विशाणूंचें: विषाणुजन्य
विशारी: विषारी जहरी विखारी विषारी विषारी
विशाळ: विशाल भव्य मोठा भव्य शानदार आलिशान प्रशस्त मोठा
विशाळकाय: महाकाय धिप्पाड अवाढव्य अगडबंब विशालकाय अजस्र अजस्त्र भीमकाय विशाल भव्य मोठा
विशीं: विषयक संबंधी सबंधीत
विशीचें: विशिष्ट
विशेश: विशिष्ट विवक्षित विशेष खास
विश्वविजेतो: जगज्जेता विश्वविजयी
विश्वव्यापी: विश्वव्यापी
विश्वासघातकी: विश्वासघातकी बेईमान दगाबाज दगलबाज कपटी निमकहराम
विश्वासी: विश्वास_करणारा विश्वास_ठेवणारा
विश्वीक: जागतिक
विसंगत: अनुचित अयोग्य गैर चुकीचा अशोभनीय अशिष्ट अप्रशस्त
विसरपी: विसराळू विसरभोळा विसरभोळ्या
विसरभोळें: विसराळू विसरभोळा विसरभोळ्या
विसराळू: विसराळू विसरभोळा विसरभोळ्या
विसरिल्लें: अपुरा अपुरा_रचलेला
विसवदिणी: आरामदायी आरामदायक सुखकारक सुखदायी
विसवहीण: आरामदायक_नसणारा त्रासदायक
विसावो: विसावा
विस्कळ: विरळ विरल
विस्कळीत: अव्यवस्थित विस्कळीत अस्ताव्यस्त स्थलांतरित स्थानच्युत विखुरलेली
विस्तारीत: विस्तृत विशाल विस्तारित
विस्तृत: सविस्तर विस्तृत तपशीलवार
विस्थापीत: स्थलांतरित स्थानच्युत
विस्फारीत: विस्फारित
विस्वासघातकी: धोकेबाज कपटी चालू धूर्त पाताळयंत्री
विस्वासू: विश्वसनीय विश्वासपात्र विश्वासार्ह प्रामाणिक विश्वासू खात्रीलायक सचोटीचा
विहीत: विहित उचित
वीज.: विजेचा विद्युताचा विजेसंबंधीचा
वीर: वीर शूर साहसी धाडशी बहादूर बहाद्दर
वीस: वीस
वेंचणूक: निवडणुकीय
वेंचिल्ली: नियुक्त नेमस्त
वेंचिल्लें: निवडक वेचक शेलका निवडलेला निवडून_आलेला निवडलेला
वेंचून_काडिल्लें: निवडलेला
वेगळायिल्लें: अपसृत अपसारित
वेगळी: अस्वाभाविक असामान्य अव्हेरी
वेगळे: वेगळा निराळा भिन्न पृथक् अलग आगळा न्यारा विभिन्न वेगवेगळा
वेगळें: विपरीत विरुद्ध उफराटा सुटा
वेगळें_केल्लें: अपसृत अपसारित
वेगळेंवेगळें: वेगवेगळा भिन्न-भिन्न
वेगवान: वेगवान जलद द्रुतगामी
वेगहीण: गतिहीन स्थिर
वेगाचे: प्रबळ प्रबल
वेगाचें: गतिशील गतिमान जलद तातडीचा घाईचा ताबडतोबीचा टाकोटाकचा
वेगान: जलद वेगवान द्रुत
वेतना_विणें: बिनपगारी
वेदज्ञ: वेदविद्
वेदतज्ञ: वेदविद्
वेदपंडीत: वेदविद्
वेदशास्त्री: वेदविद्
वेदांचें: वैदिक
वेदीक: वैदिक
वेधप: भेद्य
वेपाराचें: व्यावसायिक
वेपारीक: व्यावसायिक
वेर्थ: निरर्थक निष्फळ
वेलापवर्ती: वेलापवर्ती
वेळ: उशीराचा
वेळ_पाळपी: वक्तशीर
वेळार: समयोचित समयानुसार प्रसंगानुसार
वेवसायाचें: व्यावसायिक
वेवसायीक: व्यावसायिक
वेवस्थीत: नियोजित व्यवस्था_लावलेला सुव्यवस्थित नियमबद्ध नेमका चपखल निरापद निरानर्थ
वेव्हारी: व्यवहारी व्यवहारदक्ष व्यवहारनिपुण व्यवहारकुशल कडक व्यवहार्य व्यावहारिक शक्य
वेश्टिल्लो: आच्छादित आच्छ्न्न झाकलेले व्यापलेले
वेश्यागामी: बाहेरख्याली रंडीबाज
वेसनी: व्यसनी चंगीभंगी छंदीफंदी
वैचारीक: विचारपूर्ण विचारी विचारशील वैचारिक
वैतनीक: वेतनी
वैभवशाली: धनाढ्य धनवान श्रीमंत समृद्ध सधन धनवंत धनिक तालेवार
वैयक्तीक: खाजगी खासगी व्यक्तिगत वैयक्तिक
वैरपणाचो: खुनशी शत्रूभावयुक्त
वैरी: सशत्रू शत्रू_असलेला
वैश्वीक: जागतिक
वोल्ताचें: वळणदार
व्यक्त: अभिव्यक्त व्यक्त_केलेला प्रकट_केलेला जाहीर_केलेला उघड_केलेला अनावृत_केलेला उघड_झालेला
व्यक्तीगत: खाजगी खासगी व्यक्तिगत वैयक्तिक
व्यभिचारी: व्यभिचारी कामुक कामी व्यभिचारी
व्यर्थ: निरर्थक निष्फळ वायफळ
व्यस्त: व्यग्र गोंधळाचा गतिमान गतिशील धावपळीचा ?
व्याकूळ: आतुर अधीर उतावीळ उत्सुक उत्कंठित
व्याख्या_केल्ल्यो: स्पष्ट_केलेले व्याख्या_केलेले
व्याप्त: -व्यापी -व्याप्त व्याप्त_असलेला व्यापून_राहिलेला
व्यायामी: कमावलेला
व्युत्पन्न: ओडिसी
व्हगडायिल्लें: उधळलेला
व्हड: थोर श्रेष्ठ महान मोठा उदात्त विशाल भव्य मोठा दुष्कर बळावलेला मोठा लांब अग्रज ज्येष्ठ वडील मोठा थोरला भव्य शानदार आलिशान प्रशस्त मोठा मोठा
व्हड-मनाचो: उदार कनवाळू मोठ्या_मनाचा विशाल_ह्रदयाचा उदार_मनाचा
व्हड_आंकडो: बहुसंख्य
व्हड_काळजाचो: उदार कनवाळू मोठ्या_मनाचा विशाल_ह्रदयाचा उदार_मनाचा
व्हडली: खूप_मोठा भला_मोठा
व्हडलें: अग्रज ज्येष्ठ वडील मोठा थोरला मोठा
व्हरपी: वाहक
व्हांवतें: वाहता प्रवाही अनुक्रमाने_येणारा अनुक्रमाने_असणारा क्रमिक क्रमाने_येणारा क्रमाने_शेजारचा क्रमाने_लगेचचा क्रमानुवर्ती मालिकेतील_लगतचा
व्हांवपी: वाहता प्रवाही
शंकू: शंख शंकू
शंखाचो: शंखाचा
शंखाच्यो: शंखाचा
शंख्वाकार: शंक्वाकार
शंग्रह_करी_सारक्यो: संग्राह्य संग्रहणीय
शंढ: नपुंसक षंढ
शंबर: शंभर शत- -शे
शंबरावें: शंभरावा
शक्तीवर्धक: बलवर्धक शक्तिवर्धक
शक्तीहीण: दुबळा दुर्बल निर्बल कमकुवत
शक्य: संभाव्य संभावित संभवनीय शक्य
शटकोनी: षटकोणी
शडानन: षडानन
शतायू: शतायुषी
शत्रुहीण: अजातशत्रू
शब्दाचें: भविष्यकाळात_होणारा
शब्दाडंबराचें: एकटा सडा एकाकी
शरण_आयिल्लो: शरणागत शरणापन्न
शरणागत: शरणागत शरणापन्न
शरणार्थी: निर्वासित
शरदाचें: शारदीय शरदकालीन शारद
शरीरहीण: विदेह देहरहित अशरीर
शर्मेची: लज्जास्पद
शस्त्रधारी: शस्त्रधारी हत्यारबंद सशस्त्र
शस्त्रहीन: निःशस्त्र शस्त्रहीन
शांत: सौम्य कोमल_स्वभावाचा शांत सुस्वभावी सुशील सद्वर्तनी गंभीर शांत स्थिर शांत प्रशांत अनुद्विग्न स्थिरचित्त शांत स्थिर धीराचा शांत न_मस्तवलेला निःशब्द शांत
शांती_दिवपी: शांतिप्रद शांतिदायक शांतिदायी
शांतीदिणें: शांतिप्रद शांतिदायक शांतिदायी
शांतीपूर्ण: शांतिपूर्ण शांतिमय
शांयशीं: शाऐंशी
शाकभक्ष्यी: शाकाहारी
शाकाहारी: शाकाहारी
शाणो: दूरदर्शी दीर्घदर्शी दीर्घदृष्टी
शाण्णव: शहाण्णव
शाण्णवावें: शहाण्णवावा
शात्तर: शाहत्तर
शापीत: शापित शापग्रस्त
शापोती: उद्धट चढेल अशिष्ट उद्दाम अविनयशील धृष्ट उर्मट
शाब्दीक: भविष्यकाळात_होणारा
शारांतले: शहरी नगरवासी नागर
शारिकरणाचें: शहरीकरण_केलेला नागरीकरण_केलेला
शारिरीक: देहधारी शारीरिक
शारी: शहरी नगरवासी नागर शहरी नागरी नागर शहराचा शहराविषयीचा शहरविषयक शहरासंबंधीचा नगराबाबतचा नगराचा नगराविषयीचा नगरविषयक नगरासंबंधीचा शहराशी_संबंधित नगराशी_संबंधित महानगरीय
शारीकरणी: शहरीकरण_केलेला नागरीकरण_केलेला
शाळचें: शालेय विद्यालयीन
शाश्वत: शाश्वत नित्य अविनाशी अनश्वर चिरंतन अक्षय अक्षर अमर चिरंजीव शाश्वत
शासकी: सरकारी शासकीय प्रशासकीय शासकीय
शासन: शासित प्रशासित अभिशासित अधिशासित
शास्त्रविरूद्ध: अशास्त्रीय अशास्त्र
शास्त्रीय: शास्त्रीय शास्त्रीय
शास्वत: कायमस्वरुपी शाश्वत चिरंतन चिरस्थायी स्थायी
शाही: शाही
शिंदुरी: भगवा
शिंपडिल्लें: विखुरलेला विखरलेला पसरलेला पसरवलेला फैलवलेला प्रसारित
शिंपिल्लें: शिपलेला
शिंयाळें: हिवाळी
शिंविल्लें: शिवलेला
शिकपी: अभ्यासात_व्यग्र
शिकारी: शिकारी शिकारी
शिकिल्लें: साक्षर शिक्षित सुशिक्षित
शिक्षणीक: शैक्षणिक
शिक्षीत: साक्षर शिक्षित
शिजपी: null
शिटूक: दूरदर्शी दीर्घदर्शी दीर्घदृष्टी चपळ चटपटीत तरतरीत हजरजबाबी तैलबुद्धीचा हुशार बुद्धिमान
शिटूक.: चतुर चलाख हुशार चाणाक्ष
शिडशिडीत: बारीक शिडशिडीत सडसडीत रोड लुकडा काटकुळा हडकुळा फाटका वाळकुडा वाळलेला किरकोळ
शितकटिबंधी: शीतकटिबंधीय
शितळ: गार थंड शीतल गारट शीत गार थंड शांत शांतिपूर्ण शांतिमय शीत
शिफारशीत: शिफारसित
शिमांकीत: 1._सीमांकित
शिमीत: सीमांकित सीमित मर्यादित सीमित मोजका माफक बेताचा ठरावीक ठरलेला निश्चित नियत निर्धारित संयत
शिरंगार: सजावटी
शिरापीत: शापित शापग्रस्त
शिल्लक: देय उरलेला बाकी शिल्लक उर्वरित अवशिष्ट उरलेली राहिलेला उर्वरित बाकी
शिवराक: शाकाहारी मांसरहित शाकाहारी
शिश्ट: सभ्य शिष्ट शालीन
शिश्टाचारी: सुसंस्कृत
शींगां_आशिल्लें: शिंगेवाला शृंगवान
शीत: शीत शीत
शुद्ध: खरा चोख अस्सल शुद्ध निर्भेळ निके चोखट स्वच्छ पवित्र निर्मळ निर्मल चखोट साफ खरे शुद्ध अस्सल विशुद्ध
शुभ_चिंतक.: हितचिंतक शुभचिंतक हितैषी
शुल्लक: किरकोळ फुटकळ लहान-सहान
शूभ: मंगल शुभ
शूर: वीर शूर साहसी धाडशी बहादूर बहाद्दर
शेंकड्यांनी: शेकडो शतावधी
शेंदुरी: शेंदरी
शेचाळीस: शेचाळीस शेहेचाळीस
शेण_मेळयिल्लें: शेण_मिसळलेला
शेणलेलो: वाट_चुकलेला
शेणाचें: शेण_मिसळलेला शेण_लागलेला
शेणिल्लें: हरवलेला निसटलेला हुकलेला
शेणिल्लो: वाट_चुकलेला
शेपडायिल्लें: हत
शेपडी_आशिल्लें: शेपाळ
शेपडेचें: शेपटीवाला शेपाळ
शेळें: शिळा शिळेपाका
शेष: देय
शैव: शिव शैव
शोकहीण: शोकरहित शोकहीन विषादरहित शोकग्रस्त शोकाक्रांत दुःखरहित
शोकी: शौकीन हौशी शोकी
शोकीन: शौकीन हौशी शोकी
शोधक: शोधणारा
शोधीत: हुडकलेला शोधित
शौकीन: विलासी सुखासीन सुखलोलुप विषयलोलुप विषयासक्त भोगलोलुप भोगासक्त विषयलंपट सुखासक्त विलासासीन विलासासक्त विलासलोलुप विषयी विषयासीन
श्रद्धापात्र: श्रद्धेय
श्रद्धाळू: श्रद्धाळू
श्रवणीय: श्राव्य श्रवणीय श्राव्य ऐकण्याजोगा ऐकण्यासारखा ऐकण्यालायक ऐकणीय
श्रीमंत: धनाढ्य धनवान श्रीमंत समृद्ध सधन धनवंत धनिक तालेवार
श्रुंगारीत: वस्त्रालंकार_धारण_करणारा
श्रेयदिणें: श्रेयस्कर
श्रेयस्कर: श्रेयस्कर
श्रेष्ठ: थोर श्रेष्ठ महान मोठा उदात्त
श्लेश: द्व्यर्थी
स: सहा
स_पटींनी: सहापट
स_पायांचें: षड्पदी षड्पद
संकटग्रस्त: संकटग्रस्त आपदग्रस्त संकटग्रस्त
संकलीत: संग्रहित साठवलेले संकलित
संकल्पीत: संकल्पित ठरविलेला योजिलेला निश्चित
संकुचीत: संकुचित
संकोची: संकोची बुजरा भिडस्त
संगणकाचें: प्रतिबंधित
संगणकी: प्रतिबंधित
संगणकीकरणी: संगणकीकृत संगणकीकृत संगणकीकरण_झालेला
संगमरवरी: तेलतूपविरहित स्नेहकविरहित
संग्रहणीय: संग्राह्य संग्रहणीय
संग्रहीत: संग्रहित साठवलेले संकलित
संग्रामाचें: null
संघटनेचें: संघीय
संघटीत: संघटित
संघर्शीत: संघर्षरत
संघीय: संघीय
संचारीत: प्रसारित दळणवळण_केलेला
संचालीत: संचालित
संत: अविस्मणीय
संतुळीत: समतोल संतुलित
संतुश्ट: समाधानी
संदिसादू: संधिसाधू
संदीसादू: संधीसाधू
संन्याशी: संन्यासी
संपत्तीक: सांपत्तिक
संपादीत: संपादित
संप्रदाय: सांप्रदायिक
संप्रदायीक: सांप्रदायिक
संबंदीं: विषयक संबंधी सबंधीत
संबंदीत: संबंधित संबद्ध
संबोधक: संबोधक
संभव: संभाव्य संभावित संभवनीय शक्य
संभोग_घेवपी: संभोगी
संभोगी: संभोगी
संमोहीत: संमोहित
संयमी: पथ्य_पाळणारा पथ्याने_राहणारा संयमित संयत संयमी
संयमीत: संयमित संयमित संयत
संयुक्त: संयुक्त जोड संयुत संलग्न साधलेला संबंद्ध जोडलेला
संयोगी: अल्बेनियाई
संयोजक: अल्बेनियाई
संरचनात्मक: संरचनात्मक
संवसार_जिखपी: जगज्जेता विश्वविजयी
संवसारीक: ऐहिक इहलौकिक लौकिक सांसारिक इहलोकीय इहलोकातील विश्वव्यापी
संविधानीक: सांविधानिक संविधानीय
संवेदनशीळ: संवेदनशील
संवेदनाहारी: बधिरक बधिरकारी
संशयी: संशयित संशयी शंकेखोर संशयखोर शंकाळू भ्रमिष्ट संभ्रांत गडबडलेला घोटाळलेला
संशोदक: शोधक अन्वेषक
संशोधक: आविष्कारक
संसर्गजन्य: संसर्गजन्य
संसर्गीक: संसर्गजन्य संक्रमित
संस्कृत: संस्कृत
संस्कृतीक.: सांस्कृतिक
सकयल_दिल्लें: खालील
सकयलें: खालचा निम्न खालचा
सकयलो: निंच लहान
सकयल्ल्या__कुळाचें: खालच्या_वर्गाचा
सकर्मक: सकर्मक
सकलें: क्षुल्लक कःपदार्थ नगण्य क्षुद्र तुच्छ पामर मामुली ठेंगणा कमी_उंचीचा
सकारात्मक: होकारात्मक सकारात्मक
सक्तीचें: अनिवार्य अपरिहार्य
सक्रीय: सक्रिय क्रियाशील
सक्षम: समर्थ सक्षम सामर्थ्यवान सामर्थ्यवंत शक्तिवान
सख्खें: सख्खा
सख्खो: स्वकीय आपला
सगली: सगळा अखिल संपूर्ण सर्व सबंध अख्खा आख्खा उभा समग्र समस्त सारा अवघा तमाम
सगलें: संपूर्ण सबंध अख्खा पूर्ण साद्यन्त पुरेपूर समग्र
सगलें_खावपी: सर्वभक्षी सर्वभोजी सर्वान्नभक्षक
सगल्या_गुणांनी_भरिल्लो: सर्वगुणसंपन्न
सगल्यांक_खबर_आशिल्लें: जगजाहीर सर्वश्रुत
सगूण: सगुण
सजयिल्लें: सुशोभित शोभेपुरता वरवरचा दिखाऊ
सजावट: सजावटी
सजिल्लें: वस्त्रालंकार_धारण_करणारा
सजिल्लो: सजलेला नटलेला साजश्रुंगारित
सजीव: जीवंत चैतन्यपूर्ण
सज्ज: सज्ज
सज्जन: सज्जन भद्र सत्प्रवृत्त सद्वर्तनी
सटीक: नेमका चपखल
सडसडीत: निरोगी निकोप निरामय रोगमुक्त
सडीक: नेमका चपखल
सडेतोड: सडेतोड परखड स्पष्ट
सणसणीत: खरमरीत झणझणीत सडेतोड
सत: सत्य खरा यथार्थ वास्तव
सत_उलोवपी: सत्यवचनी सत्यवक्ता सत्यवादी
सतत: अनवरत अविरत अविश्रांत निरंतर
सतरा: सतरा सतरावा
सतर्क: चपळ चटपटीत तरतरीत जागरूक
सतर्क.???????????: सावध जागरूक दक्ष जागा सतर्क सावधान सजग
सतायिल्लें: पीडित सतावणूकग्रस्त सतावलेला
सत्तर: सत्तर
सत्तरावें: सत्तरावा
सत्ता: शासित प्रशासित अभिशासित अधिशासित
सत्ताधारी: सत्तारूढ
सत्तावन: सत्तावन्न सत्तावन
सत्तावनावें: सत्तावन्नावा सत्तावनावा
सत्ताविसावें: सत्ताविसावा
सत्तावीस: सत्तावीस
सत्ते_खाला: आधीन अधीन
सत्ते_तळा: आधीन अधीन
सत्तेचाळिसावें: सत्तेचाळिसावा
सत्त्याण्णवावें: सत्त्याण्णव सत्त्याण्णवावा
सत्य: स्वच्छ खरा चोख अम्लान सचोटीचा
सत्यनिश्ठ: सत्याचरणी
सत्यभाशी: सत्यवचनी सत्यवक्ता सत्यवादी
सत्यवादी: सत्यवचनी सत्यवक्ता सत्यवादी सत्याचरणी
सत्याग्रही: सत्याग्रही
सत्वगुणी: सात्विक
सदळ: शिथिल लुळा लुला सैल ढिला डगळ ढगळ सैल लापट ढिला
सदळ_हाताचें: उदार दानी
सदां__खातीरचें: कायमस्वरुपी शाश्वत चिरंतन चिरस्थायी स्थायी
सदाचारी: सत्प्रवृत्त नेक
सदापर्णपाती: सदाहरित
सदापर्णी: सदाहरित
सदाहरीत: सदाहरित
सद्गूण: सगुण
सद्वेव्हारी: सदवर्तनी सुस्वभावी
सनसनाटी: सनसनाटीखोर
सनातन: शाश्वत सनातन
सनाथ: सनाथ
सपांयी: षड्पदी षड्पद
सपाट: सपाट समतल सपाट
सप्तकाचें: साप्ताहिक
सभावीक: स्वाभाविक उपजत नैसर्गिक
सभ्य: सभ्य शिष्ट शालीन
सम: समान सारखा सम सदृश सदृश्य एकरूप सारखा
समकालीन: सामयिक समकालीन एककालीन
समजिकायचें: सामंजस्यपूर्ण
समजूंक_नाशिल्लें: न_कळलेला
समजूतदार: विवेकी समंजस शहाणा विवेकवंत
समजूतदारपणाचें: सामंजस्यपूर्ण
समदर्शी: समदर्शी
समन्वयीत: समन्वयित
समरुपी: एकसमान एकसारखा हुबेहूब समरूप तंतोतंत_सारखे
समर्थीत: समर्थित
समर्पीत: समर्पित अर्पित
समा: योग्य उचित माफक यथायोग्य
समांतर: समांतर
समाजवादी: समाजवादी
समाजीक: सामाजिक
समाधान: खूप_खुश
समाधानी: सुटलेला समाधान्य हर्षौल्हासित
समाधिस्त: समाधिस्थ समाधिस्त ध्यानमग्न ध्यानस्थ
समान: सारखा समांतर तदनुरूप
समानार्थी: समानार्थी पर्यायवाची
समाप्त: समाप्त खलास
समाही: सहामाही
समिक्षणात्मक: आलोचनात्मक
समुखी: षडानन
समुद्री: समुद्री सागरी समुद्रीय समुद्री सागरी समुद्रीय सागरीय सामुद्रिक समुद्री सागरी समुद्रबाबतचा सागराबाबतचा समुद्राचा सागराचा समुद्राविषयीचा सागराविषयीचा समुद्रविषयक सागरविषयक समुद्रासंबंधीचा सागरासंबंधीचा समुद्राशी_संबंधित सागराशी_संबंधित
समृद्ध: समृद्ध संपन्न
समृद्धिदिणें: समृद्धीप्रद ऐश्वर्यप्रद ऐश्वर्यदायी
समेटाचें: ठरवलेला
समेस्त: सगळा अखिल संपूर्ण सर्व सबंध अख्खा आख्खा उभा समग्र समस्त सारा अवघा तमाम
सम्मानीत: सन्मानित
सयल: लापट ढिला
सरकटें: सरीसृप सरपटणारा
सरकारी: सरकारी शासकीय प्रशासकीय शासकीय
सरपटें: सरीसृप सरपटणारा
सरबरायेचें: आतिथ्यशील पाहुणचारी
सरळ: kkkk सहज सरल सुगम सोपा सुलभ सुकर सलील स्वाभाविक साहजिक सुबोध सोपा सुगम बाळबोध साधा भोळा सरळ साधाभोळा निष्कपट निष्कपटी सोईस्कर सोयीस्कर सुनिवार्य सुनिवारणीय उभा सरळ सुगम्य सुगम स्पष्ट साधा भोळा सरळ सहजगती
सरसादारण: सर्वसामान्य सर्वसाधारण सर्व
सरसामान्य: साधारण सामान्य सर्वसामान्य सर्वसाधारण सर्वसामान्य सर्वसाधारण सर्व
सरींचें: जवळचा नजीकचा निकटवर्ती
सर्गींचें: स्वर्गीय स्वर्ग्य
सर्गेस्त: मृत दिवंगत गतप्राण मेलेला
सर्जनशीळ: विधायक
सर्पील: सर्पाकार सर्पाकृती
सर्वगुणी: सर्वगुणसंपन्न
सर्वगूणसंपन्न: सर्वगुणसंपन्न
सर्वज्ञ: सर्वज्ञ सर्ववेत्ता
सर्वज्ञानी: सर्वज्ञ सर्ववेत्ता
सर्वभक्षी: सर्वभक्षी सर्वभोजी सर्वान्नभक्षक
सर्वभिमुखी: सर्वतोमुखी
सर्वव्यापी: सर्वव्यापी सर्वव्यापक
सर्वशक्तीमान: सर्वशक्तिमान सर्वसत्ताधारी सर्वसमर्थ
सर्वशक्तीशाली: सर्वशक्तिमान सर्वसत्ताधारी सर्वसमर्थ
सर्वश्रेश्ट: उत्तम उत्कृष्ट झकास फर्मास फर्डा
सर्वसादारण: सर्वसामान्य सर्वसाधारण सर्व
सर्वसामान्य: साधारण सामान्य सर्वसामान्य सर्वसाधारण सर्वसामान्य सर्वसाधारण सर्व
सर्वांग: धडधाकट अव्यंग
सर्वांगीण: सर्वांगीण
सर्वोच्च: सर्वोच्च सर्वोच्च
सर्वोत्कृश्ठ: सर्वोत्कृष्ट सर्वश्रेष्ठ
सर्वोत्तम: सर्वोत्कृष्ट सर्वश्रेष्ठ
सर्वोपरी: सर्वोच्च
सळसळीत: गरमगरम कढत ऊनऊन गरमागरम कडकडीत
सवकाश: मंद धीमा संथ हळू स्तिमित संथगती मंदगती
सवकास: मंद धीमा संथ हळू स्तिमित संथगती मंदगती
सवती: सावत्र
सवाय: स्वस्त सवा सव्वा सव्वापट स्वस्त
सवायशीण: सुवासिनी सवाष्ण सौभाग्यवती
सवार: आरूढ
सविसावें: सव्विसावा
सवें: सहावा
सव्वा: सवा सव्वा
सव्वीस: सव्वीस
सशस्त्र: शस्त्रधारी हत्यारबंद सशस्त्र
सश्रम: सश्रम
सस्तन: जरायुज सस्तन
सह: गौण
सहकारी: सहकारी
सहज: सहज सरल सुगम सोपा सुलभ सुकर सलील स्वाभाविक साहजिक सोईस्कर सोयीस्कर सुनिवार्य सुनिवारणीय सहजगती
सहन_करपी: सहिष्णू सहनशील सोशिक
सहप्रवासी: सहप्रवासी
सहयात्री: सहप्रवासी
सहयोगी: साहाय्यक उपकारक उपकर्ता
सांकेतीक: सांकेतिक
सांगपा_सारकी: सांगण्याजोगा कथ्य
सांगि_सारकी: सांगण्याजोगा कथ्य
सांगिल्लें: उल्लेखित कथित प्रतिपाद्य
सांगिल्ल्या: उक्त
सांगिल्ल्यो: प्रचारित
सांगूंक_नाशिल्लें: अनुच्चारित
सांचिल्लें: स्थिर अप्रवाही
सांच्यांत_घातिल्लें: ओतीव
सांठयिल्लें: साठवलेला राखलेला
सांठिल्लें: स्थिर अप्रवाही
सांठ्याचें: ठेवलेला राखलेला
सांद्र: null
सांबाळपी: पोशिंदा पालनकर्ता
सांमंतकाळीन: अकालज
सांसठ: सहासष्ट
सांसठावें: सहासष्टावा
साक्षर: साक्षर शिक्षित
साक्षात: साकार डोळ्यासमोरील डोळ्यादेखतचा प्रत्यक्ष
साक्षिदार: प्रत्यक्षदर्शी
सागरी: समुद्री सागरी समुद्रीय
साठ: साठ
साठयिल्लें: ठेवलेला राखलेला
साडे: साडे
सात.: सात सप्त
सातवें: सातवा सप्तम
सातसठ: सदुसष्ट
सातसठावें: सदुसष्टावा
सातोळ्याचें: साप्ताहिक
सात्तिसावें: सदतिसावा
सात्तीस: सदतीस
सात्वीक: सात्विक
सादरीकरणाचें: null
सादारण: क्षुल्लक कःपदार्थ नगण्य क्षुद्र तुच्छ पामर मामुली सामान्य मध्यम साधारण बरा ठीक निरपवाद साधारण सामान्य सर्वसामान्य सर्वसाधारण साधा किरकोळ फुटकळ लहान-सहान
सादूर: सावध जागरूक दक्ष जागा सतर्क सावधान सजग
सादें: क्षुल्लक कःपदार्थ नगण्य क्षुद्र तुच्छ पामर मामुली सोईस्कर सोयीस्कर कोरा साधा साधा न_रंगविलेला साधा भोळा सरळ
सादें.: उभा सरळ
सादो: साधा भोळा सरळ साधाभोळा निष्कपट निष्कपटी
साध्य: साध्य साध्य सिद्ध_करण्यायोग्य सिद्ध_करण्याजोगा सिद्ध_करण्यालायक
सान: निरागस छोटा
सानुलें: लहान चिमुकला छोटा चिमणा छोटा
सापेक्ष: सापेक्ष
साफ: स्पष्ट साफ स्वच्छ सुस्पष्ट विशुद्ध
सामकें_गरजेचें: अत्यावश्यक
सामकें_पुर्विल्लें: प्राचीनतम
सामको: आनंदी प्रसन्नचित्त
सामको_उणो: अत्यल्प
सामवेदी: अल्पायू
सामान्य: सामान्य मध्यम साधारण बरा ठीक सार्वजनिक निरपवाद साधा
सामुहीक: सार्वजनिक
साम्यवादी: साम्यवादी साम्यवादी कम्युनिस्ट साम्यवादाविषयीचा साम्यवादविषयक साम्यवादाशी_संबंधित साम्यवादासंबंधीचा
सायबेरियायी: सायबेरियाई सायबेरियातील सायबेरियातला
सारकें: समान सारखा सम सदृश सदृश्य एकरूप एकसारखा एकरूप सारखा समरूप समान सुव्यवस्थित समांतर योग्य उचित माफक यथायोग्य शुद्ध
सारको: आनंदी प्रसन्नचित्त सारखा बरा ठीक
सारहीण: निःसत्त्व
सार्थ: अन्वर्थक समर्पक चपखल योग्य अर्थानुसारी
सार्थक: चरितार्थ
सार्वभौमीक: जागतिक सर्वराष्ट्रीय
साव: सभ्य शिष्ट शालीन प्रामाणिक इमानदार चोख सालस साळसूद निःकपट
सावत्र: सावत्र
सावध: सावध जागरूक दक्ष जागा सतर्क सावधान सजग
सावधी: मियादी मुदती आवर्ती
सावळेचें: सावली_देणारा
सावळो: काळा अश्वेत
सासणा_खातीरचें: कायमस्वरुपी शाश्वत चिरंतन चिरस्थायी स्थायी
सास्टांग_नमस्कार_करपी: पाया_पडणारा
साहसी: साहसी साहसिक साहसपूर्ण
साहित्यीक: साहित्यिक
सिंदुरी: शेंदरी
सिंधी: सिंधी सिंधी सिंधी सिंधी सिंधी
सिंहली: श्रीलंकी श्रीलंकीय श्रीलंकाई श्रीलंकेचा श्रीलंकेविषयीचा श्रीलंकाविषयक श्रीलंकेसंबंधीचा श्रीलंकेशी_संबंधित श्रीलंकी सिंहली
सिद्ध: सिद्ध शाबीत सिद्ध सिद्ध साधू
सिद्धांतीक: सैद्धांतिक
सिने: चित्रपटातील चित्रपटातला चित्रपटी चित्रपटीय
सुंदर: सुंदर देखणा सुरेख रूपवान रमणीय मोहक मनमोहक चित्ताकर्षक आकर्षक अत्यंत_सुंदर दिसण्यात_सुंदर
सुंदर_दंडांचें: सुबाहू
सुंदर_पांखांचें: सुपंखी
सुकडें: बारीक शिडशिडीत सडसडीत रोड लुकडा काटकुळा हडकुळा फाटका वाळकुडा वाळलेला किरकोळ हडकुळा हडक्या हडकलेला काडीपैलवान
सुकण्या_विशीचें: पक्षीविषयक पक्षीसंबंधी
सुकप: -विहीन -शिवाय -विना -रहित -विरहित -वाचून -खेरिज -शून्य
सुकिल्लें: वाळलेला वाळके सुकलेले कोमेजलेला
सुकुमार: कोमलांग
सुकें: बारीक शिडशिडीत सडसडीत रोड लुकडा काटकुळा हडकुळा फाटका वाळकुडा वाळलेला किरकोळ कोरडा शुष्क रखरखीत रूक्ष वाळलेला वाळके सुकलेले कोरडा रुक्ष
सुक्षीम: सूक्ष्म बारीक इवला बारीक
सुक्षीमदर्शी: सूक्ष्मदर्शी सूक्ष्मद्रष्टा सूक्ष्मदृष्टीचा
सुख: सुखी
सुखदिणी: सुखद सुखकर सुखदायक सुखावह आनंददायी आनंददायक सुखप्रद
सुखभरीत: आनंदाने_भरलेला सुखाने_भरलेला गुलजार
सुखाची: सुखद सुखकर सुखदायक सुखावह आनंददायी आनंददायक सुखप्रद
सुखाळ: सुखद सुखकर सुखदायक सुखावह आनंददायी आनंददायक सुखप्रद
सुखी: सुखी
सुगंधीत: सुवासिक सुगंधी
सुग्राही: सुग्राही सुग्राह्य
सुग्र्याह: सुग्राह्य
सुचक: वाचक
सुचीत: सूचित उद्धृत
सुटनासपी: अनाकलनीय
सुटसुटीत: सुडौल सुबक बांधेसूद रेखीव कमनीय घाटदार प्रमाणशीर डौलदार सुढाळ सुंदर नेटका सुरेख सुघड
सुटिल्लें: जाड लठ्ठ जाडा स्थूल
सुटिल्लो: निघालेला
सुतलावपी: लुटारू चोर
सुती: सुती
सुदारिल्लो: प्रगत पुरोगामी पुढारलेला अग्रेसर
सुदारीत: प्रगत पुरोगामी पुढारलेला अग्रेसर परिष्कृत
सुनिश्चीत: सुनिश्चित सुनिर्धारित सुनियत
सुन्न: सुन्न स्तब्ध निश्चल स्तंभित
सुपरिचीत: सुपरिचित
सुपाच्य: हलका
सुपीक: सुपीक उपजाऊ पिकाऊ
सुपुल्लें: छोटा
सुप्त: निष्क्रिय
सुप्रसिद्ध: सुप्रसिद्ध सुविख्यात सुख्यात
सुफी: सूफी सुफी
सुबेज: उद्धट असभ्य उर्मट बेपर्वा धृष्ट अशिष्ट अविनयशील अप्रशस्त अभद्र आगाऊ उद्धट चढेल अशिष्ट उद्दाम अविनयशील धृष्ट उर्मट तोंडाळ फटकळ स्पष्टवक्ता
सुरक्षीत: सुरक्षित संरक्षित रक्षित सुरक्षित सुरक्षित रक्षात्मक रक्षक निर्विघ्न निःसंकट निरापद निरानर्थ परिरक्षित
सुरवातीचें: प्राथमिक प्रारंभिक
सुरांटो: दारुडा दारुड्या दारूबाज बेवडा मद्यपी
सुरांडो: दारुडा दारुड्या दारूबाज बेवडा मद्यपी दारुडा दारुड्या दारूबाज बेवडा मद्यपी दारुडा दारुड्या दारूबाज बेवडा मद्यपी
सुरू_आशिल्लें: सुरू_केलेला चालू_असलेला
सुलक्षण: null
सुलक्षणी: सुलक्षणा
सुलभ: जाण्याजोगा सहज सरल सुगम सोपा सुलभ सुकर सलील सुलभ
सुळसुळीत: गुळगुळीत
सुवर्णी: सुंदरवर्णी सुंदर_वर्णाचा सुवर्णी
सुवादाचें: null
सुवादीक: null चवदार रुचकर चविष्ट स्वादिष्ट सुरस लज्जतदार
सुवादीन: समर्पित अर्पित
सुवार्था_बगर: निस्वार्थ
सुवार्थी: स्वार्थी मतलबी आपमतलबी आप्पलपोट्या आप्पलपोटा
सुवासाचें: सुवासिक सुगंधी
सुवासीत: सुवासित सुगंधित सुगंधिक
सुशिक्षीत: साक्षर शिक्षित सुशिक्षित
सुशील: सच्छील सच्चरित्र चारित्र्यसंपन्न चारित्र्यवान शीलवान शीलवंत सदाचारी
सुशेगाद: आळशी सुस्त ढम्म मंद निष्क्रीय आळसट ढिला मैंद
सुसंस्कृत: उदारमतवादी परमतसहिष्णुतावादी सुसंस्कृत
सुसेगदिणी: आरामदायी आरामदायक सुखकारक सुखदायी
सुसेगाद: शांत प्रशांत अनुद्विग्न मंद धीमा संथ हळू संथगती मंदगती
सुस्त: आळशी सुस्त ढम्म मंद निष्क्रीय आळसट ढिला मैंद मंद धीमा संथ हळू संथगती मंदगती
सूखदिणें: आनंददायक आनंददायी सुखद सुखकारक सुखदायी सुखदायक सुखप्रद आल्हादकारक आल्हादक तोषक रंजक
सूरहीण: बेसूर
सृजक: कर्ता सर्जक सृजक स्रष्टा रचनाकार सर्जनकार सृजनकार सर्जनकर्ता सृजनकर्ता
सृजनकर्तो: कर्ता सर्जक सृजक स्रष्टा रचनाकार सर्जनकार सृजनकार सर्जनकर्ता सृजनकर्ता
सृजनशीळ: सर्जनशील सृजनशील सर्जनक्षम सृजनक्षम प्रसवक्षम प्रसवशील
सृजनात्मक: विधायक
सॅटिनाचें: सॅटीनचा सटिनी सॅटिनी
सेगीत: अनवरत अविरत अविश्रांत निरंतर
सेचाळिसावें: सेहेचाळिसावा
सेवक: सेवक
सेवनाचें: उपभोग्य सेवनीय
सेवा_करपी: परिचारक
सेवानिवृत्त: निवृत्त सेवानिवृत्त
सेवी: सेवक
सेवीत: सेवित
सैनिकी: लष्करी लष्करी फौजी
सैन्य: लष्करी
सैन्या_बगरचें: बरोबर_सैन्य_नसलेला
सैन्या_विरयत: बरोबर_सैन्य_नसलेला
सैमीक: नैसर्गिक प्राकृतिक स्वाभाविक साहजिक
सैल: शिथिल लुळा लुला सैल ढिला डगळ ढगळ सैल
सोंपते_तारखेचें: मुदत_उलटलेला
सोंपूंक_नाशिल्लें: अपुरा अपूर्ण अर्धवट
सोंपे: सुलभ
सोंपें: जाण्याजोगा सुबोध सोपा सुगम बाळबोध सोईस्कर सोयीस्कर सुनिवार्य सुनिवारणीय
सोंपेपणाचें: सोईस्कर सोयीस्कर
सोंपो: सहज सरल सुगम सोपा सुलभ सुकर सलील
सोंशीक: सहिष्णू सहनशील सोशिक
सोकिल्लें: शोषलेला शोषून_घेतलेला
सोकून_घेतिल्लें: शोषलेला शोषून_घेतलेला
सोडिल्ले: परित्यागी
सोडिल्लें: परित्यक्त पाठवलेला रवाना
सोडून_गेल्लें: परित्यागी
सोडोवंक_जायना_अशें: अनाकलनीय
सोदक: शोधक अन्वेषक
सोदपी: शोधणारा
सोदर्यात्मक: सौंदर्यात्मक सौंदर्यपर
सोदिल्लें: हुडकलेला शोधित
सोबीत: सुंदर देखणा सुरेख रूपवान शोभादायक शोभादायी शोभायमान शोभाद अत्यंत_सुंदर दिसण्यात_सुंदर दिव्य
सोरपा_आकाराचें: सर्पाकार सर्पाकृती
सोरेकार: दारुडा दारुड्या दारूबाज बेवडा मद्यपी
सोर्‍याकार: दारुडा दारुड्या दारूबाज बेवडा मद्यपी
सोलिल्लीं: आवरणहीन
सोळा: सोळा
सोळावें: सोळावा
सोसूंक_जायना_अशें: असह्य असहनीय सोसेनासे दुःसह
सौम्य: सौम्य कोमल_स्वभावाचा शांत
सौर: सौर
स्टार्चान_भरिल्लें: पिष्ठसत्त्वयुक्त
स्टोनियायी: स्टोनियाई स्टोनियाई
स्तुतीपाठक: प्रशंसक
स्त्री: मादी मादा
स्थापीत: संस्थापित स्थापित
स्थायी: स्थायी कायमचा पक्की कायमची
स्थायीक: वसलेला
स्थावर: स्थिर स्थावर अचल स्थिर स्थावर अचल
स्थीर: गतिहीन स्थिर स्थिर स्थावर अचल अचल निश्चल स्थिर अढळ दृढ अविचल स्थिर स्थावर अचल अविस्मणीय सारखा एकसारखा सतत
स्थूल: जाड जाडा जाडजूड लठ्ठ स्थूल
स्नेही: प्रेमळ मायाळू वत्सल कनवाळू स्नेहशील स्नेहाळ स्नेहाळू
स्पटिकी: स्फटिकासारखा
स्पर्श_करी_सारकें: स्पृश्य
स्पर्श_करूंक_नाशिल्लें: अस्पृष्ट अस्पर्शित
स्पश्ट: स्पष्ट साफ स्वच्छ सुस्पष्ट स्पष्ट
स्पश्टवादी: स्पष्टवक्ता स्पष्टवादी निर्भीड
स्पृश्य: स्पृश्य
स्पॅनीश: स्पेनी स्पॅनिश
स्फटिका_भशेन: स्फटिकासारखा
स्फटिकाचें: स्फटिकी स्फटिकासारखा
स्फूर्तहीण: निरुत्साही अनुत्साही
स्फूर्तीदायक: स्फूर्तिदायक
स्फोटक: स्फोटक विस्फोटक
स्मरणीय: स्मरणीय संस्मरणीय
स्लोवाकी: स्लाव्ह स्लोव्हाक स्लाव्हिक
स्लोवेनियाचें: स्लोव्हेनियाई
स्लोवेनियायी: स्लोव्हेनियाई स्लोव्हेनियाई
स्वखोसयेचें: स्वांतःसुखाय स्वतःसाठी स्वतःकरता आपल्यासाठी
स्वगत: मनोगत
स्वच्छ: विशुद्ध
स्वजातीय: सजातीय
स्वतंत्र: स्वतंत्र स्वच्छंदी स्वच्छंद स्वतंत्र स्वेच्छाचारी
स्वता_कमयिल्लें: स्वसंपादित
स्वता_जोडिल्लें: स्वसंपादित
स्वता_मेळयिल्लें: स्वसंपादित
स्वताचें: खाजगी खासगी व्यक्तिगत वैयक्तिक स्वीय
स्वताचो: व्यक्तिगत
स्वताच्या_नांवान_प्रसिद्ध: स्वनामधन्य
स्वदेशी: देशी राष्ट्रीय स्वदेशी
स्वनामप्रसिद्ध: स्वनामधन्य
स्वनिर्भर: स्वयंपूर्ण
स्वपक्षी: स्वपक्षीय
स्वभावीक: स्वाभाविक उपजत नैसर्गिक
स्वराचें: स्वरयुक्त स्वरित
स्वराळ: स्वरयुक्त स्वरित
स्वर्णीम: सोनेरी
स्वाभावीक: स्वाभाविक साहजिक
स्वाभिमानहीण: स्वाभिमानशून्य
स्वायत्त: स्वायत्त
स्वावलंबी: स्वावलंबी_स्त्री स्वावलंबिनी आत्मनिर्भर स्वावलंबी निरावलंब स्वयंपूर्ण
स्वास_आडावपी: श्वास_रोकणारा
स्वाहिली: स्वाहिली स्वाहिलीविषयीचा स्वाहिलीविषयक स्वाहिलीशी_संबंधित स्वाहिलीसंबंधीचा स्वाहिली
स्विकार_करी_सारकें: स्वीकार्य स्विकारण्याजोगा
स्विकारपा_सारकें: स्वीकार्य स्विकारण्याजोगा
स्विकारिल्ली: मंजूर मंजूरीप्राप्त स्वीकृत मान्य -मान्य मान्यताप्राप्त
स्विकारिल्लें: अंगीकृत स्वीकालरेला पत्करलेला
स्विकारूंक_नाशिल्लें: अस्वीकृत नामंजूर
स्विकृत: परवानगी_मिळालेला अनुमती_मिळालेला अनुज्ञा_मिळालेला स्वीकृत मान्य -मान्य मान्यताप्राप्त
स्विडीश: स्वीडिश स्वीडिश
हक्क_आशिल्लो: हक्कदार अधिकारी
हजर: उपस्थित हजर हाजिर
हजरजबाबी: हजरजबाबी
हजार: हजार सहस्र
हजारांनी: हजारो सहस्रावधी
हट्टी: दुराग्रही हट्टी हटवादी हेकेखोर अडेलतट्टू हेकट हट्टी जिद्दी जितखोर
हडपिल्लें: जप्त लाटलेला
हयकारी: होकारात्मक सकारात्मक
हरवें: कच्चा अपक्व अपरिपक्व कच्चा अपक्व कच्चा हिरवागार हिरवा
हरामी: हरामखोर हलकट
हलकट: अश्लील अचकटविचकट घाणेरडा वाह्यात
हलकें: हळू बारीक सौम्य फिका गुलाबी
हलको: हलका
हळडुवें: पिवळा पीत
हळू: हळू बारीक सौम्य
हळू_हळू: मंद धीमा संथ हळू स्तिमित संथगती मंदगती
हवनी: हव्य
हवाई: हवाई
हवादार: हवेशीर
हवाबंद: हवाबंद
हसतमूख: प्रसन्नमुख प्रसन्नवदन
हस्तलिखीत: हस्तलिखित
हस्तांतरीत: हस्तांतरित
हांडेकार: धनाढ्य धनवान श्रीमंत समृद्ध सधन धनवंत धनिक तालेवार
हांशाक_म्हारग: हास्यकारक
हांशाचें: हास्यकारक
हांश्यास्पद: हास्यास्पद
हांसकुरें: हास्यास्पद
हांसपी: हसतमुख हसरा
हांसमूख: हसतमुख हसरा
हांसयाळें: हास्यास्पद हसतमुख हसरा
हांसरें: हसतमुख हसरा
हाचे_सारको: null
हाडकुळें: हाडकुळा अशक्त वाळलेला रोडावलेला क्षीण रोड बारीक शिडशिडीत सडसडीत रोड लुकडा काटकुळा हडकुळा फाटका वाळकुडा वाळलेला किरकोळ हडकुळा हडक्या हडकलेला काडीपैलवान
हाडांचें: हाडाचा अस्थिचा अस्थिमय
हातबरपाचें: हस्तलिखित
हाता_खालचें: अधीन आधीन स्वाधीन अधीन_असलेला ताब्यात_असलेला वश_असलेला वश अवलंबून_असलेला
हातांत_जाता_अशें: जमणारा
हातांत_जाय_सारकें: जमणारा
हारिल्लो: मागे_पडलेला मागे_राहिलेला पराभूत पराजित हारलेला जित
हालयिल्लें: बाजूला_काढलेला
हावरट: लोभी लालची खवय्या
हावरें: लोभी लालची
हावेसाचें: सकाम साभिलाष इच्छित अभिलाषित अभीष्ट अभीप्सित वांछित आकांशित इच्छिलेला ईप्सित
हासयाळें: हसतमुख हसरा
हास्य: हास्यकारक
हिंदी: हिंदी
हिंदुस्थानी: भारतीय हिंदुस्थानी
हिंसक: हिंसक हिंसक हिंसात्मक
हिजडो: नपुंसक षंढ
हितकारी: कल्याणकारी हितकारक फायदेशीर लाभदायक हितकर श्रेयस्कर इष्ट उपकारक
हिब्रू: हिब्रू
हिब्रू_भास: हिब्रू
हिमटो: कंजूस कंजूष कृपण कद्रू चिक्कू कवडीचुंबक चिकट
हिमालयी: हिमालयीन हिमालयीय
हिवाळी: हिवाळी
हीणपणाचें: निकृष्ट हीन अधम हलका वाईट भिकार भुक्कड कुत्सिक
हीम: हिमज
हुंपूंक_जायनाशिल्लो: दुस्तर
हुंवारग्रस्त: पूरग्रस्त
हुनहुनीत: गरमगरम कढत ऊनऊन गरमागरम कडकडीत तापलेला तप्त गरम तापलेला तप्त
हुबेहुब: हुबेहूब
हुमटपी: उन्मळून_पडणारा
हुमेल्ली: घामाघूम घामेला
हुशार: योग्य लायक समर्थ सक्षम पात्र काबील बुद्धिमान बुद्धिमंत बुद्धिवान हुषार अक्कलवान चांगला सरस चपळ चटपटीत तरतरीत चतुर चलाख हुशार चाणाक्ष
हुसक्यामेकळें: निःशंक निर्धास्त निर्भ्रांत शंकारहित
हुसक्यामेकळो: निश्चिंत चिंतारहित चिंतामुक्त काळजीमुक्त
हुस्को: चिंताग्रस्त चिंताक्रांत चिंतातुर सचिंत चिंतामग्न चिंतित चिंताकुल चिंतावलेला
हुस्क्याचें: चिंताजनक
हून: उष्ण गरम उष्म तप्त तापलेले ऊन तापलेला तप्त उबदार गरम गरम तापलेला तप्त
हे_तरेचें: तसा
हे_तरेचो: null
हे_भशेचें: तसा
हे_सारकें: तसा
हे_सारको: null
हेडगें: भटक्या भटकणारा उडाणटप्पू उनाड उनाडटप्पू बंजारा वणजारा भटका
हेर: इतर अन्य आणखी दुसरा इतर अन्य दुसरा अवांतर परका दुसरा बाहेरचा इतर
हैदराबादी: हैदराबादी
