अंकीत: °TvÀ °¦¸À»vÀ CAQvÀ
अंगरक्षक: gÀPÀëuÁ gÀPÀëuÉ0iÀÄ
अंडज: CAqÉÆÃvÁàzÀPÀ
अंतर्मुखी: CAvÀªÀÄÄðT CAvÀgÁ©üªÀÄÄT KPÁAvÀ¦æAiÀÄ
अंधश्रद्धाळू: ªÀÄvÁAzsÀ PÀmÁÖ_¸ÁA¥ÀæzÁAiÀÄªÁ¢
अकथनीय: C¤ªÀðZÀ¤ÃAiÀÄ «ªÀj¸À¯ÁUÀzÀ
अकलात्मक: PÀ¯ÁvÀäPÀªÀ®èzÀ PÀ¯ÁªÀAwPÉ¬Ä®èzÀ CgÀ¹PÀ PÀ¯Á©ügÀÄa¬Ä®èzÀ
अकल्पीत: H»¸À¯ÁUÀzÀ HºÁwÃvÀ PÀ®à£ÁwÃvÀ
अकल्याणकारी: C¤µÀÖPÀgÀ CªÀÄAUÀ®PÀgÀ ±ÀÄ¨sÀ¸ÀÆZÀPÀªÀ®èzÀ C±ÀÄ¨sÀPÀgÀ
अकस्मात: DPÀ¹äPÀ CPÀ¸ÁävÁÛzÀ C¤jÃQëvÀªÁzÀ
अकाळीक: CPÁ®_d£À£À CPÁ°PÀ
अकुळीन: PÀÄ°Ã£À ¤ªÀÄß_ªÀUÀðzÀ zÀ°vÀ
अकृत: C¥ÀÇtðªÁzÀ ¥ÀÇwðAiÀiÁUÀzÀ ¤«Äð¸À¯ÁgÀzÀ ªÀiÁqÀ¯ÁgÀzÀ gÀa¸À¯ÁgÀzÀ
अक्षम्य: CPÀëªÀÄå PÀëªÀiÁ»Ã£À
अखंड: C¨ÉÃzsÀåªÁzÀ ¨ÉÃ¢ü¸À¯ÁUÀzÀ MqÉAiÀÄ¯ÁgÀzÀ C¨sÉÃzÀå MqÉAiÀÄ¯ÁUÀzÀ
अखंडीत: MqÉAiÀÄ¯ÁUÀzÀ MqÉAiÀÄ¯ÁgÀzÀ vÀÄAqÁUÀzÀ C«¨sÁdå C¨sÁdå CRAqÀ ¨sÁV¸À¯ÁUÀzÀ
अखेरच्या: PÀqÉAiÀÄ PÉÆ£ÉAiÀÄ CAwªÀÄ DvÀåAwPÀ PÀlÖPÀqÉAiÀÄ CSÉÊgÀÄ
अग्नीशामक: ±ÁªÀÄPÀ ±ÀªÀÄ£ÀPÁj ±ÀªÀÄ£ÀUÉÆ½¸ÀÄªÀ
अग्रगामी: ªÀÄÄAZÀÆtÂUÀ ªÀÄÄAZÀÆtÂ_£ÁAiÀÄPÀ
अघटीत: £ÀqÉAiÀÄzÀ CWÀnvÀ C¸ÀA§ªÀ ¸ÁzÀåªÁUÀzÀ WÀn¸À¯ÁgÀzÀ £ÀqÉAiÀÄ¯ÁgÀzÀ
अचंचळ: zÀÈqsÀªÁzÀ UÀnÖAiÀiÁzÀ ¨sÀzÀæªÁzÀ ¹ÜgÀªÁzÀ
अचंबीत: «®PÀët «avÀæ ¨ÉgÀUÀÄUÉÆAqÀ CZÀÑjUÉÆAqÀ
अचकीत: DPÀ¹äPÀ CPÀ¸ÁävÁÛzÀ C¤jÃQëvÀªÁzÀ
अचल: (?)
अचेतन: dqÀ CZÉÃvÀ£À dqÀUÉÆAqÀ
अजय: CeÉÃAiÀÄ ¸ÉÆÃ®jAiÀÄzÀ C¥ÀgÁdAiÀÄ
अजाण: C«ªÉÃQAiÀiÁzÀ zÀqÀØ£ÁzÀ ªÀÄAzÀ§Ä¢ÞAiÀÄ
अजातशत्रू: CeÁvÀ±ÀvÀÄæ ±ÀvÀÄæUÀ½®èzÀ «gÉÆÃ¢üUÀ½®èzÀ
अजापाचें: C¨sÀÆvÀ¥ÀÇªÀð C¥ÀÇªÀð
अजापीत: C£À¥ÉÃQëvÀ ¨ÉgÀUÀÄUÉÆAqÀ CZÀÑjUÉÆAqÀ
अजीर्ण: CfÃtð
अजैत: ¸ÉÆÃ°gÀzÀ ¸ÉÆÃw®èzÀ CfvÀ C¥ÀgÁfvÀ CeÉÃAiÀÄ ¸ÉÆÃ®jAiÀÄzÀ C¥ÀgÁdAiÀÄ
अज्ञात: CeÁÕvÀ CjAiÀÄzÀ w½AiÀÄzÀ C¥ÀjavÀ ¥ÀjZÀAiÀÄ«®èzÀ w½«®èzÀ UÀÄgÀÄw®èzÀ
अटूट: UÁqsÀªÁzÀ MqÉAiÀÄ¯ÁUÀzÀ MqÉAiÀÄ¯ÁgÀzÀ vÀÄAqÁUÀzÀ MqÉAiÀÄ¯ÁgÀzÀ C¨sÉÃzÀå MqÉAiÀÄ¯ÁUÀzÀ
अडचणीन_भरिल्लें: ¤gÉÆÃzsÀPÀ vÀqÉUÀlÄÖªÀ
अडेचें: vÉÆÃjPÉAiÀÄ
अणकार_करपी: C£ÀÄªÁzÀPÀ ¨sÁµÁAvÀgÀPÁgÀ
अणकारक: C£ÀÄªÁzÀPÀ ¨sÁµÁAvÀgÀPÁgÀ
अणकारपी: C£ÀÄªÁzÀPÀ ¨sÁµÁAvÀgÀPÁgÀ
अणभवी: £ÀÄjvÀ C£ÀÄ¨sÀ« C¨Áå¸ÀªÁzÀ ¥À¼ÀVzÀ MVÎzÀ
अतंत्रीक: CvÁAwæPÀ vÁAwæPÀªÀ®èzÀ vÀAvÀæeÁÕ£ÀgÀ»vÀ
अतिंद्रीय: CUÉÆÃZÀgÀ CUÁæºÀå PÁt¯ÁUÀzÀ w½AiÀÄ¯ÁUÀzÀ UÀæ»¸À¯ÁUÀzÀ
अतिक्रमी: CwPÀæªÀÄtPÁj
अतिक्रमीत: CwPÀæ«ÄvÀ
अतीरागिश्ट: CvÀÄåUÀæªÁzÀ Cw_PÀÄëzÀæªÁzÀ
अतुलनीय: JuÉ¬Ä®èzÀ ¸Án¬Ä®èzÀ C¸ÀªÀiÁ£À ºÉÆÃ°PÉ¬Ä®èzÀ
अतुल्य: JuÉ¬Ä®èzÀ ¸Án¬Ä®èzÀ C¸ÀªÀiÁ£À ºÉÆÃ°PÉ¬Ä®èzÀ
अतूट: C¨ÉÃzsÀåªÁzÀ ¨ÉÃ¢ü¸À¯ÁUÀzÀ
अतृप्त: CvÀÈ¥ÀÛ C¸ÀAvÀÄµÀÖ C¸ÀAvÀÈ¥ÀÛ vÀÈ¦ÛAiÀiÁUÀzÀ
अत्याचारी: C£ÁåAiÀÄ_ªÀiÁqÀÄªÀªÀ CvÁåZÁj C£ÁZÁj PÀÆæj
अदृश्य: CzÀÈ±ÀåªÁzÀ CUÉÆÃZÀgÀ CQëUÉÆÃZÀgÀªÀ®èzÀ
अधाशिल्ले: CvÁå±ÉAiÀÄ zÀÄgÁ±ÉAiÀÄ ¯ÉÆÃ©üvÀ£ÀzÀ vÀÈµÉAiÀÄ
अधिकार_नाशिल्लें: C¢üPÁgÀ«®èzÀ C¢üPÁgÀ_gÀ»vÀ
अधिकारहीण: C¢üPÁgÀ«®èzÀ C¢üPÁgÀ_gÀ»vÀ
अधिकाराची: C¢üPÁgÀAiÀÄÄvÀ C¢üPÀÈvÀ C¢üPÁjPÀ
अधीन: PÉ¼ÀzÀeÉðAiÀÄ PÀrªÉÄzÀeÉðAiÀÄ
अधीनहीण: CzÀªÀÄå zÀÄ¤ðUÁæºÀå CqÀV¸À¯ÁUÀzÀ vÀqÉ0iÀÄ¯ÁUÀzÀ
अधोगतीक: E½ªÀÄÄR »AZÀ°¸ÀÄªÀ »AUÀwAiÀÄ ¥ÀæwÃ¥ÀUÁ«Ä »AdjAiÀÄÄªÀ
अध्यक्ष: PÀlÄÖ¤mÁÖzÀ_²¸ÀÄÛ¥Á°¸ÀÄªÀªÀ
अनंत: C¥ÁgÀ C«ÄvÀ ¹ÃªÀiÁ_gÀ»vÀ J¯Éè¬Ä®èzÀ «Äw¬Ä®èzÀ
अनंताचो: C£ÀAvÀªÁzÀ PÉÆ£É¬Ä®èzÀ
अनपेक्षीत: C£À¥ÉÃQëvÀ
अनर्थकारी: C£ÀxÀðPÁjAiÀiÁzÀ ªÀÄºÁzÀÄgÀAvÀzÀ «¥ÀèªÀzÀ zÀÄgÀAvÀzÀ
अनळंकृत: ¸ÀgÀ¼À ¸ÁzÁ C£À®APÀÈvÀ
अनवळखी: CeÁÕvÀ CjAiÀÄzÀ w½AiÀÄzÀ C¥ÀjavÀ ¥ÀjZÀAiÀÄ«®èzÀ w½«®èzÀ UÀÄgÀÄw®èzÀ
अनात्मदर्शी: §»ªÀÄÄðT ¨ÁºÀå¥ÀæªÀÈvÀÛ ¸ÉßÃºÀ²Ã®
अनाथ: C£ÁxÀ vÀ§â°
अनासक्त: C£Á¸ÀPÀÛ
अनितीक: C£ÉÊwPÀ C£ÉÊaÑPÀ ¤ÃwUÉlÖ zÀÄµÀÖ
अनित्सूक: ¤gÀÄvÁìºÀ PÀÄvÀÆºÀ®«gÀzÀ EµÀÖ«®èzÀ ¨ÉÃqÀªÁzÀ §AiÀÄ¸ÀzÀ
अनियमीत: C¤AiÀÄvÀ C¤UÀ¢vÀ
अनिर्धारीत: C¤¢ðµÀÖ C¤zsÁðjvÀ C¤tÂÃðvÀ ¸ÀA¢UÀÝ C¤²ÑvÀ
अनिर्मीत: ¤«Äð¸À¯ÁgÀzÀ ªÀiÁqÀ¯ÁgÀzÀ gÀa¸À¯ÁgÀzÀ
अनिश्चीत: C¤AiÀÄvÀ C¤UÀ¢vÀ
अनुकरणीय: C£ÀÄPÀgÀtÂÃAiÀÄ
अनुक्रमान: PÀæªÀiÁ£ÀÄUÀvÀ D£ÀÄPÀæ«ÄPÀ ¤gÀAvÀgÀ ¸ÀAvÀvÀ
अनुत्तीर्ण: C£ÀÄwÛÃtð ¥ÉÃ¯ÁzÀ
अनुपकारादीक: C¥ÁAiÀÄPÁj C¤µÀ×PÁj
अनुपलब्ध: zÉÆgÉAiÀÄzÀ ¹UÀzÀ G¥À®§Ý«gÀzÀ
अनुपस्थीत: C£ÀÄ¥À¹ÜvÀ UÉÊgÀÄºÁdgÁzÀ
अनुपेगी: ¤µÀàçAiÉÆÃdPÀ C£ÀÄ¥ÀAiÉÆÃV ¤µÀà® PÉ®¸ÀPÉÌ_¨ÁgÀzÀ
अनुमतीत: ¹éÃPÀÈvÀ M¦àvÀ C£ÀÄªÉÆÃ¢vÀ
अनुमतीप्राप्त: ¹éÃPÀÈvÀ M¦àvÀ C£ÀÄªÉÆÃ¢vÀ
अनुवंशीक: D£ÀÄªÀA²PÀªÁV C£ÀÄªÀA±Á£ÀÄUÀvÀ ªÀA±À¥ÁgÀA¥ÀAiÀÄðªÁV
अनुवादक: C£ÀÄªÁzÀPÀ ¨sÁµÁAvÀgÀPÁgÀ
अनुवादपी: C£ÀÄªÁzÀPÀ ¨sÁµÁAvÀgÀPÁgÀ
अनुशासक: PÀlÄÖ¤mÁÖzÀ_²¸ÀÄÛ¥Á°¸ÀÄªÀªÀ
अनुशीक: PÀrªÉÄ_¥ÀæªÀiÁtzÀ ¸Àé®à C®à
अनुसरून: C£ÀÄPÀÆ®PÀgÀ
अनेक: C£ÉÃPÀ C£ÉÃPÁ£ÉÃPÀ
अनैतीक: C£ÉÊwPÀ C£ÉÊaÑPÀ ¤ÃwUÉlÖ zÀÄµÀÖ
अनैत्शीक: C£ÉÊaÒPÀ AiÀiÁzÀÈaÒPÀ C£ÀÄ¢ÝµÀÖ
अन्य.: EvÀgÀ ¨ÉÃgÉ ¥ÀgÀ C£Àå
अन्यायपुर्ण: C£ÁåAiÀÄ £ÁåAiÉÆÃavÀªÀ®èzÀ AiÀÄÄPÀÛªÀ®èzÀ C£ÀÄavÀ
अन्यायी: C£ÁåAiÀÄ_ªÀiÁqÀÄªÀªÀ
अपंग: CAUÀ«PÀ® «PÀ¯ÁAUÀ CAUÀ»Ã£À
अपंगूळ: CAUÀ«PÀ® «PÀ¯ÁAUÀ CAUÀ»Ã£À «PÀ¯ÁAUÀ CAUÀ«PÀ®
अपभ्रंश: PÉlÖ PÀÄgÀÆ¥ÀzÀ DPÁgÀUÉlÖ «PÀÈvÀªÁzÀ
अपमान: CªÀªÀiÁ¤vÀ C¥ÀªÀiÁ¤vÀ
अपराजीत: ¸ÉÆÃ°gÀzÀ ¸ÉÆÃw®èzÀ CfvÀ C¥ÀgÁfvÀ
अपरिवर्तनशील: C¥ÀjªÀvÀð¤ÃAiÀÄ ¥ÀjªÀvÀð£ÉAiÀiÁUÀzÀ
अपरिवारीक: ºÉÆgÀV£ÀªÀ
अपरूप: ¸Àj¸Án¬Ä®èzÀ JuÉ¬Ä®èzÀ C¸ÀªÀiÁ£À
अपवित्र: ªÉÄÊ°UÉ C¥À«vÀæ D±ÀÄzÀÞ
अपहरण_केल्लें: C¥ÀºÀÈvÀ C¥ÀºÀgÀtPÉÆÌ¼ÀUÁzÀ
अपात्र: CAiÉÆÃUÀå
अपुरें: C¥ÀÇtð C¥Àj¥ÀÇtð CzÀðA§zÀð CgÉ§gÉ
अपूर्ण: C¥ÀÇtð C¥Àj¥ÀÇtð CzÀðA§zÀð CgÉ§gÉ C¥ÀÇtðªÁzÀ ¥ÀÇwð_ªÀÄÄVAiÀÄzÀ
अपेक्षा_नासतना: C£À¥ÉÃQëvÀ
अपेक्षीत: GzÉÝÃ±À¥ÀÇªÀðPÀ G¢ÝµÀÖ GzÉÝÃ²¹zÀ
अप्रतिश्ठीत: CAiÉÆÃUÀåªÁzÀ WÀ£ÀvÉ_UÁA©üÃAiÀÄð«®èzÀ UËgÀªÀPÉÌ_PÀÄAzÀÄ_ªÀiÁqÀÄªÀ
अप्रमाणीक: ªÉÆÃ¸ÀUÁjPÉAiÀÄ PÀ¥ÀlzÀ ªÀAZÀ£ÉAiÀÄ
अप्रयोजक: ¸ÀªÀÄAiÉÆÃavÀªÀ®èzÀ ¸ÀAzÀ¨sÉÆÃðavÀªÀ®èzÀ C¸ÁªÀÄ¬ÄPÀvÉ
अप्रसन्न: zÀÄBRzÀ ±ÉÆÃPÀzÀ ªÀå¸À£ÀzÀ T£Àß GzÁ¹Ã£À
अप्रसिद्ध: ¸ÁªÀiÁ£Àå ¸ÁzÁgÀt C«SÁåvÀ C¥Àæ¹zÀÞ
अप्राकृतीक: PÀÈvÀPÀªÁzÀ C¸Áé¨sÁ«PÀ C¸ÀºÀdªÁzÀ
अप्राप्त: ¹UÀzÀ ®§åªÁUÀzÀ zÉÆgÉAiÀÄzÀ ¥Áæ¥ÀÛªÁUÀzÀ
अप्रासंगीक: ¸ÀªÀÄAiÉÆÃavÀªÀ®èzÀ ¸ÀAzÀ¨sÉÆÃðavÀªÀ®èzÀ C¸ÁªÀÄ¬ÄPÀvÉ
अप्रीय: EµÀÖ«®èzÀ »r¸ÀzÀ M¦àUÉAiÀiÁUÀzÀ gÀÄa¸ÀzÀ MUÀÎzÀ C¦æAiÀÄ C¦æÃwAiÀÄ
अबादीत: UÁAiÀÄªÁUÀzÀ ¥ÉmÁÖUÀzÀ £ÉÆÃªÁUÀzÀ
अबुद्ध: C«ªÉÃQAiÀiÁzÀ zÀqÀØ£ÁzÀ ªÀÄAzÀ§Ä¢ÞAiÀÄ
अभागी: £ÀvÀzÀÈµÀÖzÀ CzÀÈµÀÖ»Ã£À zÀÄgÀzÀÈµÀÖzÀ zÀÄzÉÊð«
अभिव्यक्त: C©üªÀåPÀÛªÁzÀ ¥ÀæPÀnvÀ eÁ»gÁzÀ ¥ÀæPÀlUÉÆAqÀ
अभेद्य: C¨ÉÃzsÀåªÁzÀ ¨ÉÃ¢ü¸À¯ÁUÀzÀ
अभ्यासू: C¨Áå¸ÀªÁzÀ ¥À¼ÀVzÀ MVÎzÀ
अमान्य: ¤¶zÀÞ ¤§ðA¢üvÀ PÀlÄÖ¥ÁrgÀÄªÀ M¥Àà¯ÁUÀzÀ C£ÀAVÃPÁAiÀÄð C¹éÃPÀÈvÀªÁzÀ CAVÃPÁAiÀÄðºÀðªÀ®èzÀ ¹éÃPÁgÀAiÉÆÃUÀåªÀ®èzÀ
अमिश्रीत: ±ÀÄzÀÞªÁzÀ «Ä±Àæt«®èzÀ
अमीट: C½¸À¯ÁUÀzÀ £Á±ÀªÁUÀ¯ÁgÀzÀ
अमुरपिकें: C¥ÀPÀé ¥ÀPÀéªÁUÀzÀ
अमुर्त: ¤gÁPÁgÀ CªÀÄÆvÀð
अमुल्य: CªÀÄÆ®åªÁzÀ C£ÀWÀåðªÁzÀ ¨É¯ÉPÀlÖ¯ÁUÀzÀ
अमूर्त: CUÉÆÃZÀgÀ CUÁæºÀå PÁt¯ÁUÀzÀ w½AiÀÄ¯ÁUÀzÀ UÀæ»¸À¯ÁUÀzÀ
अयशस्वी: C¸À¥sÀ® ¥sÀ®PÁjAiÀÄ®èzÀ
अयोग्य: CAiÉÆÃUÀå
अरचीत: ¤«Äð¸À¯ÁgÀzÀ ªÀiÁqÀ¯ÁgÀzÀ gÀa¸À¯ÁgÀzÀ
अरिश्टनिवारक: ¸ÀAPÀl_¤ªÁgÀPÀ zÀÄBR_¤ªÁgÀPÀ
अरिश्टमय: zÀÄBRªÀÄ0iÀÄ ¸ÀAPÀlPÀgÀ
अरिश्टाचें: zÀÄBRªÀÄ0iÀÄ ¸ÀAPÀlPÀgÀ
अरुचीक: ¸ÁégÀ¸Àå«gÀzÀ ¸Áé¢µÀÖªÀ®èzÀ ZÀÄgÀÄQ®èzÀ
अरेखीत: ¹ÃªÀiÁwÃvÀ UÀrAiÀiÁwÃvÀ
अर्ज_केल्लें: ¤ªÉÃzÀPÀ ¥Áæyð¸ÀÄªÀªÀ
अर्जदार: ¤ªÉÃzÀPÀ ¥Áæyð¸ÀÄªÀªÀ
अर्थशास्त्राचें: CxÀð±Á¹ÛçÃAiÀÄ
अर्थशास्त्रीय: CxÀð±Á¹ÛçÃAiÀÄ
अर्थीक: DyðPÀ «wÛÃAiÀÄ ºÀtPÁ¹£À
अर्द: CzÀð¨sÁUÀzÀ
अर्दउकतें: CgÉvÉgÉzÀ vÀÄ¸ÀÄvÉgÉzÀ
अर्दकुटें: C¥ÀÇtð C¥Àj¥ÀÇtð CzÀðA§zÀð CgÉ§gÉ C¥ÀÇtðªÁzÀ ¥ÀÇwð_ªÀÄÄVAiÀÄzÀ
अर्दपिकें: C¥ÀPÀé ¥ÀPÀéªÁUÀzÀ
अर्दमेलो: CgÉfÃªÀzÀ CzÀð¸ÀvÀÛ
अर्दवट: C¥ÀÇtð C¥Àj¥ÀÇtð CzÀðA§zÀð CgÉ§gÉ
अर्दवर्सुकी: CzÀðªÁ¶ðPÀ CgÉªÁ¶ðPÀ
अर्दुकुटें: C¥ÀÇtð C¥Àj¥ÀÇtð CzÀðA§zÀð CgÉ§gÉ
अर्भक: £ÀªÀeÁvÀ
अलभ्य: ¹UÀzÀ ®§åªÁUÀzÀ zÉÆgÉAiÀÄzÀ ¥Áæ¥ÀÛªÁUÀzÀ
अलिखीत: C°TvÀ ªÀiËTPÀ
अल्प_काळीन: vÁvÁÌ°PÀ C®àPÁ°PÀ ºÀAUÁ«Ä
अल्पआहारी: C®àºÁj
अल्पसंख्यांक: C®à¸ÀASÁåvÀgÀÄ C®à¸ÀASÁåvÀ
अल्पायुशी: C¯ÁàAiÀÄÄ C¯ÁàAiÀÄÄ¶ C®àPÁ°ÃPÀ PÀët¨sÀAUÀÄgÀ
अळंकारहीण: ¸ÀgÀ¼À ¸ÁzÁ C£À®APÀÈvÀ
अळंकारा_बगरचें: ¸ÀgÀ¼À ¸ÁzÁ C£À®APÀÈvÀ
अळंकारीत: C®APÀÈvÀ C®APÁgÀ¨sÀÆ¬ÄµÀ× ¹AUÁgÀªÀÄAiÀÄ ±ÀÈAUÁgÀªÀÄAiÀÄ
अवयस्क: J¼É_ªÀAiÉÆÃªÀiÁ£ÀzÀ ¨Á®PÀ\
अवर्णनीय: CªÀtð¤ÃAiÀÄ ªÀtÂð¸À®¸ÀzÀ¼À
अवश: CzÀªÀÄå zÀÄ¤ðUÁæºÀå CqÀV¸À¯ÁUÀzÀ vÀqÉ0iÀÄ¯ÁUÀzÀ
अवाचनीय: NzÀ¯ÁgÀzÀAvÀºÀ NzÀ¯ÁgÀzÀ
अविज्ञानीक: CªÉÊeÁÕ¤PÀ CªÉÊeÁÕ¤PÀ
अविवाहीत: C«ªÁ»vÀ M§âAn
अविश्वासी: C«±Áé¹ C¥À£ÀA©UÀ¸ÀÛ
अवेवस्थीत: CªÀåªÀ¹ÜvÀ C£À£ÀÄPÀÆ®ªÁVgÀÄªÀ_(?)
अवेव्हारी: CªÀåªÀºÁjPÀ
अवेव्हारीक: ºÉÆ¸À £ÀªÀ £ÀÆvÀ£À §¼À¸ÀzÀ Fa£À
अशक्य: C¸ÁzsÀå PÀptªÁzÀ
अशांत: C±ÁAvÀ ¸ÀAPÀlzÀ zÀÄBRzÀ UÉÆÃ½£À
अशिमांकीत: ¹ÃªÀiÁwÃvÀ UÀrAiÀiÁwÃvÀ
अशीम: C¥ÁgÀ C«ÄvÀ ¹ÃªÀiÁ_gÀ»vÀ J¯Éè¬Ä®èzÀ «Äw¬Ä®èzÀ
अशीर: ©VAiÀiÁzÀ
अशुद्ध: C±ÀÄzÀÝªÁzÀ ºÉÆ®¸ÁzÀ C±ÀÄaAiÀiÁzÀ ZÉÆPÀÌl«®èzÀ
अशूभ: C¤µÀÖPÀgÀ CªÀÄAUÀ®PÀgÀ ±ÀÄ¨sÀ¸ÀÆZÀPÀªÀ®èzÀ C±ÀÄ¨sÀPÀgÀ
अशे_तरेचो: EAvÀºÀ F_¥ÀæPÁgÀzÀ
अशें-तशें: £ÀUÀtå
अश्राव्य: PÉÃ¼ÀzÀ PÉÃ¼À¯ÁgÀzÀ C±ÀæªÀå C±ÀæªÀtÂÃ0iÀÄ
अश्लील: C²èÃ® C¸À¨sÀåªÁzÀ ºÉÆ®¸ÁzÀ
असंख्य: C¸ÀASÁåvÀ CUÀtÂvÀ ¯ÉPÀÌ«®èzÀµÀÄÖ
असंतुश्ट: CvÀÈ¥ÀÛ C¸ÀAvÀÄµÀÖ C¸ÀAvÀÈ¥ÀÛ vÀÈ¦ÛAiÀiÁUÀzÀ
असंयमी: CAPÉ¬Ä®èzÀ ºÀvÉÆÃn¬Ä®èzÀ CwgÉÃPÀzÀ ºÁ¼ÀvÀ«®èzÀ ¸ÀAAiÀÄªÀÄgÀ»vÀ
असंस्कृत: MgÀmÁzÀ C¸ÀA¸ÀÌöÈvÀ C²èÃ®
असफळ: C¸À¥sÀ® ¥sÀ®PÁjAiÀÄ®èzÀ
असभावीक: C¸Áé¨sÁ«PÀ C¥ÁæPÀÈwPÀ C¸ÀºÀd C£ÉÊ¸ÀVðPÀ
असमजिकाय: C¸ÀªÀÄAd¸ÀªÁzÀ ¸ÀªÀÄAd¸ÀªÀ®èzÀ
असमजुतदार: C«ªÉÃQAiÀiÁzÀ zÀqÀØ£ÁzÀ ªÀÄAzÀ§Ä¢ÞAiÀÄ
असमाधानी: C¸ÀªÀÄzsÁ¤vÀ
असलो: EAvÀºÀ F_¥ÀæPÁgÀzÀ
असहनशील: C¸À»µÀÄÚ C¸ÀºÀ£À²Ã®
असहाय्य: C¸ÀºÀåªÁzÀ vÁ¼À¯ÁUÀzÀ C¸ÀºÀ¤Ã0iÀÄ
असाध्य: C¸ÁzsÀå PÀptªÁzÀ ªÁ¹_ªÀiÁqÀ¯ÁUÀzÀ UÀÄt¥Àr¸À¯ÁUÀzÀ ¤ªÁj¸À¯ÁgÀzÀ ¥ÀjºÀj¸À¯ÁgÀzÀ
असैमीक: PÀÈvÀPÀªÁzÀ C¸Áé¨sÁ«PÀ C¸ÀºÀdªÁzÀ
असोच: EAvÀºÀ F_¥ÀæPÁgÀzÀ
अस्कळीत: CªÀåªÀ¹ÜvÀ
अस्तंती: ¥Á±ÁÑvÀå ¥À²ÑªÀÄzÀ ¥ÀqÀÄªÀt
अस्ताव्यस्त: CªÀåªÀ¹ÜvÀ
अस्थावर: ZÀgÀ
अस्थिहीण: ªÀÄÆ¼É¬Ä®èzÀ ªÀÄÆ¼ÉgÀ»vÀ
अस्थीमय: J®Ä©£À ªÀÄÆ¼É0iÀÄ C¹Ü0iÀÄ
अस्थीर: ZÀ®£À²Ã® UÀw²Ã®
अस्पश्ट: C¸ÀàµÀÖªÁzÀ
अस्पृश्य: C¸ÀàöÈ±Àå ªÀÄÄlÖ¯ÁUÀzÀ ªÀÄÄlÖ¨ÁgÀzÀ
अस्वस्थ: G¢édÕ vÀ®ètUÉÆAqÀ ªÁåPÀÄ°vÀ DvÀAPÀUÉÆAqÀ
अस्विकृत: C¹éÃPÀÈvÀ M¦àvÀªÁUÀzÀ ¸ÀªÀÄäw¬ÄgÀzÀ
अस्सल: ±ÀÄzÀÞ CZÀÑ C¥Ààl
अहिंसक: C»A¸ÀPÀ
अहीतकारी: CªÀ£ÀwAiÀÄvÀÛ «£Á±ÀPÁj ¥ÀvÀ£ÀzÀvÀÛ
आंकवार: C«ªÁ»vÀ ªÀÄzÀÄªÉAiÀiÁUÀzÀªÀ ®UÀß«®èzÀªÀ C«ªÁ»vÀ M§âAn PÀ£Éå PÀ¤ßPÉ CPÀëvÀ0iÉÆÃ¤
आंगाचे: DAVPÀ
आंगीक: DAVPÀ
आंतकड्यांचें: PÀgÀÄ½£À
आंतरदेशी: CAvÀgïzÉÃ²ÃAiÀÄ
आंतरराज्य: CAvÀgÀgÁdåzÀ
आंतरीक: DAvÀjPÀ
आंतर्राष्ट्रीय: CAvÁgÁ¶ÖçÃAiÀÄ CAvÀgÀgÁ¶ÖçÃAiÀÄ
आंवुळिल्ल्या: ¸ÀÄPÁÌzÀ ªÀÄÄzÀÄjPÉÆAqÀ ªÀÄrPÉAiÀiÁzÀ
आकर्शक: CzÀÄãvÀ ¢ªÀå ±ÉÆÃ¨sÁAiÀÄªÀiÁ£À
आकलनीय: UÀt¤ÃAiÀÄ C¸ÀASÁåvÀ
आकस्मीक: DPÀ¹äPÀ CPÀ¸ÁävÁÛzÀ C¤jÃQëvÀªÁzÀ
आकाराचें: ªÀÄtÂÚ£À (?)
आक्रमणकारी: DPÀæªÀÄtPÁjAiÀiÁzÀ DPÀæªÀÄtzÀ ªÉÄÃ¯ÉgÀUÀÄªÀ
आगळो: ¸Àj¸Án¬Ä®èzÀ JuÉ¬Ä®èzÀ C¸ÀªÀiÁ£À
आगामी: §gÀ°gÀÄªÀ DUÀ«Ä¸À°gÀÄªÀ §gÀÄªÀ ªÀÄÄA¢£À ¨sÁ«
आजापीत: «®PÀët «avÀæ
आज्ञा_करपी: DeÁÕ¥ÀPÀ
आज्ञाकारी: DeÁÕ¥ÀPÀ
आडखळहीण: vÉÆqÀQgÀzÀ vÉÆqÀQ®èzÀ CrØ_DvÀAPÀUÀ½®èzÀ
आडखळिल्लें: (?)
आडखळीन_भरिल्लें: ¤gÉÆÃzsÀPÀ vÀqÉUÀlÄÖªÀ
आडखळीबगरचें: vÉÆqÀQgÀzÀ vÉÆqÀQ®èzÀ CrØ_DvÀAPÀUÀ½®èzÀ
आडनदर: G¥ÉÃQëvÀ GzÁ¹Ã£ÀzÀ ¤®ðPÀëzÀ vÁvÁìgÀzÀ G¥ÉÃPÀëtÂÃAiÀÄ PÀqÉUÀtÂ¸À§ºÀÄzÁzÀ
आतांचें: ªÀvÀðªÀiÁ£ÀzÀ ¸ÀzÀåzÀ
आत्माभिमानी: ¸Áé©üªÀiÁ¤ DvÁä©üªÀiÁ¤
आदर्शवादी: DzÀ±ÁðvÀäPÀ DzÀ±ÀðªÁ¢vÀ£À
आदलें: fÃtðªÁzÀ ºÀ¼ÀvÁzÀ ºÀgÀÄPÀÄ_ªÀÄÄgÀÄPÁzÀ
आदारीत: D²ævÀ CªÀ®A©vÀ DzsÁjvÀ
आधुनीक: DzsÀÄ¤PÀ
आनंददायी: D£ÀAzÀPÀgÀ ¸ÀAvÉÆÃµÀPÀgÀ
आनंदी: GvÁì» GvÁìºÀ¨sÀjvÀ GvÁìºÀ¥ÀÇtð ºÀÄªÀÄä¹ì£À
आनंदीत: D£ÀAzÀªÀÄAiÀÄ G¯Áè¸ÀªÀÄAiÀÄ ¸ÀAvÉÆÃµÀªÀÄAiÀÄ ¥Àæ¸À£ÀßªÁzÀ ¸ÀAvÀÄµÀÖªÁzÀ w½AiÀiÁzÀ vÀªÀiÁµÉ0iÀÄ «£ÉÆÃzÀzÀ ¸ÀAvÉÆÃµÀzÀ
आपणायिल्ली: ¹éÃPÀÈvÀ M¦àvÀ
आपलें: SÁ¸ÀV vÀ£ÀßzÀÄ ¸ÀéAvÀzÀ
आपल्या_पक्षाचो: ¸Àé¥ÀQëÃAiÀÄ ¸ÀéQÃAiÀÄ ¸Àé¥ÀgÀ
आपसुवार्थी: ¸Áéyð
आबुझाद: «ZÀ°vÀªÁzÀ ZÀAZÀ®ªÁzÀ C¹ÜgÀªÁzÀ C¨sÀzÀæªÁzÀ ¸Àr®ªÁzÀ
आबूझ: «ZÀ°vÀªÁzÀ ZÀAZÀ®ªÁzÀ C¹ÜgÀªÁzÀ C¨sÀzÀæªÁzÀ ¸Àr®ªÁzÀ
आभारी: PÀÈvÀdÕ C¨sÁj G¥ÀPÁgÀ_¸ÀägÀuÉAiÀÄÄ¼Àî
आभुशीत: C®APÀÈvÀ C®APÁgÀ¨sÀÆ¬ÄµÀ× ¹AUÁgÀªÀÄAiÀÄ ±ÀÈAUÁgÀªÀÄAiÀÄ
आम: ¸ÁªÀiÁ£ÀåªÁzÀ ¸ÁzsÁgÀtªÁzÀ ªÀiÁªÀÄÆ°£À
आमिझाद: s¸ÉßÃºÀ¥ÀgÀ ªÉÄÊwæ¨sÁªÀzÀ ¸À°UÉ0iÀÄ
आयकपा_सारको: PÉÃ¼À§®è_(?)
आयकुपा_सारकें: PÉÃ½¸ÀÄªÀ PÉÃ¼À§ºÀÄzÁzÀ ±ÀæªÀå ±ÀæªÀtUÉÆÃZÀgÀ
आयकूंक_नाशिल्ली: PÉÃ½gÀzÀ C±ÀÄævÀ CeÁÕvÀ
आयचो_काळ: ¸ÀªÀÄPÁ°Ã£À ¸ÀzÀåzÀ ªÀvÀðªÀiÁ£ÀzÀ
आयच्या_काळांतलें: DzsÀÄ¤PÀ
आरक्षीत: «ÄÃ¸À°lÖ PÁ¬ÄÝj¹zÀ
आरोग्याक_बरें: ¸Àé¸ÀÜªÁzÀ DgÉÆÃUÀåPÀgÀªÁzÀ
आर्थीक: DyðPÀ «wÛÃAiÀÄ ºÀtPÁ¹£À
आलमपेड्ड्यार: ¤gÀxÀðPÀ ¤gÀÄ¥ÀAiÉÆÃV PÉ®¸À_ªÀiÁqÀzÀªÀ
आल्मीखुशाल: ¤gÁvÀAPÀ C¨sÀAiÀÄ
आवडनाशिल्लें: EµÀÖ«®èzÀ »r¸ÀzÀ M¦àUÉAiÀiÁUÀzÀ gÀÄa¸ÀzÀ MUÀÎzÀ ¸ÁégÀ¸Àå«gÀzÀ ¸Áé¢µÀÖªÀ®èzÀ ZÀÄgÀÄQ®èzÀ
आवडीचें: GzÉÝÃ±À¥ÀÇªÀðPÀ G¢ÝµÀÖ GzÉÝÃ²¹zÀ £ÉaÑ£À CZÀÄÑªÉÄaÑ£À ¦æAiÀÄªÁzÀ
आशावादी: D±ÁªÁ¢
आशेल्ले: CvÁå±ÉAiÀÄ zÀÄgÁ±ÉAiÀÄ ¯ÉÆÃ©üvÀ£ÀzÀ vÀÈµÉAiÀÄ
आशेल्लो: GvÀÌl_EZÉá D±É¥ÀqÀÄªÀªÀ ¯Á®¸É0iÀÄ ºÀA§®zÀ
आश्चर्याचें: C¨sÀÆvÀ¥ÀÇªÀð C¥ÀÇªÀð
आसामी: C¸ÀªÀiÁ£À C¸ÀªÀÄ ¸ÀªÀÄ£À®èzÀ
आस्पाविल्ले: CAvÀUÀðvÀ CqÀV¸ÀÄ«PÉ ¸ÀªÀÄ¤évÀ
आहाराचें: ¨sÉÆÃdå SÁzÀå ¨sÀPÀë÷å
इतिहासीक: LwºÁ¹PÀ_(¥ÀÅ£ÀgÁªÀvÀð£É)
इत्शीक: LaÒPÀ PÀqÁØAiÀÄªÀ®èzÀ
इत्शीत: ¸Àé_EZÉÑ¬ÄAzÀ EµÀÖ¢AzÀ ¸Àé_¸ÀAvÉÆÃµÀ¢AzÀ
इत्सा_नासतना: C£ÉÊaÒPÀ AiÀiÁzÀÈaÒPÀ C£ÀÄ¢ÝµÀÖ
इत्साहीण: D¸É¬Ä®èzÀ §AiÀÄPÉ¬Ä®èzÀ EZÉÑ¬Ä®èzÀ EµÀÖ«®èzÀ ¨ÉÃqÀªÁzÀ §AiÀÄ¸ÀzÀ
इत्सीत: GzÉÝÃ±À¥ÀÇªÀðPÀ G¢ÝµÀÖ GzÉÝÃ²¹zÀ
इत्सुक: §AiÀÄ¸ÀÄªÀ EaÑ¸ÀÄªÀ C¥ÉÃQë¸ÀÄªÀ
इत्से_बगर: C£ÉÊaÒPÀ AiÀiÁzÀÈaÒPÀ C£ÀÄ¢ÝµÀÖ
इबाडिल्लो: PÉlÖ PÀÄgÀÆ¥ÀzÀ DPÁgÀUÉlÖ «PÀÈvÀªÁzÀ
इराकी: EgÁQ£À
इर्शेन_भरिल्लें: ºÉÆmÉÖQZÀÄÑ¼Àî FµÉåðAiÀÄÄ¼Àî ªÀiÁvÀìAiÀÄðªÀÅ¼Àî C¸ÀÆAiÉÄ¥ÀqÀÄªÀ PÀgÀÄ§ÄªÀ
इल्लें: ¸Àé®à PÀ«Ää C®à PÀrªÉÄ
इल्लेशें: CvÀå®àªÁzÀ ¸ÁPÀ¶ÖgÀzÀ
इश्टागत: ¸ÉßÃºÀ¥ÀgÀ «±Áé¸À¥ÀgÀ s¸ÉßÃºÀ¥ÀgÀ ªÉÄÊwæ¨sÁªÀzÀ ¸À°UÉ0iÀÄ
इश्टाबगरचो: ¸ÉßÃ»vÀj®èzÀ UÉ¼ÉAiÀÄj®èzÀ «ÄvÀæj®èzÀ
इश्टाविरयतचो: ¸ÉßÃ»vÀj®èzÀ UÉ¼ÉAiÀÄj®èzÀ «ÄvÀæj®èzÀ
इश्वरी: zÉÊ«PÀ zÉÊªÀzÀvÀÛ zÉÊ«Ã
इहलोकीक: L»PÀ ¯ËQPÀªÁzÀ ¥Áæ¥ÀAaPÀªÁzÀ
उंचल्या_कुळातलो: C©üeÁvÀ GZÀáPÀÄ°Ã£À ±ÉæÃµÀ×ªÀA±ÀzÀ
उंचवटो: G©âzÀ KjzÀ ªÀÈ¢Þ¹zÀ ºÉZÁÑzÀ
उकडिल्लें: ¨ÉÃ¬Ä¹zÀ PÀÄ¢¹zÀ
उकतायिल्लें: C©üªÀåPÀÛªÁzÀ ¥ÀæPÀnvÀ eÁ»gÁzÀ ¥ÀæPÀlUÉÆAqÀ
उकती: gÀºÀ¸ÀåªÀ®èzÀ
उकतें: ªÀÄÄaÑqÀ¯ÁgÀzÀ UÀÄ¥ÀÛªÀ®èzÀ CgÀPÀëtÂÃAiÀÄ
उक्तें: ªÀÄÄaÑqÀzÀ UË¥Àå«gÀzÀ UÀÄ¥ÀÛªÀ®èzÀ
उगडास_नाशिल्लें: ªÀÄgÉvÀ ªÀÄgÉvÀÄ_ºÉÆÃzÀ
उग्रवादी: GUÀæªÁ¢ ¨sÀAiÉÆÃvÁàzÀPÀ
उचांबळ: G¢édÕ vÀ®ètUÉÆAqÀ ªÁåPÀÄ°vÀ DvÀAPÀUÉÆAqÀ
उचीत: £ÉÊwPÀªÁV
उजळ: ©½ ±ÉéÃvÀ ¥ÀæPÁ±ÀªÀiÁ£ÀªÁV vÉÃeÉÆÃªÀÄAiÀÄªÁV ºÉÆ¼À¥ÀÅ¼Àî
उजो_पालोवपी: ±ÁªÀÄPÀ ±ÀªÀÄ£ÀPÁj ±ÀªÀÄ£ÀUÉÆ½¸ÀÄªÀ
उणे_पिरायेचें: C¯ÁàAiÀÄÄ C¯ÁàAiÀÄÄ¶ C®àPÁ°ÃPÀ PÀët¨sÀAUÀÄgÀ
उणें: ¸Àé®à PÀ«Ää C®à PÀrªÉÄ
उणें_उलोवपी: «ÄvÀ¨sÁ¶ C®à¨sÁ¶
उणें_केल्लें: CªÀiÁ£ÀvÀÄÛUÉÆAqÀ ªÀeÁUÉÆ½¹zÀ
उण्या_आयुश्याचें: C¯ÁàAiÀÄÄ C¯ÁàAiÀÄÄ¶ C®àPÁ°ÃPÀ PÀët¨sÀAUÀÄgÀ
उण्यांतउणें: PÀ¤µÀ× C®àvÀªÀÄ CvÀåAvÀ_¸Àé®à Cw¸ÀtÚ
उतरांचें: ±Á©ÝPÀ ±À§ÝUÀ¼À ªÀiÁvÀÄUÀ¼À
उतावळें: CªÀ¸ÀgÀzÀ DvÀÄgÀzÀ vÀgÁvÀÄjAiÀÄ zÀÄrQ£À
उत्तम: GvÀÌöÈµÀ× GvÀÛªÀÄ ±ÉæÃµÀ×ªÁzÀ
उत्तरकाळीन: ªÀÄÄA¢£À_¢£ÀUÀ¼À°è ªÀÄÄA§gÀÄªÀ_PÁ®zÀ°è
उत्तरदायी: ºÉÆuÉUÁjPÉ dªÁ¨ÁÝj dªÁ§Ä_PÉÆqÀ¨ÉÃPÁzÀ GvÀÛgÀzÁ¬ÄAiÀiÁzÀ
उत्तीर्ण: GwÛÃtð
उत्तेजक: GvÉÛÃdPÀ ¥ÉæÃgÀPÀ
उत्तेजीत: (?)_(_EAVèÃµï_ªÀÄvÀÄÛ_»A¢_¹£ï¸Émï_ºÉÆAzÁtÂPÉ0iÀiÁUÀÄwÛ®è)
उत्पन्न: GvÁà¢vÀ
उत्पादक: GvÁàzÀPÀ GvÀàwÛ_ªÀiÁqÀÄªÀ GvÁà¢¸ÀÄªÀ GvÀà£ÀßPÁj GvÀà£ÀßPÁgÀPÀ
उत्पादीत: GvÁà¢vÀ ¹zÀÝUÉÆAqÀ vÀ0iÀiÁgÁzÀ
उत्पादीत_जाल्लें: GvÁà¢vÀ
उत्साहपूर्ण: GvÁìºÀ¥ÀÇtð
उत्साहहीण: ¤gÀÄvÁìºÀ PÀÄvÀÆºÀ®«gÀzÀ
उत्साही: GvÁì» GvÁìºÀ¨sÀjvÀ GvÁìºÀ¥ÀÇtð ºÀÄªÀÄä¹ì£À GvÁìºÀ¥ÀÇjvÀ wÃªÉÇæÃvÁìºÀzÀ ºÀÄgÀÄ¦£À
उत्सुक: feÁÕ¸ÀÄvÀ£ÀzÀ PÀÄvÀÆºÀ®ªÀÅ¼Àî
उदक_भरशिल्लें: ¤ÃgÁzÀ ¤ÃgÀÄ¤ÃgÁzÀ Cw_vÉ¼Àî£ÉAiÀÄ
उदकाचें: ¤ÃgÁzÀ ¤ÃgÀÄ¤ÃgÁzÀ Cw_vÉ¼Àî£ÉAiÀÄ
उदकाळ: ¤Ãj£À ¤ÃgÀÄªÁ¹ d®fÃ« ¤ÃgÁzÀ ¤ÃgÀÄ¤ÃgÁzÀ Cw_vÉ¼Àî£ÉAiÀÄ
उदय_जाल्लो: GzÀ¬Ä¸ÀÄwÛgÀÄªÀ ºÀÄlÄÖwÛgÀÄªÀ
उदार: GzÁgÀ ¥ÀæUÀw¥ÀgÀ ¥ÀÅgÉÆÃUÁ«Ä GzÁgÀªÁ¢ GzÁj «±Á®_ºÀÈzÀ¬Ä zÉÆqÀØ_ªÀÄ£À¸ÀÄì zsÁgÁ¼À_ºÀÈzÀ¬Ä
उदेल्लो: GzÀ¬Ä¸ÀÄwÛgÀÄªÀ ºÀÄlÄÖwÛgÀÄªÀ
उद्येगीक: OzÉÆåÃVPÀ
उध्वस्त: PÀ¼ÉzÀÄPÉÆAqÀ PÀ¼ÉzÀÄºÉÆÃzÀ ºÁ¼ÁzÀ
उनी: GtÂÚ_§mÉÖ
उन्नत: C©üªÀÈ¢ÞºÉÆA¢zÀ «PÁ¸ÀºÉÆA¢zÀ
उन्नतीकारक: K½UÉAiÀiÁzÀ G£ÀßwAiÀiÁzÀ
उपकारादीक: G¥ÀPÁj
उपकारी: PÀÈvÀdÕ C¨sÁj G¥ÀPÁgÀ_¸ÀägÀuÉAiÀÄÄ¼Àî PÀÈvÁxÀð PÀÈvÁPÀÈxÀå
उपदेश_करपी: ¤Ãw¨ÉÆÃzsÀPÀ G¥ÀzÉÃ±ÁvÀäPÀ ²PÀëuÁvÀäPÀ
उपदेशक: ¤Ãw¨ÉÆÃzsÀPÀ G¥ÀzÉÃ±ÁvÀäPÀ ²PÀëuÁvÀäPÀ
उपदेशी: ¤Ãw¨ÉÆÃzsÀPÀ G¥ÀzÉÃ±ÁvÀäPÀ ²PÀëuÁvÀäPÀ
उपद्रवग्रस्त: ¨sÀ0iÀÄUÀæ¸ÀÛ C±ÁAw0iÀÄ
उपद्रवी: G¥ÀzÀæ« G¥ÀzÀæªÀ£ÀÄßAlÄ_ªÀiÁqÀÄªÀ QgÀÄPÀÄ¼À_PÉÆqÀÄªÀ
उपभोगी: G¥À0iÉÆÃV¸À®Ä_0iÉÆÃUÀåªÁzÀ G¥À0iÀÄÄPÀÛ_(?)
उपरो: G©âzÀ KjzÀ ªÀÈ¢Þ¹zÀ ºÉZÁÑzÀ
उपस्थीत: G¥À¹ÜvÀ ºÁdgÁzÀ
उपाट: CvÀå¢üPÀ CwºÉZÀÄÑ CzÀªÀÄåªÁzÀ vÀqÉAiÀÄ¯ÁUÀzÀ CqÀV¸À¯ÁUÀzÀ
उपासमारो: ºÀ¹«¤AzÀ_¸Á0iÀÄÄªÀªÀ ºÉÆmÉÖUÉ_E®èzÉ_¸Á0iÀÄÄªÀªÀ_(?)
उपेक्षा: G¥ÉÃPÀëtÂÃAiÀÄ PÀqÉUÀtÂ¸À§ºÀÄzÁzÀ
उपेक्षीत: G¥ÉÃQëvÀ GzÁ¹Ã£ÀzÀ ¤®ðPÀëzÀ vÁvÁìgÀzÀ
उपेगाचें: ¯Á¨sÀzÁAiÀÄPÀ
उपोश्णकटीबंधीय: G¥ÉÇÃµÀÚªÀ®AiÀÄzÀ
उप्तादीत: GvÁà¢vÀ
उबगणें: ¨ÉÃ¸ÀgÀzÀ ¨ÉÃ¸ÀgÀPÀgÀ
उबगल्लें: ¨ÉÃ¸ÀgÀªÁzÀ T£ÀßUÉÆAqÀ
उबें_केल्लें: PÀnÖzÀ ¤«ÄðvÀ gÀavÀ
उमेदी: ¥Àæ¸À£ÀßªÁzÀ ¸ÀAvÀÄµÀÖªÁzÀ w½AiÀiÁzÀ vÀªÀiÁµÉ0iÀÄ «£ÉÆÃzÀzÀ ¸ÀAvÉÆÃµÀzÀ GvÁì» GvÁìºÀ¨sÀjvÀ GvÁìºÀ¥ÀÇtð ºÀÄªÀÄä¹ì£À GvÁìºÀ¥ÀÇtð
उमेदी_बगरचें: ¤gÀÄvÁìºÀ PÀÄvÀÆºÀ®«gÀzÀ
उरपी: ¨Á½PÉ
उरफाटे: «gÀÄzÀÝªÁzÀ JzÀÄgÀÄ§zÀÄgÁzÀ C©üªÀÄÄRzÀ «gÀÄzÀÞ_§UÉ0iÀÄ ªÀåwjPÀÛªÁzÀ
उरफाटें: «gÀÄzÀÝªÁzÀ ¥ÀæwPÀÆ®ªÁzÀ «¥ÀAiÀÄð¸ÀÛªÁzÀ
उरफाटो_चलपी: «ªÀÄÄPÀ »ªÀÄÄäR »AZÀ°¸ÀÄªÀ »AUÀwAiÀÄ ¥ÀæwÃ¥ÀUÁ«Ä
उरफाट्या_काळजाचो: PÀoÉÆÃgÀ_ºÀÈzÀ¬Ä PÀ°è£ÀAvÀºÀ_ªÀÄ£À¹ì£À
उरबेवंत: GvÁìºÀ¥ÀÇjvÀ wÃªÉÇæÃvÁìºÀzÀ ºÀÄgÀÄ¦£À
उरिल्लें: RZÁðUÀzÀ §¼À¸ÀzÀ G¥ÀAiÉÆÃV¸ÀzÀ
उरिल्लें_रीण: ¨ÁQ ²®ÄÌ ±ÉÃµÀ
उलटें: «gÀÄzÀÝªÁzÀ JzÀÄgÀÄ§zÀÄgÁzÀ C©üªÀÄÄRzÀ «gÀÄzÀÞ_§UÉ0iÀÄ ªÀåwjPÀÛªÁzÀ
उलटें_सुलटें: C¸ÀA§zÀÞªÁzÀ_ªÀiÁvÀÄ C«ªÉÃPÀzÀ_ªÀiÁvÀÄ_ºÀÄZÀÄÑºÀÄZÁÑzÀ_ªÀiÁvÀÄ CxÀð«®èzÀ_ªÀiÁvÀÄ
उशीर_जाल्लें: vÀqÀªÁV «¼ÀA§ªÁzÀ
ऊंच: GvÀÛªÀÄªÁzÀ GZÀÑvÀªÀÄ ±ÉæÃµÀ×ªÁzÀ
एक: MAzÀ£É MAzÀgÀ 1
एकठांय: MmÁÖVgÀÄªÀ PÀÆrgÀÄªÀ MAzÁVgÀÄªÀ MAzÉqÉ_¸ÉÃjgÀÄªÀ
एकतर्फी: MªÀiÁäUÀðzÀ KPÀ_ªÀiÁUÀðzÀ MAzÉÃ¢QÌ£À°è_ZÀ°¸ÀÄªÀ
एकतायपूर्ण: MAzÁzÀ ¸ÀAWÀnvÀ
एकत्र: MmÁÖVgÀÄªÀ PÀÆrgÀÄªÀ MAzÁVgÀÄªÀ MAzÉqÉ_¸ÉÃjgÀÄªÀ
एकत्रीत: MAzÁzÀ ¸ÀAWÀnvÀ MmÁÖVgÀÄªÀ PÀÆrgÀÄªÀ MAzÁVgÀÄªÀ MAzÉqÉ_¸ÉÃjgÀÄªÀ
एकदम: ¥ÀPÁÌ C¥ÀàlªÁzÀ ¨ÉgÉPÉ¬Ä®èzÀ
एकमुळें: ©UÀÄªÀiÁ£ÀzÀ ¸ÀAPÉÆÃZÀzÀ
एकरुपी: ¥ÀæwgÀÆ¥À
एकलें: MAzÀ£É MAzÀgÀ 1
एकलेंच: KPÀªÀiÁvÀæ KPÀªÉÄÃªÀ C¢éwÃAiÀÄ
एकवटिल्लें: MmÁÖVgÀÄªÀ PÀÆrgÀÄªÀ MAzÁVgÀÄªÀ MAzÉqÉ_¸ÉÃjgÀÄªÀ
एकसुरें: ©UÀÄªÀiÁ£ÀzÀ ¸ÀAPÉÆÃZÀzÀ
एका_वर्साचें: ªÁ¶ðPÀ ªÀµÀðzÀ
एकांत: ¤dð£ÀªÁzÀ KPÁAvÀzÀ
एकाच_काळांतलें: ¸ÀªÀÄAiÀÄPÉÌ_¸ÀjAiÀiÁV
एकुलगें: ©UÀÄªÀiÁ£ÀzÀ ¸ÀAPÉÆÃZÀzÀ
एकुलतें: ©UÀÄªÀiÁ£ÀzÀ ¸ÀAPÉÆÃZÀzÀ
एकूच: KPÀªÀiÁvÀæ KPÀªÉÄÃªÀ C¢éwÃAiÀÄ
एतिहासीक: LwºÁ¹PÀ ZÁjwæPÀ
ओगोत_जाल्लें: vÀqÀªÁV «¼ÀA§ªÁzÀ
ओपेरासावीं: ±À¸ÀÛçaQvÀìPÀ ±À¸ÀÛçaQvÉìUÉ_¸ÀA§A¢¹zÀ_(?)
औपचारीक: O¥ÀZÁjPÀ ¥ÀzÀÝw0iÀÄ ¸ÁA¥ÀæzÁ¬ÄPÀ
कंजूस: dÄUÁÎwdÄUÀÎ dÄ¥ÀÅuÁwdÄ¥ÀÅt
कच्चें: ¨ÉÃ¬Ä¹gÀzÀ ¨ÉÃ¬Ä¹®èzÀ ºÀ¹0iÀiÁzÀ PÁ¬Ä¸ÀzÀ
कट्टरवादी: ªÀÄvÁAzsÀ PÀmÁÖ_¸ÁA¥ÀæzÁAiÀÄªÁ¢
कठोर: PÀPÀð±À PÀoÉÆÃgÀ PÀpt
कडक: wÃPÀë÷ÚªÁzÀ ZÀÄgÀÄPÁzÀ ©üÃPÀgÀªÁzÀ zÁgÀÄtªÁzÀ ©üÃµÀt ¨sÀAiÀÄAPÀgÀªÁzÀ WÉÆÃgÀªÁzÀ PÀlÄÖ¤mÁÖzÀ ©V0iÀiÁzÀ ¤µÀÄ×gÀ PÀgÁgÀÄªÀPÁÌzÀ
कडकडीत: ©¹©¹0iÀiÁzÀ ¸ÀÄqÀÄwÛgÀÄªÀ zÀ»¸ÀÄwÛgÀÄªÀ
कडेनचें: ¸À«ÄÃ¥ÀzÀ ºÀwÛgÀzÀ
कथनीय: vÀ¯ÉºÀgÀmÉ UÉÆqÀÄØºÀgÀmÉ
कनिश्ट: PÉ¼ÀzÀeÉð0iÀÄ PÀ¤µÀ× PÀrªÉÄ_CAvÀ¹Û£À
कनिश्ठ: vÀªÀÄä
कपटी: ªÉÆÃ¸ÀUÁjPÉAiÀÄ PÀ¥ÀlzÀ ªÀAZÀ£ÉAiÀÄ ¸ÀAa£À zÀÄgÁ¸ÉAiÀÄ PÀÄn®vÉ0iÀÄ ªÉÆÃ¸ÀUÁjPÉ0iÀÄ_(?)
कमी: ¸Àé®à PÀ«Ää C®à PÀrªÉÄ
कमी_उलोवपी: «ÄvÀ¨sÁ¶ C®à¨sÁ¶
करणारो: PÀvÀð
करपी: PÀvÀð
करमुक्त: vÉjUÉgÀ»vÀ PÀgÀªÀÄÄPÀÛ vÉjUÉ¬Ä®èzÀ
करहीण: vÉjUÉgÀ»vÀ PÀgÀªÀÄÄPÀÛ vÉjUÉ¬Ä®èzÀ
करूंक_नाशिल्लें: C¥ÀÇtðªÁzÀ ¥ÀÇwðAiÀiÁUÀzÀ
कर्तव्यवादी: PÀvÀðªÀå¤µÀ× ¤µÁ×ªÀAvÀ_PÉ®¸ÀUÁgÀ
कर्तृत्ववादी: PÀvÀðªÀå¤µÀ× ¤µÁ×ªÀAvÀ_PÉ®¸ÀUÁgÀ
कर्तो: PÀvÀð
कर्मवादी: PÀvÀðªÀå¤µÀ× ¤µÁ×ªÀAvÀ_PÉ®¸ÀUÁgÀ
कलंकीत: PÀ¼ÀAQvÀ zÉÆÃµÀ¥ÀÇjvÀ zÉÆÃµÀAiÀÄÄPÀÛ
कलात्मक: PÀ¯ÁvÀäPÀ PÀ¯Á¥ÀÇtð
कलापूर्ण: PÀ¯ÁvÀäPÀ PÀ¯Á¥ÀÇtð
कलाहीण: PÀ¯ÁvÀäPÀªÀ®èzÀ PÀ¯ÁªÀAwPÉ¬Ä®èzÀ CgÀ¹PÀ PÀ¯Á©ügÀÄa¬Ä®èzÀ
कल्पनेंतलें: PÁ®à¤PÀ PÀ°àvÀ CªÁ¸ÀÛ«PÀ
कल्पीत: PÀ¥ÉÇÃ®PÀ°àvÀ
कळाव_जाल्लें: vÀqÀªÁV «¼ÀA§ªÁzÀ
कवच_घाल्लें: gÀPÁëPÀªÀZÀ«gÀÄªÀ PÀªÀavÀ PÁ¥ÀÅºÉÆ¢PÉAiÀÄ
कवचधारी: gÀPÁëPÀªÀZÀ«gÀÄªÀ PÀªÀavÀ PÁ¥ÀÅºÉÆ¢PÉAiÀÄ
कशे_तरेचें: JAvÀºÀ JAxÀ 0iÀiÁªÀ_vÀgÀzÀ
कशें: JAvÀºÀ JAxÀ 0iÀiÁªÀ_vÀgÀzÀ
कश्टदिणें: PÀµÀÖPÀgÀ zÀÄBRPÀgÀ
कश्टाची: zÀÄBRzÀ £ÉÆÃ«£À AiÀiÁvÀ£ÉAiÀÄ zÀÄBRªÀÄAiÀÄ zÀÄBRzÀ PÀµÀÖªÀÄAiÀÄ
कश्टी: PÀµÀÖzÀ vÉÆAzÀgÉ0iÀÄ PÀµÀÖzÁ0iÀÄPÀ vÉÆAzÀgÉzÁ0iÀÄPÀ vÁæ¸ÀzÁ0iÀÄPÀ
कसलें: JAvÀºÀ JAxÀ 0iÀiÁªÀ_vÀgÀzÀ
कांटयारें: PÀAlPÀ «dÕ
कांटे_नाशिल्लें: ªÀÄÄ½î®èzÀ PÀAlPÀ«®èzÀ
कांटेहीण: ªÀÄÄ½î®èzÀ PÀAlPÀ«®èzÀ
कांट्याबगरचें: ªÀÄÄ½î®èzÀ PÀAlPÀ«®èzÀ
कांतिमान: ¥ÀæPÁ±ÀªÀiÁ£ÀªÁV vÉÃeÉÆÃªÀÄAiÀÄªÁV ºÉÆ¼À¥ÀÅ¼Àî
कांय: C£ÉÃPÀ C£ÉÃPÁ£ÉÃPÀ ¸Àé®à PÀ«Ää C®à PÀrªÉÄ PÀrªÉÄ_¥ÀæªÀiÁtzÀ ¸Àé®à C®à
कांयच: «gÀ¼À
कागदी: PÁUÀzÀ
कागाळ_करपी: PÀÆUÀÄªÀ PÀgÉAiÀÄÄªÀ
कागाळकार: PÀÆUÀÄªÀ PÀgÉAiÀÄÄªÀ
काजारी: «ªÁ»vÀ ªÀÄzÀÄªÉAiÀiÁzÀ ®UÀßªÁzÀ
काडिल्लें: CªÀiÁ£ÀvÀÄÛUÉÆAqÀ ªÀeÁUÉÆ½¹zÀ
काणो: MPÀÌtÂÚ£À MAzÉÃPÀtÂÚ£À
कातीचो: ZÀªÀÄð vÀéZÉ
कादंबरीक: O¥À£Áå¹PÀ
कादयेचे: ¸ÉgÉªÀÄ£ÉAiÀÄ §A¢üÃSÁ£ÉAiÀÄ
कापीत: £ÀqÀÄVzÀ PÀA¦¸ÀÄªÀ
काप्पी: £ÀqÀÄVzÀ PÀA¦¸ÀÄªÀ
काबार: ªÀÄÄPÁÛAiÀÄ ¸ÀªÀiÁ¦Û CAvÀå
कामचोर: D®¹vÀ£ÀzÀ ªÉÄÊUÀ¼ÀîvÀ£ÀzÀ ¸ÉÆÃªÀiÁjvÀ£ÀzÀ PÉ®¸À_vÀ¦à¸ÀÄªÀªÀ
कामनेचें: GzÉÝÃ±À¥ÀÇªÀðPÀ G¢ÝµÀÖ GzÉÝÃ²¹zÀ
कामहीण: PÁªÀÄ¤UÀæºÀ PÁªÀÄgÀ»vÀ
कायदेशीर: £ÁåAiÀÄAiÀÄÄvÀ £ÁåAiÉÆÃavÀ £ÁåAiÀÄAiÀÄÄPÀÛ
कायद्याचें: PÁ£ÀÆ£ÀÄ§zÀÞªÁzÀ £ÁåAiÀÄ¸ÀªÀÄAd¸ÀªÁzÀ ¸ÀªÀÄAd¸ÀªÁzÀ vÀPÀð§zÀÞªÁzÀ
कारबारी: GzÉÆåÃV zÀÄrAiÀÄÄªÀªÀ GzÉÆåÃUÀ²Ã® PÉ®¸ÀzÀ°ègÀÄªÀªÀ
कारस्थानी: PÀÄn®vÉ0iÀÄ ªÉÆÃ¸ÀUÁjPÉ0iÀÄ_(?)
कार्यरत: PÁ0iÀiÁð¤évÀ PÁ0iÀÄðPÀÌ£ÀÄUÀÄtªÁzÀ PÁ0iÀÄðPÀÌ£ÀÄ¸ÁgÀªÁzÀ Qæ0iÀiÁ²Ã® ¸ÀQæ0iÀÄ GzÉÆåÃUÀ²Ã® PÁ0iÉÆðÃ£ÀÄäR
काल्पनीक: PÁ®à¤PÀ PÀ°àvÀ CªÁ¸ÀÛ«PÀ PÀ¥ÉÇÃ®PÀ°àvÀ
काळखी: ªÀÄ¨ÁâzÀ PÀvÀÛ®ÄUÀ«zÀ ªÀÄAPÁzÀ
काळजाक_लागपी: ¨sÁªÀ¥ÀÇtðªÁzÀ
काळजेचें: aAvÁd£ÀPÀ UÀA©üÃgÀ ±ÉÆÃZÀ¤Ã0iÀÄ
काळें: PÀqÀÄ¤Ã° PÀ¥ÀÅöà_ªÀtð ±ÁåªÀÄ PÀÈµÀÚ_ªÀtð
काळें_कुळकुळीत: PÀ¥Áà£ÀÄPÀ¥ÀÅöà CwPÀ¥ÀÅöà PÁUÉPÀ¥ÁàzÀ
काश्मिरी: PÁ²äÃj PÁ²äÃj0iÀÄ
किंकोत: G¥ÉÃPÀëtÂÃAiÀÄ PÀqÉUÀtÂ¸À§ºÀÄzÁzÀ
किजिली: dUÀ¼ÀUÀAnAiÀiÁzÀ dUÀ¼ÀPÁAiÀÄÄªÀ_¸Àé¨sÁªÀzÀ PÀ®ºÀ¦æAiÀÄ dUÀ¼ÀUÀAnAiÀiÁzÀ PÀ®ºÀ¦æAiÀÄ zÀAUÉPÉÆÃgÀ
किटनाशक: QÃl£Á±ÀPÀ Qæ«Ä£Á±ÀPÀ
किटभक्षी: QÃl¨sÀPÀëPÀ QÃmÁºÁj
किडकिडीत: C¹Ü¥ÀAdgÀzÀAvÉ ªÀÄÆ¼ÉAiÀÄAxÀ J®Ä©£ÀAxÀ §qÀPÀ®Ä_zÉÃºÀzÀ J®Ä©£ÀAxÀ ªÀÄÆ¼ÉAiÀÄAxÀ_zÉÃºÀzÀ
किड्यांचें_वखद: QÃl£Á±ÀPÀ Qæ«Ä£Á±ÀPÀ
कितल्योश्योच: C£ÉÃPÀ C£ÉÃPÁ£ÉÃPÀ
किरकिरो: ¹qÀÄQ£À Qj-QjAiÀÄ ¹r-«Är
किर्तशाळी: 0iÀÄ±À¹é ºÉ¸ÀgÀÄªÁ¹0iÀiÁzÀ QÃwð¥ÀqÉzÀ 0iÀÄ±À_UÀ½¹zÀ
कुकुलें: ¸ÀtÚ_PÀgÀÄ ¥ÀÅmÁtÂ_ªÀÄUÀÄ
कुचकामी: ¤gÀÄ¥ÁAiÀÄ G¥ÁAiÀÄ«gÀzÀ
कुच्छित्री: MgÀlÄ_¸Àé¨sÁªÀzÀ PÀpt_¸Àé¨sÁªÀzÀ GUÀæ_¸Àé¨sÁªÀzÀ
कुटील: PÀÄn®vÉ0iÀÄ ªÉÆÃ¸ÀUÁjPÉ0iÀÄ_(?)
कुटुंबहीण: ¸ÀA¸ÁgÀ«®èzÀ PÀÄlÄA§«®èzÀ
कुडीचो: fÃ«vÀ ±ÀjÃgÀªÀÅ¼Àî ªÉÄÊAiÀÄÄ¼Àî
कुड्डो_विस्वासू: ªÀÄvÁAzsÀ PÀmÁÖ_¸ÁA¥ÀæzÁAiÀÄªÁ¢
कुतां_काडपी: ºÀÄ¼ÀÄPÀÄ_ºÀÄqÀÄPÀÄªÀ vÀ¥ÀÅöà_»rAiÀÄÄªÀ gÀAzsÁæ£ÉéÃ¶ czÁæ£ÉéÃ¶
कुपां_नाशिल्लें: w½AiÀiÁzÀ ¤ªÀÄð® ¤ZÀÑ¼À ¸ÀéZÀÑ ±ÀÄ¨sÀæ ¤gÀ¨sÀæ
कुपां_बगरचें: w½AiÀiÁzÀ ¤ªÀÄð® ¤ZÀÑ¼À ¸ÀéZÀÑ ±ÀÄ¨sÀæ ¤gÀ¨sÀæ
कुपां_विरयत: w½AiÀiÁzÀ ¤ªÀÄð® ¤ZÀÑ¼À ¸ÀéZÀÑ ±ÀÄ¨sÀæ ¤gÀ¨sÀæ
कुपांवीण: w½AiÀiÁzÀ ¤ªÀÄð® ¤ZÀÑ¼À ¸ÀéZÀÑ ±ÀÄ¨sÀæ ¤gÀ¨sÀæ
कुपात्र: CAiÉÆÃUÀå PÉ®¸ÀPÉÌ_¨ÁgÀzÀ ¤µÀàçAiÉÆÃdPÀ ¨É¯É¬Ä®èzÀ
कुमारिका: PÀ£Éå PÀ¤ßPÉ CPÀëvÀ0iÉÆÃ¤
कुमारी: PÀ£Éå PÀ¤ßPÉ CPÀëvÀ0iÉÆÃ¤
कुलिखीत: §gÉ0iÀÄzÀ_(?)
कुशीकचें: ¸À«ÄÃ¥ÀzÀ ºÀwÛgÀzÀ
कूडहीण: C±ÀjÃgÀ CªÀÄÆvÀð
कूळहीण: PÀÄ°Ã£À ¤ªÀÄß_ªÀUÀðzÀ zÀ°vÀ
कृतज्ञ: PÀÈvÀdÕ C¨sÁj G¥ÀPÁgÀ_¸ÀägÀuÉAiÀÄÄ¼Àî
कृतार्थ: PÀÈvÁxÀð PÀÈvÁPÀÈxÀå
कृत्रीम: vÉÆÃjPÉAiÀÄ
केंद्रीय: PÉÃA¢æÃ0iÀÄ
केसरी: PÉÃ¸ÀjÃ0iÀÄ
केसाळ: GuÉÚAiÀÄ vÀÄ¥ÀàqÀzÀ
केस्तांवी: zÀAUÉPÉÆÃgÀ
केस्ताळ: dUÀ¼ÀUÀAnAiÀiÁzÀ PÀ®ºÀ¦æAiÀÄ
कैदी: §A¢vÀ §A¢ ¸ÉgÉAiÀiÁ¼ÁzÀ
कोंगरे: UÀÄAUÀÄgÀÄ ¸ÀÄgÀÄ½
कोट्याधीश: PÉÆÃmÁå¢ü¥Àw PÉÆÃmÁå¢üÃ±À
कोडू: MUÀgÀÄ MUÀZÀÄ ¨Á¬Ä_¸ÀÄgÀÄn¸ÀÄªÀ_gÀÄa
कोमेल्ले: ªÉÆ¼ÉvÀ aUÀÄgÉÆqÉzÀ CAPÀÄgÀUÉÆAzÀ PÉÆ£ÀjzÀ PÀÄrAiÉÆqÉzÀ
कोयराचें: PÉ¸ÀgÁzÀ gÁr0iÀiÁzÀ PÉÆZÉÑ0iÀiÁzÀ
कोलवाचें: ºÀÄ°è£À
क्रमहीण: PÀæªÀÄ«®èzÀ NgÀt«®èzÀ CtÂUÉlÖ ²¹Û®èzÀ CªÀåªÀ¸ÉÜUÉÆAqÀ
क्रमा_बगरचें: PÀæªÀÄ«®èzÀ NgÀt«®èzÀ CtÂUÉlÖ ²¹Û®èzÀ CªÀåªÀ¸ÉÜUÉÆAqÀ
क्रमान: PÀæªÀiÁ£ÀÄUÀvÀ D£ÀÄPÀæ«ÄPÀ ¤gÀAvÀgÀ ¸ÀAvÀvÀ
क्रियाशीळ: Qæ0iÀiÁ²Ã® ¸ÀQæ0iÀÄ GzÉÆåÃUÀ²Ã® PÁ0iÉÆðÃ£ÀÄäR
क्रूर: CvÁåZÁj C£ÁZÁj PÀÆæj
क्षणजिवी: £À±ÀégÀ ªÀÄvÀåð ªÀÄgÀuÁ¢üÃ£À
क्षणभंगूर: £À±ÀégÀ ªÀÄvÀåð ªÀÄgÀuÁ¢üÃ£À
क्षणीक: vÁvÁÌ°PÀ C®àPÁ°PÀ ºÀAUÁ«Ä
क्षमायोग्य: PÀëªÀÄå PÀëªÀiÁºÀð ªÀÄ¤ß¸À§®è PÀë«Ä¸À§ºÀÄzÁzÀ
क्षम्य: PÀëªÀÄå PÀëªÀiÁºÀð ªÀÄ¤ß¸À§®è PÀë«Ä¸À§ºÀÄzÁzÀ
क्षय_रोगी: PÀëAiÀiÁ PÀëAiÀiÁ_gÉÆÃUÀ
क्षीण: §qÀPÀ®Ä_zÉÃºÀzÀ J®Ä©£ÀAxÀ ªÀÄÆ¼ÉAiÀÄAxÀ_zÉÃºÀzÀ
क्षुद्र: PÀÄ°Ã£À ¤ªÀÄß_ªÀUÀðzÀ zÀ°vÀ
क्षेत्रीय: ¥ÁæzÉÃ²PÀ ¥ÁæAwÃ0iÀÄ ¸ÀÜ½Ã0iÀÄ ¸ÀÜ½ÃPÀ
खंडणीय: MqÉAiÀÄÄªÀ ªÀÄÄjAiÀÄÄªÀ ©üzÀÄgÀ MqÉzÀÄ_ºÉÆÃUÀÄªÀ
खंडीत: gÀzÁÝzÀ ¤°è¹zÀ vÀqÉzÀ ªÀÄÄjzÀ MqÉzÀ
खंतदिणी: zÀÄBRzÀ £ÉÆÃ«£À AiÀiÁvÀ£ÉAiÀÄ
खंती: ºÀvÁ±À ¤gÁ±À D¸ÉUÉlÖ JzÉUÀÄA¢zÀ ¤gÁ±À£ÁzÀ ºÀvÁ±ÀUÉÆAqÀ
खंतीची: zÀÄBRzÀ £ÉÆÃ«£À AiÀiÁvÀ£ÉAiÀÄ zÀÄBRªÀÄAiÀÄ zÀÄBRzÀ PÀµÀÖªÀÄAiÀÄ
खंबीर: ¨ÁUÀzÉ ªÀÄtÂAiÀÄzÉ §UÀÎzÉ
खड्डो: ¨ÉÆÃ¼ÀÄ §PÀÌ PÀÆzÀ°®èzÀ «PÉÃ² PÉÃ±ÀgÀ»vÀ ¨ÉÆÃ¼ÀÄ ªÀÄÄAqÁ PÀÆzÀ°®èzÀ_vÀ¯É0iÀÄ
खतखतीत: ©¹©¹0iÀiÁzÀ ¸ÀÄqÀÄwÛgÀÄªÀ zÀ»¸ÀÄwÛgÀÄªÀ
खबर_आशिल्लें: UÉÆwÛgÀÄªÀ eÁÕvÀ w½zÀ
खबर_नाशिल्लें: CeÁÕvÀ CjAiÀÄzÀ w½AiÀÄzÀ
खर: CzÀªÀÄåªÁzÀ vÀqÉAiÀÄ¯ÁUÀzÀ CqÀV¸À¯ÁUÀzÀ wÃPÀë÷ÚªÁzÀ ZÀÄgÀÄPÁzÀ ©üÃPÀgÀªÁzÀ zÁgÀÄtªÁzÀ ©üÃµÀt ¨sÀAiÀÄAPÀgÀªÁzÀ WÉÆÃgÀªÁzÀ PÀPÀð±À PÀoÉÆÃgÀ PÀpt GvÁìºÀ¥ÀÇjvÀ wÃªÉÇæÃvÁìºÀzÀ ºÀÄgÀÄ¦£À
खरसाणीचे: ¥Àæ§®ªÁzÀ
खरी: ±ÀÄzÀÞ CZÀÑ C¥Ààl ªÁ¸ÀÛ«PÀªÁzÀ ¤dªÁzÀ ¢lªÁzÀ ¸ÀºÀdªÁzÀ AiÀÄxÁxÀðzÀ
खर्चीक: C¥ÀªÀåAiÀÄzÀ
खांदये_बगरचें: gÉA¨É¬ÄgÀzÀ PÀªÀ¯ÉÆqÉAiÀÄzÀ
खांदये_विरयत: gÉA¨É¬ÄgÀzÀ PÀªÀ¯ÉÆqÉAiÀÄzÀ
खांदी_नाशिल्लें: gÉA¨É¬ÄgÀzÀ PÀªÀ¯ÉÆqÉAiÀÄzÀ
खांदो: mÉÆAUÉAiÉÆqÉzÀ gÉA¨ÉAiÉÆqÉzÀ ±ÁSÉAiÀÄÄPÀÛ G¥À_«¨sÁUÀzÀ
खाजगी: SÁ¸ÀV vÀ£ÀßzÀÄ ¸ÀéAvÀzÀ ªÉÊAiÀÄQÛPÀ ªÀåQÛUÀvÀ ¸ÀéAvÀzÀ
खाद्य: ¨sÉÆÃdå SÁzÀå ¨sÀPÀë÷å
खापो: ¢UÀÎd
खायलें: £ÀUÀtå PÉ¼ÀzÀeÉðAiÀÄ PÀrªÉÄzÀeÉðAiÀÄ
खायलो: PÉ¼ÀV£À vÀUÁÎzÀ PÀÄëzÀæ_(?)
खायल्या_कुळाचें: PÀÄ°Ã£À ¤ªÀÄß_ªÀUÀðzÀ zÀ°vÀ
खावंक_नाशिल्लें: w£Àß¢gÀÄªÀ PÀÄr0iÀÄ¢gÀÄªÀ
खावपाचें: ¨sÉÆÃdå SÁzÀå ¨sÀPÀë÷å
खावपी: w£ÀÄßªÀ GtÄÚªÀ ¨sÀPÀëPÀ
खाशेलें: «²µÀ×
खाश्या: ¸ÀºÉÆÃzÀgÀ
खास: «²µÀ×
खिणयाळें: vÁvÁÌ°PÀ C®àPÁ°PÀ ºÀAUÁ«Ä
खीणयाळें: £À±ÀégÀ ªÀÄvÀåð ªÀÄgÀuÁ¢üÃ£À
खुटें: ¤ÃgÀ¸À gÀÄa¬Ä®èzÀ ªÀÄAzÀªÁzÀ
खुनी: £ÀgÀºÀvÉå0iÀÄ RÆ¤0iÀÄ
खूब: C£ÉÃPÀ C£ÉÃPÁ£ÉÃPÀ
खूब_चड: CvÀå¢üPÀ CwºÉZÀÄÑ
खेदहीण: ±ÉÆÃPÀ«gÀzÀ zÀÄBR«®èzÀ
खेळीमेळीचें: ¸ÉßÃºÀ¥ÀgÀ «±Áé¸À¥ÀgÀ
खोटे: £ÀPÀ° SÉÆÃl PÀÈvÀPÀ ¸ÀÈ¶×_ªÀiÁrzÀ ªÉÆÃ¸ÀzÀ PÀÈwæªÀÄzÀ
खोटें: ¸ÀÄ¼ÀÄîUÁgÀ C¸ÀvÀåªÀAvÀ ¤gÁzÁgÀ DzsÁgÀgÀ»vÀ §ÄqÀ«®èzÀ
खोटो: zÀÄgÁ¸ÉAiÀÄ ¸ÀÄ¼ÀÄîUÁgÀ PÀÈwæªÀÄ vÉÆÃjPÉ0iÀÄ ªÉÆÃ¸ÀUÁgÀ
खोशी: ¥Àæ¸À£ÀßªÁzÀ ¸ÀAvÀÄµÀÖªÁzÀ w½AiÀiÁzÀ vÀªÀiÁµÉ0iÀÄ «£ÉÆÃzÀzÀ ¸ÀAvÉÆÃµÀzÀ
खोसदिणें: D£ÀAzÀPÀgÀ ¸ÀAvÉÆÃµÀPÀgÀ CzÀÄãvÀ ¢ªÀå ±ÉÆÃ¨sÁAiÀÄªÀiÁ£À
खोसयाळें: D£ÀAzÀªÀÄAiÀÄ G¯Áè¸ÀªÀÄAiÀÄ ¸ÀAvÉÆÃµÀªÀÄAiÀÄ
गंधहीण: ¸ÀÄªÁ¸À£É_EgÀzÀ ªÁ¸À£É¬Ä®èzÀ UÀAzsÀgÀ»vÀ
गंधीत: ¸ÀÄªÁ¸À£É0iÀÄÄ¼Àî ¸ÀÄUÀA¢ü ¥ÀjªÀÄ¼À0iÀÄÄPÀÛ UÀªÀÄUÀ«Ä¸ÀÄªÀ
गडबडें: CªÀ¸ÀgÀzÀ DvÀÄgÀzÀ vÀgÁvÀÄjAiÀÄ zÀÄrQ£À
गणनीय: UÀt¤ÃAiÀÄ C¸ÀASÁåvÀ
गण्य: UÀt¤ÃAiÀÄ C¸ÀASÁåvÀ
गतीचें: ZÀ®£À²Ã® UÀw²Ã®
गतीशील: ZÀ®£À²Ã® UÀw²Ã®
गरजे_भायर: C£ÁªÀ±ÀåPÀ CªÀ±ÀåPÀªÀ®èzÀ CUÀvÀåªÀ®èzÀ C£ÀUÀvÀåªÁzÀ
गरजेचें: CªÀ±ÀåPÀ dgÀÆgÁV C¤ªÁAiÀÄð C¥ÀjºÁAiÀÄð
गरम: GtÂÚ_§mÉÖ
गरमागरम: ©¹©¹0iÀiÁzÀ ¸ÀÄqÀÄwÛgÀÄªÀ zÀ»¸ÀÄwÛgÀÄªÀ
गर्भेस्त: UÀ©üðtÂ UÀ¨sÀðªÀw §¹j
गर्वहीण: ¤gÀºÀAPÁj ¤UÀ«ð CºÀAPÁgÀ«®èzÀ CUËgÀªÀ UËgÀªÀ_»Ã£ÀvÉ
गर्विश्ट: dA§zÀ CºÀ«Ää£À ¸Àé¥ÀæwµÉ×AiÀÄ ¸ÉÆQÌ£À UÀ«ðµÀ×vÀ£ÀzÀ
गवताचें: ºÀÄ°è£À
गवाय: ¥ÀævÀåPÀëzÀ²ð ¥ÀævÀåPÀë¸ÁQëzÁgÀ
गांवगिरी: UÁæªÀÄå
गांवगिरे: UÁæ«ÄÃt ºÀ½îUÁr£À
गायब: CzÀÈ±ÀåªÁzÀ CUÉÆÃZÀgÀ CQëUÉÆÃZÀgÀªÀ®èzÀ
गिड्डो: PÀÄ¼Àî VqÀØ
गिन्यानान_भरिल्लें: «ZÁgÀ¥ÀÇtðªÁzÀ
गिमाळ्याचो: VæÃµÀäIÄvÀÄ VæÃµÀäPÁ® ¨ÉÃ¹UÉ_PÁ® ¸ÉPÉUÁ®
गिरेस्त: ¸ÀªÀÄÈzÀÞªÁzÀ «¥ÀÅ®ªÁzÀ CªÀÄÆ®åªÁzÀ ¸ÀA¥ÀzÀâjvÀªÁzÀ
गुंगेचें: JZÀÑgÀ«®èzÀ ¸ÀAªÉÃzÀ£À_gÀ»vÀ
गुजराती: UÀÄdgÁw UÀÄdgÁw£À
गुडहीण: gÀºÀ¸ÀåªÀ®èzÀ
गुणयुक्त: CvÀÄåvÀÛªÀÄªÁzÀ CvÀÄåvÀÌöÈµÀ×ªÁzÀ ±ÉæÃµÀ×ªÁzÀ
गुणवंत: ¸ÀzÀÄÏtÂ UÀÄtªÀAvÀ
गुणवत्तायुक्त: CvÀÄåvÀÛªÀÄªÁzÀ CvÀÄåvÀÌöÈµÀ×ªÁzÀ ±ÉæÃµÀ×ªÁzÀ
गुणी: ¸ÀzÀÄÏtÂ UÀÄtªÀAvÀ
गुपीत: UÀÄmÁÖzÀ gÀºÀ¸ÀåªÁzÀ UÀÄmÁÖVlÖ UÀÄ¥ÀÛªÁzÀ UÀÆqsÀªÁzÀ UÉÆÃ¥ÀåzÀ gÀºÀ¸ÀåzÀ UÀÄnÖ£À ¥ÀæZÀá£Àß gÀºÀ¸ÀåªÀÄAiÀÄ gÀºÀ¸ÁåvÀäPÀ
गुप्त: UÀÄmÁÖzÀ gÀºÀ¸ÀåªÁzÀ UÀÄmÁÖVlÖ UÀÄ¥ÀÛªÁzÀ UÀÆqsÀªÁzÀ UÉÆÃ¥ÀåzÀ gÀºÀ¸ÀåzÀ UÀÄnÖ£À ¥ÀæZÀá£Àß
गुप्तहेरी: UÀÆqsÁZÁjPÉ ¥ÀvÉÛÃzÁjPÉ ¨ÉÃºÀÄUÁjPÉ
गुबगुबीत: zÀµÀÖ¥ÀÅµÀÖ PÉÆ©âzÀ ªÀiÁA¸ÀAiÀÄÄPÀÛ
गुरवार: UÀ©üðtÂ UÀ¨sÀðªÀw §¹j
गुलाम: ZÀªÀÄZÁVj ºÀ®ÄèVAdÄªÀ CAUÁ¯ÁZÀÄªÀ
गुल्ल: vÀ°èÃ£ÀvÉ¬ÄAzÀ ªÀÄUÀßvÉ¬ÄAzÀ
गूढ: UÀÄmÁÖzÀ gÀºÀ¸ÀåªÁzÀ UÀÄmÁÖVlÖ UÀÄ¥ÀÛªÁzÀ UÀÆqsÀªÁzÀ UÉÆÃ¥ÀåzÀ gÀºÀ¸ÀåzÀ UÀÄnÖ£À ¥ÀæZÀá£Àß gÀºÀ¸ÀåªÀÄAiÀÄ gÀºÀ¸ÁåvÀäPÀ
गैरहजर: C£ÀÄ¥À¹ÜvÀ UÉÊgÀÄºÁdgÁzÀ
गोड: ¸ÀÄ¸ÀégÀ ªÀÄzsÀÄgÀ_¸ÀégÀ EA¥ÁzÀ_¸ÀégÀ
गोड_उलोवपी: ¦æAiÀÄªÁzÀ_ªÀiÁvÀÄUÁjPÉ ¦æAiÀÄªÁzÀÄzÀ£ÉßÃ_ªÀiÁvÀ£ÁqÀÄªÀªÀ
गोडभाशी: ¦æAiÀÄªÁzÀ_ªÀiÁvÀÄUÁjPÉ ¦æAiÀÄªÁzÀÄzÀ£ÉßÃ_ªÀiÁvÀ£ÁqÀÄªÀªÀ
गोरो: ©½AiÀÄ UËgÀªÀªÀtðzÀ ±ÉéÃvÀªÀtðzÀ
गोरो_धवो: ©½AiÀÄ UËgÀªÀªÀtðzÀ ±ÉéÃvÀªÀtðzÀ
गौण: CªÀÄÄRå C¥ÀæªÀÄÄR C¥ÀæzsÁ£À D£ÀÄµÀAVPÀ UËt
ग्रंथिकी: ¥ÀÅ¸ÀÛPÀzÀ ¥ÀoÀåzÀ §ÄQÌ£À
ग्रीक: CAiÉÆÃ¤AiÀÄ£ï VæÃPï£À
घट: UÁqsÀªÁzÀ
घट_काळजाचो: PÀoÉÆÃgÀ_ºÀÈzÀ¬Ä PÀ°è£ÀAvÀºÀ_ªÀÄ£À¹ì£À
घडयिल्लें: PÀ¥ÉÇÃ®PÀ°àvÀ PÀnÖzÀ ¤«ÄðvÀ gÀavÀ
घडिल्लें: ¸ÀA§«¹zÀ DzÀ WÀn¹zÀ £ÀqÉzÀ
घडूंक_नाशिल्लें: £ÀqÉAiÀÄzÀ CWÀnvÀ C¸ÀA§ªÀ ¸ÁzÀåªÁUÀzÀ
घमेंडी: dA§zÀ CºÀ«Ää£À ¸Àé¥ÀæwµÉ×AiÀÄ ¸ÉÆQÌ£À UÀ«ðµÀ×vÀ£ÀzÀ
घरहीण: ªÀÄ£É¬Ä®èzÀ UÀÈºÀgÀ»vÀ UÀw¬Ä®èzÀ
घाई_करपी: CªÀ¸ÀgÀzÀ DvÀÄgÀzÀ vÀgÁvÀÄjAiÀÄ zÀÄrQ£À
घाणीचें: UÉÆ§Äâ£ÁvÀzÀ £ÁgÀÄªÀ zÀÄªÁð¸À£ÉAiÀÄ zÀÄUÀðAzsÀzÀ PÉlÖ_ªÁ¸À£ÉAiÀÄ
घातकी: »A¸ÁZÁj »A¸ÀPÀ «±Áé¸ÀWÁvÀÄPÀvÀ£ÀzÀ ªÀAZÀ£É0iÀÄ zÉÆæÃºÀzÀ £ÀA©PÉ¬Ä®èzÀ ªÀZÀ£À¨sÀæµÀÖ C¥Á0iÀÄPÁj «¥ÀvïPÁj vÉÆAzÀgÉzÁ0iÀÄPÀ
घाळ: CeÁUÀævÉAiÀÄ ¤®ðPÀë÷åzÀ C£ÁzÀgÀzÀ C¸ÀqÉØAiÀÄ G¥ÉÃPÉëAiÀÄ
घुवळीचें: JZÀÑgÀ«®èzÀ ¸ÀAªÉÃzÀ£À_gÀ»vÀ ªÀiÁzÀPÀ CªÀÄ¯ÉÃj¸ÀÄªÀ ªÀÄvÉÛÃj¸ÀÄªÀ £À±É0iÉÄÃj¸ÀÄªÀ
घुसपटिल्लें: (?)
घुसपल्लें: (?)
घुस्पूंक_नाशिल्लें: ¸ÀgÁUÀªÁV vÉÆqÀQ®èzÀ QèµÀÖªÀ®èzÀ (?)
घेरिल्लो: ¸ÀÄvÀÄÛªÀgÉzÀ
घोळटी: ¥ÀæZÀ°vÀ eÁj
घोस्ताचें: £ÉaÑ£À CZÀÄÑªÉÄaÑ£À ¦æAiÀÄªÁzÀ
चंचळ: «ZÀ°vÀªÁzÀ ZÀAZÀ®ªÁzÀ C¹ÜgÀªÁzÀ C¨sÀzÀæªÁzÀ ¸Àr®ªÁzÀ C±ÁAvÀ ¸ÀAPÀlzÀ zÀÄBRzÀ UÉÆÃ½£À
चकचकपी: ±ÉÆÃ¨sÁAiÀÄªÀiÁ£À ªÉÊ¨sÀªÀAiÀÄÄvÀ
चकचकीत: ¥ÀæPÁ±ÀªÀiÁ£ÀªÁzÀ ºÉÆ¼ÉAiÀÄÄªÀ ¨É¼ÀUÀÄªÀ Gdé®ªÁzÀ ¥ÀæPÁ±ÀªÀiÁ£ÀªÁzÀ
चक्रवर्ती: ZÀPÀæªÀwð KPÀZÀPÁæ¢ü¥Àw
चड: C£ÉÃPÀ C£ÉÃPÁ£ÉÃPÀ
चड_काळाचें: ¢üÃWÀðPÁ°Ã£À agÀPÁ°Ã£À §ºÀÄPÁ°Ã£À
चड_गरजेचें: CvÀåUÀvÀå CvÀåªÀ±ÀåPÀ
चतुर्भुजी: ZÀvÀÄ¨sÀÄðdzÀ ZÀvÀÄµÉÆÌÃ£ÀzÀ ZÀvÀÄ¨sÀÄðfÃAiÀÄ £Á®ÄÌ¨ÁºÀÄUÀ¼ÀÄ¼Àî
चमचो: ZÀªÀÄZÁVj ºÀ®ÄèVAdÄªÀ CAUÁ¯ÁZÀÄªÀ
चमत्कारी: ZÀªÀÄvÁÌjPÀ ZÀªÀÄvÁÌj
चरित्रहीण: ªÀå©üZÁjtÂ ºÁzÀgÀVwÛ eÁgÉ ªÉÃµÉå ¸ÀÆ¼É ¥ÁvÀgÀzÀªÀ¼ÀÄ ¤ÃwUÉlÖ ¨sÀæµÀÖ
चर्चीत: ZÀaðvÀ «ªÁ¢vÀ
चलणुकेची: ¥ÀæZÀ°vÀ eÁj
चलपी: ZÀ°¸ÀÄwÛgÀÄªÀ ZÁ®£ÉAiÀÄ°ègÀÄªÀ
चामटो: dÄUÁÎwdÄUÀÎ dÄ¥ÀÅuÁwdÄ¥ÀÅt
चारशेंवीस: ªÉÆÃ¸ÀUÁjPÉAiÀÄ PÀ¥ÀlzÀ ªÀAZÀ£ÉAiÀÄ
चालंत: ZÀ®£À²Ã® UÀw²Ã®
चालू: ZÀ®£À²Ã® UÀw²Ã® ZÀ°¸ÀÄwÛgÀÄªÀ ZÁ®£ÉAiÀÄ°ègÀÄªÀ PÁªÀÄÄPÀ D±É§ÄgÀÄPÀ
चाळीस: £À®ªÀvÀÛ£ÉAiÀÄ 40
चिंतपाचें: UÀªÀÄ£ÁºÀð UÀªÀÄ¤ÃAiÀÄ «ZÁgÀtÂÃAiÀÄ D¯ÉÆÃa¸ÀvÀPÀÌ
चिंताजनक: aAvÁd£ÀPÀ UÀA©üÃgÀ ±ÉÆÃZÀ¤Ã0iÀÄ
चिंतेस्त: aAvÁPÁæAvÀ aAvÁUÀæ¸ÀÛ
चिकित्सा: ªÉÊzÀåQÃ0iÀÄ aQwìÃ0iÀÄ
चिकू: dÄUÁÎwdÄUÀÎ dÄ¥ÀÅuÁwdÄ¥ÀÅt
चिकें: ¸Àé®à PÀ«Ää C®à PÀrªÉÄ
चिखलाचें: PÉ¸ÀgÁzÀ gÁr0iÀiÁzÀ PÉÆZÉÑ0iÀiÁzÀ
चिडचिडो: ¹qÀÄQ£À Qj-QjAiÀÄ ¹r-«Är
चिडिल्लें: PÁ°¤AzÀ_vÀÄ½AiÀÄ®àlÖ_(?)
चित्रांकीत: avÁæAQvÀ
चित्रायिल्लें: avÁæAQvÀ
चित्रीत: avÁæAQvÀ
चुरगळिल्ल्या: ¸ÀÄPÁÌzÀ ªÀÄÄzÀÄjPÉÆAqÀ ªÀÄrPÉAiÀiÁzÀ
चेंचिल्लें: PÁ°¤AzÀ_vÀÄ½AiÀÄ®àlÖ_(?)
चेंपिल्लें: PÁ°¤AzÀ_vÀÄ½AiÀÄ®àlÖ_(?)
चेडी: ªÀå©üZÁjtÂ ºÁzÀgÀVwÛ eÁgÉ ªÉÃµÉå ¸ÀÆ¼É ¥ÁvÀgÀzÀªÀ¼ÀÄ
चेतनायुक्त: ¥ÀæeÉÕAiÀÄÄ¼Àî JZÀÑgÀzÀ JZÉÑwÛgÀÄªÀ
चौदा: ºÀ¢£Á®ÄÌ
छंदी: zÀÄªÀðå¸À¤
जंगम: ZÀgÀ
जंगली: ªÀ£Àå PÁqÀÄ
जगजयी: «±Àé«eÉÃvÀ
जगजाहीर: dUÀeÁÓ»ÃgÁzÀ dUÀwÛUÉÃ_w½zÀ
जबाबदार: ¨ÉÃdªÁ¨ÁÝjAiÀÄ ºÉÆuÉUÁjPÉ¬Ä®èzÀ
जयी: ¸À¥sÀ®ªÁzÀ ¥sÀ®PÁjAiÀiÁzÀ
जागरूक: eÁUÀævÁ eÁUÀÈvÀ ¤zÉæ¬Ä®èzÉ CjªÀÅ¼Àî ¥ÀæeÉß÷åAiÀÄÄ¼Àî w¼ÀÄªÀ½PÉAiÀÄÄ¼Àî
जागृत: eÁUÀævÁ eÁUÀÈvÀ ¤zÉæ¬Ä®èzÉ
जागे: CjªÀÅ¼Àî ¥ÀæeÉß÷åAiÀÄÄ¼Àî w¼ÀÄªÀ½PÉAiÀÄÄ¼Àî
जागें: eÁUÀævÁ eÁUÀÈvÀ ¤zÉæ¬Ä®èzÉ
जाणकार: £ÀÄjvÀ C£ÀÄ¨sÀ«
जाणटें: ªÀÄÄ¢AiÀiÁzÀ ªÀAiÀÄ¸ÁìzÀ ªÀÄÄ¥ÉàÃjzÀ ªÀÈzÀÞ£ÁzÀ ªÀiÁVzÀ
जाणा_आशिल्लें: UÉÆwÛgÀÄªÀ eÁÕvÀ w½zÀ
जाणाजाल्लें: UÉÆwÛgÀÄªÀ eÁÕvÀ w½zÀ
जाती_भितरलें: ¸ÀéeÁwÃAiÀÄ ¸ÀeÁwÃAiÀÄ MAzÉÃ_ªÀUÀðzÀ MAzÉÃ_¥ÀAUÀqÀzÀ
जाती_विशींचें: eÁwAiÀÄ PÉÆÃ«Ä£À PÀÄ®_¨sÁAzÀªÀ
जातीचें: eÁwAiÀÄ PÉÆÃ«Ä£À PÀÄ®_¨sÁAzÀªÀ
जापसालदार: ¨ÉÃdªÁ¨ÁÝjAiÀÄ ºÉÆuÉUÁjPÉ¬Ä®èzÀ ºÉÆuÉUÁjPÉ dªÁ¨ÁÝj dªÁ§Ä_PÉÆqÀ¨ÉÃPÁzÀ GvÀÛgÀzÁ¬ÄAiÀiÁzÀ
जाबाबदार: ºÉÆuÉUÁjPÉ dªÁ¨ÁÝj dªÁ§Ä_PÉÆqÀ¨ÉÃPÁzÀ GvÀÛgÀzÁ¬ÄAiÀiÁzÀ
जाम: PÀëªÀÄvÉ¬ÄgÀzÀ CAiÉÆÃUÀåªÁzÀ ¤±ÀPÀÛªÁzÀ
जाम_जाल्लें: zÀtÂzÀ ¸ÀÄ¸ÁÛVgÀÄªÀ
जायत्यो: C£ÉÃPÀ C£ÉÃPÁ£ÉÃPÀ
जाल्लें: ¸ÀA§«¹zÀ DzÀ WÀn¹zÀ £ÀqÉzÀ
जावन_गेल्लें: ¸ÀA§«¹zÀ DzÀ WÀn¹zÀ £ÀqÉzÀ
जासुसी: UÀÆqsÁZÁjPÉ ¥ÀvÉÛÃzÁjPÉ ¨ÉÃºÀÄUÁjPÉ
जाहीर: ªÀÄÄaÑqÀ¯ÁgÀzÀ UÀÄ¥ÀÛªÀ®èzÀ CgÀPÀëtÂÃAiÀÄ C©üªÀåPÀÛªÁzÀ ¥ÀæPÀnvÀ eÁ»gÁzÀ ¥ÀæPÀlUÉÆAqÀ
जिक्के: JµÀÄÖ
जिखिल्लें: d¬Ä¸À§ºÀÄzÁzÀ UÉ®è§ºÀÄzÁzÀ «d¬ÄAiÀiÁUÀ§ºÀÄzÁzÀ
जिज्ञासु: feÁÕ¸ÀÄvÀ£ÀzÀ PÀÄvÀÆºÀ®ªÀÅ¼Àî
जितके: JµÀÄÖ
जितले: JµÀÄÖ
जितेंद्री: fvÉÃA¢æAiÀÄ EAzÀæfÃvï fvÉÃAzÀæ
जितो: ¥ÀæeÉÕAiÀÄÄ¼Àî JZÀÑgÀzÀ JZÉÑwÛgÀÄªÀ
जिद्दी: ºÀoÀªÀiÁjAiÀiÁzÀ ªÉÆAqÀvÀ£ÀzÀ
जिवघेणें: ªÀiÁgÀuÁAwPÀ ªÀiÁgÀPÀ WÁvÀÄPÀ ¥ÁæuÁAwPÀ «£Á±ÀPÀ
जिवनदान: ¥ÁæuÁzÁAiÀÄPÀ fÃªÀzsÁgÀPÀ ¥ÁæuÉÆÃfÓÃªÀPÀ
जिवो: ¥ÀæeÉÕAiÀÄÄ¼Àî JZÀÑgÀzÀ JZÉÑwÛgÀÄªÀ
जुनें: fÃtðªÁzÀ ºÀ¼ÀvÁzÀ ºÀgÀÄPÀÄ_ªÀÄÄgÀÄPÁzÀ
जुल्मी: CvÁåZÁj C£ÁZÁj PÀÆæj
जुवळीं: CªÀ½dªÀ½
जेझू_विशीं: PÉæöÊ¸ÀÛ_zsÀ«ÄÃðAiÀÄ PÉæöÊ¹ÛÃAiÀÄ
जेवपाचें: ¨sÉÆÃdå SÁzÀå ¨sÀPÀë÷å
जैतवंत: d¬Ä¸À§ºÀÄzÁzÀ UÉ®è§ºÀÄzÁzÀ «d¬ÄAiÀiÁUÀ§ºÀÄzÁzÀ ¸À¥sÀ®ªÁzÀ ¥sÀ®PÁjAiÀiÁzÀ
जोडिल्लें: ¸ÀA®UÀßUÉÆAqÀ ¸ÉÃjzÀ M¼À¥ÀlÖ eÉÆÃr¹zÀ
ज्ञानपूर्ण: «ZÁgÀ¥ÀÇtðªÁzÀ
ज्ञानमय: «ZÁgÀ¥ÀÇtðªÁzÀ
झगझगीत: ¥ÀæPÁ±ÀªÀiÁ£ÀªÁzÀ ºÉÆ¼ÉAiÀÄÄªÀ ¨É¼ÀUÀÄªÀ xÀ¼ÀÄQ£À PÀtÄÚ_PÉÆÃgÉÊ¸ PÀtÄÚ_PÀÄPÀÄÌªÀAxÀ
झगडपी: dUÀ¼ÀUÀAnAiÀiÁzÀ dUÀ¼ÀPÁAiÀÄÄªÀ_¸Àé¨sÁªÀzÀ PÀ®ºÀ¦æAiÀÄ
झगडाळ: dUÀ¼ÀUÀAnAiÀiÁzÀ dUÀ¼ÀPÁAiÀÄÄªÀ_¸Àé¨sÁªÀzÀ PÀ®ºÀ¦æAiÀÄ dUÀ¼ÀUÀAnAiÀiÁzÀ PÀ®ºÀ¦æAiÀÄ
झगडाळू: zÀAUÉPÉÆÃgÀ
झगडूल: dUÀ¼ÀUÀAnAiÀiÁzÀ dUÀ¼ÀPÁAiÀÄÄªÀ_¸Àé¨sÁªÀzÀ PÀ®ºÀ¦æAiÀÄ
झगड्याचें: «ªÁzÁ¸ÀàzÀ «ªÁzÀPÉÌqÉAiÀiÁzÀ «ªÁzÀPÉÌ_UÀÄjAiÀiÁzÀ
झांकपी: ¥Áæ¯Á¦¸ÀÄªÀ ºÀÄZÀÄÑZÁÑzÀ_ªÀiÁvÀÄ
झिरझिरिल्ली: fÃtðªÁzÀ ºÀ¼ÀvÁzÀ ºÀgÀÄPÀÄ_ªÀÄÄgÀÄPÁzÀ
झुजपी: zÀÈqsÀªÁVgÀÄªÀ ¤±ÀÑ®ªÁVgÀÄªÀ ¹ÜgÀªÁV_¤®ÄèªÀ
झुजा_इत्सुक: 0iÀÄÄzÁÞ¥ÉÃQë 0iÀÄÄzÁÞ¸ÀPÀÛ
टकलू: ¨ÉÆÃ¼ÀÄ ªÀÄÄAqÁ PÀÆzÀ°®èzÀ_vÀ¯É0iÀÄ
टकलो: ¨ÉÆÃ¼ÀÄ §PÀÌ PÀÆzÀ°®èzÀ «PÉÃ² PÉÃ±ÀgÀ»vÀ
टाळूं_येना: C¤ªÁAiÀÄð vÀ¦à¹PÉÆ¼Àî¯ÁUÀzÀ RArvÀ_DUÀÄªÀ £ÀqÉAiÀÄÄªÀ
टिकाकार: ¤AzÀPÀ zÀÆµÀPÀ
ठिपक्यांचें: gÀAUÀÄgÀAV£À ªÀtðgÀAfvÀ
ढोंगी: DµÁqsÀ¨sÀÆwvÀ£ÀzÀ PÀ¥ÀlzsÁ«ÄðPÀvÉ0iÀÄ zsÁ«ÄðPÀ_¸ÉÆÃV£À zsÀªÀÄð_qÁA©PÀvÉ0iÀÄ
तंत्रांविशींचें: vÁAwæPÀ
तंत्राबगरचें: CvÁAwæPÀ vÁAwæPÀªÀ®èzÀ vÀAvÀæeÁÕ£ÀgÀ»vÀ
तंत्रीक: vÁAwæPÀ
तकलेंतलें: PÁ®à¤PÀ PÀ°àvÀ CªÁ¸ÀÛ«PÀ
तकलेचें: ªÉÄzÀÄ½£À «ÄzÀÄ½£À
तटवासी: £À¢wÃgÀzÀ_ªÁ¹UÀgÀÄ £À¢zÀqÀzÀ_£É¯É¹UÀgÀÄ
तटस्थ: vÀl¸ÀÜ ¤¸ÀàPÀë¥ÁvÀ
तड्डकी: ¸ÀÄ¼ÀÄîUÁgÀ C¸ÀvÀåªÀAvÀ
तथ्यपूर्ण: ¤dªÁzÀ ªÁ¸ÀÛªÀªÁzÀ
तपाशिल्लें: ªÉÄÃ°éZÁgÀuÉ «ZÁgÀuÉ
तपासणी: ªÉÊzÀåQÃ0iÀÄ aQwìÃ0iÀÄ
तयार_करूंक_नाशिल्लें: ¤«Äð¸À¯ÁgÀzÀ ªÀiÁqÀ¯ÁgÀzÀ gÀa¸À¯ÁgÀzÀ
तयार_केल्लें: PÀnÖzÀ ¤«ÄðvÀ gÀavÀ
तयार_जाल्लें: GvÁà¢vÀ
तर्कपुर्ण: vÀPÀð§zÀÞªÁzÀ vÀPÀð¸ÀªÀÄävÀªÁzÀ AiÀÄÄQÛAiÀÄÄPÀÛªÁzÀ
तांकीवंत: ±ÀQÛ±Á° §®±Á° ±ÀQÛ0iÀÄÄvÀ
तांतया_आकाराचो: ªÀÈvÁÛPÁgÀzÀ zÀÄAqÁPÁgÀzÀ ªÀÄAqÀ¯ÁPÁgÀzÀ
तांबडो: PÉA¥ÁzÀ
ताकतिकेन: ªÉÃUÀ ¨ÉÃUÀ ²ÃWÀæ
ताकतीक_करपी: CªÀ¸ÀgÀzÀ DvÀÄgÀzÀ vÀgÁvÀÄjAiÀÄ zÀÄrQ£À
ताठ: ¨ÁUÀzÉ ªÀÄtÂAiÀÄzÉ §UÀÎzÉ
तापट: ¹mÁÖzÀ PÉÆæÃzsÀUÉÆAqÀ ¹qÀÄQ£À ¹mÁÖUÀÄªÀ gÉÃUÀÄªÀ PÉÆÃ¦µÀ×
तार्कीक: vÀPÀðzÀ vÁQðPÀ ªÁzÀzÀ ¸ÉÃjPÉÆArgÀÄªÀ ºÉÆA¢PÉÆArgÀÄªÀ ¸ÀA¸ÀPÀÛ
ताळो: mÉÆAUÉAiÉÆqÉzÀ gÉA¨ÉAiÉÆqÉzÀ ±ÁSÉAiÀÄÄPÀÛ G¥À_«¨sÁUÀzÀ
तिकतीकपी: ±ÉÆÃ¨sÁAiÀÄªÀiÁ£À ªÉÊ¨sÀªÀAiÀÄÄvÀ
तिक्ष्ण: wÃPÀë÷ÚªÁzÀ ZÀÄgÀÄPÁzÀ
तिखट: ªÀÄ¸Á¯É¨sÀjvÀ SÁgÀªÁzÀ
तिगपी: ¨Á½PÉ
तिबक्यांचें: gÀAUÀÄgÀAV£À ªÀtðgÀAfvÀ
तिरकटी: PÀlÄªÁ¢ ¤µÀÄ×gÀ
तिरसुवादीक: PÀlÄªÁ¢ ¤µÀÄ×gÀ
तिरायताचें: ¥ÀgÀQÃAiÀÄ C£ÀågÀ ¥ÀgÀgÀ
तिव्र: wÃPÀë÷ÚªÁzÀ ZÀÄgÀÄPÁzÀ
तीख: ªÀÄ¸Á¯É¨sÀjvÀ SÁgÀªÁzÀ
तुंबिल्लें: ¤AvÀ ¸ÀÜVvÀ ¹ÜgÀ
तुटकें: ºÀgÀPÀÄ-ªÀÄÄgÀÄPÀÄ ºÁ¼ÁVgÀÄªÀ
तुटकें-फुटकें: ºÀgÀPÀÄ-ªÀÄÄgÀÄPÀÄ ºÁ¼ÁVgÀÄªÀ
तुल्य: vÀÄ®£ÁvÀäPÀ vÀÄ®£ÁºÀð ºÉÆÃ°¸À§ºÀÄzÁzÀ
तुश्ट: ¸ÀAvÀÄµÀÖ£ÁVgÀÄªÀªÀ vÀÈ¥ÀÛ£ÁVgÀÄªÀªÀ vÁ¼Éä¬ÄA¢gÀÄªÀªÀ
तेजपूर्ण: ¥ÀæPÁ±ÀªÀiÁ£ÀªÁV vÉÃeÉÆÃªÀÄAiÀÄªÁV ºÉÆ¼À¥ÀÅ¼Àî
तेजस्वी: ¥ÀæPÁ±ÀªÀiÁ£ÀªÁV vÉÃeÉÆÃªÀÄAiÀÄªÁV ºÉÆ¼À¥ÀÅ¼Àî
तेजहीण: PÀ¼ÉUÀÄA¢zÀ ¤¸ÉÛÃd PÁAw»Ã£À ªÀÄAPÁzÀ ©½aPÉÆAqÀ
तोखणायेचे: ¥Àæ±ÀA¸À¤ÃAiÀÄ ¥Àæ±ÀA¸Àå ±ÁèWÀ¤ÃAiÀÄ C©ü£ÀAzÀ¤ÃAiÀÄ
त्रस्त: ¦ÃqÀPÀ ¨sÀAiÀÄUÉÆ½¸ÀÄªÀªÀ_(?)
त्रासदिणी: zÀÄBRzÀ £ÉÆÃ«£À AiÀiÁvÀ£ÉAiÀÄ
त्रासदिणें: PÀµÀÖPÀgÀ zÀÄBRPÀgÀ
त्रासाची: zÀÄBRªÀÄAiÀÄ zÀÄBRzÀ PÀµÀÖªÀÄAiÀÄ
त्रासिल्लो: ¦ÃqÀPÀ ¨sÀAiÀÄUÉÆ½¸ÀÄªÀªÀ_(?)
त्रासीक: zÀÄBTAiÀiÁzÀ zÀÄBTvÀ£ÁzÀ £ÉÆAzÀªÀ
त्रिबुनालीन: £Áå¬ÄPÀ £ÁåAiÀÄ¸ÁÜ£ÀzÀ £ÁåAiÀÄ¸ÁÜ¤ÃAiÀÄ
त्वचेचो: ZÀªÀÄð vÀéZÉ
थंड: ¸ËªÀÄå_¸Àé¨sÁªÀzÀ vÁ¼ÉäAiÀÄ ±ÁAvÀ_¸Àé¨sÁªÀzÀ ¸ËªÀÄå ¸ÁzsÀÄ ±ÁAvÀ ªÀÄÈzsÀÄ ªÉÄvÀÛ£ÉAiÀÄ vÀtÚV£À vÀtÚVgÀÄªÀ vÀtÚ£ÉAiÀÄ ²ÃvÀ® vÀtÚ£ÉAiÀÄ ²ÃvÀ® ²ÃvÀ® ±ÁAvÀ
थकिल्लें: zÀtÂzÀ ¸ÀÄ¸ÁÛVgÀÄªÀ
थरथरपी: £ÀqÀÄVzÀ PÀA¦¸ÀÄªÀ
थरांचें: ¥ÀzÀgÀÄ¥ÀzÀgÁzÀ ¸ÀÛgÀ¸ÀÛgÀªÁVgÀÄªÀ vÀgÀvÀgÀUÀ½AzÁzÀ
थांबिल्ली: ¸ÀÜVvÀUÉÆAqÀ ¤µÉÌçAiÉÄUÉÆAqÀ ¤±ÉÑÃµÀÖUÉÆAqÀ
थायां_पडपी: PÀtÂÚUÉ_PÁtÄªÀ zÀÈUÉÆÎÃZÀgÀ zÀÈ±Àå UÉÆÃZÀgÀªÁzÀ
थारायिल्लें: ¤²ÑvÀ ¤¢ðµÀÖ ¤AiÀÄ«ÄvÀ
थीर: zÀÈqsÀªÁzÀ UÀnÖAiÀiÁzÀ ¨sÀzÀæªÁzÀ ¹ÜgÀªÁzÀ ¨ÁUÀzÉ ªÀÄtÂAiÀÄzÉ §UÀÎzÉ
थीर_चित्ताचो: ¤±ÀÑ® ¸ÀÛ§Þ CZÀ® ¥Àæ±ÁAvÀªÁzÀ
थोडे_भितर: ¸ÀAPÉëÃ¥ÀªÁzÀ ¸ÀAUÀæºÀªÁzÀ ¸ÁgÁA±À
थोडें: ¸Àé®à PÀ«Ää C®à PÀrªÉÄ
थोडें_उलोवपी: «ÄvÀ¨sÁ¶ C®à¨sÁ¶
थोडोसो: PÀrªÉÄ_¥ÀæªÀiÁtzÀ ¸Àé®à C®à
दर्शनीय: £ÉÆÃqÀ§ºÀÄzÁzÀ PÁtÄªÀ £ÉÆÃqÀ¯ÁUÀzÀ £ÉÆÃqÀ¯ÁgÀzÀ
दलीत: zÀ°vÀ zÀ¨Áâ½PÉUÉ_M¼ÀUÁzÀ vÀÄ½vÀPÉÌ_¹QÌzÀ
दांत_नाशिल्लो: ºÀ°è®èzÀ ºÀ®ÄèUÀ°gÀzÀ zÀAvÀ«gÀzÀ
दाट: MvÁÛV ºÀwÛgÀ d£ÀdAUÀÄ½
दानवीर: zÁ£À±ÀÆgÀ
दानशूर: zÁ£À±ÀÆgÀ
दानी: zÁ£À±ÀÆgÀ
दिखावटी: vÉÆÃjPÉAiÀÄ DqÀA§gÀzÀ ºÉÆgÀ£ÉÆÃlzÀ PÀÈwæªÀÄzÀ £ÀPÀ°vÀ£ÀzÀ O¥ÀZÁjPÀ ¥ÀzÀÝw0iÀÄ ¸ÁA¥ÀæzÁ¬ÄPÀ
दिखावू: ¤ÃmÁzÀ pÃPÁzÀ CAzÀªÁzÀ ZÉAzÀªÁzÀ ¸ÀÄAzÀgÀªÁzÀ
दिग्गज: ¢UÀÎd ¢UÀÎd ¥ÀæSÁAqÀ
दिनवाशी: PÀÈvÀdÕ C¨sÁj G¥ÀPÁgÀ_¸ÀägÀuÉAiÀÄÄ¼Àî
दिल्लें: ¹UÀ§®è zÉÆgÀPÀ§®è ®§å G¥À®§Ý ¥Áæ¥ÀÛ
दिवाळखोर: ¢ªÁ½AiÀiÁzÀ
दिश्टी_पडपी: PÀtÂÚUÉ_PÁtÄªÀ zÀÈUÉÆÎÃZÀgÀ zÀÈ±Àå UÉÆÃZÀgÀªÁzÀ
दिसपी: PÀtÂÚUÉ_PÁtÄªÀ zÀÈUÉÆÎÃZÀgÀ zÀÈ±Àå UÉÆÃZÀgÀªÁzÀ
दीन: zÀ0iÀiÁ¤Ã0iÀÄ zÀÄBRPÀgÀ ¸ÀAPÀlPÀgÀ
दीर्घ_काळाचें: ¢üÃWÀðPÁ°Ã£À agÀPÁ°Ã£À §ºÀÄPÁ°Ã£À
दुकाळिल्लो: zÀÄBRªÀÄ0iÀÄ PÀtÂÚÃjr¸ÀÄªÀ ±ÉÆÃZÀ¤Ã0iÀÄ
दुखदिणें: PÀµÀÖPÀgÀ zÀÄBRPÀgÀ
दुखापती_बगरचे: UÁAiÀÄªÁUÀzÀ ¥ÉmÁÖUÀzÀ £ÉÆÃªÁUÀzÀ
दुख्खदिणी: zÀÄBRzÀ £ÉÆÃ«£À AiÀiÁvÀ£ÉAiÀÄ
दुख्खहीण: ±ÉÆÃPÀ«gÀzÀ zÀÄBR«®èzÀ
दुख्खाची: zÀÄBRzÀ £ÉÆÃ«£À AiÀiÁvÀ£ÉAiÀÄ zÀÄBRªÀÄAiÀÄ zÀÄBRzÀ PÀµÀÖªÀÄAiÀÄ
दुख्खी: zÀÄBRvÀ¥ÀÛ ±ÉÆÃPÀ¨sÀjvÀ zÀÄBTAiÀiÁzÀ zÀÄBTvÀ£ÁzÀ £ÉÆAzÀªÀ PÀµÀÖzÀ vÉÆAzÀgÉ0iÀÄ PÀµÀÖzÁ0iÀÄPÀ vÉÆAzÀgÉzÁ0iÀÄPÀ vÁæ¸ÀzÁ0iÀÄPÀ
दुबळो: PÀëªÀÄvÉ¬ÄgÀzÀ CAiÉÆÃUÀåªÁzÀ ¤±ÀPÀÛªÁzÀ
दुबावा_बगरचो: C£ÀÄªÀiÁ¤¸ÀzÀ ¸ÀAzÉÃºÀ_¥ÀqÀzÀ ¸ÀA±ÀAiÀÄ_¸Àé¨sÁªÀ«®èzÀ ±ÀAPÉ_¥ÀqÀzÀ
दुबावा_विरयत: C£ÀÄªÀiÁ¤¸ÀzÀ ¸ÀAzÉÃºÀ_¥ÀqÀzÀ ¸ÀA±ÀAiÀÄ_¸Àé¨sÁªÀ«®èzÀ ±ÀAPÉ_¥ÀqÀzÀ ¤¸ÀìA±ÀAiÀÄªÁzÀ ¤¸ÀìAzÉÃºÀªÁzÀ ¸ÀAzÉÃºÀ¥ÀqÀ¯ÁUÀzÀ C£ÀÄªÀiÁ£À«gÀzÀ
दुबावीत: ¨sÀ0iÀÄ¥ÀqÀÄªÀ DvÀAPÀUÉÆAqÀ ºÉzÀjzÀ ±ÀAPÉ¥ÀqÀÄªÀ ¸ÀA±ÀAiÀiÁ¸ÀàzÀ ¸ÀA±ÀAiÀiÁvÀäPÀ C£ÀÄªÀiÁ£Á¸ÀàzÀ ¸ÀAzÉÃºÁ¸ÀàzÀ ¸ÀA¢UÀÞªÁzÀ C£ÀÄªÀiÁ£À C¤²ÑvÀ wÃªÀiÁð£ÀªÁUÀzÀ RavÀ¥ÀqÀzÀ
दुरदर्शिकायहीण: ªÀÄÄ£ÉßZÀÑjPÉ¬Ä®èzÀ ¤®ðPÀë÷åzÀ ªÀÄÄAzÁ¯ÉÆÃZÀ£É¬Ä®èzÀ
दुरदर्शी: zÀÆgÀzÀ²ðvÀé
दुर्गूण: zÀÄUÀÄðtzÀ PÉlÖUÀÄtzÀ
दुर्दशाग्रस्त: vÉÆAzÀgÉUÉÆ¼ÀUÁzÀ ¥ÉÃa£À
दुर्भागी: £ÀvÀzÀÈµÀÖzÀ CzÀÈµÀÖ»Ã£À zÀÄgÀzÀÈµÀÖzÀ zÀÄzÉÊð«
दुर्मीळ: C¥ÀgÀÆ¥ÀzÀ «gÀ¼ÀªÁzÀ zÀÄ®ð¨sÀ
दुर्वेव्हारी: zÀÄgÁZÁj zÀÄdð£À_(?)
दुश्ट: zÀÄgÁvÀä ¤ÃZÁvÀä ¥Á¥ÁvÀä
दुसरे_जातीचें: «eÁwAiÀÄ ¥ÀgÀeÁwAiÀÄ ©ü£Àß_eÁwAiÀÄ ¨ÉÃgÉeÁwAiÀÄ
दुसर्‍यांचेर_आदारून: ¥ÀgÁªÀ®A© D²ævÀ
दुसर्‍याचें: ¥ÀgÀQÃAiÀÄ C£ÀågÀ ¥ÀgÀgÀ
दुस्मानहीण: CeÁvÀ±ÀvÀÄæ ±ÀvÀÄæUÀ½®èzÀ «gÉÆÃ¢üUÀ½®èzÀ
दुस्वाशी: dÄUÀÄ¥ÉìAiÀÄ£ÀÄßAlÄªÀiÁqÀÄªÀªÀ C¸ÀºÀåPÀgÀ C¸ÀºÀåd¤vÀ
दूर: zÀÆgÀzÀ zÀÆgÀzÀ°ègÀÄªÀ
दृश्टियुक्त: PÀtÄÚ¼Àî zÀÈ¶ÖAiÀÄÄ¼Àî
देंवयिल्लें: CªÀiÁ£ÀvÀÄÛUÉÆAqÀ ªÀeÁUÉÆ½¹zÀ
देगेचें: ¸À«ÄÃ¥ÀzÀ ºÀwÛgÀzÀ
देशद्रोही: zÉÃ±À¥ÉæÃªÀÄ«®èzÀ ¸ÀézÉÃ±Á©üªÀiÁ£À«®èzÀ
देशी.: zÉÃ²ÃAiÀÄ ¸ÀézÉÃ²ÃAiÀÄ zÉÃ¹
दैववादी: CzÀÈµÀÖªÁ¢ zÉÊªÀªÁ¢ «¢üªÁ¢ ¤AiÀÄwªÁ¢
दैवी: zÉÊ«PÀ zÉÊªÀzÀvÀÛ zÉÊ«Ã
दोंगराळ: Vjd£À §ÄqÀPÀlÄÖ_d£À PÁqÀÄ_d£À
दोनवर्सुकी: zÉéöÊªÁ¶ðPÀ zÀéAiÀiÁAiÀÄÄ JgÀqÀÄ_ªÀµÀðzÀ
दोशी: ¤AzÀ¤ÃAiÀÄ ¤AzÁºÀð cªÀiÁj_ºÁPÀ§ºÀÄzÁzÀ
द्विधाग्रस्थ: ¸ÀA±À0iÀÄ¸ÀÛ C£ÀÄªÀiÁ£À¸ÀÛ ±ÀAPÉ_¥ÀqÀÄªÀªÀ
द्विवर्शी: zÉéöÊªÁ¶ðPÀ zÀéAiÀiÁAiÀÄÄ JgÀqÀÄ_ªÀµÀðzÀ
धंदेकार: ªÀåªÀºÁgÀ_eÁÕ£À ¯ËQPÀ_«ªÉÃPÀªÀÅ¼Àî
धडपडो: G¥ÀzÀæ« G¥ÀzÀæªÀ£ÀÄßAlÄ_ªÀiÁqÀÄªÀ QgÀÄPÀÄ¼À_PÉÆqÀÄªÀ
धनवान: ¸ÀªÀÄÈzÀÞªÁzÀ «¥ÀÅ®ªÁzÀ CªÀÄÆ®åªÁzÀ ¸ÀA¥ÀzÀâjvÀªÁzÀ
धनी: ¸ÀªÀÄÈzÀÞªÁzÀ «¥ÀÅ®ªÁzÀ CªÀÄÆ®åªÁzÀ ¸ÀA¥ÀzÀâjvÀªÁzÀ
धन्य: PÀÈvÁxÀð PÀÈvÁPÀÈxÀå
धन्यवादी: PÀÈvÀdÕ C¨sÁj G¥ÀPÁgÀ_¸ÀägÀuÉAiÀÄÄ¼Àî
धर्म_मानपी: zsÀªÀiÁðªÀ®A© ªÀÄvÁ£ÀÄAiÀiÁ¬Ä zsÀªÀiÁð£ÀÄAiÀiÁ¬Ä
धर्मालंबी: zsÀªÀiÁðªÀ®A© ªÀÄvÁ£ÀÄAiÀiÁ¬Ä zsÀªÀiÁð£ÀÄAiÀiÁ¬Ä
धर्मावलंबी: zsÀªÀiÁðªÀ®A© ªÀÄvÁ£ÀÄAiÀiÁ¬Ä zsÀªÀiÁð£ÀÄAiÀiÁ¬Ä
धर्मिश्ठ: zsÀªÀiÁðªÀ®A© ªÀÄvÁ£ÀÄAiÀiÁ¬Ä zsÀªÀiÁð£ÀÄAiÀiÁ¬Ä
धर्मीक: zsÀªÀiÁðªÀ®A© ªÀÄvÁ£ÀÄAiÀiÁ¬Ä zsÀªÀiÁð£ÀÄAiÀiÁ¬Ä
धवें: ©½ ±ÉéÃvÀ
धवो: ©½AiÀÄ UËgÀªÀªÀtðzÀ ±ÉéÃvÀªÀtðzÀ
धांवडायिल्लें: CªÀiÁ£ÀvÀÄÛUÉÆAqÀ ªÀeÁUÉÆ½¹zÀ
धाकलो: vÀªÀÄä
धाडशी: ¸ÁºÀ¹ zÉÊAiÀÄð±Á°
धातूचें: ¯ÉÆÃºÀAiÀÄÄPÀÛ ¯ÉÆÃºÀªÀÄAiÀÄ ¯ÉÆÃ»ÃAiÀÄ
धात्वीय: ¯ÉÆÃºÀAiÀÄÄPÀÛ ¯ÉÆÃºÀªÀÄAiÀÄ ¯ÉÆÃ»ÃAiÀÄ
धादोशी: ¸ÀAvÀÄµÀÖ£ÁVgÀÄªÀªÀ vÀÈ¥ÀÛ£ÁVgÀÄªÀªÀ vÁ¼Éä¬ÄA¢gÀÄªÀªÀ
धीट: ¸ÁºÀ¹ zÉÊAiÀÄð±Á°
धुगधुगीत: GUÀÄgÀÄ_¨ÉZÀÑ£É0iÀÄ £ÉZÀÑ¨ÉZÀÑUÉ PÀªÉÇÃµÀÚ ªÀÄAzÉÆÃµÀÚ PÀÄzÀÄµÀÚ
धैर्यहीण: CzÉÊAiÀÄðzÀ zÉÊAiÀÄð«®èzÀ zÉÊAiÀÄð«gÀzÀ
ध्यानहीन: zsÁå£À«®èzÀ vÀ°èÃ£ÀvÉ¬Ä®èzÀ
नकली: vÉÆÃjPÉAiÀÄ ¤ÃmÁzÀ pÃPÁzÀ CAzÀªÁzÀ ZÉAzÀªÁzÀ ¸ÀÄAzÀgÀªÁzÀ
नकारात्मक: £ÀPÁgÁvÀäPÀ ¤gÁPÀgÀuÁvÀäPÀ ¤µÉÃzsÁxÀðPÀ £ÉÃvÁåvÀäPÀ
नखेत्रांनी_भरिल्लें: £ÀPÀëvÀæªÀÄAiÀÄ £ÀPÀëvÀæ_¸ÀzÀÈ±À £ÀPÀëvÀæ_PÀavÀ
नगरवासी: £ÀUÀjUÀ £ÀUÀgÀ_ªÁ¹ ¥ÀlÖt_ªÁ¹
नगरेंतले: £ÀUÀjUÀ £ÀUÀgÀ_ªÁ¹ ¥ÀlÖt_ªÁ¹
नटिल्लो: C®APÀÈvÀ ±ÉÆÃ©üvÀ ¨sÀÆ¶vÀ CAzÀUÉÆ½¹zÀ
नडणी: PÁqÀÄVqÀ ºÁ¼ÀÄVqÀ
नदर_आशिल्लो: PÀtÄÚ¼Àî zÀÈ¶ÖAiÀÄÄ¼Àî
नदरेक_पडपी: PÀtÂÚUÉ_PÁtÄªÀ zÀÈUÉÆÎÃZÀgÀ zÀÈ±Àå UÉÆÃZÀgÀªÁzÀ
नम्र: «£ÀªÀÄæ £ÀªÀÄæ ±ÁAvÀ
नरम: ¸ËªÀÄå_¸Àé¨sÁªÀzÀ vÁ¼ÉäAiÀÄ ±ÁAvÀ_¸Àé¨sÁªÀzÀ §¼ÀÄPÀÄªÀ ªÀÄtÂAiÀÄÄªÀ ¨ÁUÀÄªÀ ¸ÀÄ£ÀªÀÄå ZÁPÀZÀPÀåªÀÅ¼Àî
नवलकाणीक: O¥À£Áå¹PÀ
नवशिकें: C¥ÀPÀé C£À£ÀÄ¨sÀªÀ
नवशिक्षीत: C¥ÀPÀé C£À£ÀÄ¨sÀªÀ
नविनीकरणी: £À«ÃPÀj¸À§ºÀÄzÁzÀ ºÉÆ¸ÀzÁV¸À§ºÀÄzÁzÀ ¥ÀÅ£ÀgÀÄfÓÃªÀ£ÀUÉÆ½¸À§ºÀÄzÁzÀ
नवेंच_शिकिल्लें: C¥ÀPÀé C£À£ÀÄ¨sÀªÀ
नवो: DzsÀÄ¤PÀ
नशीबवान: CzÀÈµÀÖ±Á° £À¹Ã§ªÀAvÀ ¨sÁUÀå±Á°
नशेचें: ªÀiÁzÀPÀ CªÀÄ¯ÉÃj¸ÀÄªÀ ªÀÄvÉÛÃj¸ÀÄªÀ £À±É0iÉÄÃj¸ÀÄªÀ
नशेबाज: ªÀiÁzÀPÀ_ªÀå¸À¤ PÀÄqÀÄPÀ ºÉAqÀUÀÄqÀÄPÀ
नश्ट: PÀ¼ÉzÀÄPÉÆAqÀ PÀ¼ÉzÀÄºÉÆÃzÀ ºÁ¼ÁzÀ
नश्टो: dÄUÀÄ¥ÉìAiÀÄ£ÀÄßAlÄªÀiÁqÀÄªÀªÀ C¸ÀºÀåPÀgÀ C¸ÀºÀåd¤vÀ zÀÄgÁvÀä ¤ÃZÁvÀä ¥Á¥ÁvÀä
नश्वर: £À±ÀégÀ ªÀÄvÀåð ªÀÄgÀuÁ¢üÃ£À
नसायहीण: ºÉÆmÉÖQaÑgÀzÀ PÀgÀÄ§Ä«PÉ¬Ä®èzÀ FµÉð¬ÄgÀzÀ C¸ÀÆAiÉÄ¬ÄgÀzÀ
नस्तार: £ÀPÁgÁvÀäPÀ ¤gÁPÀgÀuÁvÀäPÀ ¤µÉÃzsÁxÀðPÀ £ÉÃvÁåvÀäPÀ
नाउमेदी: ¤gÀÄvÁìºÀ PÀÄvÀÆºÀ®«gÀzÀ
नाकाजाल्लें: C£ÁªÀ±ÀåPÀ CªÀ±ÀåPÀªÀ®èzÀ CUÀvÀåªÀ®èzÀ C£ÀUÀvÀåªÁzÀ
नाखूश: C¥Àæ¸À£ÀßªÁzÀ C¸ÀAvÀÄµÀ×ªÁzÀ
नाजूक: ¸ÀÄPÀÄªÀiÁgÀ£ÀAvÀºÀ £ÁdÆPÁzÀ £À0iÀÄªÁzÀ
नाटकी: vÉÆÃjPÉAiÀÄ O¥ÀZÁjPÀ ¥ÀzÀÝw0iÀÄ ¸ÁA¥ÀæzÁ¬ÄPÀ
नापसंतीचें: C¦æAiÀÄ C¦æÃwAiÀÄ
नापास: C£ÀÄwÛÃtð ¥ÉÃ¯ÁzÀ
नामंजुर: £À¥Á¸ÁzÀ
नामंजूर: C¹éÃPÀÈvÀ M¦àvÀªÁUÀzÀ ¸ÀªÀÄäw¬ÄgÀzÀ C¹éÃPÀÈvÀ
नामनेचे: «±Àé«SÁåvÀ «±Àé¥Àæ¹zÀÞ dUÀvï¥Àæ¹zÀÞ
नालायक: CAiÉÆÃUÀå ¤gÀxÀðPÀ ¤gÀÄ¥ÀAiÉÆÃV PÉ®¸À_ªÀiÁqÀzÀªÀ
नावडटें: EµÀÖ«®èzÀ »r¸ÀzÀ M¦àUÉAiÀiÁUÀzÀ gÀÄa¸ÀzÀ MUÀÎzÀ
नावडीचें: C¦æAiÀÄ C¦æÃwAiÀÄ
नावेश: PÀtägÉAiÀiÁzÀ ªÀÄgÉAiÀiÁzÀ ºÁ¼ÁzÀ UÀw¹zÀ
नाशवंत: £À±ÀégÀ ªÀÄvÀåð ªÀÄgÀuÁ¢üÃ£À
निंदक: ¤AzÀPÀ zÀÆµÀPÀ
निंदा_करपी: ¤AzÀPÀ zÀÆµÀPÀ
निंदेस्त: ¤AzÀ¤ÃAiÀÄ ¤AzÁºÀð cªÀiÁj_ºÁPÀ§ºÀÄzÁzÀ
नितळ: w½AiÀiÁzÀ ¤ªÀÄð® ¤ZÀÑ¼À ¸ÀéZÀÑ ±ÀÄ¨sÀæ ¤gÀ¨sÀæ ¥ÀjµÀÌj¹zÀ ¸ÀA¸ÀÌj¹zÀ ±ÀÄzÀÞUÉÆ½¹zÀ
नितीक: PÁ£ÀÆ£ÀÄ§zÀÞªÁzÀ £ÁåAiÀÄ¸ÀªÀÄAd¸ÀªÁzÀ ¸ÀªÀÄAd¸ÀªÁzÀ vÀPÀð§zÀÞªÁzÀ
नितीकतायपूर्ण: £ÉÊwPÀªÁV
नितीपूर्ण: £ÉÊwPÀªÁV
निद्रागत: ¤zÁæªÀÄUÀß ¤¢æ¸ÀÄwÛgÀÄªÀ ¤¢æAiÀÄ°ègÀÄªÀ
निपक्ष: vÀl¸ÀÜ ¤¸ÀàPÀë¥ÁvÀ
निबर: PÀlÄÖ¤mÁÖzÀ ©V0iÀiÁzÀ ¤µÀÄ×gÀ PÀgÁgÀÄªÀPÁÌzÀ PÀoÉÆÃgÀ_ºÀÈzÀ¬Ä PÀ°è£ÀAvÀºÀ_ªÀÄ£À¹ì£À
निमाण्या: PÀqÉAiÀÄ PÉÆ£ÉAiÀÄ CAwªÀÄ DvÀåAwPÀ PÀlÖPÀqÉAiÀÄ CSÉÊgÀÄ
नियमीत: ¤AiÀÄªÀÄ§zÀÞ
नियाळिल्लें: ªÉÄÃ°éZÁgÀuÉ «ZÁgÀuÉ
नियुक्तीत: ¤AiÀÄÄPÀÛ ¤AiÀÄ«Ä¸Àà®àlÖ £ÉÃ«Ä¸À®àlÖ
निरंहकारी: ¤gÀºÀAPÁj ¤UÀ«ð CºÀAPÁgÀ«®èzÀ
निरपराधी: ¤zÉÆÃð¶ ¤gÀ¥ÀgÁ¢ü zÉÆÃµÀ«gÀzÀ_ªÀåQÛ
निरभिमानी: ¤gÀºÀAPÁj ¤UÀ«ð CºÀAPÁgÀ«®èzÀ
निरर्थक: C¸ÀA§zÀÞªÁzÀ_ªÀiÁvÀÄ C«ªÉÃPÀzÀ_ªÀiÁvÀÄ_ºÀÄZÀÄÑºÀÄZÁÑzÀ_ªÀiÁvÀÄ CxÀð«®èzÀ_ªÀiÁvÀÄ
निराकार: ¤gÁPÁgÀ CªÀÄÆvÀð
निराधार: C¸ÀºÁAiÀÄPÀ C¸ÀºÁAiÀÄ ¤gÁzÁgÀ DzsÁgÀgÀ»vÀ §ÄqÀ«®èzÀ
निराश: JzÉUÀÄA¢zÀ ¤gÁ±À£ÁzÀ ºÀvÁ±ÀUÉÆAqÀ
निराश्रीत: ¤UÀðwPÀ ¤gÁ²ævÀ zÀjzÀæ
निरुत्तर: GvÀÛgÀ«®èzÀ ¤gÀÄvÀÛgÀªÁzÀ
निरुत्साही: ¤gÀÄvÁìºÀ PÀÄvÀÆºÀ®«gÀzÀ
निरुपेगी: ¤µÀàçAiÉÆÃdPÀ C£ÀÄ¥ÀAiÉÆÃV ¤µÀà® PÉ®¸ÀPÉÌ_¨ÁgÀzÀ
निरूपयोगी: ¤gÀÄ¥ÁAiÀÄ G¥ÁAiÀÄ«gÀzÀ
निर्जन: ¤dð£ÀªÁzÀ KPÁAvÀzÀ
निर्जाप: GvÀÛgÀ«®èzÀ ¤gÀÄvÀÛgÀªÁzÀ
निर्जीव: ¤fÃðªÀ fÃªÀgÀ»vÀ fÃªÀ«®èzÀ dqÀ CZÉÃvÀ£À dqÀUÉÆAqÀ
निर्दोश: ¤zÉÆÃð¶ ¤gÀ¥ÀgÁ¢ü zÉÆÃµÀ«gÀzÀ_ªÀåQÛ
निर्बळ: PÀëªÀÄvÉ¬ÄgÀzÀ CAiÉÆÃUÀåªÁzÀ ¤±ÀPÀÛªÁzÀ
निर्माण_केल्लें: PÀnÖzÀ ¤«ÄðvÀ gÀavÀ
निर्मिल्लें: PÀnÖzÀ ¤«ÄðvÀ gÀavÀ
निर्मीत: PÀnÖzÀ ¤«ÄðvÀ gÀavÀ
निर्लज्ज: £ÁaPÉ¬Ä®èzÀ ¤®ðeÉÓAiÀÄ ®eÁÓgÀ»vÀ ®eÁÓ»Ã£À
निर्विवाद: UÀnÖAiÀiÁzÀ CRAqÀ¤ÃAiÀÄ PÀrAiÀÄ¯ÁUÀzÀ C£ÁPÀæªÀÄtÂÃAiÀÄ
निर्शेल्लें: zÀÄBRzÀ ±ÉÆÃPÀzÀ ªÀå¸À£ÀzÀ T£Àß GzÁ¹Ã£À
निर्शेवप: ºÀvÁ±À ¤gÁ±À D¸ÉUÉlÖ
निलंबीत: CªÀiÁ£ÀvÀÄÛUÉÆAqÀ ªÀeÁUÉÆ½¹zÀ
निवडिल्ली: ¤AiÀÄÄPÀÛ ¤AiÀÄ«Ä¸Àà®àlÖ £ÉÃ«Ä¸À®àlÖ
निवडिल्लें: DAiÉÄÌAiÀiÁzÀ Dj¹zÀ
निवळ: Gdé®ªÁzÀ ¥ÀæPÁ±ÀªÀiÁ£ÀªÁzÀ ¥ÀjµÀÌj¹zÀ ¸ÀA¸ÀÌj¹zÀ ±ÀÄzÀÞUÉÆ½¹zÀ
निशाणी__केल्ली: ºÀ¸ÁÛPÀëgÀ«gÀÄªÀ ¸À»¬ÄgÀÄªÀ PÉÊ§gÀºÀ«gÀÄªÀ
निशाणे_बगर: zÀ¸ÀUÀwÛ®èzÀ ¸À»¬Ä®èzÀ
निशाणे_विरयत: zÀ¸ÀUÀwÛ®èzÀ ¸À»¬Ä®èzÀ
निश्चीत: C¤ªÁAiÀÄð vÀ¦à¹PÉÆ¼Àî¯ÁUÀzÀ RArvÀ_DUÀÄªÀ £ÀqÉAiÀÄÄªÀ ¤²ÑvÀ ¤¢ðµÀÖ ¤AiÀÄ«ÄvÀ
निश्ठाहीण: £ÀA©PÉ¬Ä®èzÀ ¤µÉ×¬ÄgÀzÀ £ÀA©PÉzÉÆæÃºÀzÀ «±Áé¸ÀzÉÆæÃºÀzÀ
निश्पाप: ¤zÉÆÃð¶ ¤gÀ¥ÀgÁ¢ü zÉÆÃµÀ«gÀzÀ_ªÀåQÛ
निश्प्राण: ¤fÃðªÀ fÃªÀgÀ»vÀ fÃªÀ«®èzÀ
निस्तेज: T£Àß «µÀtÚ ªÀiÁè£À ¨ÁrzÀ PÁAw»Ã£À PÀ¼Á»Ã£ÀªÁzÀ
निस्वार्थी: ¤¸ÁéxÀð ¸ÁéxÀð»Ã£À
नुतनीकरणी: £À«ÃPÀj¸À§ºÀÄzÁzÀ ºÉÆ¸ÀzÁV¸À§ºÀÄzÁzÀ ¥ÀÅ£ÀgÀÄfÓÃªÀ£ÀUÉÆ½¸À§ºÀÄzÁzÀ
नेटाचें: ¥Àæ§®ªÁzÀ dUÀ¼ÀUÀAn G¥ÀzÀæ«
नेटान: ªÉÃUÀ ¨ÉÃUÀ ²ÃWÀæ
नेणटें: J¼É_ªÀAiÉÆÃªÀiÁ£ÀzÀ ¨Á®PÀ\
नेणार: C«ªÉÃQAiÀiÁzÀ zÀqÀØ£ÁzÀ ªÀÄAzÀ§Ä¢ÞAiÀÄ
नेम_पाळपी: ¤AiÀÄwÛ£À ¥ÁæªÀiÁtÂPÀvÉAiÀÄ
नेमान: ¤AiÀÄªÀÄ§zÀÞ
नेमी: ¤AiÀÄwÛ£À ¥ÁæªÀiÁtÂPÀvÉAiÀÄ
नैसर्गीक: £ÉÊ¸ÀVðPÀ ¥ÁæPÀÈwPÀ
नोंदणी: ¢Ã¥Á¯ÁAPÀÈvÀ_(?)
नोंदीत: ¢Ã¥Á¯ÁAPÀÈvÀ_(?)
न्याय_करपी: £ÁåAiÀÄAiÀÄÄvÀ M¼ÉîAiÀÄ
न्यायकरतो: £ÁåAiÀÄAiÀÄÄvÀ M¼ÉîAiÀÄ
न्यायालयीन: £Áå¬ÄPÀ £ÁåAiÀÄ¸ÁÜ£ÀzÀ £ÁåAiÀÄ¸ÁÜ¤ÃAiÀÄ
न्यायी: £ÁåAiÀÄAiÀÄÄvÀ M¼ÉîAiÀÄ
न्हयकार: £ÀPÁgÁvÀäPÀ ¤gÁPÀgÀuÁvÀäPÀ ¤µÉÃzsÁxÀðPÀ £ÉÃvÁåvÀäPÀ
न्हिदिल्लें: ¤zÁæªÀÄUÀß ¤¢æ¸ÀÄwÛgÀÄªÀ ¤¢æAiÀÄ°ègÀÄªÀ
न्हीदमग्न: ¤zÁæªÀÄUÀß ¤¢æ¸ÀÄwÛgÀÄªÀ ¤¢æAiÀÄ°ègÀÄªÀ
पंचकोनी: ¥ÀAZÀPÉÆÃ£ÀzÀ ¥ÀAZÀPÉÆÃ¤Ã0iÀÄ LªÀÄÆ¯É0iÀÄ
पंचेचाळिसावें: £À®ªÀvÉÛöÊzÀ£ÉAiÀÄ
पक्षपाती: ¥ÀPÀë¥Áw ¥ÀÇªÁðUÀæºÀªÀÅ¼Àî ¨ÉÃzÀ¨sÁªÀzÀ
पगारी: ªÉÃvÀ£À_¥ÀqÉ0iÀÄÄªÀªÀ ªÉÃvÀ£ÀUÁæ» ªÉÃvÀ£ÀzÁ¬Ä
पचकळ: ¥Áæ¯Á¦¸ÀÄªÀ ºÀÄZÀÄÑZÁÑzÀ_ªÀiÁvÀÄ
पचनाशिल्लें: fÃtðªÁUÀzÀ CgÀUÀzÀ
पडिल्लें: zÀÄBRzÀ ±ÉÆÃPÀzÀ ªÀå¸À£ÀzÀ T£Àß GzÁ¹Ã£À
पड्डो: vÉ¼ÀÄªÁzÀ vÉ¼ÀîV£À
पनवतीचो: ¤ÃwUÉlÖ ¨sÀæµÀÖvÀ£ÀzÀ «µÀAiÀÄ®A¥ÀlvÀ£ÀzÀ Cw_¨sÉÆÃUÀzÀ
पयलींचें: fÃtðªÁzÀ ºÀ¼ÀvÁzÀ ºÀgÀÄPÀÄ_ªÀÄÄgÀÄPÁzÀ
पयश्यांची: DyðPÀ «wÛÃAiÀÄ ºÀtPÁ¹£À
पयस: zÀÆgÀzÀ zÀÆgÀzÀ°ègÀÄªÀ ªÀAavÀ ¹UÀzÀ zÉÆgÉ0iÀÄzÀ
परक्याचें: ¥ÀgÀQÃAiÀÄ C£ÀågÀ ¥ÀgÀgÀ
परजळपी: ±ÉÆÃ¨sÁAiÀÄªÀiÁ£À ªÉÊ¨sÀªÀAiÀÄÄvÀ
परजळीत: ¥ÀæPÁ±ÀªÀiÁ£ÀªÁzÀ ºÉÆ¼ÉAiÀÄÄªÀ ¨É¼ÀUÀÄªÀ
परजातीचें: «eÁwAiÀÄ ¥ÀgÀeÁwAiÀÄ ©ü£Àß_eÁwAiÀÄ ¨ÉÃgÉeÁwAiÀÄ
परत_घेतिल्लो: AiÀÄxÁ¹Üw
परत_दिल्लो: AiÀÄxÁ¹Üw
परतें: «gÀÄzÀÝªÁzÀ ¥ÀæwPÀÆ®ªÁzÀ «¥ÀAiÀÄð¸ÀÛªÁzÀ «gÀÄzÀÝªÁzÀ JzÀÄgÀÄ§zÀÄgÁzÀ C©üªÀÄÄRzÀ «gÀÄzÀÞ_§UÉ0iÀÄ ªÀåwjPÀÛªÁzÀ
परदेशी: «zÉÃ²ÃAiÀÄ ¥ÀgÀzÉÃ²ÃAiÀÄ C£ÀåzÉÃ²ÃAiÀÄ
परमळहीण: ¸ÀÄªÁ¸À£É_EgÀzÀ ªÁ¸À£É¬Ä®èzÀ UÀAzsÀgÀ»vÀ
परमळीत: PÀA¦£À ¥ÀjªÀÄ¼ÀzÀ ¸ÀÄªÁ¸À£É0iÀÄ ¸ÀÄUÀAzsÀzÀ ¸ÀÄªÁ¸À£É0iÀÄÄ¼Àî ¸ÀÄUÀA¢ü ¥ÀjªÀÄ¼À0iÀÄÄPÀÛ UÀªÀÄUÀ«Ä¸ÀÄªÀ
परावलंबी: ¥ÀgÁªÀ®A©_ªÀÄ»¼É ¥ÀgÁªÀ®A©_¹ÛçÃ D²ævÀ CªÀ®A©vÀ DzsÁjvÀ
परिचीत: UÉÆwÛgÀÄªÀ eÁÕvÀ w½zÀ
परिपक्व: £ÀÄjvÀ C£ÀÄ¨sÀ«
परिपूर्ण: ¥Àj¥ÀÇtð ¸ÀA¥ÀÇtð
परिवर्तन: ¥ÀjªÀwðvÀ §zÀ¯ÁzÀ
परिवर्तनशील: ¥ÀjªÀvÀð£Á²Ã® ¥ÀjªÀvÀð¤ÃAiÀÄ C¤AiÀÄvÀ
परोपकारी: ¥ÀgÉÆÃ¥ÀPÁj
पर्यायहीण: ¤gÀÄ¥ÁAiÀÄ G¥ÁAiÀÄ«gÀzÀ
पर्यायी: LaÒPÀ PÀqÁØAiÀÄªÀ®èzÀ
पळपी: ¥À¯ÁAiÀÄ£ÀªÁ¢ Nr_ºÉÆÃUÀÄªÀAvÀºÀ
पळपुटो: ¥À¯ÁAiÀÄ£ÀªÁ¢ Nr_ºÉÆÃUÀÄªÀAvÀºÀ
पळयिल्लें: ªÉÄÃ°éZÁgÀuÉ «ZÁgÀuÉ
पळोवंक_नाशिल्लें: UÀªÀÄ¤¸ÀzÀ ®PÀë÷å«lÄÖ_£ÉÆÃqÀzÀ C«ÃQëvÀ
पळोवपा_सारकें: £ÉÆÃqÀ§ºÀÄzÁzÀ PÁtÄªÀ £ÉÆÃqÀ¯ÁUÀzÀ £ÉÆÃqÀ¯ÁgÀzÀ
पवित्र: ¥À«vÀæªÁzÀ ¥ÀÅtåªÁzÀ ¥ÀÅ¤ÃvÀªÁzÀ
पसरिल्लें: ºÀgÀrgÀÄªÀ ZÀzÀÄjgÀÄªÀ ZÉ¯Áè¦°èAiÀiÁVgÀÄªÀ
पांचकोनी: ¥ÀAZÀPÉÆÃ£ÀzÀ ¥ÀAZÀPÉÆÃ¤Ã0iÀÄ LªÀÄÆ¯É0iÀÄ
पाखंडी: DµÁqsÀ¨sÀÆwvÀ£ÀzÀ PÀ¥ÀlzsÁ«ÄðPÀvÉ0iÀÄ zsÁ«ÄðPÀ_¸ÉÆÃV£À zsÀªÀÄð_qÁA©PÀvÉ0iÀÄ
पाचवेंचार: £À¼À£À½¸ÀÄªÀ PÀ¼ÀPÀ½¸ÀÄªÀ ¥Àæ¥sÀÅ®èªÁzÀ
पाठ्य: NzÀ§®è NzÀ§ºÀÄzÁzÀ
पाड: RArvÀªÁV ¤²ÑvÀªÁV
पाडे_बुद्धीचो: zÀÄgÁvÀä ¤ÃZÁvÀä ¥Á¥ÁvÀä
पाडो: dÄUÀÄ¥ÉìAiÀÄ£ÀÄßAlÄªÀiÁqÀÄªÀªÀ C¸ÀºÀåPÀgÀ C¸ÀºÀåd¤vÀ zÀÄgÁvÀä ¤ÃZÁvÀä ¥Á¥ÁvÀä
पाण: ¤Ãj£À ¤ÃgÀÄªÁ¹ d®fÃ«
पाणाविल्लो: zÀÄBRªÀÄ0iÀÄ PÀtÂÚÃjr¸ÀÄªÀ ±ÉÆÃZÀ¤Ã0iÀÄ
पातयेवणें: £ÀA©UÀ¸ÀÛ «±Àé¸À¤ÃAiÀÄ «±Áé¸À¥ÁvÀæ
पातळ: ¤ÃgÁzÀ ¤ÃgÀÄ¤ÃgÁzÀ Cw_vÉ¼Àî£ÉAiÀÄ
पातळिल्लें: ºÀgÀrgÀÄªÀ ZÀzÀÄjgÀÄªÀ ZÉ¯Áè¦°èAiÀiÁVgÀÄªÀ
पानाळ: J¯ÉAiÀÄÄ¼Àî J¯É¨sÀjvÀ ¥Àtð¨sÀjvÀ J¯É_vÀÄA©zÀ
पापी: zÀÄgÁvÀä ¤ÃZÁvÀä ¥Á¥ÁvÀä
पारखुपी: zÀÆgÀzÀ²ðvÀé
पारपांरीक: ¥ÁgÀA¥ÀjPÀ ¸ÁA¥ÀæzÁ¬ÄPÀ_(?)
पालविल्लें: vÀtÚ£ÉAiÀÄ ²ÃvÀ®
पावयिल्लें: ¨ÉÃ¨ÁQ ZÀÄPÁÛ
पाश्चात्य: ¥Á±ÁÑvÀå ¥À²ÑªÀÄzÀ ¥ÀqÀÄªÀt
पास: GwÛÃtð
पिंजिल्लें: aA¢ ºÀgÀPÀ®Ä
पिकसावं: aAvÁPÁæAvÀ aAvÁUÀæ¸ÀÛ
पिकाळ: ¥sÀ®ªÀvÁÛzÀ ºÀÄ®Ä¸ÁzÀ ¸ÀªÀÄÈzÀÞªÁzÀ vÀÄA§Ä_¥sÀ®zÀ
पिडिल्लो: ¦ÃqÀPÀ ¨sÀAiÀÄUÉÆ½¸ÀÄªÀªÀ_(?)
पिडेस्त: zÀÄBTAiÀiÁzÀ zÀÄBTvÀ£ÁzÀ £ÉÆAzÀªÀ
पुंवाळ: QÃªÀÅ_vÀÄA©zÀ
पुनर्नियुक्ती: AiÀÄxÁ¹Üw
पुराय: ¥ÀPÁÌ C¥ÀàlªÁzÀ ¨ÉgÉPÉ¬Ä®èzÀ
पुरो: AiÀÄxÉÃZÀÑ AiÀÄvÉÃµÀÖ ¸ÁPÀµÀÄÖ ºÉÃgÀ¼À «¥ÀÅ®
पुरो_जाल्लें: zÀtÂzÀ ¸ÀÄ¸ÁÛVgÀÄªÀ
पुर्विल्लें: ¥ÀÅgÁvÀ£À ¥ÁæaÃ£À D¢ªÀÄ_PÁ®zÀ ¥ÁæZÀå
पुसट: C¸ÀàµÀÖªÁzÀ
पुस्तकी: ¥ÀÅ¸ÀÛPÀzÀ ¥ÀoÀåzÀ §ÄQÌ£À
पेज: ¥Áæ¯Á¦¸ÀÄªÀ ºÀÄZÀÄÑZÁÑzÀ_ªÀiÁvÀÄ
पेझाद: ±ÀQÛ±Á° §®±Á° ±ÀQÛ0iÀÄÄvÀ
पोंग: UÀÆ£ÀÄ¨É¤ß£À UÀÆ£ÀÄ¨É£ÀÄß¼Àî
पोजडें: C²èÃ® C¸À¨sÀåªÁzÀ ºÉÆ®¸ÁzÀ
पोटभर: ºÉÆmÉÖvÀÄA§
पोटसरें: ¸ÀjÃ¸ÀÈ¥ÀzÀAvÀºÀ ºÀjzÁqÀÄªÀAvÀºÀ vÉªÀ¼ÀÄªÀAvÀºÀ
पोरणें: fÃtðªÁzÀ ºÀ¼ÀvÁzÀ ºÀgÀÄPÀÄ_ªÀÄÄgÀÄPÁzÀ ¥ÀÅgÁvÀ£À ¥ÁæaÃ£À D¢ªÀÄ_PÁ®zÀ ¥ÁæZÀå ¥ÀÅgÁvÀ£À_PÁ®zÀ UÀvÀPÁ®zÀ »A¢£À_PÁ®zÀ
प्रखर: wÃPÀë÷ÚªÁzÀ ZÀÄgÀÄPÁzÀ
प्रगट: C©üªÀåPÀÛªÁzÀ ¥ÀæPÀnvÀ eÁ»gÁzÀ ¥ÀæPÀlUÉÆAqÀ
प्रगतिशील: C©üªÀÈ¢ÞºÉÆA¢zÀ «PÁ¸ÀºÉÆA¢zÀ
प्रचलीत: ZÀ°¸ÀÄwÛgÀÄªÀ ZÁ®£ÉAiÀÄ°ègÀÄªÀ ¥ÀæZÀ°vÀ eÁj
प्रतिगामी: «ªÀÄÄPÀ »ªÀÄÄäR »AZÀ°¸ÀÄªÀ »AUÀwAiÀÄ ¥ÀæwÃ¥ÀUÁ«Ä
प्रतिभावान: ¥Àæw¨sÁ±Á° ¥Àæw¨sÁªÀAvÀ ¸ÁªÀÄxÀåðªÀAvÀ
प्रतिभाशाली: ¥Àæw¨sÁ±Á° ¥Àæw¨sÁªÀAvÀ ¸ÁªÀÄxÀåðªÀAvÀ
प्रतिरुपी: ¥ÀæwgÀÆ¥À
प्रतिश्ठीत: ¥Àæw¶×vÀ UÀtå ¸ÁÜ¦¸À®àlÖ £É¯ÉUÉÆAqÀ
प्रदुशीत: PÉÆ¼É0iÀiÁzÀ ºÉÆ®¸ÁzÀ ªÀiÁ¹zÀ ªÉÄÊ°UÉ0iÀiÁzÀ
प्रमाणीक_वेव्हारी: ¸ÀzïªÀåªÀºÁj(?)
प्रमाणें: C£ÀÄPÀÆ®PÀgÀ
प्रयत्नशील: ¥ÀæAiÀÄvÀß²Ã® GzÀåªÀÄ²Ã®
प्रयोजनार्थी: ¥ÀæAiÉÆÃd£À_¥ÀqÉzÀ ¥ÀæAiÉÆÃd£Áyð
प्रवेशाचें: ¥ÀæªÉÃ±ÀAiÉÆÃUÀå ¥ÀæªÉÃ±ÀPÉÌ__AiÉÆÃUÀåªÁzÀ
प्रवेशीत: M¼ÀUÉ_ºÉÆÃzÀ ¥ÀæªÉÃ²vÀ
प्रशंसक: ¥Àæ±ÀA¸ÀPÀ ¥Àæ±ÀA¸ÉAiÀÄ
प्रशिक्षणार्थी: «zÁåyð
प्रसन्न: ¥Àæ¸À£ÀßªÁzÀ ¸ÀAvÀÄµÀÖªÁzÀ w½AiÀiÁzÀ
प्रसिद्ध: «±Àé«SÁåvÀ «±Àé¥Àæ¹zÀÞ dUÀvï¥Àæ¹zÀÞ
प्राकृतीक: £ÉÊ¸ÀVðPÀ ¥ÁæPÀÈwPÀ
प्राचीन: ¥ÀÅgÁvÀ£À ¥ÁæaÃ£À D¢ªÀÄ_PÁ®zÀ ¥ÁæZÀå
प्राणघातक: ªÀiÁgÀuÁAwPÀ ªÀiÁgÀPÀ WÁvÀÄPÀ ¥ÁæuÁAwPÀ «£Á±ÀPÀ
प्राथमीक: DgÀA¨sÀzÀ ¥ÁægÀA¨sÀzÀ ªÉÆzÀ°£À
प्राप्त: UÀ½¹zÀ Cfð¹zÀ ¸ÀA¥Á¢¹zÀ
प्राप्त_करपी: ¹éÃPÀvÀð ¥ÀqÉAiÀÄÄªÀªÀ ¹éÃPÀj¸ÀÄªÀªÀ
प्राप्त_केल्लें: ¹UÀ§®è zÉÆgÀPÀ§®è ®§å G¥À®§Ý ¥Áæ¥ÀÛ
प्रामाणीक: £ÀA©UÀ¸ÀÛ «±Àé¸À¤ÃAiÀÄ «±Áé¸À¥ÁvÀæ ¤dªÁzÀ ªÁ¸ÀÛªÀªÁzÀ
प्रारब्दवादी: CzÀÈµÀÖªÁ¢ zÉÊªÀªÁ¢ «¢üªÁ¢ ¤AiÀÄwªÁ¢
प्रासंगीक: ¥Áæ¸ÀAVPÀ D£ÀÄµÀAVPÀ D_¸ÀAzÀ§ðPÉÌ_¸ÀjAiÀiÁV
प्रीयभाशी: ¦æAiÀÄªÁzÀ_ªÀiÁvÀÄUÁjPÉ ¦æAiÀÄªÁzÀÄzÀ£ÉßÃ_ªÀiÁvÀ£ÁqÀÄªÀªÀ
प्रेमासक्त: ¥ÉæÃªÀiÁ¸ÀPÀÛ C£ÀÄgÀPÀÛ C£ÀÄgÁV
प्रेरणा_दिवपी: ¥ÉæÃgÀtzÁAiÀÄPÀ ¸ÀÆàwðzÁAiÀÄPÀ
प्रेरणादायक: ¥ÉæÃgÀtzÁAiÀÄPÀ ¸ÀÆàwðzÁAiÀÄPÀ
प्रेरणास्पद: ¥ÉæÃgÀtzÁAiÀÄPÀ ¸ÀÆàwðzÁAiÀÄPÀ
फकत: PÉÃªÀ® §j0iÀÄ ªÀiÁvÀæ
फटकिरें: ¸ÀÄ¼ÀÄîUÁgÀ C¸ÀvÀåªÀAvÀ
फटकिरो: ¸ÀÄ¼ÀÄîUÁgÀ PÀÈwæªÀÄ vÉÆÃjPÉ0iÀÄ ªÉÆÃ¸ÀUÁgÀ
फटींग: ¸ÀÄ¼ÀÄîUÁgÀ C¸ÀvÀåªÀAvÀ ¤gÁzÁgÀ DzsÁgÀgÀ»vÀ §ÄqÀ«®èzÀ ªÉÆÃ¸ÀUÁjPÉAiÀÄ PÀ¥ÀlzÀ ªÀAZÀ£ÉAiÀÄ ¸ÀÄ¼ÀÄîUÁgÀ PÀÈwæªÀÄ vÉÆÃjPÉ0iÀÄ ªÉÆÃ¸ÀUÁgÀ C¥ÀæªÀiÁtÂPÀ ªÉÆÃ¸ÀzÀ ªÀAZÀ£ÉAiÀÄ zÀUÁ¨ÁfAiÀÄ oÀQÌ£À vÀlªÀlzÀ
फटीचें: PÀ¥ÉÇÃ®PÀ°àvÀ
फरारी: ¥ÀgÁj0iÀiÁzÀ NrºÉÆÃzÀ PÁ®ÄQvÀÛ vÀ¦à¹PÉÆAqÀ
फळादीक: ¸À¥sÀ®ªÁzÀ ¥sÀ®PÁjAiÀiÁzÀ
फांकिल्लें: ºÀgÀrgÀÄªÀ ZÀzÀÄjgÀÄªÀ ZÉ¯Áè¦°èAiÀiÁVgÀÄªÀ
फांटो: mÉÆAUÉAiÉÆqÉzÀ gÉA¨ÉAiÉÆqÉzÀ ±ÁSÉAiÀÄÄPÀÛ G¥À_«¨sÁUÀzÀ
फांफार्रांव: PÀqÀÄ_zsÉÊAiÀÄðzÀ JAmÉzÉAiÀÄ ¤¨sÀðAiÀÄzÀ zsÀÈµÀÖ
फाटल्या: ¥ÀÅgÁvÀ£À_PÁ®zÀ UÀvÀPÁ®zÀ »A¢£À_PÁ®zÀ
फाटीचें: £ÀPÀ° SÉÆÃl PÀÈvÀPÀ ¸ÀÈ¶×_ªÀiÁrzÀ ªÉÆÃ¸ÀzÀ PÀÈwæªÀÄzÀ
फातरा_काळजाचो: PÀoÉÆÃgÀ_ºÀÈzÀ¬Ä PÀ°è£ÀAvÀºÀ_ªÀÄ£À¹ì£À
फाफशिल्लें: ºÀgÀrgÀÄªÀ ZÀzÀÄjgÀÄªÀ ZÉ¯Áè¦°èAiÀiÁVgÀÄªÀ
फामाद: «±Àé«SÁåvÀ «±Àé¥Àæ¹zÀÞ dUÀvï¥Àæ¹zÀÞ
फायद्याचें: ¯Á¨sÀzÁAiÀÄPÀ
फारीक_केल्लें: ¨ÉÃ¨ÁQ ZÀÄPÁÛ
फालतू: C¸ÀA§zÀÞªÁzÀ_ªÀiÁvÀÄ C«ªÉÃPÀzÀ_ªÀiÁvÀÄ_ºÀÄZÀÄÑºÀÄZÁÑzÀ_ªÀiÁvÀÄ CxÀð«®èzÀ_ªÀiÁvÀÄ ¤µÀàçAiÉÆÃdPÀ C£ÀÄ¥ÀAiÉÆÃV ¤µÀà® PÉ®¸ÀPÉÌ_¨ÁgÀzÀ C£ÁªÀ±ÀåPÀ CªÀ±ÀåPÀªÀ®èzÀ CUÀvÀåªÀ®èzÀ C£ÀUÀvÀåªÁzÀ
फावोशें: C£ÀÄPÀÆ®PÀgÀ
फीट: ©VAiÀiÁzÀ
फुटकें: ºÀgÀPÀÄ-ªÀÄÄgÀÄPÀÄ ºÁ¼ÁVgÀÄªÀ
फुटिल्लें: MqÉzÀ
फुटीर: C¸ÀAWÀnvÀ
फुटें: ¤ÃgÀ¸À gÀÄa¬Ä®èzÀ ªÀÄAzÀªÁzÀ
फुडलो: ªÀÄÄA¨sÁUÀzÀ ªÀÄÄAUÀqÉAiÀÄ ¥ÀÅgÉÆÃªÀwð
फुडल्या: ªÀÄÄA§gÀ°gÀÄªÀ §gÀ°gÀÄªÀ DUÀ«Ä¸À°gÀÄªÀ ¨sÁ«
फुडाराचें: §gÀ°gÀÄªÀ DUÀ«Ä¸À°gÀÄªÀ §gÀÄªÀ ªÀÄÄA¢£À ¨sÁ«
फुलां_बगरचें: ºÀÆ_©qÀzÀ
फुलांनी_भरिल्लें: ºÀÆ_©qÀÄªÀ ºÀÆ«gÀÄªÀ
फुलिल्लें: CgÀ¼ÀÄªÀ «PÀ¹¸ÀÄªÀ ºÀÆªÁUÀÄªÀ
फॅल: C£ÀÄwÛÃtð ¥ÉÃ¯ÁzÀ
फोल्गी: C¥ÀªÀåAiÀÄzÀ «¯Á¹ M0iÀiÁågÀzÀ
बंदखणीचे: ¸ÉgÉªÀÄ£ÉAiÀÄ §A¢üÃSÁ£ÉAiÀÄ
बंदिस्त: §A¢0iÀiÁzÀ ¸ÉgÉ¹PÀÌ
बंदो: ZÀªÀÄZÁVj ºÀ®ÄèVAdÄªÀ CAUÁ¯ÁZÀÄªÀ
बकें: §qÀPÀ®Ä_zÉÃºÀzÀ J®Ä©£ÀAxÀ ªÀÄÆ¼ÉAiÀÄAxÀ_zÉÃºÀzÀ
बडबडे: ªÁZÁ½AiÀiÁzÀ ºÀgÀmÉPÉÆÃgÀ£ÁzÀ «¥ÀjÃvÀ_ªÀiÁvÀÄUÁgÀ£ÁzÀ
बडबडें: ºÀgÀmÉPÉÆÃgÀ ªÀiÁw£ÀªÀÄ®è §qÀ§r¸ÀÄªÀªÀ
बडबडेचें: C¸ÀA§zÀÞªÁzÀ_ªÀiÁvÀÄ C«ªÉÃPÀzÀ_ªÀiÁvÀÄ_ºÀÄZÀÄÑºÀÄZÁÑzÀ_ªÀiÁvÀÄ CxÀð«®èzÀ_ªÀiÁvÀÄ
बडबडो: ¥Áæ¯Á¦¸ÀÄªÀ ºÀÄZÀÄÑZÁÑzÀ_ªÀiÁvÀÄ
बडीचें: D£ÀÄªÀA²PÀªÁV C£ÀÄªÀA±Á£ÀÄUÀvÀ ªÀA±À¥ÁgÀA¥ÀAiÀÄðªÁV
बदल: ¥ÀjªÀwðvÀ §zÀ¯ÁzÀ
बदलनासपी: C¥ÀjªÀvÀð¤ÃAiÀÄ ¥ÀjªÀvÀð£ÉAiÀiÁUÀzÀ
बदलपी: ¥ÀjªÀvÀð£Á²Ã® ¥ÀjªÀvÀð¤ÃAiÀÄ C¤AiÀÄvÀ
बद्‍दल: ¸ÀA§A¢¹zÀ £ÀAlÄ¼Àî
बनावट: vÉÆÃjPÉAiÀÄ DqÀA§gÀzÀ ºÉÆgÀ£ÉÆÃlzÀ PÀÈwæªÀÄzÀ £ÀPÀ°vÀ£ÀzÀ vÉÆÃjPÉAiÀÄ PÀ¥ÉÇÃ®PÀ°àvÀ
बरयल्लें: PÁUÀzÀ
बरयल्लो: °TvÀ °¦¸À»vÀ CAQvÀ
बरी: GvÀÌöÈµÀ× GvÀÛªÀÄ ±ÉæÃµÀ×ªÁzÀ
बरें: GvÀÛªÀÄ M¼ÉîAiÀÄ ±ÉæÃµÀ×ªÁzÀ ¸À¨sÀåªÁzÀ ²Ã®AiÀÄÄPÀÛ C²èÃ®ªÀ®èzÀÄÝ ªÁ¹ªÀiÁqÀ§ºÀÄzÁzÀ UÀÄt¥Àr¸À§ºÀÄzÁzÀ ±ÀªÀÄ£À¸ÁzÀå ¥ÀjºÁgÀ¸ÁzÀå gÀÄaPÀmÁÖzÀ gÀÄaPÀgÀªÁzÀ gÀÄaAiÀiÁzÀ ¸Áé¢µÀÖ ¸À«AiÀiÁzÀ
बरें_जायना__अशें: ªÁ¹_ªÀiÁqÀ¯ÁUÀzÀ UÀÄt¥Àr¸À¯ÁUÀzÀ ¤ªÁj¸À¯ÁgÀzÀ ¥ÀjºÀj¸À¯ÁgÀzÀ
बरो: ¸ÀdÓ£À M¼ÉîAiÀÄ ¸ÀZÁÑjvÀæ÷åªÀAvÀ ²Ã®ªÀAvÀ GvÀÛªÀÄ G£ÀßvÀ M¼Éî0iÀÄ ZÉ£ÁßzÀ ªÉÄÃ¯ÁzÀ
बळादीक: ±ÀQÛ±Á° §®±Á° ±ÀQÛ0iÀÄÄvÀ
बळिश्ट: ±ÀQÛ±Á° §®±Á° ±ÀQÛ0iÀÄÄvÀ
बहिर्दृश्टी: §»ªÀÄÄðT ¨ÁºÀå¥ÀæªÀÈvÀÛ ¸ÉßÃºÀ²Ã®
बहिर्मूख: §»ªÀÄÄðT ¨ÁºÀå¥ÀæªÀÈvÀÛ ¸ÉßÃºÀ²Ã®
बांदिल्लें: PÀnÖzÀ ¤«ÄðvÀ gÀavÀ
बाकी: ¨ÁQ ²®ÄÌ ±ÉÃµÀ
बागवल्लें: ¨ÁVzÀ ªÀÄtÂzÀ NgÉAiÀiÁzÀ
बाजारांतलें: ¥ÉÃmÉ0iÀÄ ¥ÉÃmÉ0iÀÄ°ègÀÄªÀ §eÁj£À
बाजाराचें: ¥ÉÃmÉ0iÀÄ ¥ÉÃmÉ0iÀÄ°ègÀÄªÀ §eÁj£À
बाजारी: ¥ÉÃmÉ0iÀÄ ¥ÉÃmÉ0iÀÄ°ègÀÄªÀ §eÁj£À
बाद: ¤gÀxÀðPÀ ¤gÀÄ¥ÀAiÉÆÃV PÉ®¸À_ªÀiÁqÀzÀªÀ RArvÀªÁV ¤²ÑvÀªÁV
बारामाही: ªÀµÀð«rÃ ªÀµÀð¥ÀÇwð J¯Áè_IÄvÀÄUÀ¼À®Æè_EgÀÄªÀ ªÀµÀð¥ÀÇwð ºÀ£ÉßgÀqÀÄ_wAUÀ¼ÀÆ_(?)
बारीक: §qÀPÀ®Ä_zÉÃºÀzÀ J®Ä©£ÀAxÀ ªÀÄÆ¼ÉAiÀÄAxÀ_zÉÃºÀzÀ ¸ÀÆPÀë÷ä ¸ÀuÁÚw¸ÀtÚ PÀÄëzÀæ
बारीकसाणेचो.: dÄUÁÎwdÄUÀÎ dÄ¥ÀÅuÁwdÄ¥ÀÅt
बालपण: ºÀÄqÀÄUÀÄvÀ£ÀzÀ ºÀÄqÀÄUÀÄ§Ä¢Þ0iÀÄ
बाळक: £ÀªÀeÁvÀ
बावन: LªÀvÉÛgÀqÀÄ 52
बाविल्लें: PÀ¼ÉUÀÄA¢zÀ ¤¸ÉÛÃd PÁAw»Ã£À ªÀÄAPÁzÀ ©½aPÉÆAqÀ T£Àß «µÀtÚ ªÀiÁè£À ¨ÁrzÀ PÁAw»Ã£À PÀ¼Á»Ã£ÀªÁzÀ zÀÄBRzÀ ±ÉÆÃPÀzÀ ªÀå¸À£ÀzÀ T£Àß GzÁ¹Ã£À
बावीस: E¥ÀàvÉÛgÀqÀ£É0iÀÄ
बासठ: CgÀªÀvÉÛgÀqÀÄ
बाह्य: ºÉÆgÀ ¨ÁºÀå
बिगरनिवासी: ¥ÀæªÁ¹ ¥ÉæÃPÀëPÀ_(?)
बिनकांटयारें: ªÀÄÄ½î®èzÀ PÀAlPÀ«®èzÀ
बिनराखीव: PÁ¬ÄÝj¸ÀzÀ «ÄÃ¸À®®èzÀ
बुडिल्लो: C¸ÀÛAUÀvÀªÁzÀ ªÀÄÄ¼ÀÄVzÀ
बुदवंत: §Ä¢ÞfÃ«
बुद्दिजिवी: §Ä¢ÞfÃ«
बुरशें: C²èÃ® C¸À¨sÀåªÁzÀ ºÉÆ®¸ÁzÀ
बुराकाची: vÀÆvÀÄUÀ½gÀÄªÀ ¸ÀgÀAzsÀæ gÀAzsÀæUÀ½AzÀ_vÀÄA©zÀ
बेकायदेशीर: PÁ£ÀÆ£ÀÄ_¨Á»gÀ CPÀæªÀÄ ±Á¸À£À¸ÀªÀÄävÀªÀ®èzÀ PÁ¬ÄzÉ_«gÀÄzÀÞ
बेकार: ¤gÀÄzÉÆåÃV ¤gÀxÀðPÀ ¤gÀÄ¥ÀAiÉÆÃV PÉ®¸À_ªÀiÁqÀzÀªÀ
बेकारलवडी: ¤gÀxÀðPÀ ¤gÀÄ¥ÀAiÉÆÃV PÉ®¸À_ªÀiÁqÀzÀªÀ
बेगडी: vÉÆÃjPÉAiÀÄ DqÀA§gÀzÀ ºÉÆgÀ£ÉÆÃlzÀ PÀÈwæªÀÄzÀ £ÀPÀ°vÀ£ÀzÀ vÉÆÃjPÉAiÀÄ ¤ÃmÁzÀ pÃPÁzÀ CAzÀªÁzÀ ZÉAzÀªÁzÀ ¸ÀÄAzÀgÀªÁzÀ O¥ÀZÁjPÀ ¥ÀzÀÝw0iÀÄ ¸ÁA¥ÀæzÁ¬ÄPÀ
बेगीन: ªÉÃUÀ ¨ÉÃUÀ ²ÃWÀæ
बेघर: ªÀÄ£É¬Ä®èzÀ UÀÈºÀgÀ»vÀ UÀw¬Ä®èzÀ
बेचैन: G¢édÕ vÀ®ètUÉÆAqÀ ªÁåPÀÄ°vÀ DvÀAPÀUÉÆAqÀ
बेजार: C¥Àæ¸À£ÀßªÁzÀ C¸ÀAvÀÄµÀ×ªÁzÀ ºÀvÁ±À ¤gÁ±À D¸ÉUÉlÖ JzÉUÀÄA¢zÀ ¤gÁ±À£ÁzÀ ºÀvÁ±ÀUÉÆAqÀ
बेजारदिणें: ¨ÉÃ¸ÀgÀzÀ ¨ÉÃ¸ÀgÀPÀgÀ
बेजारिल्लें: ¨ÉÃ¸ÀgÀªÁzÀ T£ÀßUÉÆAqÀ
बेपरवा: G¥ÉÃPÀëtÂÃAiÀÄ PÀqÉUÀtÂ¸À§ºÀÄzÁzÀ
बेबदो: ªÀiÁzÀPÀ_ªÀå¸À¤ PÀÄqÀÄPÀ ºÉAqÀUÀÄqÀÄPÀ
बेयमान: C¥ÀæªÀiÁtÂPÀ ªÉÆÃ¸ÀzÀ ªÀAZÀ£ÉAiÀÄ zÀUÁ¨ÁfAiÀÄ oÀQÌ£À vÀlªÀlzÀ
बेवारशी: C£ÁxÀ vÀ§â°
बेशुद्ध: ¥ÀæeÉÕ¬Ä®èzÀ eÁÕ£ÀvÀ¦àzÀ ªÉÄÊªÉÄÃ¯É_JZÀÑgÀ«®èzÀ
बेसावध: CeÁUÀævÉAiÀÄ ¤®ðPÀë÷åzÀ C£ÁzÀgÀzÀ C¸ÀqÉØAiÀÄ G¥ÉÃPÉëAiÀÄ
बोडकें: MtVzÀ
बोडको: J¯ÉUÀ½®èzÀ ¥ÀtðgÀ»vÀ C¥Àtð
बोधपूर्ण: «ZÁgÀ¥ÀÇtðªÁzÀ
बोध्य: UÀæ»¸À§®è CjAiÀÄ§®è w½AiÀÄ§®è
बौद्ध: ¨ËzÀÞ
ब्याणव: vÉÆA§vÉÛgÀqÀÄ 92
भंगीत: ªÀÄÄjzÀ MqÉzÀ
भंयभीत: ¨sÀ0iÀÄ©üÃvÀ UÁ§j0iÀÄ ¨ÉzÀgÀÄªÀ ºÉzÀgÀÄªÀ PÀAUÁ¯ÁUÀÄªÀ
भक्षक: w£ÀÄßªÀ GtÄÚªÀ ¨sÀPÀëPÀ
भक्ष्य: ¨sÉÆÃdå SÁzÀå ¨sÀPÀë÷å
भगवो: PÉÃ¸ÀjÃ0iÀÄ
भटकें: C¯ÉªÀiÁj wgÀÄUÁqÀÄªÀªÀ C¯ÉAiÀÄÄªÀªÀ
भडक: GvÉÛÃdPÀ ¥ÉæÃgÀPÀ xÀ¼ÀÄQ£À PÀtÄÚ_PÉÆÃgÉÊ¸ PÀtÄÚ_PÀÄPÀÄÌªÀAxÀ
भरपूर: CvÀå¢üPÀ CwºÉZÀÄÑ
भरिल्लें: ¥Àj¥ÀÇtð ¸ÀA¥ÀÇtð ¨ÉÃ¨ÁQ ZÀÄPÁÛ
भलायकेक_बरें: ¸Àé¸ÀÜªÁzÀ DgÉÆÃUÀåPÀgÀªÁzÀ
भलें: GvÀÛªÀÄ M¼ÉîAiÀÄ ±ÉæÃµÀ×ªÁzÀ
भव्य: ¸ÀÆÜ®PÁAiÀÄ ªÀÄºÁPÁAiÀÄzÀ «±Á®ªÁzÀ §ÄæºÀvÁÛzÀ CUÁzsÀªÁzÀ «¸ÁÛgÀªÁzÀ
भशेन: CAvÀºÀ CzÀgÀAvÉ
भाग्यशाली: CzÀÈµÀÖ±Á° £À¹Ã§ªÀAvÀ ¨sÁUÀå±Á°
भाट: ¥Àæ±ÀA¸ÀPÀ ¥Àæ±ÀA¸ÉAiÀÄ
भायलें: ºÉÆgÀ ¨ÁºÀå
भायलो: «zÉÃ²ÃAiÀÄ ¥ÀgÀzÉÃ²ÃAiÀÄ C£ÀåzÉÃ²ÃAiÀÄ
भायल्याचें: ¥ÀgÀQÃAiÀÄ C£ÀågÀ ¥ÀgÀgÀ
भावपूर्ण: ¨sÁªÀ¥ÀÇtðªÁzÀ
भावी: ªÀÄÄA§gÀ°gÀÄªÀ §gÀ°gÀÄªÀ DUÀ«Ä¸À°gÀÄªÀ ¨sÁ«
भावूक: ¨ÁªÀ£ÁvÀäPÀ ¨ÁªÀÅPÀ
भाशांतरकार: C£ÀÄªÁzÀPÀ ¨sÁµÁAvÀgÀPÁgÀ
भाशातंर_करपी: C£ÀÄªÁzÀPÀ ¨sÁµÁAvÀgÀPÁgÀ
भिकाड्डो: dÄUÁÎwdÄUÀÎ dÄ¥ÀÅuÁwdÄ¥ÀÅt
भिजिल्लें: ¤ÃgÀÄ_ºÁ¬Ä¹zÀ ¤ÃgÀÄ_ZÀÄªÀÄÄQ¹zÀ ¤ÃgÉgÀazÀ
भितरले: DAvÀjPÀ
भियेल्लो: DvÀAQvÀ ¨sÀAiÀÄUÀæ¸ÀÛ
भुंयगत: ©®ªÁ¹_(?)
भुतकाळ: ¥ÀÅgÁvÀ£À_PÁ®zÀ UÀvÀPÁ®zÀ »A¢£À_PÁ®zÀ
भुतकाळीन: ¨sÀÆvÀPÁ°Ã£À UÀvÀPÁ°Ã£À
भुताचें: zÉªÀézÀ ¨sÀÆvÀzÀ ¥ÉæÃvÀzÀ
भुताटकेचें: zÉªÀézÀ ¨sÀÆvÀzÀ ¥ÉæÃvÀzÀ
भुरगें: J¼É_ªÀAiÉÆÃªÀiÁ£ÀzÀ ¨Á®PÀ\
भुरगेपण: ºÀÄqÀÄUÀÄvÀ£ÀzÀ ºÀÄqÀÄUÀÄ§Ä¢Þ0iÀÄ
भुलयणें: ¸ÀªÉÆäÃºÀ£ÀUÉÆ½¸À§®è ªÉÆÃºÀPÀUÉÆ½¸À§®è
भेसळीचें: C±ÀÄzÀÝªÁzÀ ºÉÆ®¸ÁzÀ C±ÀÄaAiÀiÁzÀ ZÉÆPÀÌl«®èzÀ
भोंवपी: C¯ÉªÀiÁj wgÀÄUÁqÀÄªÀªÀ C¯ÉAiÀÄÄªÀªÀ
भोगी: PÁªÀÄÄPÀ D±É§ÄgÀÄPÀ
भोळो: ¸ËªÀÄå_¸Àé¨sÁªÀzÀ vÁ¼ÉäAiÀÄ ±ÁAvÀ_¸Àé¨sÁªÀzÀ
भोवमानेस्त: DzÀgÀtÂÃAiÀÄ UËgÀªÁºÀð
भोववर्शी: ¢ÃWÀðPÁ°Ã£À §ºÀÄPÁ°Ã£À
भोवसंख्या: §ºÀÄ¸ÀASÁåvÀ §ºÀÄ¸ÀASÁå
मचमचीत: gÀÄaPÀmÁÖzÀ gÀÄaPÀgÀªÁzÀ gÀÄaAiÀiÁzÀ ¸Áé¢µÀÖ ¸À«AiÀiÁzÀ ªÀÄ¸Á¯É¨sÀjvÀ
मजेशीर: PÀÄvÀÆºÀ®PÁj DPÀ±ÀðPÀ PÀÄvÀÆºÀ®_PÉgÀ½¸ÀÄªÀ ¸ÁégÀ¸ÀåPÀgÀ gÉÆÃZÀPÀ
मडील्लें: ªÀÄtÂÚ£À (?)
मढोवंक_नाशिल्लें: vÀAiÀiÁgÁUÀzÀ DPÁgÀ»Ã£À ¤gÁPÁgÀ
मतींतलें: PÁ®à¤PÀ PÀ°àvÀ CªÁ¸ÀÛ«PÀ
मदेवर्ती: ªÀÄzsÀå¹ÜPÉAiÀÄ
मद्यम_पिरायेचें: ªÀÄzsÀåªÀAiÀÄ¸ÀÌ £ÀqÀÄªÀAiÀÄ¹ì£À
मध्यवर्ती: ªÀÄzsÀå¹ÜPÉAiÀÄ
मनभुलयणी: gÀªÀÄtÂÃAiÀÄ ZÉ®ÄªÁzÀ
मनभुलयणें: CzÀÄãvÀ ¢ªÀå ±ÉÆÃ¨sÁAiÀÄªÀiÁ£À
मनरिजवणेचें: ªÀÄ£ÉÆÃgÀAdPÀ ªÀÄ£ÀgÀAf¸ÀÄªÀ «£ÉÆÃzÀUÉÆ½¸ÀÄªÀ
मनायेचें: ¤¶zÀÞ ¤§ðA¢üvÀ PÀlÄÖ¥ÁrgÀÄªÀ
मनीस_निर्मीत: PÀÈvÀPÀ vÀAiÀiÁj¹zÀ ªÀÄ£ÀÄµÀåPÀÈvÀ
मनीसचलीत: ªÀiÁ£ÀªÀ_ZÁ°vÀ
मनीसपण: GvÀÛªÀÄ M¼ÉîAiÀÄ ±ÉæÃµÀ×ªÁzÀ
मनीसपणाचें: ªÀiÁ£À«ÃAiÀÄ
मरणादीक: fÃªÁ¥ÁAiÀÄ ªÀÄÈvÀÄåPÁj
मर्यादीत: «ÄvÀªÀåAiÀÄ
मळ्यांचीं: ªÀÄºÀrUÀ¼À CAvÀ¸ÀÄÛUÀ¼À£ÀÄß¼Àî G¥ÀàjUÉUÀ¼À£ÀÄß_ºÉÆA¢zÀ
मशागत: ¥Á®£É_ªÀiÁrzÀ ¥ÉÇÃ¶¹zÀ
मसालेदार: ªÀÄ¸Á¯É¨sÀjvÀ
मसाल्याचें: ªÀÄ¸Á¯É¨sÀjvÀ
मस्तिल्लें: PÁ°¤AzÀ_vÀÄ½AiÀÄ®àlÖ_(?)
महत्वाकांक्षी: ªÀÄºÁvÀéPÁAQë ºÉ§âAiÀÄPÉ
माजी: »A¢£À ¥ÀÇªÀðzÀ ºÀ¼ÉAiÀÄ ªÀÄÄAa£À ªÉÆzÀ°£À
माड्डिल्लें: PÁ°¤AzÀ_vÀÄ½AiÀÄ®àlÖ_(?)
माणकुलें: ¸ÀtÚ_PÀgÀÄ ¥ÀÅmÁtÂ_ªÀÄUÀÄ
मातयेभरवण: PÀ¼ÉzÀÄPÉÆAqÀ PÀ¼ÉzÀÄºÉÆÃzÀ ºÁ¼ÁzÀ
मातसो: CvÀå®àªÁzÀ ¸ÁPÀ¶ÖgÀzÀ
मातेराचें: QÃªÀÅ_vÀÄA©zÀ
मादक: ªÀiÁzÀPÀ CªÀÄ¯ÉÃj¸ÀÄªÀ ªÀÄvÉÛÃj¸ÀÄªÀ £À±É0iÉÄÃj¸ÀÄªÀ
माननीय: (?)
मानवी: ªÀiÁ£À«ÃAiÀÄ
मानसीक: ªÀÄ£ÉÆÃgÉÆÃV ªÀiÁ£À¹PÀ_C¸Àé¸ÀÜ ºÀÄZÀÄÑ_»rzÀªÀ
मानादीक: (?) DzÀgÀtÂÃAiÀÄ UËgÀªÁºÀð
मानिल्लें: C¤§ðA¢üvÀ ¤§ðA¢ü¸ÀzÀ «ÄvÀUÉÆ½¸ÀzÀ ¥Àj«ÄvÀ_ªÀiÁqÀzÀ PÀlÄÖ¥Àr¸ÀzÀ
मान्य: C¤§ðA¢üvÀ ¤§ðA¢ü¸ÀzÀ «ÄvÀUÉÆ½¸ÀzÀ ¥Àj«ÄvÀ_ªÀiÁqÀzÀ PÀlÄÖ¥Àr¸ÀzÀ ¹éÃPÁAiÀÄð M¥Àà§ºÀÄzÁzÀ M¥ÀàvÀPÀÌ ¹éÃPÁgÀ_AiÉÆÃUÀå CAVÃPÁgÁºÀð
मान्य_केल्ली: ¹éÃPÀÈvÀ M¦àvÀ
मान्य_नाशिल्लें: M¥Àà¯ÁUÀzÀ C£ÀAVÃPÁAiÀÄð C¹éÃPÀÈvÀªÁzÀ CAVÃPÁAiÀÄðºÀðªÀ®èzÀ ¹éÃPÁgÀAiÉÆÃUÀåªÀ®èzÀ
माफ_करी_सारकी: PÀëªÀÄå PÀëªÀiÁºÀð ªÀÄ¤ß¸À§®è PÀë«Ä¸À§ºÀÄzÁzÀ
माफी-बगरचो: CPÀëªÀÄå PÀëªÀiÁ»Ã£À
मामे: ªÀiÁªÀ£À ªÀiÁªÀA¢gÀ
मायेस्त: ¸ÉßÃºÀªÀÄAiÀÄ ¸ÉßÃºÀ¥ÀÇªÀðPÀ
माळी: ªÀÄºÀrUÀ¼À CAvÀ¸ÀÄÛUÀ¼À£ÀÄß¼Àî G¥ÀàjUÉUÀ¼À£ÀÄß_ºÉÆA¢zÀ
मावळिल्लो: C¸ÀÛAUÀvÀªÁzÀ ªÀÄÄ¼ÀÄVzÀ
मावशे: vÁ¬Ä0iÀÄ_¸ÀºÉÆÃzÀj0iÀÄ_¸ÀA§AzsÀªÀÅ¼Àî
मावस: vÁ¬Ä0iÀÄ_¸ÀºÉÆÃzÀj0iÀÄ_¸ÀA§AzsÀªÀÅ¼Àî
मासाळ: zÀµÀÖ¥ÀÅµÀÖ PÉÆ©âzÀ ªÀiÁA¸ÀAiÀÄÄPÀÛ wgÀÄ½£ÀAvÀºÀ
मिटना__अशें: C½¸À¯ÁUÀzÀ £Á±ÀªÁUÀ¯ÁgÀzÀ
मित्रत्व: ¸ÉßÃºÀ¥ÀgÀ «±Áé¸À¥ÀgÀ
मिश्र: «Ä²ævÀ ¸À«Ää±Àæt
मिस्तुराद: C±ÀÄzÀÝªÁzÀ ºÉÆ®¸ÁzÀ C±ÀÄaAiÀiÁzÀ ZÉÆPÀÌl«®èzÀ «Ä²ævÀ ¸À«Ää±Àæt
मुक्त: ¸ÀévÀAvÀæ C¢üÃ£ÀªÀ®èzÀ C¥ÀgÁ¢üÃ£À ¸Áé¢ü¥ÀvÀåzÀ
मुखार_येवपी: ªÀÄÄA§gÀ°gÀÄªÀ §gÀ°gÀÄªÀ DUÀ«Ä¸À°gÀÄªÀ ¨sÁ«
मुखारचो: ªÀÄÄA¨sÁUÀzÀ ªÀÄÄAUÀqÉAiÀÄ ¥ÀÅgÉÆÃªÀwð
मुखावयलो: ªÀÄÄA¨sÁUÀzÀ ªÀÄÄAUÀqÉAiÀÄ ¥ÀÅgÉÆÃªÀwð
मुखेली: ¥ÀæzsÁ£À ¥ÀæªÀÄÄR ªÀÄÄRå
मुदयाळे: UÀÄAUÀÄgÀÄ ¸ÀÄgÀÄ½
मुळावें: DgÀA¨sÀzÀ ¥ÁægÀA¨sÀzÀ ªÉÆzÀ°£À
मुस्तिल्लें: PÁ°¤AzÀ_vÀÄ½AiÀÄ®àlÖ_(?)
मूर्त: ªÉÄÊzÉ¼ÉzÀ ªÉÄÊªÉvÀÛ ¸ÁPÁgÀ ªÉÄÊzÁ½zÀ
मूळ: ¸ÀégÀavÀ ªÀÄÆ®zÀ
मेकळें: ªÀÄÄaÑqÀzÀ UË¥Àå«gÀzÀ UÀÄ¥ÀÛªÀ®èzÀ ¸ÀévÀAvÀæ C¢üÃ£ÀªÀ®èzÀ C¥ÀgÁ¢üÃ£À ¸Áé¢ü¥ÀvÀåzÀ
मेघहीण: w½AiÀiÁzÀ ¤ªÀÄð® ¤ZÀÑ¼À ¸ÀéZÀÑ ±ÀÄ¨sÀæ ¤gÀ¨sÀæ
मेजपा_योग्य: UÀt¤ÃAiÀÄ C¸ÀASÁåvÀ
मेजी_सारक्यो: UÀt¤ÃAiÀÄ C¸ÀASÁåvÀ
मेल्लें: ªÀÄÈvÀ dqÀ ¤fÃðªÀ MtVzÀ
मेळनाशिल्लें: zÉÆgÉAiÀÄzÀ ¹UÀzÀ G¥À®§Ý«gÀzÀ
मेळिल्लें: UÀ½¹zÀ Cfð¹zÀ ¸ÀA¥Á¢¹zÀ
मेळोवन_दिल्लें: ¹UÀ§®è zÉÆgÀPÀ§®è ®§å G¥À®§Ý ¥Áæ¥ÀÛ
मेळोवपी: ¹éÃPÀvÀð ¥ÀqÉAiÀÄÄªÀªÀ ¹éÃPÀj¸ÀÄªÀªÀ
मैत्री: s¸ÉßÃºÀ¥ÀgÀ ªÉÄÊwæ¨sÁªÀzÀ ¸À°UÉ0iÀÄ
मोगाळ: ¸ÉßÃºÀªÀÄAiÀÄ ¸ÉßÃºÀ¥ÀÇªÀðPÀ
मोगासक्त: ¥ÉæÃªÀiÁ¸ÀPÀÛ C£ÀÄgÀPÀÛ C£ÀÄgÁV
मोड: ©gÀÄUÁ½0iÀÄAvÉ ©gÀÄUÁ½0iÀÄ_gÀ§¸ÀzÀAvÉ
मोडकें: ºÀgÀPÀÄ-ªÀÄÄgÀÄPÀÄ ºÁ¼ÁVgÀÄªÀ
मोडको: PÀÄ¼Àî VqÀØ
मोडवो: PÀÄ¼Àî VqÀØ
मोडिल्लें: ªÀÄÄjzÀ MqÉzÀ
मोनो: ªÀiË£ÀªÁVgÀÄªÀ ªÀiÁvÁqÀzÀ ¸ÉÆ¯ÉèvÀÛzÀ vÀÄn¦lPÉÌ£ÀßzÀ
मोलादीक: CªÀÄÆ®åªÁzÀ C£ÀWÀåðªÁzÀ ¨É¯ÉPÀlÖ¯ÁUÀzÀ
मोव: ¸ËªÀÄå_¸Àé¨sÁªÀzÀ vÁ¼ÉäAiÀÄ ±ÁAvÀ_¸Àé¨sÁªÀzÀ §¼ÀÄPÀÄªÀ ªÀÄtÂAiÀÄÄªÀ ¨ÁUÀÄªÀ ¸ÀÄ£ÀªÀÄå ZÁPÀZÀPÀåªÀÅ¼Àî
मोव_काळजाचें: zÀ0iÀiÁªÀÄ0iÀÄ PÀgÀÄuÁ¼ÀÄ PÀgÀÄuÁªÀÄ0iÀÄ PÀgÀÄuÁzÀæð_ºÀÈzÀ0iÀÄzÀ PÉÆÃªÀÄ®_ºÀÈzÀ¬Ä
मोहक: ¸ÀªÉÆäÃºÀ£ÀUÉÆ½¸À§®è ªÉÆÃºÀPÀUÉÆ½¸À§®è CzÀÄãvÀ ¢ªÀå ±ÉÆÃ¨sÁAiÀÄªÀiÁ£À
म्हत्व_नाशिल्लें: CªÀÄÄRå PÀÄëzÀæ ºÀÄgÀÄ½®èzÀ
म्हत्वकांक्षा_नाशिल्लें: ªÀÄºÁvÁéPÁAPÉë¬ÄgÀzÀ ¤gÁ±ÁzÁAiÀÄPÀ
म्हत्वपूर्ण: ªÀÄºÀvÀé¥ÀÇtð CªÀÄÆ®åªÁzÀ
म्हत्वहीण: CªÀÄÄRå PÀÄëzÀæ ºÀÄgÀÄ½®èzÀ
म्हत्वाचें: ªÀÄºÀvÀé¥ÀÇtð CªÀÄÆ®åªÁzÀ
म्हा: ¥ÀæSÁAqÀ
म्हातारें: ªÀÄÄ¢AiÀiÁzÀ ªÀAiÀÄ¸ÁìzÀ ªÀÄÄ¥ÉàÃjzÀ ªÀÈzÀÞ£ÁzÀ ªÀiÁVzÀ
म्हान: ¥ÀæSÁAqÀ
म्हापापी: ªÀÄºÁ¥Á¦ ¥Á¥ÁvÀä ¥ÁvÀQ zÀÄgÁvÀä ¥Á¦µÀ×
म्हामुर्ख: ªÀÄºÁªÀÄÆRð CwªÀÄÆRð
म्हारग: zÀÄ¨Áj vÀÄnÖ_(?)
म्हालम्हातारें: ªÀÄÄ¢AiÀiÁzÀ ªÀAiÀÄ¸ÁìzÀ ªÀÄÄ¥ÉàÃjzÀ ªÀÈzÀÞ£ÁzÀ ªÀiÁVzÀ
म्होंवाळ: ¸ÀÄ¸ÀégÀ ªÀÄzsÀÄgÀ_¸ÀégÀ EA¥ÁzÀ_¸ÀégÀ
म्होंवाळ_उलोवपी: ¦æAiÀÄªÁzÀ_ªÀiÁvÀÄUÁjPÉ ¦æAiÀÄªÁzÀÄzÀ£ÉßÃ_ªÀiÁvÀ£ÁqÀÄªÀªÀ
यंत्रचलीत: AiÀÄAvÀæ_ZÁ°vÀ AiÀiÁAwæPÀ
यत्नशील: ¥ÀæAiÀÄvÀß²Ã® GzÀåªÀÄ²Ã®
याद__नाशिल्लें: ªÀÄgÉvÀ ªÀÄgÉvÀÄ_ºÉÆÃzÀ
युनानी: CAiÉÆÃ¤AiÀÄ£ï VæÃPï£À
येवंक_नाशिल्लो: ¹UÀzÀ ¨ÁgÀzÀ DeÁÕvÀ UÉÆvÁÛUÀzÀ
येवजिल्लें: ¸Àé_EZÉÑ¬ÄAzÀ EµÀÖ¢AzÀ ¸Àé_¸ÀAvÉÆÃµÀ¢AzÀ
येवपी: §gÀ°gÀÄªÀ DUÀ«Ä¸À°gÀÄªÀ §gÀÄªÀ ªÀÄÄA¢£À ¨sÁ«
येशस्वी: ¸À¥sÀ®ªÁzÀ ¥sÀ®PÁjAiÀiÁzÀ 0iÀÄ±À¹é ºÉ¸ÀgÀÄªÁ¹0iÀiÁzÀ QÃwð¥ÀqÉzÀ 0iÀÄ±À_UÀ½¹zÀ
योग्य: C£ÀÄPÀÆ®PÀgÀ ¤²ÑvÀ ¤¢ðµÀÖ ¤AiÀÄ«ÄvÀ PÁ£ÀÆ£ÀÄ§zÀÞªÁzÀ £ÁåAiÀÄ¸ÀªÀÄAd¸ÀªÁzÀ ¸ÀªÀÄAd¸ÀªÁzÀ vÀPÀð§zÀÞªÁzÀ
योग्य_वेळार: ¸ÀªÀÄAiÉÆÃavÀ PÁ¯ÉÆÃavÀ ¸ÀPÁ®zÀ
रक्तहीण: gÀPÀÛ»Ã£À gÀPÀÛ«®èzÀ
रक्ताचें: PÉÆ¯É¥ÁvÀPÀvÀ£À
रक्षक: gÀPÀëuÁ gÀPÀëuÉ0iÀÄ
रगत_नाशिल्लें: gÀPÀÛ»Ã£À gÀPÀÛ«®èzÀ
रचिल्लें: PÁ®à¤PÀ PÀ°àvÀ CªÁ¸ÀÛ«PÀ PÀnÖzÀ ¤«ÄðvÀ gÀavÀ
रचूंक_नाशिल्लें: ¤«Äð¸À¯ÁgÀzÀ ªÀiÁqÀ¯ÁgÀzÀ gÀa¸À¯ÁgÀzÀ
रद्द: gÀzÁÝzÀ ¤°è¹zÀ vÀqÉzÀ
रमणीय: gÀªÀÄtÂÃAiÀÄ ZÉ®ÄªÁzÀ
रम्य: gÀªÀÄtÂÃAiÀÄ ZÉ®ÄªÁzÀ
रसहीण: gÀ¸À«®èzÀ gÀ¸À«gÀzÀ ¤ÃgÀ¸À
रसाळ: gÀ¸À¥ÀÇjvÀ gÀ¸À¨sÀjvÀ
रसीक: gÀ¹PÀ
रहस्य: gÀºÀ¸ÀåªÀÄAiÀÄ gÀºÀ¸ÁåvÀäPÀ
रहस्यहीण: gÀºÀ¸ÀåªÀ®èzÀ
राखीव: «ÄÃ¸À°lÖ PÁ¬ÄÝj¹zÀ
राखीवतेबगरचें: PÁ¬ÄÝj¸ÀzÀ «ÄÃ¸À®®èzÀ
रागिश्ट: ¹mÁÖzÀ PÉÆæÃzsÀUÉÆAqÀ ¹qÀÄQ£À ¹mÁÖUÀÄªÀ gÉÃUÀÄªÀ PÉÆÃ¦µÀ×
राजकारणाचे: gÁdvÁAwæPÀ gÁAiÀÄ¨sÁgÀzÀ
राजकारणी: gÁdvÁAwæPÀ gÁAiÀÄ¨sÁgÀzÀ ¤Ãwdå÷ß ¤ÃwPÀÄ±À® ¤Ãw²Ã®
राजनितीक: gÁdvÁAwæPÀ gÁAiÀÄ¨sÁgÀzÀ
रानटी: ªÀ£Àå PÁqÀÄ
रानवटी: ªÀ£Àå PÁqÀÄ
रानवासी: CgÀtåªÁ¹ ªÀ£ÀªÁ¹
राबित्याच्यो: ªÁ¸À¸ÁÜ£ÀzÀ
राष्ट्रद्रोही: zÉÃ±À¥ÉæÃªÀÄ«®èzÀ ¸ÀézÉÃ±Á©üªÀiÁ£À«®èzÀ
राष्ट्रीय: CAvÀgïzÉÃ²ÃAiÀÄ
रासायनीक: gÁ¸ÁAiÀÄ¤PÀ
रितसर: ¸ÀÄªÀåªÀ¹ÜvÀªÁzÀ M¥ÀàªÁzÀ NgÀtªÁzÀ CZÀÄÑPÀmÁÖzÀ
रीतसर: ¸ÀÄªÀåªÀ¹ÜvÀ ¸ÀÄ¸ÀAWÀnvÀªÁzÀ
रुचीक: ¸À«AiÀiÁzÀ gÀÄaAiÀiÁzÀ ¸ÁézÀAiÀÄÄPÀÛ
रुचीचें: ¸À«AiÀiÁzÀ gÀÄaAiÀiÁzÀ ¸ÁézÀAiÀÄÄPÀÛ
रूच_नाशिल्लें: gÀÄa¬Ä®èzÀ ¸À«¬Ä®èzÀ CgÀÄa
रूचीक: gÀÄaPÀmÁÖzÀ gÀÄaPÀgÀªÁzÀ gÀÄaAiÀiÁzÀ ¸Áé¢µÀÖ ¸À«AiÀiÁzÀ
लकलकीत: ¥ÀæPÁ±ÀªÀiÁ£ÀªÁzÀ ºÉÆ¼ÉAiÀÄÄªÀ ¨É¼ÀUÀÄªÀ Gdé®ªÁzÀ ¥ÀæPÁ±ÀªÀiÁ£ÀªÁzÀ
लक्षवेदी: UÀÄgÀÄ¬ÄqÀÄªÀ UÀÄj¬ÄlÄÖ_ºÉÆqÉAiÀÄÄªÀ
लक्षा_वसून_पयस: UÀÄj¬Ä®èzÀ GzÉÞÃ±À«®èzÀ
लग्न_जाल्लें: «ªÁ»vÀ ªÀÄzÀÄªÉAiÀiÁzÀ ®UÀßªÁzÀ
लज_नाशिल्लो: £ÁaPÉ¬Ä®èzÀ ¤®ðeÉÓAiÀÄ ®eÁÓgÀ»vÀ ®eÁÓ»Ã£À
लजेची: £ÁaPÉUÉÃr£À CªÀªÀiÁ£ÀzÀ vÀ¯ÉvÀVÎ¸ÀÄªÀAxÀ ºÉ¸ÀgÀÄ_PÉqÀÄªÀAxÀ
लटकें: ¤gÁzÁgÀ DzsÁgÀgÀ»vÀ §ÄqÀ«®èzÀ vÉÆÃjPÉAiÀÄ DqÀA§gÀzÀ ºÉÆgÀ£ÉÆÃlzÀ PÀÈwæªÀÄzÀ £ÀPÀ°vÀ£ÀzÀ
लटको: ¸ÀÄ¼ÀÄîUÁgÀ PÀÈwæªÀÄ vÉÆÃjPÉ0iÀÄ ªÉÆÃ¸ÀUÁgÀ
लडकें: £ÀPÀ° SÉÆÃl PÀÈvÀPÀ ¸ÀÈ¶×_ªÀiÁrzÀ ªÉÆÃ¸ÀzÀ PÀÈwæªÀÄzÀ
लवचीक: §¼ÀÄPÀÄªÀ ªÀÄtÂAiÀÄÄªÀ ¨ÁUÀÄªÀ ¸ÀÄ£ÀªÀÄå ZÁPÀZÀPÀåªÀÅ¼Àî
लांचखोर: ®AZÀPÉÆÃgÀ
लांब_काळाचें: ¢üÃWÀðPÁ°Ã£À agÀPÁ°Ã£À §ºÀÄPÁ°Ã£À
लागचें: ¸À«ÄÃ¥ÀzÀ ºÀwÛgÀzÀ
लागींचें: ¸À«ÄÃ¥ÀzÀ ºÀwÛgÀzÀ
लाचार: ¤gÀÄ¥ÁAiÀÄ G¥ÁAiÀÄ«gÀzÀ
लाबदिणें: ¯Á¨sÀzÁAiÀÄPÀ
लाभहीण: ¯Á¨sÀ«®èzÀ ¯Á¨sÀgÀ»vÀ UÀ½PÉ¬Ä®èzÀ
लाभार्थी: ¯Á¨sÀzÁAiÀÄPÀªÁzÀ C£ÀÄPÀÆ®PÀgÀªÁzÀ ¥ÀæAiÉÆÃd£ÀPÁjAiÀiÁzÀ
लाल: PÉA¥ÁzÀ
लिकलीकपी: ±ÉÆÃ¨sÁAiÀÄªÀiÁ£À ªÉÊ¨sÀªÀAiÀÄÄvÀ
लिखीत: °TvÀ °¦¸À»vÀ CAQvÀ PÁUÀzÀ
लुकसाणदिणें: ºÁ¤PÀgÀ PÉqÀÄQ£À G¥ÀzÀæªÀPÀgÀ C¥ÁAiÀÄPÁj
लुकसाणीचें: ºÁ¤PÀgÀ PÉqÀÄQ£À G¥ÀzÀæªÀPÀgÀ C¥ÁAiÀÄPÁj
लुकसाणीचो: ¯Á¨sÀ«®èzÀ ¯Á¨sÀgÀ»vÀ UÀ½PÉ¬Ä®èzÀ
लुप्त: PÀtägÉAiÀiÁzÀ ªÀÄgÉAiÀiÁzÀ ºÁ¼ÁzÀ UÀw¹zÀ
लुळोपांगळो: CAUÀ«PÀ® «PÀ¯ÁAUÀ CAUÀ»Ã£À
लेंवाळ: GuÉÚAiÀÄ vÀÄ¥ÀàqÀzÀ
लोककल्याणकारी: ¯ÉÆÃPÉÆÃ¥ÀPÁj ¯ÉÆÃPÀ»vÀ
लोकरी: GtÂÚ_§mÉÖ
लोकांमुखी: (?)
लोकांमौखीक: (?)
लोकाचें: ¥ÀgÀQÃAiÀÄ C£ÀågÀ ¥ÀgÀgÀ
लोकोपयोगी: d£ÉÆÃ¥ÀAiÉÆÃV ¯ÉÆÃPÉÆÃ¥ÀAiÉÆÃV
लोकोपेगी: d£ÉÆÃ¥ÀAiÉÆÃV ¯ÉÆÃPÉÆÃ¥ÀAiÉÆÃV
लोभी: ¸Áéyð
ल्हान: PÉ¼ÀzÀeÉð0iÀÄ PÀ¤µÀ× PÀrªÉÄ_CAvÀ¹Û£À vÀªÀÄä
ल्हारांचो: C¯É vÉgÉ vÀgÀAUÀ ®ºÀj
वंचीत: ªÀAavÀ ¹UÀzÀ zÉÆgÉ0iÀÄzÀ
वंशावळीचें: D£ÀÄªÀA²PÀªÁV C£ÀÄªÀA±Á£ÀÄUÀvÀ ªÀA±À¥ÁgÀA¥ÀAiÀÄðªÁV
वक्र: PÀÄgÀÆ¥ÀzÀ ¤gÀÆ¥À DPÁgÀ«®èzÀ gÀÆ¥ÀgÀ»vÀ «gÀÆ¥ÀªÁzÀ «PÁgÀªÁzÀ
वखदी: OµÀ¢üÃ0iÀÄ
वनवासी: CgÀtåªÁ¹ ªÀ£ÀªÁ¹
वयर_आयिल्लो: GzÀ¬Ä¸ÀÄwÛgÀÄªÀ ºÀÄlÄÖwÛgÀÄªÀ
वयले: GvÀÛªÀÄªÁzÀ GZÀÑvÀªÀÄ ±ÉæÃµÀ×ªÁzÀ
वयल्या_कुळांतलो: C©üeÁvÀ GZÀáPÀÄ°Ã£À ±ÉæÃµÀ×ªÀA±ÀzÀ
वयल्यावयलें: vÉÆÃjPÉAiÀÄ DqÀA§gÀzÀ ºÉÆgÀ£ÉÆÃlzÀ PÀÈwæªÀÄzÀ £ÀPÀ°vÀ£ÀzÀ
वयस्क: ªÀAiÀÄ¸ÀÌ
वरिश्ठ: ªÀÄÄ¢AiÀiÁzÀ ªÀAiÀÄ¸ÁìzÀ ªÀÄÄ¥ÉàÃjzÀ ªÀÈzÀÞ£ÁzÀ ªÀiÁVzÀ
वरी: CAvÀºÀ CzÀgÀAvÉ
वर्जीत: ¤¶zÀÞ ¤§ðA¢üvÀ PÀlÄÖ¥ÁrgÀÄªÀ
वर्ज्य: ¤¶zÀÞ ¤§ðA¢üvÀ PÀlÄÖ¥ÁrgÀÄªÀ
वर्णनीय: CªÀtð¤ÃAiÀÄ
वर्तमान: ªÀvÀðªÀiÁ£ÀzÀ ¸ÀzÀåzÀ
वर्तमान_काळ: ¸ÀªÀÄPÁ°Ã£À ¸ÀzÀåzÀ ªÀvÀðªÀiÁ£ÀzÀ
वर्सभराच्यो: ªÀµÀð«rÃ ªÀµÀð¥ÀÇwð J¯Áè_IÄvÀÄUÀ¼À®Æè_EgÀÄªÀ
वर्सुकी: ªÁ¶ðPÀ ªÀµÀðzÀ
वळखीचें: UÉÆwÛgÀÄªÀ eÁÕvÀ w½zÀ
वळेरेंत: PÀæªÀiÁ£ÀÄUÀvÀ D£ÀÄPÀæ«ÄPÀ ¤gÀAvÀgÀ ¸ÀAvÀvÀ
वसतीघरवासी: «zÁåyð¤®AiÀÄªÁ¹
वांकडें: ªÀPÀæªÁzÀ NgÉAiÀiÁzÀ ¸ÉÆlÖ£ÁzÀ
वांगडें: PÀÄgÀÆ¥ÀzÀ ¤gÀÆ¥À DPÁgÀ«®èzÀ gÀÆ¥ÀgÀ»vÀ «gÀÆ¥ÀªÁzÀ «PÁgÀªÁzÀ
वाकडें: ¨ÁVzÀ ªÀÄtÂzÀ NgÉAiÀiÁzÀ
वाचपायोग्य: NzÀ§®è NzÀ§ºÀÄzÁzÀ
वाचाळ: ªÁZÁ½AiÀiÁzÀ ºÀgÀmÉPÉÆÃgÀ£ÁzÀ «¥ÀjÃvÀ_ªÀiÁvÀÄUÁgÀ£ÁzÀ
वाचीक: NzÀ§®è NzÀ§ºÀÄzÁzÀ
वाठारी: ¥ÁæzÉÃ²PÀ ¥ÁæAwÃ0iÀÄ ¸ÀÜ½Ã0iÀÄ ¸ÀÜ½ÃPÀ
वादग्रस्त: «ªÁzÁ¸ÀàzÀ «ªÁzÀPÉÌqÉAiÀiÁzÀ «ªÁzÀPÉÌ_UÀÄjAiÀiÁzÀ
वादाचें: «ªÁzÁ¸ÀàzÀ «ªÁzÀPÉÌqÉAiÀiÁzÀ «ªÁzÀPÉÌ_UÀÄjAiÀiÁzÀ
वादास्पद: «ªÁzÁ¸ÀàzÀ «ªÁzÀPÉÌqÉAiÀiÁzÀ «ªÁzÀPÉÌ_UÀÄjAiÀiÁzÀ
वापरिल्लें: §¼À¹zÀ §¼ÀPÉUÉÆAqÀ_(?)
वायट: zÀÄgÁ¸ÉAiÀÄ
वायट_करपी: zÀÄµÀÌ«Äð zÀÄgÀÄ¼À PÉlÖªÀ£ÀÄ ¥Á¦vÀ£ÀzÀ zÀÄ£ÀðqÀvÉAiÀÄ
वायट_गूण: zÀÄUÀÄðtzÀ PÉlÖUÀÄtzÀ
वायट_वेव्हारी: zÀÄgÁZÁj zÀÄdð£À_(?)
वायट_वेसनी: zÀÄªÀðå¸À¤
वायट_सभावाचो: MgÀlÄ_¸Àé¨sÁªÀzÀ PÀpt_¸Àé¨sÁªÀzÀ GUÀæ_¸Àé¨sÁªÀzÀ
वासनाहीण: PÁªÀÄ¤UÀæºÀ PÁªÀÄgÀ»vÀ
वासाचें: PÀA¦£À ¥ÀjªÀÄ¼ÀzÀ ¸ÀÄªÁ¸À£É0iÀÄ ¸ÀÄUÀAzsÀzÀ
वास्तवीक: ªÁ¸ÀÛ«PÀªÁzÀ ¤dªÁzÀ ¢lªÁzÀ ¸ÀºÀdªÁzÀ AiÀÄxÁxÀðzÀ
विकपाच्यो: ªÀiÁgÀÄªÀ ªÀiÁgÁlQÌgÀÄªÀ ªÀiÁgÀ°PÉÌ_ElÖ
विकल्पी: LaÒPÀ PÀqÁØAiÀÄªÀ®èzÀ
विकसीत: C©üªÀÈ¢ÞºÉÆA¢zÀ «PÁ¸ÀºÉÆA¢zÀ
विकृत: PÉlÖ PÀÄgÀÆ¥ÀzÀ DPÁgÀUÉlÖ «PÀÈvÀªÁzÀ
विक्रेच्यो: ªÀiÁgÀÄªÀ ªÀiÁgÁlQÌgÀÄªÀ ªÀiÁgÀ°PÉÌ_ElÖ
विखाचें: «µÀAiÀÄÄPÀÛ
विखारी: «µÀAiÀÄÄPÀÛ
विखाळ: «µÀAiÀÄÄPÀÛ
विख्यात: «±Àé«SÁåvÀ «±Àé¥Àæ¹zÀÞ dUÀvï¥Àæ¹zÀÞ
विचलीत: C±ÁAvÀ ¸ÀAPÀlzÀ zÀÄBRzÀ UÉÆÃ½£À
विचार_करपाचें: UÀªÀÄ£ÁºÀð UÀªÀÄ¤ÃAiÀÄ «ZÁgÀtÂÃAiÀÄ D¯ÉÆÃa¸ÀvÀPÀÌ
विचार_केल्लें: «ZÁgÀ_ªÀiÁrzÀ D¯ÉÆÃa¹zÀ ¥ÀjÃQë¹zÀ
विचार_जाल्लें: «ZÁgÀ_ªÀiÁrzÀ D¯ÉÆÃa¹zÀ ¥ÀjÃQë¹zÀ
विचारशुन्य: G¥ÉÃPÉëAiÀÄ ¤®ðPÀë÷åzÀ UÀªÀÄ¤¸ÀzÀ ®Që¸ÀzÀ
विचारहीण: G¥ÉÃPÉëAiÀÄ ¤®ðPÀë÷åzÀ UÀªÀÄ¤¸ÀzÀ ®Që¸ÀzÀ
विचारी: UÀªÀÄ£ÁºÀð UÀªÀÄ¤ÃAiÀÄ «ZÁgÀtÂÃAiÀÄ D¯ÉÆÃa¸ÀvÀPÀÌ
विचारीक: «ZÁgÀAiÀÄÄPÀÛ «ªÉÃPÀzÀ ¸ÀªÀÄAd¸ÀªÁzÀ ¸ÀjAiÀiÁzÀ
विचित्र: C¸Áé¨sÁ«PÀ C¥ÁæPÀÈwPÀ C¸ÀºÀd C£ÉÊ¸ÀVðPÀ «avÀæ
विजयी: ¸À¥sÀ®ªÁzÀ ¥sÀ®PÁjAiÀiÁzÀ
विजातीय: «eÁwAiÀÄ ¥ÀgÀeÁwAiÀÄ ©ü£Àß_eÁwAiÀÄ ¨ÉÃgÉeÁwAiÀÄ
विज्ञानीक: ªÉÊeÁÕ¤PÀªÁzÀ
विटिल्लें: ¨ÉÃ¸ÀgÀªÁzÀ T£ÀßUÉÆAqÀ
विदेशी: «zÉÃ²ÃAiÀÄ ¥ÀgÀzÉÃ²ÃAiÀÄ C£ÀåzÉÃ²ÃAiÀÄ
विद्रूप: PÉlÖ PÀÄgÀÆ¥ÀzÀ DPÁgÀUÉlÖ «PÀÈvÀªÁzÀ
विद्वत्तापूर्ण: «zÀévÀÆàtð ¥ÁArvÀå¥ÀÇtð
विधिचें: PÁ£ÀÆ£ÀÄ§zÀÞªÁzÀ £ÁåAiÀÄ¸ÀªÀÄAd¸ÀªÁzÀ ¸ÀªÀÄAd¸ÀªÁzÀ vÀPÀð§zÀÞªÁzÀ
विनम्र: «£ÀªÀÄæ £ÀªÀÄæ
विपक्षी: «¥ÀQëÃAiÀÄ «gÉÆÃzsÀ_¥ÀQëÃAiÀÄ
विपक्षीय: «¥ÀQëÃAiÀÄ «gÉÆÃzsÀ_¥ÀQëÃAiÀÄ
विभागणी: «¨sÁdå «¨sÀd¤ÃAiÀÄ
विभागी: ¥ÁæzÉÃ²PÀ ¥ÁæAwÃ0iÀÄ ¸ÀÜ½Ã0iÀÄ ¸ÀÜ½ÃPÀ
विभुशीत: C®APÀÈvÀ C®APÁgÀ¨sÀÆ¬ÄµÀ× ¹AUÁgÀªÀÄAiÀÄ ±ÀÈAUÁgÀªÀÄAiÀÄ
विमूख: UÀÄj¬Ä®èzÀ GzÉÞÃ±À«®èzÀ
विरक्त: «gÁV «gÀPÀÛvÉ ªÉÊgÁUÀåzÀ
विरळ: «gÀ¼À
विरुद्ध: «gÀÄzÀÝªÁzÀ ¥ÀæwPÀÆ®ªÁzÀ «¥ÀAiÀÄð¸ÀÛªÁzÀ «gÀÄzÀÝªÁzÀ JzÀÄgÀÄ§zÀÄgÁzÀ C©üªÀÄÄRzÀ «gÀÄzÀÞ_§UÉ0iÀÄ ªÀåwjPÀÛªÁzÀ
विलक्षण: «avÀæ
विलासी: PÁªÀÄÄPÀ D±É§ÄgÀÄPÀ «¯Á¹ M0iÀiÁågÀzÀ
विवादास्पद: «ªÁzÁ¸ÀàzÀ «ªÁzÀPÉÌqÉAiÀiÁzÀ «ªÁzÀPÉÌ_UÀÄjAiÀiÁzÀ
विवाहीत: «ªÁ»vÀ ªÀÄzÀÄªÉAiÀiÁzÀ ®UÀßªÁzÀ
विवीध: C£ÉÃPÀ C£ÉÃPÁ£ÉÃPÀ
विवेकी: «ªÉÃZÀ£Á±ÀQÛAiÀÄÄ¼Àî «ªÉÃPÀzÀ vÀPÀð±ÀQÛAiÀÄÄ¼Àî ¥ÀjeÁÕ£ÀªÀÅ¼Àî
विशाचें: «µÀAiÀÄÄPÀÛ
विशारी: «µÀAiÀÄÄPÀÛ
विशाळ: «±Á®ªÁzÀ §ÄæºÀvÁÛzÀ CUÁzsÀªÁzÀ «¸ÁÛgÀªÁzÀ
विशाळकाय: ¸ÀÆÜ®PÁAiÀÄ ªÀÄºÁPÁAiÀÄzÀ
विशीं: ¸ÀA§A¢¹zÀ £ÀAlÄ¼Àî
विशेश: «²µÀ×
विश्वविजेतो: «±Àé«eÉÃvÀ
विश्वासघातकी: «±Áé¸ÀWÁvÀÄPÀvÀ£ÀzÀ ªÀAZÀ£É0iÀÄ zÉÆæÃºÀzÀ £ÀA©PÉ¬Ä®èzÀ ªÀZÀ£À¨sÀæµÀÖ
विश्वासी: «±Áé¸ÀªÀÅ¼Àî £ÀA©UÀ¸ÀÛ ¥ÀæªÀiÁtÂPÀªÁzÀ
विसरिल्लें: ªÀÄgÉvÀ ªÀÄgÉvÀÄ_ºÉÆÃzÀ
विस्कळीत: CªÀåªÀ¹ÜvÀ
विस्तीर्ण: ªÁå¥ÀPÀªÁzÀ «¸ÁÛgÀªÁzÀ
विस्वासू: £ÀA©UÀ¸ÀÛ «±Àé¸À¤ÃAiÀÄ «±Áé¸À¥ÁvÀæ
वीस: E¥ÀàvÀÄÛ 20
वेंचिल्ली: ¤AiÀÄÄPÀÛ ¤AiÀÄ«Ä¸Àà®àlÖ £ÉÃ«Ä¸À®àlÖ
वेंचिल्लें: DAiÉÄÌAiÀiÁzÀ Dj¹zÀ
वेगळी: C¸Áé¨sÁ«PÀ C¥ÁæPÀÈwPÀ C¸ÀºÀd C£ÉÊ¸ÀVðPÀ
वेगळें: «gÀÄzÀÝªÁzÀ ¥ÀæwPÀÆ®ªÁzÀ «¥ÀAiÀÄð¸ÀÛªÁzÀ
वेगहीण: ¸ÀÜVvÀUÉÆAqÀ ¤µÉÌçAiÉÄUÉÆAqÀ ¤±ÉÑÃµÀÖUÉÆAqÀ
वेगाचे: ¥Àæ§®ªÁzÀ
वेगाचें: ZÀ®£À²Ã® UÀw²Ã® dUÀ¼ÀUÀAn G¥ÀzÀæ«
वेगान: ªÉÃUÀ ¨ÉÃUÀ ²ÃWÀæ
वेळार: ¸ÀªÀÄAiÉÆÃavÀ PÁ¯ÉÆÃavÀ ¸ÀPÁ®zÀ
वेवस्थीत: ¸ÀÄªÀåªÀ¹ÜvÀ ¸ÀÄ¸ÀAWÀnvÀªÁzÀ ¸ÀÄªÀåªÀ¹ÜvÀªÁzÀ M¥ÀàªÁzÀ NgÀtªÁzÀ CZÀÄÑPÀmÁÖzÀ ¤AiÀÄªÀÄ§zÀÞ
वेव्हारी: ªÀåªÀºÁgÀ_eÁÕ£À ¯ËQPÀ_«ªÉÃPÀªÀÅ¼Àî PÀlÄÖ¤mÁÖzÀ ©V0iÀiÁzÀ ¤µÀÄ×gÀ PÀgÁgÀÄªÀPÁÌzÀ
वेश्यागामी: ªÉÃ±Éå0iÀÄ£ÀÄß_ElÄÖPÉÆAqÀ ªÉÃ±Áå¸ÀºÀªÁ¹
वेसनी: zÀÄªÀðå¸À¤
वैचारीक: «ZÁgÀAiÀÄÄPÀÛ «ªÉÃPÀzÀ ¸ÀªÀÄAd¸ÀªÁzÀ ¸ÀjAiÀiÁzÀ
वैतनीक: ªÉÃvÀ£À_¥ÀqÉ0iÀÄÄªÀªÀ ªÉÃvÀ£ÀUÁæ» ªÉÃvÀ£ÀzÁ¬Ä
वैयक्तीक: ªÉÊAiÀÄQÛPÀ ªÀåQÛUÀvÀ ¸ÀéAvÀzÀ
व्यक्त: C©üªÀåPÀÛªÁzÀ ¥ÀæPÀnvÀ eÁ»gÁzÀ ¥ÀæPÀlUÉÆAqÀ
व्यक्तीगत: ªÉÊAiÀÄQÛPÀ ªÀåQÛUÀvÀ ¸ÀéAvÀzÀ
व्यभिचारी: ªÀå©üZÁjAiÀiÁzÀ ªÀå©üZÁjtÂ ºÁzÀgÀVwÛ eÁgÉ ªÉÃµÉå ¸ÀÆ¼É ¥ÁvÀgÀzÀªÀ¼ÀÄ
व्यापक: ªÁå¥ÀPÀªÁzÀ «¸ÁÛgÀªÁzÀ
व्हड: «±Á®ªÁzÀ §ÄæºÀvÁÛzÀ CUÁzsÀªÁzÀ «¸ÁÛgÀªÁzÀ
व्हड-मनाचो: GzÁj «±Á®_ºÀÈzÀ¬Ä zÉÆqÀØ_ªÀÄ£À¸ÀÄì zsÁgÁ¼À_ºÀÈzÀ¬Ä
व्हड_आंकडो: §ºÀÄ¸ÀASÁåvÀ §ºÀÄ¸ÀASÁå
व्हड_काळजाचो: GzÁj «±Á®_ºÀÈzÀ¬Ä zÉÆqÀØ_ªÀÄ£À¸ÀÄì zsÁgÁ¼À_ºÀÈzÀ¬Ä
व्हांवतें: ºÀjAiÀÄÄªÀ ¥ÀæªÀ»¸ÀÄªÀ
व्हांवपी: ºÀjAiÀÄÄªÀ ¥ÀæªÀ»¸ÀÄªÀ
शंबरावें: £ÀÆgÀ£É £ÀÆgÀÄ ±ÀvÀ 100
शत्रुहीण: CeÁvÀ±ÀvÀÄæ ±ÀvÀÄæUÀ½®èzÀ «gÉÆÃ¢üUÀ½®èzÀ
शब्दाचें: ±Á©ÝPÀ ±À§ÝUÀ¼À ªÀiÁvÀÄUÀ¼À
शरण_आयिल्लो: ±ÀgÀuÁUÀvÀ
शरणागत: ±ÀgÀuÁUÀvÀ
शरीरहीण: C±ÀjÃgÀ CªÀÄÆvÀð
शर्मेची: £ÁaPÉUÉÃr£À CªÀªÀiÁ£ÀzÀ vÀ¯ÉvÀVÎ¸ÀÄªÀAxÀ ºÉ¸ÀgÀÄ_PÉqÀÄªÀAxÀ
शस्त्रधारी: ¸À±À¸ÀÛç ±À¸ÁÛçzsÁj
शांत: ¸ËªÀÄå_¸Àé¨sÁªÀzÀ vÁ¼ÉäAiÀÄ ±ÁAvÀ_¸Àé¨sÁªÀzÀ ¸ËªÀÄå ¸ÁzsÀÄ ±ÁAvÀ ªÀÄÈzsÀÄ ªÉÄvÀÛ£ÉAiÀÄ ±ÁAvÀªÁzÀ ¤±À§ÝªÁzÀ ¤±ÀÑ®ªÁzÀ ¤±ÀÑ® ¸ÀÛ§Þ CZÀ® ¥Àæ±ÁAvÀªÁzÀ ¹nÖgÀzÀ PÉÆÃ¥À«gÀzÀ PÉÆæÃzsÀ«®èzÀ ±ÁAvÀ
शाखा: mÉÆAUÉAiÉÆqÉzÀ gÉA¨ÉAiÉÆqÉzÀ ±ÁSÉAiÀÄÄPÀÛ G¥À_«¨sÁUÀzÀ
शाणो: zÀÆgÀzÀ²ðvÀé
शापोती: PÀqÀÄ_zsÉÊAiÀÄðzÀ JAmÉzÉAiÀÄ ¤¨sÀðAiÀÄzÀ zsÀÈµÀÖ
शाब्दीक: ±Á©ÝPÀ ±À§ÝUÀ¼À ªÀiÁvÀÄUÀ¼À
शारांतले: £ÀUÀjUÀ £ÀUÀgÀ_ªÁ¹ ¥ÀlÖt_ªÁ¹
शारिरीक: fÃ«vÀ ±ÀjÃgÀªÀÅ¼Àî ªÉÄÊAiÀÄÄ¼Àî
शारी: £ÀUÀjUÀ £ÀUÀgÀ_ªÁ¹ ¥ÀlÖt_ªÁ¹
शाश्वत: ±Á±ÀévÀªÁzÀ PÁ¯ÁwÃvÀªÁzÀ
शास्वत: C½¸À¯ÁUÀzÀ £Á±ÀªÁUÀ¯ÁgÀzÀ
शिंगां_नाशिल्लें: PÉÆÃr®èzÀ PÉÆA©®èzÀ
शिंगाबगरचें: PÉÆÃr®èzÀ PÉÆA©®èzÀ
शिंदुरी: PÉÃ¸ÀjÃ0iÀÄ
शिंपडिल्लें: ºÀgÀrgÀÄªÀ ZÀzÀÄjgÀÄªÀ ZÉ¯Áè¦°èAiÀiÁVgÀÄªÀ
शिंपिल्लें: ¤ÃgÀÄ_ºÁ¬Ä¹zÀ ¤ÃgÀÄ_ZÀÄªÀÄÄQ¹zÀ ¤ÃgÉgÀazÀ
शिंयाळें: ZÀ½UÁ®
शिटूक: zÀÆgÀzÀ²ðvÀé
शितळ: vÀtÚV£À vÀtÚVgÀÄªÀ vÀtÚ£ÉAiÀÄ ²ÃvÀ® ±ÁAvÀ
शिमा_रक्षक: UÀr_gÀPÀëPÀgÀÄ UÀr_PÁªÀ®ÄUÁgÀgÀÄ
शिमांकीत: ¹ÃªÀiÁgÉÃSÉ
शिमीत: ¥Àj«ÄvÀ ¹Ã«ÄvÀ
शिल्लक: ¨ÁQ ²®ÄÌ ±ÉÃµÀ
शिस्त_नाशिल्लो: CAPÉ¬Ä®èzÀ ºÀvÉÆÃn¬Ä®èzÀ CwgÉÃPÀzÀ ºÁ¼ÀvÀ«®èzÀ ¸ÀAAiÀÄªÀÄgÀ»vÀ
शिस्तीची: ²¹Û£À jÃwAiÀÄ
शींगां_आशिल्लें: PÉÆA§Ä¼Àî PÉÆÃqÀÄUÀ¼ÀÄ¼Àî MgÀ¸ÀÄ¼Àî
शीत: ²ÃvÀ®
शीम_रक्षक: UÀr_gÀPÀëPÀgÀÄ UÀr_PÁªÀ®ÄUÁgÀgÀÄ
शीलवान: ¸ÀZÁÑjvÀæ ¥ÁæªÀiÁtÂPÀ ¸ÀvÀåªÀAvÀgÁzÀ
शुद्ध: ±ÀÄzÀÞ CZÀÑ C¥Ààl ¥ÀjµÀÌj¹zÀ ¸ÀA¸ÀÌj¹zÀ ±ÀÄzÀÞUÉÆ½¹zÀ
शेणलेलो: PÉlÖzÁj»rzÀ zÁjUÉlÖ C¥ÀªÀiÁVðAiÀiÁzÀ ¥ÀxÀ¨sÀæµÀÖ PÀÄªÀiÁVð zÀÄgÁZÁj
शेणिल्लो: PÉlÖzÁj»rzÀ zÁjUÉlÖ C¥ÀªÀiÁVðAiÀiÁzÀ ¥ÀxÀ¨sÀæµÀÖ PÀÄªÀiÁVð zÀÄgÁZÁj
शेष: ¨ÁQ ²®ÄÌ ±ÉÃµÀ
शोकहीण: ±ÉÆÃPÀ«gÀzÀ zÀÄBR«®èzÀ
शौकीन: «¯Á¹ M0iÀiÁågÀzÀ
श्रवणीय: PÉÃ¼À§®è_(?) PÉÃ½¸ÀÄªÀ PÉÃ¼À§ºÀÄzÁzÀ ±ÀæªÀå ±ÀæªÀtUÉÆÃZÀgÀ
संकटग्रस्त: ¸ÀAPÀlUÉÆAqÀ zÀÄBRUÉÆAqÀ
संकटनाशक: ¸ÀAPÀl_¤ªÁgÀPÀ zÀÄBR_¤ªÁgÀPÀ
संकटनाशी: ¸ÀAPÀl_¤ªÁgÀPÀ zÀÄBR_¤ªÁgÀPÀ
संकटमय: zÀÄBRªÀÄ0iÀÄ ¸ÀAPÀlPÀgÀ
संकटाचें: zÀÄBRªÀÄ0iÀÄ ¸ÀAPÀlPÀgÀ
संकलीत: ¸ÀAUÀæ»vÀ
संगणकाचें: UÀtPÀAiÀÄAvÀæzÀ PÀA¥ÀÇålj£À
संगणकी: UÀtPÀAiÀÄAvÀæzÀ PÀA¥ÀÇålj£À
संग्रहीत: ¸ÀAUÀæ»vÀ
संतुश्ट: ¸ÀAvÀÄµÀÖ£ÁVgÀÄªÀªÀ vÀÈ¥ÀÛ£ÁVgÀÄªÀªÀ vÁ¼Éä¬ÄA¢gÀÄªÀªÀ
संबंदीं: ¸ÀA§A¢¹zÀ £ÀAlÄ¼Àî
संबंदीत: ¸ÀA§A¢ü¹zÀ ¸ÀA§AzsÀªÀÅ¼Àî ¸ÀA§A¢üvÀ
संबोधक: DºÁé¤vÀ
संवसार_जिखपी: «±Àé«eÉÃvÀ
संवसारीक: L»PÀ ¯ËQPÀªÁzÀ ¥Áæ¥ÀAaPÀªÁzÀ
संवेदनशीळ: s¸ÀAªÉÃzÀ£Á²Ã®
संवेदनाहारी: JZÀÑgÀ«®èzÀ ¸ÀAªÉÃzÀ£À_gÀ»vÀ
संशयी: ¸ÀAzÉÃºÁ¸ÀàzÀ ¸ÀA¢UÀÞªÁzÀ C£ÀÄªÀiÁ£À C¤²ÑvÀ wÃªÀiÁð£ÀªÁUÀzÀ RavÀ¥ÀqÀzÀ
संशोधक: PÀAqÀÄ»rzÀªÀ D«µÁÌgÀPÀ ±ÉÆÃzsÀPÀ
सकयलो: PÉ¼ÀV£À vÀUÁÎzÀ PÀÄëzÀæ_(?)
सकलें: £ÀUÀtå
सक्तीचें: C¤ªÁAiÀÄð C¥ÀjºÁAiÀÄð
सक्रीय: Qæ0iÀiÁ²Ã® ¸ÀQæ0iÀÄ GzÉÆåÃUÀ²Ã® PÁ0iÉÆðÃ£ÀÄäR
सक्षम: PÀëªÀÄvÉ¬ÄgÀÄªÀ ±ÀQÛ±Á°AiÀiÁzÀ AiÉÆÃUÀåvÉ¬ÄgÀÄªÀ
सख्खें: ¸ÀºÉÆÃzÀgÀ
सगल्या_गुणांनी_भरिल्लो: ¸ÀªÀðUÀÄt_¸ÀA¥À£ÀßªÁzÀ ¸ÀªÀðUÀÄtÂAiÀiÁzÀ
सगल्यांक_खबर_आशिल्लें: dUÀeÁÓ»ÃgÁzÀ dUÀwÛUÉÃ_w½zÀ
सच्चरित्री: ¸ÀZÁÑjvÀæ ¥ÁæªÀiÁtÂPÀ ¸ÀvÀåªÀAvÀgÁzÀ
सजिल्लो: C®APÀÈvÀ ±ÉÆÃ©üvÀ ¨sÀÆ¶vÀ CAzÀUÉÆ½¹zÀ
सज्जन: ¸ÀdÓ£À M¼ÉîAiÀÄ ¸ÀZÁÑjvÀæ÷åªÀAvÀ ²Ã®ªÀAvÀ
सतरा: ºÀ¢£ÉÃ¼ÀÄ ºÀ¢£ÉÃ¼À£ÉAiÀÄ 17
सतर्क: CjªÀÅ¼Àî ¥ÀæeÉß÷åAiÀÄÄ¼Àî w¼ÀÄªÀ½PÉAiÀÄÄ¼Àî
सत्कर्मी: ¸ÀvÀÌ«Äð
सत्तर: J¥ÀàvÀÄÛ J¥ÀàvÀÛ£ÉAiÀÄ 70
सदां__खातीरचें: C½¸À¯ÁUÀzÀ £Á±ÀªÁUÀ¯ÁgÀzÀ
सदाचरणी: ¸ÀZÁÑjvÀæ ¥ÁæªÀiÁtÂPÀ ¸ÀvÀåªÀAvÀgÁzÀ
सद्चरित्री: ¸ÀZÁÑjvÀæ ¥ÁæªÀiÁtÂPÀ ¸ÀvÀåªÀAvÀgÁzÀ
सद्वेव्हारी: ¸ÀzïªÀåªÀºÁj(?)
सनातन: ±Á±ÀévÀªÁzÀ PÁ¯ÁwÃvÀªÁzÀ
सभावीक: ¸Áé¨sÁ«PÀ ¸Áé¨sÁªÀvÀºÀ
सम: CAvÀºÀ CzÀgÀAvÉ
समकालीन: ¸ÀªÀÄAiÀÄPÉÌ_¸ÀjAiÀiÁV
समजिकायचें: vÀPÀÄÌzÁzÀ ºÉÆA¢PÉÆ¼ÀÄîªÀ M¥ÀÅöàªÀ C£ÀÄUÀÄtªÁzÀ ¸ÀªÀÄAd¸ÀªÁzÀ C£ÀÄgÀÆ¥ÀªÁzÀ
समजूतदार: «ªÉÃZÀ£Á±ÀQÛAiÀÄÄ¼Àî «ªÉÃPÀzÀ vÀPÀð±ÀQÛAiÀÄÄ¼Àî ¥ÀjeÁÕ£ÀªÀÅ¼Àî
समजूतदारपणाचें: vÀPÀÄÌzÁzÀ ºÉÆA¢PÉÆ¼ÀÄîªÀ M¥ÀÅöàªÀ C£ÀÄUÀÄtªÁzÀ ¸ÀªÀÄAd¸ÀªÁzÀ C£ÀÄgÀÆ¥ÀªÁzÀ
समरुपी: ¥ÀæwgÀÆ¥À
समाजीक: ¸ÁªÀiÁfPÀ
समाधानी: ¸ÀªÀiÁzsÁ¤vÀ ¥ÀjºÀj¸À§ºÀÄzÁzÀ ¥ÀjºÁAiÀÄð §UÉºÀj¸À§ºÀÄzÁzÀ
समान: CAvÀºÀ CzÀgÀAvÉ
समाप्त: ªÀÄÄPÁÛAiÀÄ ¸ÀªÀiÁ¦Û CAvÀå
समाही: CzÀðªÁ¶ðPÀ CgÉªÁ¶ðPÀ
समृद्ध: ¸ÀªÀÄÈzÀÞ ¸ÀA¥À£Àß
सम्मानीत: ¸À£Áä¤vÀ UËgÀªÀ¨Ád£À_(?)
सम्राट: ZÀPÀæªÀwð KPÀZÀPÁæ¢ü¥Àw
सय__केल्ली: ºÀ¸ÁÛPÀëgÀ«gÀÄªÀ ¸À»¬ÄgÀÄªÀ PÉÊ§gÀºÀ«gÀÄªÀ
सरकटें: ¸ÀjÃ¸ÀÈ¥ÀzÀAvÀºÀ ºÀjzÁqÀÄªÀAvÀºÀ vÉªÀ¼ÀÄªÀAvÀºÀ
सरपटें: ¸ÀjÃ¸ÀÈ¥ÀzÀAvÀºÀ ºÀjzÁqÀÄªÀAvÀºÀ vÉªÀ¼ÀÄªÀAvÀºÀ
सरळ: ¸ÀgÁUÀªÁV vÉÆqÀQ®èzÀ QèµÀÖªÀ®èzÀ (?) ¸Áé¨sÁ«PÀ ¸ÀºÀd £ÉÊd ¥ÁæPÀÈwPÀ £ÉÊ¸ÀVðPÀ UÀæ»¸À§®è CjAiÀÄ§®è w½AiÀÄ§®è C£ÀÄPÀÆ®PÀgÀªÁzÀ ¸ËPÀAiÀÄðªÀÅ¼Àî vÀPÀÄÌzÁzÀ
सरींचें: ¸À«ÄÃ¥ÀzÀ ºÀwÛgÀzÀ
सर्वगुणी: ¸ÀªÀðUÀÄt_¸ÀA¥À£ÀßªÁzÀ ¸ÀªÀðUÀÄtÂAiÀiÁzÀ
सर्वगूणसंपन्न: ¸ÀªÀðUÀÄt_¸ÀA¥À£ÀßªÁzÀ ¸ÀªÀðUÀÄtÂAiÀiÁzÀ
सर्वश्रेश्ट: GvÀÌöÈµÀ× GvÀÛªÀÄ ±ÉæÃµÀ×ªÁzÀ
सळसळीत: ©¹©¹0iÀiÁzÀ ¸ÀÄqÀÄwÛgÀÄªÀ zÀ»¸ÀÄwÛgÀÄªÀ
सशस्त्र: ¸À±À¸ÀÛç ±À¸ÁÛçzsÁj
सस्तन: dgÁAiÀÄÄd UÀ¨sÀðd
सहज: ¸Áé¨sÁ«PÀ ¸ÀºÀd £ÉÊd ¥ÁæPÀÈwPÀ £ÉÊ¸ÀVðPÀ C£ÀÄPÀÆ®PÀgÀªÁzÀ ¸ËPÀAiÀÄðªÀÅ¼Àî vÀPÀÄÌzÁzÀ
सहन_करपी: vÁ¼Éä0iÀÄ ¸ÉÊgÀuÉ0iÀÄÄ¼Àî ¸À»µÀÄÚ
सांगपा_सारकी: vÀ¯ÉºÀgÀmÉ UÉÆqÀÄØºÀgÀmÉ
सांगि_सारकी: vÀ¯ÉºÀgÀmÉ UÉÆqÀÄØºÀgÀmÉ
सांचिल्लें: ¤AvÀ ¸ÀÜVvÀ ¹ÜgÀ
सांठिल्लें: ¤AvÀ ¸ÀÜVvÀ ¹ÜgÀ
सांसठ: CgÀªÀvÁÛgÀÄ
साक्षात: ªÉÄÊzÉ¼ÉzÀ ªÉÄÊªÉvÀÛ ¸ÁPÁgÀ ªÉÄÊzÁ½zÀ
साक्षिदार: ¥ÀævÀåPÀëzÀ²ð ¥ÀævÀåPÀë¸ÁQëzÁgÀ
साठ: CgÀªÀvÀÄÛ 60
सादारण: £ÀUÀtå ¸ÁªÀiÁ£ÀåªÁzÀ ¸ÁzsÁgÀtªÁzÀ ªÀiÁªÀÄÆ°£À
सादें: £ÀUÀtå C£ÀÄPÀÆ®PÀgÀªÁzÀ ¸ËPÀAiÀÄðªÀÅ¼Àî vÀPÀÄÌzÁzÀ
साधवी: ¸ÀZÁÑjvÀæ ¥ÁæªÀiÁtÂPÀ ¸ÀvÀåªÀAvÀgÁzÀ
साध्य: ªÁ¹ªÀiÁqÀ§ºÀÄzÁzÀ UÀÄt¥Àr¸À§ºÀÄzÁzÀ ±ÀªÀÄ£À¸ÁzÀå ¥ÀjºÁgÀ¸ÁzÀå
सानुलें: ¸ÀtÚ_PÀgÀÄ ¥ÀÅmÁtÂ_ªÀÄUÀÄ
साफ: ¥ÀjµÀÌj¹zÀ ¸ÀA¸ÀÌj¹zÀ ±ÀÄzÀÞUÉÆ½¹zÀ
सामकें_गरजेचें: CvÀåUÀvÀå CvÀåªÀ±ÀåPÀ
सामको: ¥ÀPÁÌ C¥ÀàlªÁzÀ ¨ÉgÉPÉ¬Ä®èzÀ
सामको_उणो: CvÀå®àªÁzÀ ¸ÁPÀ¶ÖgÀzÀ
सामान्य: ¸ÁªÀiÁ£ÀåªÁzÀ ¸ÁzsÁgÀtªÁzÀ ªÀiÁªÀÄÆ°£À ¸ÁªÀðd¤PÀ ¸ÁªÀÄÄzÁ¬ÄPÀ ¸ÁªÀÄÆ»PÀ
सामुहीक: ¸ÁªÀðd¤PÀ ¸ÁªÀÄÄzÁ¬ÄPÀ ¸ÁªÀÄÆ»PÀ
सारकें: ¸ÀÄªÀåªÀ¹ÜvÀªÁzÀ M¥ÀàªÁzÀ NgÀtªÁzÀ CZÀÄÑPÀmÁÖzÀ
सारको: ¥ÀPÁÌ C¥ÀàlªÁzÀ ¨ÉgÉPÉ¬Ä®èzÀ CAvÀºÀ CzÀgÀAvÉ
सार्वभौमीक: «±ÀéªÁå¦AiÀiÁzÀ «±ÁévÀäPÀ dUÀzÁé÷å¥ÀPÀ
सावळेचें: £ÉgÀ¼ÀÄPÉÆqÀÄªÀ
सासणा_खातीरचें: C½¸À¯ÁUÀzÀ £Á±ÀªÁUÀ¯ÁgÀzÀ
सुंदर: CzÀÄãvÀ ¢ªÀå ±ÉÆÃ¨sÁAiÀÄªÀiÁ£À
सुकडें: §qÀPÀ®Ä_zÉÃºÀzÀ J®Ä©£ÀAxÀ ªÀÄÆ¼ÉAiÀÄAxÀ_zÉÃºÀzÀ
सुकिल्लें: MtVzÀ
सुकुमार: ¸ÀÄPÀÄªÀiÁgÀ£ÀAvÀºÀ £ÁdÆPÁzÀ £À0iÀÄªÁzÀ
सुक्षीम: ¸ÀÆPÀë÷ävÀªÀÄ ¸ÀÆPÀë÷ä ¸ÀuÁÚw¸ÀtÚ PÀÄëzÀæ
सुक्ष्म: ¸ÀÆPÀë÷ävÀªÀÄ
सुखदिणी: »vÀªÁzÀ ¸ÀÄRPÀgÀªÁzÀ ¸ÀAvÉÆÃµÀPÀgÀªÁzÀ
सुखाची: »vÀªÁzÀ ¸ÀÄRPÀgÀªÁzÀ ¸ÀAvÉÆÃµÀPÀgÀªÁzÀ
सुखाळ: »vÀªÁzÀ ¸ÀÄRPÀgÀªÁzÀ ¸ÀAvÉÆÃµÀPÀgÀªÁzÀ
सुगंधीत: PÀA¦£À ¥ÀjªÀÄ¼ÀzÀ ¸ÀÄªÁ¸À£É0iÀÄ ¸ÀÄUÀAzsÀzÀ
सुचरित्री: ¸ÀZÁÑjvÀæ ¥ÁæªÀiÁtÂPÀ ¸ÀvÀåªÀAvÀgÁzÀ
सुटसुटीत: ¸ÀÄAzÀgÀªÁzÀ ªÀÄ£ÉÆÃºÀgÀªÁzÀ_(?)
सुती: £ÀÆ°£À
सुदारीत: ¥ÀjµÀÌöÈvÀ
सुपीक: ¥sÀ®ªÀvÁÛzÀ ºÀÄ®Ä¸ÁzÀ ¸ÀªÀÄÈzÀÞªÁzÀ vÀÄA§Ä_¥sÀ®zÀ
सुबेज: PÀqÀÄ_zsÉÊAiÀÄðzÀ JAmÉzÉAiÀÄ ¤¨sÀðAiÀÄzÀ zsÀÈµÀÖ
सुरक्षीत: gÀQëvÀ ¸ÀAgÀQëvÀ PÁ¦lÖ
सुरवातीचें: DgÀA¨sÀzÀ ¥ÁægÀA¨sÀzÀ ªÉÆzÀ°£À
सुरू_आशिल्लें: ZÀ°¸ÀÄwÛgÀÄªÀ ZÁ®£ÉAiÀÄ°ègÀÄªÀ
सुलक्षण: ¸ÀÄ®PÀët ¸ÉÆUÀ¸ÁzÀ ªÀÄÄzÁÝzÀ
सुलभ: ºÉÆÃUÀ§ºÀÄzÁzÀ £ÀqÉAiÀÄ§ºÀÄzÁzÀ ¸ÀÄ®¨sÀªÁV_¹UÀÄªÀ ¸ÀÄ®¨sÀªÁV_zÉÆgÉAiÀÄÄªÀ ¸ÀÄUÀªÀÄå ¸ÀÄ®¨sÀ®¨sÀå
सुवादाचें: ¸À«AiÀiÁzÀ gÀÄaAiÀiÁzÀ ¸ÁézÀAiÀÄÄPÀÛ
सुवादीक: ¸À«AiÀiÁzÀ gÀÄaAiÀiÁzÀ ¸ÁézÀAiÀÄÄPÀÛ gÀÄaPÀmÁÖzÀ gÀÄaPÀgÀªÁzÀ gÀÄaAiÀiÁzÀ ¸Áé¢µÀÖ ¸À«AiÀiÁzÀ
सुवार्थी: ¸Áéyð
सुवासहीण: ¸ÀÄªÁ¸À£É_EgÀzÀ ªÁ¸À£É¬Ä®èzÀ UÀAzsÀgÀ»vÀ
सुवासाचें: PÀA¦£À ¥ÀjªÀÄ¼ÀzÀ ¸ÀÄªÁ¸À£É0iÀÄ ¸ÀÄUÀAzsÀzÀ
सुवासीक: ¸ÀÄªÁ¸À£É0iÀÄÄ¼Àî ¸ÀÄUÀA¢ü ¥ÀjªÀÄ¼À0iÀÄÄPÀÛ UÀªÀÄUÀ«Ä¸ÀÄªÀ
सुसंस्कृत: GzÁgÀ ¥ÀæUÀw¥ÀgÀ ¥ÀÅgÉÆÃUÁ«Ä GzÁgÀªÁ¢
सुसेगाद: ±ÁAvÀªÁzÀ ¤±À§ÝªÁzÀ ¤±ÀÑ®ªÁzÀ
सूखदिणें: D£ÀAzÀPÀgÀ ¸ÀAvÉÆÃµÀPÀgÀ
सैमीक: £ÉÊ¸ÀVðPÀ ¥ÁæPÀÈwPÀ ¸Áé¨sÁ«PÀ ¸ÀºÀd £ÉÊd ¥ÁæPÀÈwPÀ £ÉÊ¸ÀVðPÀ
सोंपूंक_नाशिल्लें: C¥ÀÇtðªÁzÀ ¥ÀÇwð_ªÀÄÄVAiÀÄzÀ
सोंपे: ¸ÀÄ®¨sÀªÁV_¹UÀÄªÀ ¸ÀÄ®¨sÀªÁV_zÉÆgÉAiÀÄÄªÀ ¸ÀÄUÀªÀÄå ¸ÀÄ®¨sÀ®¨sÀå
सोंपें: ºÉÆÃUÀ§ºÀÄzÁzÀ £ÀqÉAiÀÄ§ºÀÄzÁzÀ UÀæ»¸À§®è CjAiÀÄ§®è w½AiÀÄ§®è C£ÀÄPÀÆ®PÀgÀªÁzÀ ¸ËPÀAiÀÄðªÀÅ¼Àî vÀPÀÄÌzÁzÀ
सोंपेपणाचें: C£ÀÄPÀÆ®PÀgÀªÁzÀ ¸ËPÀAiÀÄðªÀÅ¼Àî vÀPÀÄÌzÁzÀ
सोंशीक: vÁ¼Éä0iÀÄ ¸ÉÊgÀuÉ0iÀÄÄ¼Àî ¸À»µÀÄÚ
सोशीक: ¸ÀºÀ¤ÃAiÀÄ ¸ÀºÀå ¸À»¸À§ºÀÄzÁzÀ vÀqÉzÀÄPÉÆ¼Àî§ºÀÄzÁzÀ
सोसूंक_जायना_अशें: C¸ÀºÀåªÁzÀ vÁ¼À¯ÁUÀzÀ C¸ÀºÀ¤Ã0iÀÄ
सौम्य: ¸ËªÀÄå_¸Àé¨sÁªÀzÀ vÁ¼ÉäAiÀÄ ±ÁAvÀ_¸Àé¨sÁªÀzÀ
स्तुतीपाठक: ¥Àæ±ÀA¸ÀPÀ ¥Àæ±ÀA¸ÉAiÀÄ
स्थापणूक_करी_सारकें: ¸ÁÜ¥À£ÁAiÉÆÃUÀå ¸ÁÜ¥Àå ¸ÀA¸ÁÜ¥À¤ÃAiÀÄ
स्थापी_सारकें: ¸ÁÜ¥À£ÁAiÉÆÃUÀå ¸ÁÜ¥Àå ¸ÀA¸ÁÜ¥À¤ÃAiÀÄ
स्थापीत: s¸ÀA¸ÁÜ¦vÀ C¢üµÁ×¦vÀ
स्थालांतरीत: ¥ÀæªÁ¹ ¥ÉæÃPÀëPÀ_(?)
स्थावर: (?)
स्थीर: ¸ÀÜVvÀUÉÆAqÀ ¤µÉÌçAiÉÄUÉÆAqÀ ¤±ÉÑÃµÀÖUÉÆAqÀ (?)
स्नेही: ¸ÉßÃºÀªÀÄAiÀÄ ¸ÉßÃºÀ¥ÀÇªÀðPÀ
स्पश्टवादी: ¤µÀÄ×j ¤zÁðQëtåzÀ £ÉÃgÁ£ÉÃgÁ
स्फूर्तहीण: ¤gÀÄvÁìºÀzÀ GzÁ¹Ã£ÀzÀ CgÉªÀÄ£À¹ì£À
स्फूर्तीदायक: ¸ÀÆàwðzÁAiÀÄPÀ
स्वच्छ: ¥ÀjµÀÌj¹zÀ ¸ÀA¸ÀÌj¹zÀ ±ÀÄzÀÞUÉÆ½¹zÀ
स्वजातीय: ¸ÀéeÁwÃAiÀÄ ¸ÀeÁwÃAiÀÄ MAzÉÃ_ªÀUÀðzÀ MAzÉÃ_¥ÀAUÀqÀzÀ
स्वतंत्र: ¸ÀévÀAvÀæ C¢üÃ£ÀªÀ®èzÀ C¥ÀgÁ¢üÃ£À ¸Áé¢ü¥ÀvÀåzÀ
स्वताचें: SÁ¸ÀV vÀ£ÀßzÀÄ ¸ÀéAvÀzÀ
स्वदेशी: zÉÃ²ÃAiÀÄ ¸ÀézÉÃ²ÃAiÀÄ zÉÃ¹
स्वपक्षी: ¸Àé¥ÀQëÃAiÀÄ ¸ÀéQÃAiÀÄ ¸Àé¥ÀgÀ
स्वभावीक: ¸Áé¨sÁ«PÀ ¸Áé¨sÁªÀvÀºÀ
स्वशिक्षीत: ¸Àé²QëvÀ
स्वाभावीक: ¸Áé¨sÁ«PÀ ¸ÀºÀd £ÉÊd ¥ÁæPÀÈwPÀ £ÉÊ¸ÀVðPÀ
स्वाभिमानहीण: ¸Áé©üªÀiÁ£À«®èzÀ DvÀäUËgÀªÀ«®èzÀªÀ
स्वाभिमानी: ¸Áé©üªÀiÁ¤ DvÁä©üªÀiÁ¤
स्वावलंबी: ¸ÁéªÀ®A©_ªÀÄ»¼É ¸ÁéªÀ®A©_¹ÛçÃ
स्विकार_करी_सारकें: M¥Àà§ºÀÄzÁzÀ M¥ÀàvÀPÀÌ UÁæºÀå ¹éÃPÁAiÀÄð ¹éÃPÁgÀAiÉÆÃUÀå CAVPÁgÁºÀð
स्विकारपा_सारकें: M¥Àà§ºÀÄzÁzÀ M¥ÀàvÀPÀÌ UÁæºÀå ¹éÃPÁAiÀÄð ¹éÃPÁgÀAiÉÆÃUÀå CAVPÁgÁºÀð
स्विकारिल्ली: ¹éÃPÀÈvÀ M¦àvÀ ¹éÃPÁAiÀÄð M¥Àà§ºÀÄzÁzÀ M¥ÀàvÀPÀÌ ¹éÃPÁgÀ_AiÉÆÃUÀå CAVÃPÁgÁºÀð
स्विकारूंक_नाशिल्लें: C¹éÃPÀÈvÀ M¦àvÀªÁUÀzÀ ¸ÀªÀÄäw¬ÄgÀzÀ
स्विकृत: ¹éÃPÀÈvÀ M¦àvÀ C£ÀÄªÉÆÃ¢vÀ ¹éÃPÁAiÀÄð M¥Àà§ºÀÄzÁzÀ M¥ÀàvÀPÀÌ ¹éÃPÁgÀ_AiÉÆÃUÀå CAVÃPÁgÁºÀð
हजर: G¥À¹ÜvÀ ºÁdgÁzÀ
हट्टी: ºÀoÀªÁ¢ ºÀoÀªÀiÁj ºÀoÀªÀiÁjAiÀiÁzÀ ªÉÆAqÀvÀ£ÀzÀ
हरवें: ¨ÉÃ¬Ä¹gÀzÀ ¨ÉÃ¬Ä¹®èzÀ ºÀ¹0iÀiÁzÀ PÁ¬Ä¸ÀzÀ
हांस्यहीण: ºÁ¸Àå»Ã£À ºÁ¸ÀågÀ»vÀ
हाचे_सारको: EAvÀºÀ F_¥ÀæPÁgÀzÀ
हाडकुळें: C¹Ü¥ÀAdgÀzÀAvÉ ªÀÄÆ¼ÉAiÀÄAxÀ J®Ä©£ÀAxÀ §qÀPÀ®Ä_zÉÃºÀzÀ J®Ä©£ÀAxÀ ªÀÄÆ¼ÉAiÀÄAxÀ_zÉÃºÀzÀ
हाडांचें: J®Ä©£À ªÀÄÆ¼É0iÀÄ C¹Ü0iÀÄ
हाता_खालचें: PÉ¼ÀzÀeÉðAiÀÄ PÀrªÉÄzÀeÉðAiÀÄ
हारिल्लो: ¥ÀgÁfvÀ ¸ÉÆÃvÀÄºÉÆÃzÀ
हावेसाचें: GzÉÝÃ±À¥ÀÇªÀðPÀ G¢ÝµÀÖ GzÉÝÃ²¹zÀ
हिंसक: »A¸ÁZÁj »A¸ÀPÀ
हिवाळी: ZÀ½UÁ®
हुनहुनीत: ©¹©¹0iÀiÁzÀ ¸ÀÄqÀÄwÛgÀÄªÀ zÀ»¸ÀÄwÛgÀÄªÀ
हुशार: GvÀÛªÀÄ G£ÀßvÀ M¼Éî0iÀÄ ZÉ£ÁßzÀ ªÉÄÃ¯ÁzÀ
हुसक्यामेकळें: ¤gÁvÀAPÀ C¨sÀAiÀÄ
हुस्को: aAvÁPÁæAvÀ aAvÁUÀæ¸ÀÛ
हुस्क्याचें: aAvÁd£ÀPÀ UÀA©üÃgÀ ±ÉÆÃZÀ¤Ã0iÀÄ
हे_तरेचो: EAvÀºÀ F_¥ÀæPÁgÀzÀ
हे_सारको: EAvÀºÀ F_¥ÀæPÁgÀzÀ
हेडगें: C¯ÉªÀiÁj wgÀÄUÁqÀÄªÀªÀ C¯ÉAiÀÄÄªÀªÀ
हेर: EvÀgÀ ¨ÉÃgÉ ¥ÀgÀ C£Àå
हेरगिरीचें: UÀÆqsÁZÁjPÉ ¥ÀvÉÛÃzÁjPÉ ¨ÉÃºÀÄUÁjPÉ
होंवरेंत_रावपी: UÀÄºÁAvÀUÁð«ÄvÀ£À PÀAzÀgÀªÁ¹
