अंक: ¸ÀAaPÉ CAPÀ
अंक_दिणें: ªÀiË®åªÀiÁ¥À£À
अंक_दिवप: ªÀiË®åªÀiÁ¥À£À
अंगरक्षक: CAUÀgÀPÀëPÀ ªÉÄÊUÁªÀ®ÄUÁgÀ ¨ÉAUÁªÀ°UÀ
अंडकोश: CAqÀPÉÆÃ±À ªÀÈµÀt vÀgÀqÀÄ_(©Ãd)
अंडग्रंथी: CAqÀUÀæAy
अंत: ¸ÀªÀiÁ¦Û ªÀÄÄPÁÛAiÀÄ ¸ÀªÀiÁgÉÆÃ¥À CAvÀå Ew CAvÀå PÉÆ£É ¸ÀªÀiÁ¦Û
अंतरा_अवयव: zÉÃºÀzÀ_M¼ÁªÀAiÀÄªÀ zÉÃºÀzÀ_DAvÀjPÀ_CAUÀ
अंतरांग: zÉÃºÀzÀ_M¼ÁªÀAiÀÄªÀ zÉÃºÀzÀ_DAvÀjPÀ_CAUÀ
अंतरात्मो: CAvÀgÁvÀä CAvÀgÁ¼À M¼ÀªÀÄ£À¸ÀÄì
अंतराळ: DPÁ±À ¨Á£ÀÄ ¨ÁAzÀ¼À CA§gÀ CAvÀjPÀë UÀUÀ£À £À¨sÉÆÃªÀÄAqÀ®
अंतरीक्ष: DPÁ±À ¨Á£ÀÄ ¨ÁAzÀ¼À CA§gÀ CAvÀjPÀë UÀUÀ£À £À¨sÉÆÃªÀÄAqÀ®
अंतर्मन: CAvÀgÁvÀä CAvÀgÁ¼À M¼ÀªÀÄ£À¸ÀÄì
अंतस्करण: CAvÀgÁvÀä CAvÀgÁ¼À M¼ÀªÀÄ£À¸ÀÄì ªÀÄ£À¸ÀÄì avÀÛ UÀªÀÄ£À
अंदमान_निकोबार: CAqÀªÀiÁ£ï_¤PÉÆÃ¨Ágï CAqÀªÀiÁ£ï_¤PÉÆÃ¨Ágï_¢éÃ¥À
अंदाज: C£ÀÄªÀiÁ£À CAzÁdÄ HºÉ
अंधविश्वास: ªÀÄÆqsÀ£ÀA©PÉ CAzsÀ±ÀæzÉÞ
अंपायर: CA¥ÉÊgÀÄ wÃ¥ÀÅðUÁgÀ
अकरा: ºÀ£ÉÆßAzÀÄ
अकुशळटाय: C¥ÀjtÂvÀ CzÀPÀë÷å
अक्ष: CZÀÄÑ UÁrAiÀÄ_ªÉÆ¼É
अक्षर: CPÀëgÀ ªÀtð °¦ §gÀºÀ
अक्षरगणीत: ©ÃdUÀtÂvÀ
अक्षरमाळ: ªÀtðªÀiÁ¯É CPÀëgÀªÀiÁ¯É
अक्षरशैली: ªÀiÁvÀæPÀëgÀªÀiÁ¯É ªÀiÁvÁæ°¦ªÀiÁ¯É
अक्षांश_रेशा: CPÁëA±À CPÁëA±À_gÉÃSÉ
अखंडताय: ¤gÀAvÀgÀªÁV JqÉ©qÀzÉ
अग्नाशय: ªÉÄÃzÉÆÃfÃgÀPÀ_UÀæAy
अग्रभाग: ªÀÄÄA¨sÁUÀ ªÀÄÄAzÉ ªÉÆzÀ®¸ÁÜ£À
अचर्य: CZÀÑj ZÀªÀÄvÁÌgÀ «¸Àä0iÀÄ ¸ÉÆÃfUÀ PÀlÖZÀÑj ¤¨ÉâgÀUÀÄ «¸ÀäAiÀÄ PËvÀÄUÀ ¸ÉÆÃfUÀ ¨ÉPÀÌ¸À
अजाणपण: CdÕvÉ Cj«®è¢gÀÄ«PÉ CeÁÕ£À C¸ÀAªÉÃ¢vÀé
अजाप: EAzÀæeÁ® eÁzÀÆ «¸ÀäAiÀÄ PËvÀÄUÀ ¸ÉÆÃfUÀ ¨ÉPÀÌ¸À
अज्ञान: CeÁÕ£À C«zÁå ªÀiËqsÀå CeÁÕ£À w½«®è¢gÀÄªÀÅzÀÄ Cj«®è¢gÀÄªÀÅzÀÄ
अज्ञानपण: CdÕvÉ Cj«®è¢gÀÄ«PÉ CeÁÕ£À C¸ÀAªÉÃ¢vÀé
अटक: ¸ÉgÉ §AzsÀ£À PÉÊªÀ±À zÀ¸ÀÛVj PÉÊzÀÄ
अठरा: ºÀ¢£ÉAlÄ 18
अडचण: «dÕ CqÀZÀuÉ ¨sÁzÉ vÉÆAzÀgÉ aAvÉ PÀ¼ÀªÀ¼À ªÁåPÀÄ®
अडाणपण: ªÀiËqsÀå CeÁÕ£À w½«®è¢gÀÄªÀÅzÀÄ Cj«®è¢gÀÄªÀÅzÀÄ ªÀÄÆRðvÀ£À C«ªÉÃPÀ zÀqÀØvÀ£À
अडाणीपण: CeÁÕ£À C«zÁå
अड्डो: PÉÃAzÀæ PÉÃA¢æÃAiÀÄ_¸ÁÜ£À
अणभव: C£ÀÄ¨sÀªÀ
अणभवहीणटाय: C£À£ÀÄ¨sÀªÀ C£ÀÄ¨sÀªÀgÁ»vÀå C£ÀÄ¨sÀªÀ«®è¢gÀÄ«PÉ
अणू: ¥ÀgÀªÀiÁtÄ ClªÀiï
अतिक्रमण: CwPÀæªÀÄt G®èAWÀ£É J¯Éè«ÄÃgÀÄ CwPÀæªÀÄt G®èAWÀ£É
अतिताय: Cw±ÀAiÉÆÃQÛ GvÉàçÃPÉë
अतिथी_कक्ष: Cwy_UÀÈºÀ Cyw_PÉÆÃuÉ
अतिथीघर: Cwy_UÀÈºÀ Cyw_¤ªÁ¸À Cyw_¨sÀªÀ£À
अतिशयोक्ती: Cw±ÀAiÉÆÃQÛ GvÉàçÃPÉë
अतीत: PÀ¼ÉzÀ »AzÀt ¸ÀAzÀ UÀvÀ
अतृप्ती: CvÀÈ¦Û C¸ÀAvÀÈ¦Û C¸ÀªÀiÁzÁ£À
अत्तर: CvÀÛgÀÄ ¥À¤ßgÀÄ ªÁ¸À£É_JuÉÚ
अदमास: C£ÀÄªÀiÁ£À CAzÁdÄ HºÉ CAzÁdÄ JtÂPÉ UÀæºÀt
अदीकताय: CvÀå¢üPÀ C¢üPÀ
अधर्मीक_काम: ¥Á¥À_¥ÀÅtå
अधर्मीपण: CzsÁ«ÄðPÀvÉ £Á¹ÛPÀvÉ
अधार्मीकताय: CzsÁ«ÄðPÀvÉ £Á¹ÛPÀvÉ
अधिकताय: CvÀå¢üPÀ C¥Àj«ÄvÀvÉ ºÉÃgÀ¼ÀªÁVgÀÄ«PÉ «¥ÀÅ®vÉ ¥ÀÅµÀÌ®vÉ
अधिकार: C¢ü¥ÀvÀå MqÉvÀ£À ¸ÁéªÀÄå C¢üPÁgÀ
अधिकारिकी: C¢üPÁjUÀ¼ÀÄ_(?)
अधोगती: CzsÉÆÃUÀw ¥ÀvÀ£À CªÀ£Àw CzsÉÆÃUÀw
अध्ययन: CzÀåAiÀÄ£À eÁÕ£Ádð£É
अध्यादेश: ¤AiÀÄªÀiÁ£ÀÄ¸ÁgÀ «zsÁAiÀÄPÀ
अध्यापिका: ²PÀëQ UÀÄgÀÄªÀiÁvÉ CzÁå¥ÀQ
अनतिक्रमण: CwPÀæ«Ä¸À¢gÀÄªÀÅzÀÄ «Äw«ÄÃgÀ¢gÀÄªÀÅzÀÄ
अनाचार: zÀÄªÀðvÀð£É CAiÉÆÃUÀåªÀvÀð£É PÉlÖzÁV_£ÀqÉ¹PÉÆ¼ÀÄîªÀÅzÀÄ
अनावश्यकताय: C£ÁªÀ±ÀåPÀvÉ C£ÀÄ¥ÀAiÉÆÃVvÀ
अनासक्ती: C£Á¸ÀQÛ «gÀQÛ
अनित्सा: EµÀÖ«®è¢gÀÄ«PÉ ªÀÄ£À¹ì®è¢gÀÄ«PÉ M®èzÀ_ªÀÄ£À¹ì¤A¢gÀÄªÀÅzÀÄ
अनिपूणटाय: C¥ÀjtÂvÀ CzÀPÀë÷å
अनुकरण: C£ÀÄPÀgÀt
अनुकूल: C£ÀÄPÀÆ®_(?)
अनुक्रमणिका: ¸ÀÆa C£ÀÄPÀæªÀÄtÂPÉ
अनुपयोगिताय: C£ÁªÀ±ÀåPÀvÉ C£ÀÄ¥ÀAiÉÆÃVvÀ
अनुपलब्धताय: ¹UÀ¢gÀÄªÀÅzÀÄ zÉÆgÉAiÀÄ¢gÀÄªÀÅzÀÄ
अनुभव: C£ÀÄ¨sÀªÀ
अनुभुती: ¸ÀAªÉÃzÀ£É ¨sÁªÉÇÃzÉæÃPÀ
अनुयायी: C£ÀÄAiÀiÁ¬Ä C£ÀÄªÀwð C£ÀÄZÀgÀ ¥ÀjZÁgÀPÀ
अनुशासन: ²¸ÀÄÛ ¤0iÀÄªÀÄ¥Á®£É
अनुश्ठान: zsÀªÀÄð_PÀªÀÄð
अनैतिकताय: zÀÄµÀÖvÀ£À
अन्याय: C£ÁåAiÀÄ CzsÀªÀÄð
अपघात: zÀÄWÀðl£É
अपराधपूर्णताय: zÉÆÃµÀ¥ÀÇtð C¥ÀgÁ¢üvÀ
अपराधी: C¥ÀgÁ¢ü
अपर्याप्तताय: PÉÆgÀvÉ PÀrªÉÄ ¸ÁPÁUÀÄªÀµÀÄÖ_E®è¢gÀÄ«PÉ
अपवाद: C¥ÀªÁzÀ ºÉÆgÀvÀÄ «£Á¬Äw
अपव्यय: C¥ÀªÀåAiÀÄ zÀÄAzÀÄªÉZÀÑ
अपशब्द: ¨ÉÊUÀÄ¼À PÉlÖ_ªÀiÁvÀÄ §AiÀÄÄå«PÉ ¤AzÀ£É zÀÆµÀuÉ ¨ÉÊUÀ¼ÀÄ ±Á¥À ¤AzÉ C¥ÀzÀÞ
अपसारण_चिन्न: PÀÆqÀÄUÉgÉ "_-_"
अपात्रताय: CAiÉÆÃUÀåvÉ C£ÀºÀðvÉ C¸ÀªÀÄxÀð
अपूर्ण: CgÉeÁÕ£À C¥ÀÇtð_w¼ÀÄªÀ½PÉ
अपेक्षा: C¥ÉÃPÉë DPÁAPÉë
अप्रधानताय: C¢üÃ£ÀvÉ
अप्रवीणटाय: C¥ÀjtÂvÀ CzÀPÀë÷å
अप्रसिद्दी: CeÁÕvÀvÉ C¥Àæ¹zÀÞ ¨É¼ÀQUÉ_§gÀzÀ
अप्राथमीकताय: C¢üÃ£ÀvÉ
अप्राप्ती: ¹UÀzÀ zÉÆgÀPÀzÀ C®§å C¥Áæ¥ÀÛ
अप्रामाणीक: C«±Áé¹ £ÀA©UÀ¸ÀÜ£À®èzÀªÀ
अफीम: C¦ÃªÀÄÄ
अफू: C¦ÃªÀÄÄ
अभिनेतो: £Àl C©ü£À0iÀÄPÁgÀ PÀ¯Á«zÀ PÀ¯ÁPÁgÀ C©ü£ÉÃwæ
अभिमानशुन्यताय: ¤gÀ©üªÀiÁ¤ C©üªÀiÁ£À_»Ã£ÀvÉ
अभिमानहिणटाय: ¤gÀ©üªÀiÁ¤ C©üªÀiÁ£À_»Ã£ÀvÉ
अभिरूची: C©ügÀÄa D¸ÀQÛ M®ªÀÅ
अभ्यास: CzÀåAiÀÄ£À eÁÕ£Ádð£É C¨Áå¸À gÀÆrü
अभ्रो: DªÀgÀt ¯ÉÃ¥À ZÀªÀÄð ¥ÀgÉ ªÉÆÃ¯ÉÆ¢PÉ PÀªÀZÀ
अमंगळ: CªÀÄAUÀ® C¤µÀÖ C±ÀÄ¨sÀ PÉqÀÄPÀÄ
अमान्यताय: C¸ÀªÀÄäw M¦àvÀªÀ®èzÀ
अमिबा: C«ÄÃ§ KPÀPÉÆÃ±À_fÃ«
अरिश्ट: «dÕ CqÀZÀuÉ ¨sÁzÉ vÉÆAzÀgÉ
अरुणांचल: CgÀÄuÁZÀ®_¥ÀæzÉÃ±À CgÀÄuÁAZÀ®
अरुणाचल_प्रदेश: CgÀÄuÁZÀ®_¥ÀæzÉÃ±À CgÀÄuÁAZÀ®
अरूची: EµÀÖ«®è¢gÀÄ«PÉ ¸ÉÃgÀ¢gÀÄ«PÉ DUÀ¢gÀÄ«PÉ »r¸À¢gÀÄ«PÉ C¦æAiÀÄ CgÀÄa C¦æÃw
अरेरारी: wgÀ¸ÁÌgÀ C®èUÀ¼É
अर्ज: ¤ªÉÃzÀ£É PÉÆÃjPÉ ªÀÄ£À« ¥ÁæxÀð£É CºÀªÁ®Ä «£ÀAw
अर्दचंद्रीम: CzsÀðZÀAzÀæ CgÉ_ZÀAzÀæ
अर्दवट: CgÉeÁÕ£À C¥ÀÇtð_w¼ÀÄªÀ½PÉ
अर्दविराम: CzsÀð«gÁªÀÄ._CzsÀð«gÁªÀÄ_aºÉß"_;_"
अर्दविराम_चिन्न: CzsÀð«gÁªÀÄ._CzsÀð«gÁªÀÄ_aºÉß"_;_"
अल्पताय: PÀqÀªÉÄ PÀ«Ää CgÀPÉ ¸Àé®à
अल्पविराम: C®à«gÁªÀÄ C®à«gÁªÀÄ_aºÉß_" "
अल्ला: C¯Áèºï C¯Áè
अल्लाह: C¯Áèºï C¯Áè
अळंकार: D¨sÀgÀt MqÀªÉ
अवज्ञा: wgÀ¸ÁÌgÀ C®èUÀ¼É
अवतरण_चिन्न: GzÀÞgÀt GzÀÞgÀt_aºÉß(_"......"_)
अवतरणिका: ¥Àæ¸ÁÛªÀ£É ¦ÃpPÉ
अवधी: ¸ÀªÀÄAiÀÄ ºÉÆvÀÄÛ ªÉÃ¼É ©qÀÄªÀÅ ¥ÀÅgÀÄ¸ÉÆvÀÄÛ PÁ¯ÁªÀ¢ü ªÀÄÄzÀÝvÀÄ
अवयव: EA¢æAiÀÄ eÁÕ£ÉÃA¢æAiÀÄ
अविचार: ¤®ðPÀë G¥ÉÃPÉë UÀªÀÄ¤¸À¢gÀÄ«PÉ
अविरक्ती: C«gÀPÀÛ
अविश्कारी: CªÀ¢ü ¸ÀªÀÄAiÀÄ
अविस्वास: C«±Áé¸À C¥À£ÀA©PÉ «±Áé¸À«®è¢gÀÄªÀÅzÀÄ
अविस्वासी: C«±Áé¹ £ÀA©UÀ¸ÀÜ£À®èzÀªÀ
अवेव्हारीकताय: CªÀåªÀºÁjPÀvÉ
अशांतताय: C±ÁAw C¸ËRå £ÉªÀÄä¢UÉÃqÀÄ ¸ÀÄSÁ¨sÁªÀ
अशांती: CvÀÈ¦Û C¸ÀAvÀÈ¦Û C¸ÀªÀiÁzÁ£À
अशुद्धताय: PÉÆ¼ÀPÀÄ PÀ±Àä® ªÀiÁ°£Àå ªÀÄ°£ÀvÉ PÉÆ¼É C±ÀÄzÀÝvÉ
अश्लीलताय: C²èÃ®vÉ C¸À¨sÀåvÉ ¨sÀAqÀvÀ£À
अश्वशाळा: PÀÄzÀÄgÉ¯ÁAiÀÄ C±Àé±Á¯É
असंतुळण: C¸ÀªÀÄvÉÆÃ®£À
असंतुश्टी: CvÀÈ¦Û C¸ÀAvÀÈ¦Û C¸ÀªÀiÁzÁ£À
असंतोश: CvÀÈ¦Û C¸ÀAvÀÈ¦Û C¸ÀªÀiÁzÁ£À
असंयम: CwgÉÃPÀ GZÀÒöÈAR®vÉ ¸ÀAAiÀÄªÀÄgÁ»vÀå ºÀvÁ¼À_vÀ¦àgÀÄªÀÅzÀÄ ºÀvÉÆÃn_vÀ¦àgÀÄªÀÅzÀÄ
असहमती: C¸ÀªÀÄäw M¦àvÀªÀ®èzÀ
असाधारणताय: C¸ÀªÀiÁ£ÀåvÉ C¸ÁzsÁgÀtªÁVgÀÄªÀÅzÀÄ
असामान्यताय: C¸ÀªÀiÁ£ÀåvÉ C¸ÁzsÁgÀtªÁVgÀÄªÀÅzÀÄ
अस्तंती_वारें: ¥ÀqÀÄªÀt_UÁ½ ¥À²ÑªÀÄ_ªÀiÁgÀÄvÀ
अस्तीत्व: C¹ÛvÀé EgÀÄ«PÉ EgÀªÀÅ ¹Üw
अस्त्र: C¸ÀÛç Që¥ÀàtÂ
अस्थिरताय: ZÀAZÀ® ZÀ¥À®.vÀÄAl
अस्पश्टताय: C¸ÀàµÀÖvÉ
अस्वीकार: ¤gÁPÀgÀuÉ C¹éÃPÀÈw C¸ÀªÀÄäw
अहवाल: ¸ÁgÁA±À MmÁÖgÉ_ºÉÃ¼ÀÄ«PÉ vÁvÀà0iÀÄð
अहिंसा: C»A¸Á C»A¸É
अहीत: £ÀµÀÖ ®ÄPÁì£À PÀ¼ÉvÀ C»vÀ
आंकडो: ¸ÀASÉå CAPÉ
आंकवार: PÀÄªÀj PÀÄªÀiÁj ºÀÄqÀÄV
आंकवार_चली: C«ªÁ»vÉ C«ªÁ»vÀ_ªÀÄ»¼É PÀÄªÀiÁj PÀÄªÀj
आंकवार_दादलो: C«ªÁ»vÀ §æºÁäZÁj ªÀÄzÀÄªÉ0iÀiÁUÀzÀªÀ£ÀÄ
आंकवारपण: PËªÀiÁ0iÀÄð PÀÄªÀiÁgÀ
आंकुर: ªÉÆ¼ÀPÉ_MqÉAiÀÄÄªÀÅzÀÄ PÀÄrAiÉÆqÉAiÀÄÄªÀÅzÀÄ aUÀÄgÀÄªÀÅzÀÄ CAPÀÄgÀt
आंग: CAUÀ CªÀAiÀÄªÀ ±ÁjÃjPÀ_CAUÀ
आंग_भास: ¸À£Éß PÉÊ¸À£Éß_¨ÁAiÀÄì£Éß
आंगण: ªÀÄ£É_ªÀÄÄAzÉ ªÀÄ£É_ªÀÄÄA¨sÁUÀ
आंगवळणी: D®¸Àå ¸ÀÄ¸ÀÄÛ
आंचको: ¸ÁªÀÅ ªÀÄgÀt ¤zsÀ£À CªÀ¸Á£À ªÀÄÈvÀÄå CAvÀå
आंड: CAqÀPÉÆÃ±À ªÀÈµÀt vÀgÀqÀÄ_(©Ãd)
आंदोलन: DAzÉÆÃ®£À ZÀ¼ÀÄªÀ½ vÉÆ¼À¯Ál vÀ¼ÀªÀÄ¼À
आंध्र_प्रदेश: DAzÀæ_¥ÀæzÉÃ±À DAzÀæ
आंध्रा: DAzÀæ_¥ÀæzÉÃ±À DAzÀæ
आंबाडो: dqÉ dmÉ ªÀÄÄr
आकलन: CAzÁdÄ JtÂPÉ UÀæºÀt
आका: zÉÆqÀØPÀÌ
आकांतवाद: DvÀAPÀªÁzÀ ¨sÀAiÉÆÃvÁàzÀ£É
आकांतवादी: DvÀAPÀªÁ¢ GUÀæªÁ¢ ¨sÀAiÉÆÃvÁàzÀPÀ DvÀAPÀªÁ¢ GUÀæªÁ¢ ¨sÀAiÉÆÃvÁàzÀPÀ
आकुर: ªÉÆ¼ÀPÉ aUÀÄgÀÄ PÀÄr
आकृताय: zÉÃºÀzÀ_ªÉÄÊPÀlÄÖ ±ÀjÃjPÀ_¤®Ä«PÉ_(?)
आक्रमण: CwPÀæªÀÄt G®èAWÀ£É J¯Éè«ÄÃgÀÄ
आक्षेप: ¥ÀæwªÁzÀ RAqÀ£É «gÉÆÃzsÀ
आख्यायिका: d£À¥ÀzÀ_PÀvÉ
आघात: KlÄ ¥ÉlÄÖ ºÉÆqÉvÀ
आचरण: £ÀqÀªÀ½PÉ £ÀqÁªÀ½ ªÀvÀð£É
आजाप: CZÀÑj ZÀªÀÄvÁÌgÀ «¸Àä0iÀÄ ¸ÉÆÃfUÀ PÀlÖZÀÑj ¤¨ÉâgÀUÀÄ
आजी: CfÓ
आज्ञा: C£ÀÄªÀÄw ¸ÀªÀÄäw C£ÀÄªÉÆÃzÀ£É M¦àUÉ
आज्ञा_पत्र: DeÁß÷å¥ÀvÀæ DzÉÃ±À_¥ÀvÀæ ¥ÀgÀªÁ£ÀV_¥ÀvÀæ
आठवडो: ªÁgÀ ¸Á¥ÁÛºÀ
आठवण: £É£À¥ÀÅ ¸ÀäöÈw ¸ÀägÀuÉ
आडंबर: PÀ¥Àl ªÉÆÃ¸À £Àl£É ¸ÉÆÃUÀÄ
आडखळ: «dÕ CqÀZÀuÉ ¨sÁzÉ vÉÆAzÀgÉ vÉÆAzÀgÉ PÀoÉÆÃgÀvÉ ©gÀÄ¸ÀÄvÀ£À ¸ÀAPÀl DPÉëÃ¥ÀuÉ CrØ vÀPÀgÁgÀÄ ¸ÀªÀÄ¸Éå aAvÉ PÀ¼ÀªÀ¼À ªÁåPÀÄ®
आडणी: J¯É ¥Àtð ¥ÀvÀæ
आडनांव: PÀÄ®£ÁªÀÄ ªÀÄ£ÉvÀ£ÀzÀ_ºÉ¸ÀgÀÄ
आडमेळी: DPÉëÃ¥ÀuÉ CrØ vÀPÀgÁgÀÄ
आडवाद: C¥ÀªÁzÀ ºÉÆgÀvÀÄ «£Á¬Äw
आडावणी: J¯É ¥Àtð ¥ÀvÀæ
आडो: J¯É ¥Àtð ¥ÀvÀæ
आतंक: DvÀAPÀ ºÉzÀjPÉ
आतंकवाद: DvÀAPÀªÁzÀ ¨sÀAiÉÆÃvÁàzÀ£É
आतूरताय: DvÀAPÀ PÀ¼ÀªÀ¼À £ÉªÀÄä¢¬Ä®è¢gÀÄªÀÅzÀÄ
आत्मकथन: DvÀäPÀxÉ DvÀäPÀxÀ£À DvÀäPÀxÉ CvÀäPÀxÁ£ÀPÀ DvÀäZÀjvÉæ
आत्मकथा: DvÀäPÀxÉ DvÀäPÀxÀ£À
आत्मचरित्र: DvÀäPÀxÉ DvÀäPÀxÀ£À
आत्मचरित्रण: DvÀäPÀxÉ CvÀäPÀxÁ£ÀPÀ DvÀäZÀjvÉæ
आदर: ªÀAzÀ£É ¥ÀæuÁªÀÄ C©üªÀAzÀ£É C©üªÁzÀ£À
आदर्श: DzÀ±Àð DzÀ±Àð¥ÁæAiÀÄ
आदवोगाद: £ÁåAiÀÄ±Á¸ÀÛçdÕ £ÁåAiÀÄ±Á¸ÀÛçªÉÃvÀÛ £ÁåAiÀÄ±Á¸ÀÛç_¥ÀrvÀ
आदार: G¥ÀPÁgÀ zÀAiÀiÁ¥ÀgÀvÉ CªÀ®A§£É ¸ÀºÁAiÀÄ ¸ÀºÁAiÀÄ £ÉgÀªÀÅ ¸ÀºÀPÁgÀ MvÁÛ¸É
आदेश: DeÉÕ DzÉÃ±À ºÀÄPÀÄªÀÄÄ PÀlÄÖ¥ÁqÀÄ PÀlÖ¼É
आदेश_पत्र: DeÁß÷å¥ÀvÀæ DzÉÃ±À_¥ÀvÀæ ¥ÀgÀªÁ£ÀV_¥ÀvÀæ
आदोगाद: £ÁåAiÀÄ±Á¸ÀÛçdÕ £ÁåAiÀÄ±Á¸ÀÛçªÉÃvÀÛ £ÁåAiÀÄ±Á¸ÀÛç_¥ÀrvÀ
आनंद: vÀÈ¦Û ¸ÀAvÀÈ¦Û ¸ÀAvÀÄ¶Ö G¯Áè¸À ºÀµÀð D£ÀAzÀ £À°ªÀÅ ¸ÀAvÉÆÃµÀ GvÁìºÀ ºÀÄªÀÄä¸ÀÄì G¯Áè¸À eÉÆÃ±ï ¸ÀA¨sÀæªÀÄ ¸ÀqÀUÀgÀ G§âmÉ GªÉÄÃzÀÄ
आपजीण: DvÀäPÀxÉ DvÀäPÀxÀ£À DvÀäPÀxÉ CvÀäPÀxÁ£ÀPÀ DvÀäZÀjvÉæ
आपरोस: ¸ÁgÀ ¸ÁgÁA±À n¥ÀàtÂ
आपलेपण: ¸ËºÁzÀð ¸ÀºÀÈzÀAiÀÄvÉ
आपोवणें: PÀgÉAiÉÆÃ¯É DªÀÄAvÀæt_¥ÀvÀæ «eÁÕ¥À£À_¥ÀvÀæ DºÁé£À_¥ÀvÀæ
आबूजपण: ¥ÀæPÀÄë§ÝvÉ C¸ÀÛªÀå¸ÀÛvÉ CªÀåªÀ¸ÉÜ G¢éUÀßvÉ
आमंत्रणपत्र: PÀgÉAiÉÆÃ¯É DªÀÄAvÀæt_¥ÀvÀæ «eÁÕ¥À£À_¥ÀvÀæ DºÁé£À_¥ÀvÀæ
आमंत्रणपत्रिका: PÀgÉAiÉÆÃ¯É DªÀÄAvÀæt_¥ÀvÀæ «eÁÕ¥À£À_¥ÀvÀæ DºÁé£À_¥ÀvÀæ
आम्ल: DªÀÄè ºÀÄ½AiÀiÁzÀ
आयज: ªÀvÀðªÀiÁ£À_PÁ®
आयदन: ¥ÁvÉæ
आयोग: DAiÉÆÃUÀ PÀ«ÄÃµÀ£ï
आयोजक: DAiÉÆÃdPÀ
आयोजन: DAiÉÆÃd£É vÀAiÀiÁj
आयोजन_करपी: DAiÉÆÃdPÀ
आरंब: DgÀA¨sÀ ¥ÁægÀA¨sÀ ±ÀÄgÀÄ
आरंभ: DgÀA¨sÀ ¥ÁægÀA¨sÀ ±ÀÄgÀÄ ªÀÄÆ® ªÉÆzÀ®Ä DgÀA¨sÀ ¥ÁægÀA¨sÀ ±ÀÄgÀÄ
आराखडो: £ÀªÀÄÆ£É ¥ÀæwgÀÆ¥À
आरोप: PÀ¼ÀAPÀ zÉÆÃµÀ PÀÄAzÀÄ_(?)
आर्य: DAiÀÄð DAiÀÄð_PÀÄ®
आर्य_जात: DAiÀÄð DAiÀÄð_PÀÄ®
आलपेण: ¸ÉÃ¦Ö_¦£ï
आलफिनेत: ¸ÉÃ¦Ö_¦£ï
आलाशिरो: D±ÀæAiÀÄ D¸ÀgÉ
आलें: ±ÀÄAp ¸ÀÄAp C®è
आळ: PÀ¼ÀAPÀ zÉÆÃµÀ PÀÄAzÀÄ_(?)
आळस: ªÉÄÊªÀÄÄjAiÀÄÄ«PÉ D®¸Àå ¸ÀÄ¸ÀÄÛ DPÀ½PÉ dÈA¨sÀt
आळें: ¥Áw
आवटेपण: ªÀÄÆRðvÀ£À C«ªÉÃPÀ zÀqÀØvÀ£À
आवटो: ªÀÄÆRð ¨ÉÃPÀÆ¥sóÀ
आवड: C©ügÀÄa D¸ÀQÛ M®ªÀÅ ªÀå¸À£À ¯Á®¸É ZÀl C©ügÀÄa D¸ÀQÛ M®ªÀÅ GvÁìºÀ ºÀÄªÀÄä¸ÀÄì G¯Áè¸À eÉÆÃ±ï ¸ÀA¨sÀæªÀÄ ¸ÀqÀUÀgÀ G§âmÉ GªÉÄÃzÀÄ ZÀÆn ZÀ¼ÀPÀ ¸ÀÄn ²ÃWÀæUÀw ZÀÄgÀÄPÀÄ
आवत: G¥ÀPÀgÀt ¸À®PÀgÀuÉ ¸ÁzsÀ£À ±À¸ÀÛç ±À¸ÁÛç¸ÀÛç DAiÀÄÄzsÀ
आवयबापूय: vÀAzÉ_vÁ¬Ä ªÀiÁvÀ_¦vÀÈ C¥Àà_CªÀÄä C¥Àà_CªÀé
आविश्कार: D«µÁÌgÀ ±ÉÆÃzsÀ£É
आवृत्ती: ¸ÀAaPÉ CAPÀ
आवेग: GvÉÛÃd£À G¢ÝÃ¥À£À ¥ÀæZÉÆÃzÀ£À
आवेदनपत्र: AiÀiÁZÀ£É PÉÆÃjPÉ
आव्हान: ¸ÀªÁ®Ä
आशा: C¥ÉÃPÉë DPÁAPÉë
आशावाद: D±ÁªÁzÀ
आशिया: K¶0iÀiÁ K¶0iÀiÁ_ªÀÄºÁ¢éÃ¥À
आशिया_खंड: K¶0iÀiÁ K¶0iÀiÁ_ªÀÄºÁ¢éÃ¥À
आशिया_म्हाद्वीप: K¶0iÀiÁ K¶0iÀiÁ_ªÀÄºÁ¢éÃ¥À
आसन: D¸À£À ¦ÃoÀ
आसपाव: PÀÆrPÉÆ¼ÀÄî«PÉ CAvÀUÀðvÀªÁUÀÄ«PÉ
आसरो: D±ÀæAiÀÄ D¸ÀgÉ
आसाम: C¸ÁìªÀÄ C¸ÁìªÀiï
आसामी: C¸Áì«ÄUÀ C¸Áì«Ä
आस्त: C¥ÉÃPÉë DPÁAPÉë
आस्तिकवाद: D¹ÛPÀ D¹ÛPÀvÉ D¹ÛPÀªÁzÀ
इंद्रीय: EA¢æAiÀÄ eÁÕ£ÉÃA¢æAiÀÄ
इकरा: ºÀ£ÉÆßAzÀÄ
इण्टरवाल: ªÀÄzsÁåAvÀgÀ ªÀÄzsÀå_¨sÁUÀ
इतिहास: EwºÁ¸À ZÀjvÉæ
इत्सा_पुर्ती: ªÀÄ£À¥ÀÇªÀðPÀ EZÁÑ¥ÀÇªÀðPÀ EµÀÖ¥ÀlÄÖ
इत्सा_प्राप्ती: ªÀÄ£À¥ÀÇªÀðPÀ EZÁÑ¥ÀÇªÀðPÀ EµÀÖ¥ÀlÄÖ
इत्सापुर्णताय: EZÁÑ¥ÀÇªÀðPÀªÁzÀ
इत्साहीणटाय: EµÀÖ«®è¢gÀÄ«PÉ ªÀÄ£À¹ì®è¢gÀÄ«PÉ M®èzÀ_ªÀÄ£À¹ì¤A¢gÀÄªÀÅzÀÄ
इनाम: ¨sÀQëÃ¸ÀÄ E£ÁªÀÄÄ §ºÀÄªÀiÁ£À
इबाडणी: «PÁgÀ «gÀÆ¥À «PÀÈw ªÀPÀævÉ
इश्ट: UÉ¼ÉAiÀÄ «ÄvÀæ ¸ÉßÃ»vÀ zÉÆÃ¸ÀÛ ¥ÉæAqï
इस्लाम: E¸ÁèA_zsÀªÀÄð E¸ÁèA ªÀÄºÀªÀÄ¢ÃAiÀÄ_zsÀªÀÄð ¸ÁºÉÃ§gÀ_zsÀªÀÄð
इस्लाम_धर्म: E¸ÁèA_zsÀªÀÄð E¸ÁèA ªÀÄºÀªÀÄ¢ÃAiÀÄ_zsÀªÀÄð ¸ÁºÉÃ§gÀ_zsÀªÀÄð
ईद: Fzï_«Ä¯Ázï Fzï
ईश: K¸ÀÄQæ¸ÀÛ fÃ¸À¸ï
ईसा: K¸ÀÄQæ¸ÀÛ fÃ¸À¸ï
उंचाबळटाय: ¥ÀæPÀÄë§ÝvÉ C¸ÀÛªÀå¸ÀÛvÉ CªÀåªÀ¸ÉÜ G¢éUÀßvÉ
उकतावण: GzÁÏl£É
उकतावप: C©üªÀåQÛ ¥ÀæPÀluÉ ºÉÆgÀUÉqÉvÀ
उकाडो: ©¹®Ä gÀhÄ¼À ©¹ºÀªÉ GµÀÚUÁ½
उक्ते_करप: C©üªÀåQÛ ¥ÀæPÀluÉ ºÉÆgÀUÉqÉvÀ
उखळप: GPÀÄÌ
उगडास: £É£À¥ÀÅ ¸ÀäöÈw ¸ÀägÀuÉ
उगमस्थळ: GUÀªÀÄ ªÀÄÆ®
उगमाची_सुवात: GUÀªÀÄ ªÀÄÆ®
उचांबळटाय: wgÀÄªÀÅ_ªÀÄÄgÀÄªÀÅ vÀ¯É_PÉ¼ÀUÁzÀ §ÄqÀªÉÄÃ¯ÁzÀ
उच्च_न्यायालय: GZÀÑ_£ÁåAiÀiÁ®AiÀÄ ºÉÊ_PÉÆÃmïð
उच्च_पदधिकारी: GZÀÒ_C¢üPÁj G£ÀßvÀ_C¢üPÁj
उच्चार: GZÁágÀ GZÁágÀuÉ
उच्चारण: GZÁágÀ GZÁágÀuÉ
उजवाडें: QlQ ¨É¼ÀQAr UÀªÁQë
उठाव: GvÀÄÛAUÀ O£ÀåvÀå G£Àßw
उडकी: £ÉUÉvÀ fVvÀ ºÁjPÉ ®AWÀ£À JUÀgÀÄ PÀÄ¥Àà½PÉ zÀÄªÀÄÄPÀÄ«PÉ
उडन_तबकडी: ºÁgÀÄªÀ_vÀmÉÖ
उडी: £ÉUÉvÀ fVvÀ ºÁjPÉ ®AWÀ£À JUÀgÀÄ PÀÄ¥Àà½PÉ zÀÄªÀÄÄPÀÄ«PÉ
उणाव: PÀqÀªÉÄ PÀ«Ää CgÀPÉ ¸Àé®à C¨sÁªÀ PÉÆgÀvÉ PÉÆgÀvÉ PÀrªÉÄ ¸ÁPÁUÀÄªÀµÀÄÖ_E®è¢gÀÄ«PÉ
उणेपण: PÀrªÉÄ PÀqÀªÉÄ E½vÀ E½ªÉÄ vÀUÀÄÎ«PÉ
उतारो: C£ÀÄZÉÒÃzÀ D±Áé¸À ¨sÁUÀ ¥ÀªÀð SÁAqÀ ¸ÀUÀð
उत्कर्श: GvÀÌöÈµÀÖvÉ CvÀÄåvÀÛªÀÄ M¼ÉîAiÀÄ
उत्कृश्ठताय: M¼ÉîAiÀÄvÀ£À ±ÉæÃµÀ×vÉ
उत्तमताय: M¼ÉîAiÀÄvÀ£À ±ÉæÃµÀ×vÉ
उत्तर: GvÀÛgÀ dªÁ§Ä ªÀiÁ£ÀÄðr ªÀÄgÀÄªÀiÁvÀÄ
उत्तर_प्रदेश: GvÀÛgÀ_¥ÀæzÉÃ±À 0iÀÄÄ¦
उत्तेजना: PÉÆëÃ¨sÉ ¥ÀæPÀÄë§ÝvÉ vÀ¼ÀªÀÄ¼À ªÁåPÀÄ®
उत्थान: GvÀÄÛAUÀ O£ÀåvÀå G£Àßw
उत्पत्ती: GzÀAiÀÄ DgÀA¨sÀ GvÀàwÛ C«¨sÁðªÀ
उत्पादन: GvÀà£Àß ªÁtÂdå_¸ÀgÀPÀÄ ªÀiÁgÁlzÀ_¸ÀgÀPÀÄ ©PÀj_ªÀiÁ®Ä GvÁàzÀ£É
उत्सव: ºÀ§â GvÀìªÀ eÁvÉæ ¥ÀªÀð
उत्साह: GvÁìºÀ ºÀÄªÀÄä¸ÀÄì G¯Áè¸À eÉÆÃ±ï ¸ÀA¨sÀæªÀÄ ¸ÀqÀUÀgÀ G§âmÉ GªÉÄÃzÀÄ ZÀÆn ZÀ¼ÀPÀ ¸ÀÄn ²ÃWÀæUÀw ZÀÄgÀÄPÀÄ
उत्साहहीनताय: ¤gÀÄvÁìºÀ G¯Áè¸ÀgÀ»vÀ
उदकांतले_जीव: d®ªÁa_(?)
उदकांतलें_वाहन: £ËPÉ
उदकांतलो_जीव: d®ZÀgÀ d®ZÀgÀ_¥ÁætÂ
उदकाखेळ: d®QæÃqÉ d®«ºÁgÀ
उदकाशेवणें: ¤ÃgÀ_ºÀQÌ d®_¥ÀQë
उदघाटन: GzÁÏl£É
उदय: GzÀAiÀÄ DgÀA¨sÀ GvÀàwÛ C«¨sÁðªÀ
उदरगत: G£Àßw »jªÉÄ K½UÉ JvÀÛgÀ
उदानीनताय: C¸ÀªÀÄzsÁ£À C¸ÀAvÉÆÃµÀ CvÀÈ¦Û
उदासपण: C¸ÀªÀÄzsÁ£À C¸ÀAvÉÆÃµÀ CvÀÈ¦Û
उदेंती_वाय: DµÁqsÀUÁ½ ªÀÄÆqÀ®UÁ½ ¥ÀÇªÀðªÀiÁgÀÄvÀ
उदेंती_हवा: DµÁqsÀUÁ½ ªÀÄÆqÀ®UÁ½ ¥ÀÇªÀðªÀiÁgÀÄvÀ
उद्गारचिन्न: D±ÀÑAiÀÄð_¸ÀÆZÀPÀ C£ÀÄªÀiÁ£À_¸ÀÆZÀPÀ D±ÀÑAiÀÄð_¸ÀÆZÀPÀ_aºÉß_"_!_"
उद्देग: GzÉÆåÃUÀ ªÀå¥ÁgÀ ¥Àæ0iÀÄvÀß
उद्धार: C©üªÀÈ¢Þ ¸ÀÄzsÁgÀuÉ ¥ÁgÀÄªÀiÁqÀÄ ©qÀÄUÀqÉUÉÆ½¸ÀÄ «ªÉÆÃZÀ£É_ªÀiÁr¸ÀÄ
उद्येग: GzÀåªÀÄ PÉÊUÁjPÉ
उन्नती: G£Àßw »jªÉÄ K½UÉ JvÀÛgÀ
उप_राष्ट्रपती: G¥À_gÁµÀÖç¥Àw ªÉÊ¸ï_¥Àæ¹qÉAmï
उपकरण: G¥ÀPÀgÀt ¸À®PÀgÀuÉ ¸ÁzsÀ£À
उपकार: PÀÈvÀdÕvÉ C¨sÁj G¥ÀPÁgÀ_¸ÀägÀuÉ
उपचार: aQvÉì G¥ÀZÁgÀ
उपदेश: G¥ÀzÉÃ±À ¤Ãw¨sÉÆÃzÉ zsÀªÉÆðÃ¥ÀzÉÃ±À
उपनटी: G¥À_£ÁAiÀÄQ
उपनायक: G¥À_£ÁAiÀÄPÀ
उपनायिका: G¥À_£ÁAiÀÄQ
उपभोग: s¸ÀÄSÁ£ÀÄ¨sÀªÀ_(?)
उपमा: ºÉÆÃ°PÉ G¥ÀªÉÄ ¸ÁªÀÄå ¸ÁzÀÈµÀå
उपरान: G¥ÀªÀ£À GzÁå£À ¥ÁPÀÄð
उपलब्धताय: G¥À®§ÞvÉ zÉÆgÀPÀÄ«PÉ ¹PÀÄÌ«PÉ
उपहास: ¥ÀjºÁ¸À ºÀtPÀ «£ÉÆÃzÀ ZÉÃµÉÖ ¤AzÉ
उपाधी: ¥ÀzÀ£ÁªÀÄ ¥ÀzÀ« G¥Á¢ü
उपाध्यक्ष: G¥ÁzÀåPÀë
उपाय: §UÉ jÃw ¸ÁzsÀ£À ªÀiÁUÀð G¥Á0iÀÄ ¨ÉÃgÉ C£Àå §zÀ°
उपासमार: ºÉÆmÉÖV®èzÀ_¹Üw PÀëvÀÄÛ ¤gÁºÁgÀ G¥ÀªÁ¸À_(?)
उपेग: C£ÀÄ¨sÉÆÃUÀ G¥À¨sÉÆÃUÀ ªÀiÁgÁl RZÁðUÀÄ«PÉ
उफेवप: GPÀÄÌ
उबारणी: eÉÆÃqÀuÉ ¸ÀAAiÉÆÃd£É
उबें_पीक: MtVzÀ_¥À¸À®Ä
उभयचर: G¨sÀ0iÀÄªÁ¹_¥ÁætÂ
उमळशीक: C©ügÀÄa D¸ÀQÛ M®ªÀÅ ZÀÆn ZÀ¼ÀPÀ ¸ÀÄn ²ÃWÀæUÀw ZÀÄgÀÄPÀÄ G¯Áè¸À ®ªÀ®«PÉ »UÀÄÎ GvÁìºÀ
उमेद: G¯Áè¸À ºÀµÀð D£ÀAzÀ £À°ªÀÅ ¸ÀAvÉÆÃµÀ GvÁìºÀ ºÀÄªÀÄä¸ÀÄì G¯Áè¸À eÉÆÃ±ï ¸ÀA¨sÀæªÀÄ ¸ÀqÀUÀgÀ G§âmÉ GªÉÄÃzÀÄ ZÀÆn ZÀ¼ÀPÀ ¸ÀÄn ²ÃWÀæUÀw ZÀÄgÀÄPÀÄ G¯Áè¸À ®ªÀ®«PÉ »UÀÄÎ GvÁìºÀ
उमेदवार: GªÉÄÃzÀÄªÁgÀ CfðzÁgÀ ªÀÄ£À«zÁgÀ zÀgÀSÁ¸ÀÄÛzÁgÀ C¨Áåyð
उमो: ªÀÄÄvÀÄÛ ZÀÄA§£À
उर्जा: ±ÀQÛ PÀ¸ÀÄªÀÅ D¥ÀÅ C¼ÀªÀÅ §®
उलट_तपासणी: ¥Án¸ÀªÁ®Ä
उलो: ¸ÀA¨sÉÆÃzÀ£É PÀÆUÀÄ«PÉ PÀgÉAiÀÄÄ«PÉ JZÀÑj¸ÀÄ«PÉ w½¸ÀÄ«PÉ
उलोवप: ¨sÁµÀt G¥À£Áå¸À ªÀiÁvÀÄ ºÉÃ½PÉ GQÛ ¤gÀÆ¥ÀuÉ ¥ÀæPÀluÉ0iÀÄ_ªÀiÁvÀÄ
उस्वास: ªÀÄÄ®ÄPÀÄ £ÀgÀ¼Ál £ÀgÀ½PÉ
एकवटीत_घराबो: PÀÆqÀÄ_PÀÄlÄA§ C«¨sÀPÀÛ_PÀÄlÄA§
एकाग्रता: UÀªÀÄ£ÀªÀ»¸ÀÄ«PÉ ®PÀë÷å«qÀÄ«PÉ
एकाग्रताय: vÀ°èÃ£À
एको: ºÁ¸ÀÄ JPÀÌ K¸ï
एक्सीडेंट: zÀÄWÀðl£É
एटम: ¥ÀgÀªÀiÁtÄ ClªÀiï
एटर्नी: £ÁåAiÀÄ±Á¸ÀÛçdÕ £ÁåAiÀÄ±Á¸ÀÛçªÉÃvÀÛ £ÁåAiÀÄ±Á¸ÀÛç_¥ÀrvÀ
एप्रेगाद: ¨Áåj¸ÀÖgï
एसीड: DªÀÄè ºÀÄ½AiÀiÁzÀ
ऑक्सीजन: DªÀÄèd£ÀPÀ DQìd£ï
ओंकीर: ¦ZÀÄÑ PÀtÂÚ£À_PÉÆ¼É VÃdÄ
ओग्गीपण: ªÀiË£À vÉ¥ÀàVgÀÄªÀÅzÀÄ ¸ÀÄªÀÄä£ÁUÀÄ«PÉ ¤±Àå§ÝvÉ
ओडणी: ºÉÆ¢PÉ ºÉÆ¢ÝPÉ ºÉÆzÀPÉ
ओपकरेसांव: ±À¸ÀÛçaQvÉì ±À¸ÀÛçQæAiÉÄ D¥ÀgÉÃµÀ£ï
ओपार: UÁzÉ £ÁtÄÚr ªÀZÀ£À ¯ÉÆÃPÉÆÃQÛ ¸ÁªÀÄw ¥ÀæºÉÃ½PÉ
ओपेरासांव_करपी: ±À¸ÀÛçaQvÉì
ओरिसा: GvÀÌ®_zÉÃ±À zÀQët_©ºÁgÀ
ओवरसियर: ªÉÄÃ°éZÁgÀPÀ ¥Àj«ÃPÀëPÀ
कंजूसपण: f¥ÀÅtÄvÀ£À PÀÈ¥ÀtvÀ£À PÁ¥Àðtå ¯ÉÆÃ©üvÀ£À
कंठ: PÀAoÀ PÉÆgÀ¼ÀÄ ªÀÄÄAUÉÆgÀ¼ÀÄ ªÀÄÄAUÀvÀÄÛ ªÉÄlgÉ UÉÆÃtÄ UÉÆÃ£Á½ PÀvÀÄÛ PÀÄwÛUÉ UÀAl®Ä
कंठमणी: UÀAl®_ªÀÄtÂ UÉÆÃªÀiÁ¼É
कंस: DªÀgÀt PÉÆÃµÀ×PÀ PÀA¸À DªÀgÀt__aºÉß_(...........)
कचकच: Qj_Qj ¤gÀxÀðPÀ_dUÀ¼À ªÀåvÀðªÁzÀ_§qÀ§rPÉ
कटकट: Qj_Qj ¤gÀxÀðPÀ_dUÀ¼À ªÀåvÀðªÁzÀ_§qÀ§rPÉ
कठपुतली_बावली: QÃ®ÄUÉÆA¨É ¸ÀÆvÀæzÀUÉÆA¨É
कठीण: vÉÆAzÀgÉ PÀoÉÆÃgÀvÉ ©gÀÄ¸ÀÄvÀ£À ¸ÀAPÀl
कठीण_काम: PÀµÀÖzÀ_PÉ®¸À PÀpt_PÉ®¸À
कड: ¢£Éß aPÀÌUÀÄqÀØ vÉªÀgÀÄ
कडकसाण: PÀoÉÆÃgÀvÉ PÁptåvÉ
कडवें: G¯ÉèÃR GzÀÞgÀt GzÁºÀgÀuÉ DzsÁgÀ Crn¥ÀàtÂ ¤ÃwªÁPÀå M¼ÉîAiÀÄ_ªÀiÁvÀÄ GQÛ ¸ÀÆQÛ ¸ÀÄ¨sÁ¶vÀ ¸ÀÄªÀZÀ£À
कडी: PÁ¯ÉâÃr ¨ÉÃr ¸ÀAPÀ¯É ±ÀÈAR¯É
कडें: GAUÀÄgÀÄ §¼É CAUÀÄ°Ã0iÀÄ
कडेक: ¥ÀPÀÌ ¥Á±Àéð ªÀÄUÀÎ®Ä §¢
कण: zsÁ£Àå ©Ãd PÁ¼ÀÄ PÀt CtÄ ZÀÆgÀÄ vÀÄtÄPÀÄ
कणीक: ZÀÆgÀÄ vÀÄtÄPÀÄ
कत्तलखानो: PÀ¸Á¬ÄSÁ£É PÀlÄPÀgÀAUÀr
कथन: ºÉÃ½PÉ ªÀiÁvÀÄ GQÛ ºÉÃ½PÉ GQÛ £ÀÄr ªÀZÀ£À ¨sÁµÀt ºÉÃ½PÉ GQÛ ¤gÀÆ¥ÀuÉ ¥ÀæPÀluÉ0iÀÄ_ªÀiÁvÀÄ
कन्या: PÀ£Àå PÀ£Àå_gÁ²
कप: PÀ¥ï C®APÁjPÀ_§lÖ®Ä
कपटताय: PÀÄn®vÉ PÀ¥Àl
कपटनितीतज्ञ: ZÀvÀÄgÀ ¤¥ÀÅt PÀÄ±À®ªÀÄw
कपटी_चाल: ªÉÆÃ¸À0iÀÄÄPÀÛ PÀ¥Àl0iÀÄÄPÀÛ ªÉÆÃ¸À¢AzÀ_PÀÆrzÀÄzÀÄ PÀ¥Àl¢AzÀ_PÀÆrzÀÄzÀÄ
कपटी_युक्ती: ªÉÆÃ¸À0iÀÄÄPÀÛ PÀ¥Àl0iÀÄÄPÀÛ ªÉÆÃ¸À¢AzÀ_PÀÆrzÀÄzÀÄ PÀ¥Àl¢AzÀ_PÀÆrzÀÄzÀÄ
कपटीपण: PÀÄn®vÉ PÀ¥Àl
कपडो: §mÉÖ ªÀ¸ÀÛç
कपल: CzÀÈµÀÖ ¨sÁUÀå AiÉÆÃUÀ «¢ü £À¹Ã§
कपात: PÀrªÉÄ PÀqÀªÉÄ E½vÀ E½ªÉÄ vÀUÀÄÎ«PÉ
कफन: ±ÀªÀ¸ÀA¥ÀÅl ±ÀªÁZÁÒzÀ£À
कबंद: £ÀÆ¯ÉÃtÂ ºÀUÀÎzÀ_eÁ½UÉ
कबलात: M¥ÀàAzÀ M¦àUÉ PÀgÁgÀÄ ¸ÀAzsÁ£À gÁf M¥ÀàAzÀ
कबाब: PÀ¨Á¨ï
कमळ: PÀªÀÄ® vÁªÀgÉ
कमी: PÀqÀªÉÄ PÀ«Ää CgÀPÉ ¸Àé®à
कमीशन: DAiÉÆÃUÀ PÀ«ÄÃµÀ£ï zÀ¯Áè½ ªÀÄzsÀå¸ÀÜ ¨ÉÆæÃPÀgÀÄ
कर: PÀgÀ vÉjUÉ PÀAzÁ0iÀÄ mÁåPÀì
कर_भरपी: PÀAzÁAiÀÄ_ªÀ¸ÀÆ°UÁgÀ_(?)
करंडक: PÀ¥ï C®APÁjPÀ_§lÖ®Ä
करणी: QæAiÀiÁ¥ÀzÀ QæAiÉÄ PÉ®¸À PÁAiÀÄð PÀªÀÄð PÁAiÀÄPÀ PÀÈvÀå GzÉÆåÃUÀ_(?)
करदातो: PÀAzÁAiÀÄ_ªÀ¸ÀÆ°UÁgÀ_(?)
करार: M¥ÀàAzÀ M¦àUÉ PÀgÁgÀÄ ¸ÀAzsÁ£À gÁf M¥ÀàAzÀ ¸ÀºÀªÀÄvÀ
करीम: C¯Áèºï C¯Áè
कर्क: PÀlPÀ PÀlPÀ_gÁ²
कर्णा_अळंकार: Q«AiÉÆÃ¯É Q«AiÀÄÄAUÀÄgÀ ºÀvÀÛPÀqÀPÀÄ ºÀvÉÆÛAn PÀtðPÀÄAqÀ® ªÀÄÄgÀÄªÀÅ
कर्तूब: PÉ®¸À PÁAiÀÄð PÀªÀÄð PÁAiÀÄPÀ PÀÈvÀå GzÉÆåÃUÀ_(?) QæAiÀiÁ²Ã®vÉ GzÉÆåÃUÀ²Ã®vÉ PÉ®¸À PÀªÀÄð PÁAiÀÄPÀ
कर्नाटक: PÀ£ÁðlPÀ PÀgÀÄ£ÁqÀÄ PÀ£ÀßqÀ£ÁqÀÄ
कर्म: PÉ®¸À PÁAiÀÄð PÀªÀÄð PÁAiÀÄPÀ PÀÈvÀå GzÉÆåÃUÀ_(?) PÉ®¸À PÀªÀÄð PÁAiÀÄPÀ
कर्मचारी: £ËPÀgÀ GzÉÆåÃV ¸ÉÃªÁ¤gÀvÀ ªÀÈwÛ¤gÀvÀ
कर्मफळ: PÀªÀÄð¥sÀ®
कर्माचें_फळ: PÀªÀÄð¥sÀ®
कर्यकर्तो: PÁ0iÀÄðPÀvÀð
कला: PÀ¯É PÀ¯Á
कलाकृती: PÀ¯ÁPÀÈw gÀZÀ£ÁPÀÈw
कलाहीणटाय: PÀ¯ÁvÀäPÀªÀ®èzÀ CPÀ¯ÁvÀäPÀ
कल्पना: PÀ®à£É ¸ÀÈd£É
कल्याण: »vÀ PÀ¯Áåt PÉëÃªÀÄ ¸ËRå PÀÄ±À® PÀ¯Áåt ¸ÀÄR_¸ÀªÀÄÈ¢Þ
कळम: vÀÄPÀÄÌ Q®Ä§Ä
कळोवणी: ªÀÄÄ£ÀÆìZÀ£É ¸ÀÆZÀ£É JZÀÑjPÉ ¸ÀÄ½ªÀÅ
कवच: PÀªÀZÀ AiÀÄÄzÀÞ_PÀªÀZÀ gÀPÁë_PÀªÀZÀ PÁ¥ÀÅ_ºÉÆ¢PÉ vÀ£ÀÄvÁæt ªÉÄÊeÉÆÃqÀÄ CAUÀgÀQë PÀAZÀÄPÀ
कवर: ¨Á¬ÄArAUÀÄ ¨ÉÊArUï
कविता_झेलो: PÁªÀå_UÀæAxÀ PÁªÀå_PÀÈw
कवी: PÀ«
कश्ट: PÀµÀÖ 0iÀiÁvÀ£É ¨ÉÃUÀÄ¢ PÀqÀÄ¸ÀAPÀl MqÀ®£ÉÆÃªÀÅ
कस: ºÀgÀ¼ÀÄ G¸ÀÄPÀÄ
कसब: §Ä¢ÝªÀAwPÉ eÁtvÀ£À eÁuÉä «ªÉÃPÀ
कांकण: GAUÀÄgÀÄ §¼É CAUÀÄ°Ã0iÀÄ
कांगारू: PÁAUÀgÀÆ
कांच: ¹Ã¸À UÁdÄ PÁZÀ
कांटयारें_झोंप: PÀAmÉ ¥É¼É ¥ÉÇzÉ
कांटो: «ÄÃ¤£À_ªÀÄÄ¼ÀÄî
कांठ: vÀÄ¢ vÀÄlÖ_vÀÄ¢ CAZÀÄ
कांडण: ©Ã¸ÀÄªÀ_PÁ¼ÀÄ ©Ã¸À®àqÀÄªÀ_¥ÀzÁxÀð
कांडी: a£ÀßzÀ_©¸ÉÌÃmï
कांतपाचें_यंत्र: £ÉÃAiÀÄÄªÀ_G¥ÀPÀt £ÉÃPÁjPÉAiÀÄ_G¥ÀPÀgÀt
कांती: vÉÃd¹é PÁAwAiÀÄÄ¼ÀîªÀ ¸ÀªÀÄxÀð ¥Àæ¨sÁªÀ±Á°
काकडी: ¸ËvÉÃPÁ¬Ä ¸ËvÉÃ§½î
कागदां: ¯ÉPÀÌ¥ÀvÀæ zÁ¸ÁÛªÉÃdÄ zÁR¯É DzsÁgÀ ¥ÀæªÀiÁt
कागाळ: zÀÆgÀÄ ¤AzÉ ¥ÀæwªÁzÀ RAqÀ£É «gÉÆÃzsÀ
काचुली: PÀZÀUÀÄ½ ZÀPÀÌ¼ÀUÀÄ½ §Ä¼ÀÄUÀÄnÖ¸ÀÄ«PÉ QQÌ½_ªÀiÁqÀÄ«PÉ
काजळी: ªÀÄ¹ PÀ¥ÀÅöà PÀÄrPÀ¥ÀÅöà
काजार: «ªÁºÀ ªÀÄzÀÄªÉ ®UÀß
काझ: UÀÄAr0iÀÄ_vÀÆvÀÄ PÁf
काटी: PÉÊPÉÆÃ®Ä
काटूकपण: f¥ÀÅtÄvÀ£À PÀÈ¥ÀtvÀ£À PÁ¥Àðtå ¯ÉÆÃ©üvÀ£À
काठ: £À¢_zÀAqÉ
काठमांडू: PÁoÀªÀiÁAqÀÄ PÁoÀªÀÄAqÀÄ
काठी: PÉÆÃ®Ä §rUÉ zÀAqÀ zÉÆuÉÚ
काडिमोड: «ZÉÑÃzÀ£À «ªÁºÀ_«ZÉÑÃzÀ£À
काडी: ºÀÄ®Äè vÀÈt PÀgÀqÀÄ
कातरपाचें_आवत: PÉÆAiÀÄÄåªÀ_G¥ÀPÀgÀt PÉÆ¬Ä®Ä_G¥ÀPÀgÀt
कातरे: MqÉ¢gÀÄªÀ
कादंबरिकार: PÁzÀA§jPÁgÀ
कान_बुराक: ±ÀæªÀuÉÃA¢æAiÀÄ
कानपट: PÀtvÀ¯É PÀ¥ÉÇÃ® UÀAqÀ¸ÀÜ¼À
कानसूल: PÀtvÀ¯É PÀ¥ÉÇÃ® UÀAqÀ¸ÀÜ¼À
कानाचो_पड्डो: Q«_¥ÉÇgÉ
कानाचो_बुराक: ±ÀæªÀuÉÃA¢æAiÀÄ
कानापड्डो: Q«_¥ÉÇgÉ
कापणी: PÉÆAiÀÄÄè PÀmÁªÀÅ CAUÀZÉÑÃzsÀ£À CAUÀZÉÑÃzsÀ
कापूस: CgÀ¼É ºÀwÛ
काम: QæAiÀiÁ¥ÀzÀ QæAiÉÄ PÉ®¸À PÁAiÀÄð PÀªÀÄð PÁAiÀÄPÀ PÀÈvÀå GzÉÆåÃUÀ_(?) PÉ®¸À PÀªÀÄð PÁAiÀÄPÀ GzÀåªÀÄ PÉÊUÁjPÉ GzÉÆåÃUÀ ªÀå¥ÁgÀ ¥Àæ0iÀÄvÀß
कामगार: £ËPÀgÀ GzÉÆåÃV ¸ÉÃªÁ¤gÀvÀ ªÀÈwÛ¤gÀvÀ
कायदेशीर: ¤AiÀÄªÀiÁ£ÀÄ¸ÁgÀ £ÁåAiÀÄ¸ÀªÀÄävÀªÁVgÀÄªÀÅzÀÄ «¢ü§zÀÞvÉ £ÁåAiÀÄ§zÀÞvÉ
कायदो: ¹zÁÝAvÀ ¤AiÀÄªÀÄ PÁAiÉÄÝ
कायशांव: ±ÀªÀ¥ÉnÖUÉ ±ÀªÀzÁ¤ ±ÀªÀ¸ÀA¥ÀÅl ºÉtªÀ¤ßqÀÄªÀ_¥ÉnÖUÉ
कारण: PÁgÀt PÁgÀPÀ ¤«ÄvÀå ºÉÃvÀÄ
कारभार: GzÉÆåÃUÀ ªÀå¥ÁgÀ ¥Àæ0iÀÄvÀß
कारागीर: PÀÄ±À®PÀ«Äð PÀgÀPÀÄ±À° PÀ¸À§ÄzÁgÀ ªÀÈwÛUÁgÀ
कार्बन: PÁ§ð£ï EAUÁ® CAUÁgÀ
कार्बोहायड्रेट: PÁ¨ÉÆðÃºÉÊqÉæÃlÄ ±ÀPÀðgÀ¦µÀÖ
कार्य: PÉ®¸À PÁAiÀÄð PÀªÀÄð PÁAiÀÄPÀ PÀÈvÀå GzÉÆåÃUÀ_(?) PÉ®¸À PÀªÀÄð PÁAiÀÄPÀ
कार्य_समाप्ती: PÉÆ£É ªÀÄÄPÁÛAiÀÄ ¸ÀªÀiÁ¦Û
कार्यन्वय: PÁAiÀÄðUÀvÀUÉÆ½¸ÀÄ«PÉ £ÉgÀªÉÃj¸ÀÄ«PÉ ¥ÀÇgÉÊ¸ÀÄ«PÉ
कालोर: ©¹®Ä gÀhÄ¼À ©¹ºÀªÉ GµÀÚUÁ½ PÁªÀÅ GµÀÚ vÁ¥À ©¸ÀÄ¥ÀÅ
काळ: ¸ÀªÀÄAiÀÄ PÁ® UÀAmÉ ¸ÀªÀÄAiÀÄ ºÉÆvÀÄÛ ªÉÃ¼É ©qÀÄªÀÅ ¥ÀÅgÀÄ¸ÉÆvÀÄÛ PÁ¯ÁªÀ¢ü ªÀÄÄzÀÝvÀÄ 0iÀÄÄUÀ ±ÀPÀ
काळजी: aAvÉ ªÀåxÉ
काळीं_कुपां: PÁªÀÄÄðV®Ä PÁªÉÆÃðqÀ zÀlÖ_ªÉÆÃqÀ
काळींकिट्ट_कुपां: PÁªÀÄÄðV®Ä PÁªÉÆÃðqÀ zÀlÖ_ªÉÆÃqÀ
काळीज: ªÀÄ£À¸ÀÄì avÀÛ UÀªÀÄ£À
काळीज_कलकलणी: JzÉ_§rvÀ JzÉ_ºÉÆqÉvÀ
काळीज_धडधडणी: JzÉ_§rvÀ JzÉ_ºÉÆqÉvÀ
काळो_बावटो: PÀ¥ÀÅöà_zÀéd PÀ¥ÀÅöà_¥ÀvÁPÉ
काव: (?)
कावल: gÀ¢Ý gÀ¢Ý_¥ÉÃ¥Àgï gÀ¢Ý_¸ÁªÀiÁ£ÀÄ ªÉÃ¸ïÖ
कावळो: PÀ¥Àl PÀÄAiÀÄÄQÛ PÀÄvÀAvÀæ ¸ÁéxÀð¥ÀÇjvÀ_eÁtvÀ£À
काव्य_झेलो: PÁªÀå_UÀæAxÀ PÁªÀå_PÀÈw
काव्य_संग्रह: PÁªÀå_UÀæAxÀ PÁªÀå_PÀÈw
काव्यकार: PÀ«
काव्यग्रंथ: PÁªÀå_UÀæAxÀ PÁªÀå_PÀÈw
काशांव: ±ÀªÀ¥ÉnÖUÉ ±ÀªÀzÁ¤ ±ÀªÀ¸ÀA¥ÀÅl ºÉtªÀ¤ßqÀÄªÀ_¥ÉnÖUÉ
काश्मीर: PÁ²äÃgÀ dªÀÄÄä_PÁ²äÃgÀ
कास: ¨ÉÃmÉ ²PÁj ªÀÄÈUÀAiÀiÁ«ºÁgÀ
किजील: UÀ¯ÁmÉ dUÀ¼À ¨ÉÊUÀÄ¼À_(?)
किटकिटो: ClÖºÁ¸À UÀºÀUÀ»¹_£ÀUÀÄ C§âj¹_£ÀUÀÄ
किडनाशक: Ql£Á±ÀPÀ Qæ«Ä£Á±ÀPÀ
किण्णटाय: ¤±Àå§Ý ¸À¢Ý®è¢gÀÄ«PÉ
किण्व: ºÀÄ½ ºÀÄ½_»lÄÖ ºÉ¥ÀÅöà ºÀÄzÀÄV£À_¥ÀÅr_(?)
किताब: ¥ÀzÀ£ÁªÀÄ ¥ÀzÀ« G¥Á¢ü
किरकीर: Qj_Qj ¤gÀxÀðPÀ_dUÀ¼À ªÀåvÀðªÁzÀ_§qÀ§rPÉ
किरकोळ_वेपारी: a®ègÉ_ªÁå¥Áj
किरिस्तांव: PÉæöÊ¸ÀÛ PÉæöÊ¸ÀÛ_zsÀ«ÄÃðAiÀÄ
किवलें: zÉÆÃn eÉÆÃn_PÉÆÃ®Ä GzÀÝ£É_©zÀÄgÀÄPÉÆÃ®Ä
किशर: ºÀgÀ¼ÀÄ G¸ÀÄPÀÄ
किशोर: ºÀgÉ0iÀÄzÀªÀ ¥Áæ0iÀÄzÀªÀ vÀgÀÄtÂ 0iÀÄÄªÀPÀ
कीर्त: ¥ÀæSÁåvÀ ºÉ¸ÀgÀÄªÁ¹ ¥Àæ¹zÀÞ SÁåvÀ QÃwð ºÉ¸ÀgÁzÀ
कुंड: CuÉPÀlÄÖ d¯Á±ÀAiÀÄ DuÉPÀlÄÖ d¯Á±ÀAiÀÄ qÁåªÀiï
कुंभ: PÀÄA¨sÀ_gÁ² PÀÄA¨sÀ
कुकर्म: CzsÀªÀÄð C£ÁåAiÀÄ
कुटनिती: gÁd¤¥ÀÅtvÉ ªÀåªÀºÁgÀPË±À® ªÀåªÀºÁgÀ_¤¥ÀÅtvÉ_(?)
कुटिरोद्योग: PÀÄ®_PÀ¸À§Ä ¸Àé_GzÉÆåÃUÀ ªÀÄ£É_PÀ¸À§Ä UÀÄr_PÉÊUÁjPÉ
कुटुंब: ¸ÀA§A¢üPÀgÀÄ ¥ÀjªÁgÀzÀªÀgÀÄ PÀÄlÄA§zÀªÀgÀÄ £ÉAlgÀÄ ªÀA±À PÀÄ® eÁw ªÀUÀð
कुडको: aA¢ CjªÉ ºÀjzÀ_ºÀjªÉ0iÀÄ_vÀÄAqÀÄ
कुडींघर: ±ÀªÀzÀªÀÄ£É ºÉtzÀªÀÄ£É
कुड्डो_विस्वास: ªÀÄÆqsÀ£ÀA©PÉ CAzsÀ±ÀæzÉÞ
कुदळ: UÀÄzÀÝ° ¦PÁ¹
कुधर्म: CzsÀªÀÄð C£ÁåAiÀÄ
कुपात्रताय: CAiÉÆÃUÀåvÉ C£ÀºÀðvÉ C¸ÀªÀÄxÀð
कुप्रसिद्दी: PÀ¼ÀAPÀ zÀÆµÀuÉ C¥ÀQÃwð C¥ÀªÀiÁ£À
कुमार: C«ªÁ»vÀ §æºÁäZÁj ªÀÄzÀÄªÉ0iÀiÁUÀzÀªÀ£ÀÄ
कुमारिका: PÀÄªÀj PÀÄªÀiÁj ºÀÄqÀÄV
कुमारी: C«ªÁ»vÉ C«ªÁ»vÀ_ªÀÄ»¼É PÀÄªÀiÁj PÀÄªÀj
कुराड: PÉÆqÀ° ¥ÀgÀ±ÀÄ PÉÆrè
कुराण: PÀÄgÁ£ï PÉÆgÁ£ÀÄ RÄgÁ£ÀÄ
कुरुपा: PÀÄgÀÆ¦_ºÉAUÀ¸ÀÄ
कुरू: ¸À£Éß ¸ÀAeÉÕ ¸ÀAPÉÃvÀ
कुरूप_बायल: PÀÄgÀÆ¦_ºÉAUÀ¸ÀÄ
कुलचांव: vÀr UÁ¢ ¸ÀeÉÓ ¯ÉÃ¥ÀÅ ªÉÄvÉÛ
कुळनांव: PÀÄ®£ÁªÀÄ ªÀÄ£ÉvÀ£ÀzÀ_ºÉ¸ÀgÀÄ
कुवत: §®±Á° ¸ÀªÀÄxÀðPÀ vÁPÀvï_EgÀÄªÀªÀ ±ÀQÛªÀAvÀ UÀnÖUÀ
कुशळटाय: ¤¥ÀÅtvÉ ¥Àæ«ÃtvÉ §Ä¢ÞªÀAwPÉ
कुशासन: zÀÄgÁqÀ½vÀ CAzsÀ_zÀ¨ÁðgÀÄ
कुशीक: ¥ÀPÀÌ ¥Á±Àéð ªÀÄUÀÎ®Ä §¢
कुसवण: ºÀÄ½ ºÀÄ½_»lÄÖ ºÉ¥ÀÅöà ºÀÄzÀÄV£À_¥ÀÅr_(?)
कुस्कूट: ºÀgÀ¼ÀÄ G¸ÀÄPÀÄ
कूच: ¥Àæ0iÀiÁt_(?)
कूट_संकेत: s¸ÀAPÉÃvÀ PÉÆÃqï
कूळ: ªÀA±À PÀÄ® eÁw ªÀUÀð
कूस: ¥Á±Àéð ¥Á±Àéð_¨sÁUÀ ªÀÄUÀÎ®Ä ¥ÀPÀÌ ºÀgÀ¼ÀÄ G¸ÀÄPÀÄ
कृतज्ञताय: PÀÈvÀdÕvÉ C¨sÁj G¥ÀPÁgÀ_¸ÀägÀuÉ
कृती: PÉ®¸À PÀªÀÄð PÁAiÀÄPÀ
कृत्य: PÉ®¸À PÁAiÀÄð PÀªÀÄð PÁAiÀÄPÀ PÀÈvÀå GzÉÆåÃUÀ_(?)
कृत्रीम_उपगिरे: PÀÈvÀPÀ_G¥ÀUÀæºÀ ªÀiÁ£ÀªÀPÀÈvÀ_PÁAiÀÄ
कृत्रीमताय: C¸ÀºÀd C¸Áé¨sÁ«PÀ PÀÈwæªÀÄ PÀÈvÀPÀvÉ ¸ÉÆÃUÀÄ
कृशी_भूंय: ¥sÀ®ªÀvÁÛzÀ_¨sÀÆ«Ä PÀÈ¶¨sÀÆ«Ä
कृषी: PÀÈ¶ ¨ÉÃ¸ÁAiÀÄ ªÀåªÀ¸ÁAiÀÄ MPÀÌ®ÄvÀ£À
कॅलॅण्डर: PÁå®AqÀgï ¢£À¸ÀÆa ¥ÀAZÁAUÀ
केंद्र: PÉÃAzÀæ PÉÃA¢æÃAiÀÄ_¸ÁÜ£À
केंद्रबिंदू: PÉÃAzÀæ_©AzÀÄ PÉÃAzÀæ ªÀÄzsÀå©AzÀÄ
केंद्री_कचेरी: PÉÃAzÀæ_PÀbÉÃj ¥ÀæzsÁ£À_PÀbÉÃj PÉÃA¢æÃ0iÀÄ_PÁ0iÀiÁð®0iÀÄ ªÀÄÄRå_PÀZÉÃj
केंद्रीय_कार्यालय: PÉÃAzÀæ_PÀbÉÃj ¥ÀæzsÁ£À_PÀbÉÃj PÉÃA¢æÃ0iÀÄ_PÁ0iÀiÁð®0iÀÄ ªÀÄÄRå_PÀZÉÃj
केंद्रीय_सुवात: PÉÃAzÀæ PÉÃA¢æÃAiÀÄ_¸ÁÜ£À
केक: PÉÃPï
केरळ: PÉÃgÀ¼À
केवलें: zÉÆÃn eÉÆÃn_PÉÆÃ®Ä GzÀÝ£É_©zÀÄgÀÄPÉÆÃ®Ä
केस्तांव: UÀ¯ÁmÉ dUÀ¼À ¨ÉÊUÀÄ¼À_(?)
कॉलर: PÉÆgÀ¼ÀÄ¥ÀnÖ PÀvÀÄÛ¥ÀnÖ PÀÄwÛUÉ¥ÀnÖ PÁ®gï
कोंडो: PÉÆÃ®Ä §rUÉ zÀAqÀ zÉÆuÉÚ
कोंब: ªÉÆ¼ÀPÉ_MqÉAiÀÄÄªÀÅzÀÄ PÀÄrAiÉÆqÉAiÀÄÄªÀÅzÀÄ aUÀÄgÀÄªÀÅzÀÄ CAPÀÄgÀt
कोकीन: PÉÆÃPï PÉÆPÉÃ£ï
कोगलें: zÉÆÃn eÉÆÃn_PÉÆÃ®Ä GzÀÝ£É_©zÀÄgÀÄPÉÆÃ®Ä
कोठार: ºÀUÉÃªÀÅ ºÀUÉ PÀtd
कोठी: GUÁæt ¨sÀAqÁgÀ zÁ¸ÁÛ£ÀÄ_PÉÆoÀr ºÀUÉÃªÀÅ ºÀUÉ PÀtd
कोडसाण: PÀlÄªÁzÀ PÀ»AiÀiÁzÀ C¦æAiÀÄªÁzÀ
कोडूपण: PÀlÄªÁzÀ PÀ»AiÀiÁzÀ C¦æAiÀÄªÁzÀ
कोत्रायणें: PÀÄAZÀ
कोन: UÉqÉØ_UÉt¸ÀÄ PÉÆÃ£À
कोनसो: PÉÆÃ£À
कोप्रेकार: VgÀ«zÁgÀ ¨sÉÆÃUÀåzÁgÀ FqÀÄzÁgÀ CqÀªÀÅzÁgÀ C©üUÁæºÀPÀ
कोम: ªÉÆ¼ÀPÉ aUÀÄgÀÄ PÀÄr
कोमोड: ¨ÉÃ¸À£ï PÀªÉÆqï_(?)
कोयर: PÀ¸À aA¢ ªÉÃ¸ïÖ PÀ¸À_PÀrØ zÀÆ¼ÀÄ_zÀÄ¥Ààn ªÀÄÄgÀÄPÀ®ÄUÀÄ¥Éà_(?) w¥Éà PÀ¸À_(?)
कोयो: CAqÀPÉÆÃ±À ªÀÈµÀt vÀgÀqÀÄ_(©Ãd)
कोरणें: PÀÄAZÀ
कोर्ट_मार्शल: s¸ÉÊ¤PÀ_£Áå0iÀiÁ®0iÀÄ
कोर्त: QÃ°PÉÊ wgÀÄ¥ÀÅPÉÊ
कोर्द: QÃ°PÉÊ wgÀÄ¥ÀÅPÉÊ
कोलकाता: PÉÆÃ¯ÉÆÌvÀÛ PÉÆ®PÀvÀÛ PÉÆ®ÌvÀÛ PÀ®PÀl
कोळया_घर: eÉÃqÀgÀ§¯É
कोश: ¨sÀAqÁgÀ ¨ÉÆPÀÌ¸À PÉÆÃ±À_(?)
कोसळणी: ¥ÀvÀ£À £Á±À C½ªÀÅ CzsÉÆÃUÀw
कोहिनूर: PÉÆ»£ÀÆgï_ªÀdæ
कौल: C£ÀÄªÀÄw ¸ÀªÀÄäw C£ÀÄªÉÆÃzÀ£É M¦àUÉ ¹éÃPÁgÀ ¹éÃPÀÈw CAVÃPÁgÀ
क्रमहीणटाय: C¸ÀÛªÀå¸ÀÜvÉ PÀæªÀÄ«®è¢gÀÄ«PÉ CªÀåªÀ¸ÉÜ M¥ÀàªÁV®è¢gÀÄ«PÉ PÀæªÀÄgÀ»vÀvÉ
क्रांतिकारी: PÁæAwPÁgÀ §AqÁAiÀÄPÁgÀ
क्रांती: PÁæAw
क्रिडा: Dl PÉÃ½ QæÃqÉ Dl QæÃqÉ PÉÃ½
क्रिया: QæAiÀiÁ¥ÀzÀ QæAiÉÄ ¥ÀæQæAiÉÄ ¤ªÀðºÀt
क्रियापद: QæAiÀiÁ¥ÀzÀ QæAiÉÄ
क्रिश्चन: PÉæöÊ¸ÀÛ PÉæöÊ¸ÀÛ_zsÀ«ÄÃðAiÀÄ
क्रिस्चन: PÉæöÊ¸ÀÛ PÉæöÊ¸ÀÛ_zsÀ«ÄÃðAiÀÄ
क्रिस्तांव: PÉæöÊ¸ÀÛ PÉæöÊ¸ÀÛ_zsÀ«ÄÃðAiÀÄ
क्रुर: ¤zÀð¬Ä_ªÀåQÛ ¤µÀÌgÀÄtÂ PÀÆæj
क्षमताय: AiÉÆÃUÀåvÉ CºÀðvÉ PÀëªÀÄvÉ D¼À ºÀgÀªÀÅ «¸ÁÛgÀ
क्षमा: PÀëªÉÄ ªÀiÁ¦üû PÀë«Ä¸ÀÄªÀÅzÀÄ
क्षय: PÉÆ¼ÉvÀ PÀë0iÀÄ fÃtðvÉ
क्षार: ¥ÀævÁåªÀÄè
क्षेत्र: ¥ÀæzÉÃ±À ¥ÁæAvÀ ¤lÄÖ PÉëÃvÀæ
खंडपीठ: £Áå0iÀÄ¦ÃoÀ
खंत: SÉÃzÀ zÀÄBR §¼À°PÉ ¥ÀjvÁ¥À C£ÀÄvÁ¥À
खंबीरताय: zÀÈqsÀvÉ CZÀ®vÉ ¹ÜgÀvÉ PÀzÀ®zÉ C®ÄUÁqÀzÉ «Ä¸ÀÄPÁqÀzÉ
खगोलविद्वान: RUÉÆÃ¼ÀdÕ RUÉÆÃ¼À±Á¸ÀÛçdÕ
खजानो: ¨sÀAqÁgÀ ¨ÉÆPÀÌ¸À PÉÆÃ±À_(?)
खजूर: PÀdÆðgÀ
खटखट: lPïlPï
खड्डो: PÀÄtÂ vÀUÀÄÎ UÀÄAr ºÉÆAqÀ
खण: ZÀZËÑPÀ ZÀzÀgÀ ZÀvÀÄgÀ¸Àæ_(?) ZÀzÀgÀ ZËPÀ½ ZÀZËÑPÀ ¸ÀªÀÄZÀvÀÄ¨sÀÄðd
खत: ºÉ¥ÀÅöà ªÀÄÄzÉÝ UÉqÉØPÀnÖzÀ_¥ÀzÁxÀð
खप: C£ÀÄ¨sÉÆÃUÀ G¥À¨sÉÆÃUÀ ªÀiÁgÁl RZÁðUÀÄ«PÉ
खबर: eÁÕ£À w½ªÀÅ CjªÀÅ ¸ÀAzÉÃ±À w½¢gÀÄªÀ ¥ÀjavÀ UÉÆwÛgÀÄªÀ ºÉÃ½PÉ ªÀiÁvÀÄ GQÛ ¸ÀAzÉÃ±À ªÉÄ¸ÉÃeï
खबरांपत्र: ¥ÀwæPÉ ¥ÉÃ¥Àgï ¸ÀÄ¢Ý¥ÀwæPÉ ¸ÀªÀiÁZÁgÀ_¥ÀwæPÉ
खर_प्रतिज्ञा: zÀÈqsÀ_¸ÀAPÀ®à UÀnÖ_¤zÁðgÀ ©üÃµÀä_¥ÀæweÉÕ
खरवत: UÀgÀUÀ¸À gÀA¥À PÀæPÀZÀ
खरें: ¸ÀvÀå ¤d AiÀÄxÁxÀðvÉ ªÁ¸ÀÛ«PÀ_¸ÀAUÀw
खरेदी: PÀjÃ¢¸ÀÄ«PÉ PÉÆ¼ÀÄî«PÉ PÉÆAqÀÄPÉÆ¼ÀÄîªÀÅzÀÄ
खर्च: RZÀÄð ªÀå0iÀÄ ªÉZÀÑ
खलनायक: R¼À£ÁAiÀÄPÀ
खलनायिका: R¼À£ÁAiÀÄQ
खलिफा: PÀ°Ã¥sÁ
खळखळ: ClÖºÁ¸À UÀºÀUÀ»¹_£ÀUÀÄ C§âj¹_£ÀUÀÄ
खळें: ªÀÄ£É_ªÀÄÄAzÉ ªÀÄ£É_ªÀÄÄA¨sÁUÀ ¢ªÁ½ ¢ªÁ½vÀ£À £ÁzÁjvÀ£À ¥Á¥ÀgÀÄVj
खळ्ळ: zÀ¥Àà£É zÀqÀªÀiï zÀqÀA
खवदळ: wgÀÄªÀÅ_ªÀÄÄgÀÄªÀÅ vÀ¯É_PÉ¼ÀUÁzÀ §ÄqÀªÉÄÃ¯ÁzÀ UÀzÀÝ® UÀ¯ÁmÉ zÁAzsÀ¯É gÀUÀ¼É
खांच: ¥ÉÇlgÉ ¥ÉÇ¼ÀÄî mÉÆ¼ÀÄî
खाक: §UÀ®Ä PÀAPÀÄ¼ÀÄ PÀAPÀÄ¼ÀÄPÀÄ½ PÀPÀë
खाचकुली: PÀZÀUÀÄ½ ZÀPÀÌ¼ÀUÀÄ½ §Ä¼ÀÄUÀÄnÖ¸ÀÄ«PÉ QQÌ½_ªÀiÁqÀÄ«PÉ
खाजूर: PÀdÆðgÀ
खाट: ºÁ¹UÉ ªÀÄAZÀ ¥À®èAUÀ
खाडी: gÀeÉ ¸ÀÆn ©qÀw
खाण: PÁ¼ÀÄ §Æ¸Á
खातकुतली: PÀZÀUÀÄ½ ZÀPÀÌ¼ÀUÀÄ½ §Ä¼ÀÄUÀÄnÖ¸ÀÄ«PÉ QQÌ½_ªÀiÁqÀÄ«PÉ
खाद्यफळ: w£ÀÄßªÀAvÀºÀ_ºÀtÄÚ SÁzÀå_¥sÀ® ¨ÉÆÃdå_¥sÀ®
खानावळ: ¥sÀ®ºÁgÀªÀÄA¢gÀ ¨sÉÆÃd£ÀªÀÄA¢gÀ
खामसुत्री_बावली: QÃ®ÄUÉÆA¨É ¸ÀÆvÀæzÀUÉÆA¨É
खायलो_ओंठ: PÉ¼ÀzÀÄn CªÀÅqÀÄ
खावड: PÁ¼ÀÄ §Æ¸Á
खाशेलपण: «²µÀ×vÉ CºÀðvÉ ®PÀët UÀÄt «²µÀÖ ªÉÊ²µÀÖ÷å ªÉÊ®PÀëtå
खाशेलो_अधिकार: «±ÉÃµÁ¢üPÁgÀ
खिडकी: QlQ QqÀQ UÀªÁQë ªÁvÁ0iÀÄ£À d£Àß®Ä
खिळी: J¯É ¥Àtð ¥ÀvÀæ
खिसो: eÉÃ§Ä Q¸É
खुदा: C¯Áèºï C¯Áè
खुलासो: ¸Àà¶ÖÃPÀgÀt ¸ÀàµÀÖ£É «±À¢ÃPÀgÀt
खूंट: UÀÆl zÀ¹
खूण: ¸À£Éß ¸ÀAeÉÕ ¸ÀAPÉÃvÀ UÀÄgÀÄvÀÄ aºÉß a£Éí ¸ÀAPÉÃvÀ UÀÄgÀÄvÀÄºÁPÀÄ aºÉßºÁPÀÄ CAPÀ£À ¯ÁAbÀ£À PÀÄgÀÄºÀÄ UÀÄgÀÄvÀÄ ¸ÀAPÉÃvÀ
खून: ºÀvÉå RÆ¤ PÉÆ¯É ªÀzsÉ
खूम: UÀÄgÀÄvÀÄ aºÉß a£Éí ¸ÀAPÉÃvÀ
खेदहिणटाय: zÀÄBR«®è¢gÀÄ«PÉ ±ÉÆÃPÀ«®è¢gÀÄ«PÉ
खेळ: Dl PÉÃ½ QæÃqÉ Dl QæÃqÉ PÉÃ½ ¸ÁºÀ¸À_¥ÀæzÀ±Àð£À PÀ¸ÀgÀwÛ£À_¥ÀæzÀ±Àð£À
खेळगडी: DlUÁgÀ QæÃqÁ¼ÀÄ QæÃqÁ¥ÀlÄ
खेळणें: DnPÉ DlzÀ_¸ÁªÀiÁ£ÀÄ
खेळाडू: DlUÁgÀ QæÃqÁ¼ÀÄ QæÃqÁ¥ÀlÄ
खोंकली: PÉªÀÄÄä PÉªÀÄÄäªÀÅzÀÄ
खोंप: UÀÄr¸À®Ä eÉÆÃ¥Àr PÀÄnÃgÀ
खोंपटी: UÀÄr¸À®Ä eÉÆÃ¥Àr PÀÄnÃgÀ
खोंपूट: UÀÄr¸À®Ä eÉÆÃ¥Àr PÀÄnÃgÀ
खोटें: C¸ÀvÀå ¸ÀÄ¼ÀÄî ºÀÄ¹ ¸ÀmÉ C£ÀÈvÀ
खोटें_नशीब: zË¨sÁðUÀå zÀÄzÉÊðªÀ zÀÄgÀzÀÈµÀ×
खोर्न: ¨sÀnÖ
खोल: DªÀgÀt ¯ÉÃ¥À ZÀªÀÄð ¥ÀgÉ ªÉÆÃ¯ÉÆ¢PÉ PÀªÀZÀ
खोश: GvÁìºÀ ºÀÄªÀÄä¸ÀÄì G¯Áè¸À eÉÆÃ±ï ¸ÀA¨sÀæªÀÄ ¸ÀqÀUÀgÀ G§âmÉ GªÉÄÃzÀÄ
खोस: vÀÈ¦Û ¸ÀAvÀÈ¦Û ¸ÀAvÀÄ¶Ö G¯Áè¸À ºÀµÀð D£ÀAzÀ £À°ªÀÅ ¸ÀAvÉÆÃµÀ
गंगटोक: UÀAUïmÉÆÃPï UÁåAUïmÁPï
गंगा: UÀAUÁ UÀAUÁ£À¢ ¨sÁVgÀy eÁºÀß« ªÀÄAzÁQ¤ ªÀiÁ°¤ £ÀA¢¤ ªÉÊµÀÚ«
गंज: vÀÄPÀÄÌ Q®Ä§Ä
गंडरी: CAqÀPÉÆÃ±À ªÀÈµÀt vÀgÀqÀÄ_(©Ãd)
गंद: ²æÃUÀAzsÀ ZÀAzÀ£À
गंभीरताय: ¸ÀªÀÄavÀÛvÉ avÀÛ¸Áé¸ÀÜ÷å ¥Àæ±ÁAvÀvÉAiÀÄ_¨sÁªÀ ªÀÄ£À¸ÀìªÀiÁzsÁ£À
गज_सेना: UÀd_¸ÉÃ£É UÀd_zÀ¼À D£É_zÀ¼À
गजल: UÀdû¯ï
गजाल: ¸ÀAzÉÃ±À ºÉÃ½PÉ ªÀiÁvÀÄ GQÛ
गजाली: UÉÆÃ¶× ¸À¨sÉ ¸ÀºÀªÁ¸À
गझल: UÀdû¯ï
गट: ¸ÉÊ£Àå zÀAqÀÄ
गडबड: PÉÆÃ¯ÁºÀ® d£ÀdAUÀÄ½ CªÁAvÀgÀ UÀ¯ÁmÉ UÀzÀÝ® wgÀÄªÀÅ_ªÀÄÄgÀÄªÀÅ vÀ¯É_PÉ¼ÀUÁzÀ §ÄqÀªÉÄÃ¯ÁzÀ UÀzÀÝ® UÀ¯ÁmÉ zÁAzsÀ¯É gÀUÀ¼É DvÀÄgÀ¥ÀqÀÄ«PÉ zÀÄqÀÄPÀÄªÀÅzÀÄ ®UÀÄ§UÉ CªÀ¸ÀgÀ vÀégÉ UÀr©r
गडी: DlUÁgÀ QæÃqÁ¼ÀÄ QæÃqÁ¥ÀlÄ
गड्डो: ¥ÀUÀqÉPÁ¬Ä ¥ÀUÀqÉ_DlzÀ_UÀÄAqÀÄ
गणतंत्र_दीस: UÀtgÁdå_¢£À ¥ÀæeÁgÁdå_¢£À
गतिरोध: ¸ÀÜVvÀvÉ ©PÀÌlÄÖ dqÀvÉ_(?)
गतीमापक: ªÉÃUÀ_ªÀiÁ¥ÀPÀ
गनिमी_झूज: UÉÆj¯Áè_AiÀÄÄzÀÞ
गरज: CªÀ±ÀåPÀvÉ ¨ÉÃPÁVgÀÄ«PÉ
गरमी: ©¹®Ä gÀhÄ¼À ©¹ºÀªÉ GµÀÚUÁ½
गरी: UÁ¼À PÉÆAr ¸ÀtÚªÉÆ¼É
गर्दी: GvÀìªÀ ªÉÄgÀªÀtÂUÉ d£À¸ÉÆÛÃªÀÄ d£À_¸ÀªÀÄÆºÀ d£ÀdAUÀÄ½
गर्भपिशवी: UÀ¨sÀðPÉÆÃ±À UÀ¨sÁðµÀ0iÀÄ UÀ¨sÀð
गर्भाशय: UÀ¨sÀðPÉÆÃ±À UÀ¨sÁðµÀ0iÀÄ UÀ¨sÀð
गर्मी: PÁªÀÅ GµÀÚ vÁ¥À ©¸ÀÄ¥ÀÅ
गल्ली: ¸ÀA¢ NtÂ
गळगळो: ¨Á¬Ä_ªÀÄÄPÀÌ½¸ÀÄªÀÅzÀÄ
गळो: PÀAoÀ PÉÆgÀ¼ÀÄ ªÀÄÄAUÉÆgÀ¼ÀÄ ªÀÄÄAUÀvÀÄÛ ªÉÄlgÉ UÉÆÃtÄ UÉÆÃ£Á½
गवायेपांजरो: PÀl_PÀmÉ
गश्त: UÀ¸ÀÄÛ ¥ÀºÀgÉ
गांजा: UÁAeÁ
गांजो: UÁAeÁ_VqÀ ¨sÀAV_VqÀ
गांठ: UÀAlÄ PÀÄtÂPÉ ¸ÀgÀUÀÄtÂPÉ PÀvÀÄÛ PÀÄwÛUÉ UÀAl®Ä §AzsÀ£À »rvÀ ¸ÀàzsÉð ¥Àæw¸ÀàzsÉð
गांठबांधणी: «ªÁºÀ_§AzsÀ_(?)
गांव: £É¯ÉUÉÆ½¸ÀÄªÀÅzÀÄ ªÀ¹Û_ªÀiÁqÀÄªÀÅzÀÄ £É¯É¸ÀÄªÀÅzÀÄ
गांवकार: UÁæªÀÄ¥ÀAZÁ¬ÄÛ_CzÀåPÀëgÀÄ
गांवचो_मुखेली: UÁæªÀÄ¥ÀAZÁ¬ÄÛ_CzÀåPÀëgÀÄ
गांवधनी: UÁæªÀÄ¥ÀAZÁ¬ÄÛ_CzÀåPÀëgÀÄ
गाजर: UÀdÓj PÁågÀlÄÖ
गाडी: PÉÊUÁr PÉÊ§Ar
गाडो: vÀ¼ÀÄîUÁr zÉ§Äâ§Ar
गादी: ¸ÁgÁ¬Ä_CAUÀr ªÀÄzÀåzÀAUÀr ¸ÁgÁ¬Ä_CAUÀr ºÉAqÀzÀAUÀr ªÉÄvÀÛ£É_UÁ¢ ªÉÄvÀÛ£É_D¸À£À UÀzÀÄÝUÉ vÀr UÁ¢ ¸ÀeÉÓ ¯ÉÃ¥ÀÅ ªÉÄvÉÛ
गायत्री: UÀAUÁ UÀAUÁ£À¢ ¨sÁVgÀy eÁºÀß« ªÀÄAzÁQ¤ ªÀiÁ°¤ £ÀA¢¤ ªÉÊµÀÚ«
गायन: UÁ0iÀÄ£À ºÁrPÉ ºÁqÀÄUÁjPÉ ¸ÀAVÃvÀ
गाळ: ¨ÉÊUÀÄ¼À PÉlÖ_ªÀiÁvÀÄ §AiÀÄÄå«PÉ ¤AzÀ£É zÀÆµÀuÉ ¨ÉÊUÀ¼ÀÄ ±Á¥À ¤AzÉ C¥ÀzÀÞ
गावपी_शेवणें: PÀÆUÀÄªÀ_¥ÀQë
गिड्डो: PÀÄ¼Àî VqÀØ ªÉÆÃl PÀÄ§Ó UÀÄeÁÓj ZÉÆÃl
गिन्यान: eÁÕ£À w½ªÀÅ CjªÀÅ CjAiÀÄÄ«PÉ UÀæºÀt ªÉÃzÀ£À UÀæ»PÉ CjAiÀÄÄªÀ_QæAiÉÄ
गिरायक: UÁæºÀPÀ PÉÆ¼ÀÄîªÀªÀ RjÃ¢zÁgÀ VgÁQ
गीत: VÃvÉ ºÁqÀÄ UÁ£À ¥ÀzÀ
गीतकार: VÃvÀgÀZÀ£ÉPÁgÀ VÃvÀPÁgÀ
गुंगताय: vÀ°èÃ£À
गुंडा: ¤ÃZÀ zÀÄµÀÖ._¥ÀÅAqÀ ¥sÀnAUÀ ¥ÉÇÃPÀj ¥ÉÇÃ°
गुंडूक: §ÄUÀÄmÉ UÀzÀÄªÀÅ
गुजरात: UÀÄdgÁvï UÀÄdðgÀ_¥ÀæzÉÃ±À
गुजराती: UÀÄdgÁw
गुढपण: UÀÄlÄÖ gÀºÀ¸Àå UË¥ÀåvÉ
गुणगान: UÀÄtUÁ£À
गुणगूणणी: Q«ªÀiÁvÀÄ UÀÄ¥ÀÛªÀiÁvÀÄ ¦¸ÀÄ¦¸ÀÄ_ªÀiÁvÀÄ
गुणयुक्तताय: M¼ÉîAiÀÄvÀ£À ±ÉæÃµÀ×vÉ
गुणाकार: UÀÄt®§Þ
गुदांव: ºÀUÉÃªÀÅ ºÀUÉ PÀtd
गुदावं: GUÁæt ¨sÀAqÁgÀ zÁ¸ÁÛ£ÀÄ_PÉÆoÀr
गुन्यांवकारी: C¥ÀgÁ¢ü
गुन्यांवपूर्णताय: zÉÆÃµÀ¥ÀÇtð C¥ÀgÁ¢üvÀ
गुपीत_दार: UÀÄ¥ÀÛzÁégÀ UÀÄ¥ÀÛzÁj PÀ¼ÀîQAr gÀºÀ¸Àå_ªÀiÁUÀð
गुपीतपण: UÀÄlÄÖ gÀºÀ¸Àå UË¥ÀåvÉ
गुप्तआंग: d£À£ÁAUÀ UÀÄ¥ÁÛAUÀ
गुप्तहेर: UÀÄmÁÖzÀ_«µÀ0iÀÄ_ºÉÃ¼ÀÄªÀªÀ
गुप्तांग: d£À£ÁAUÀ d£À£ÉÃA¢æAiÀÄ
गुरवाचार: UÀ¨sÁðªÀ¸ÉÜ UÀ¨sÀðzsÁgÀuÉ UÀ¨sÀðªÁ¸À
गुरवारपण: UÀ¨sÁðªÀ¸ÉÜ UÀ¨sÀðzsÁgÀuÉ UÀ¨sÀðªÁ¸À
गुरुद्वारा: UÀÄgÀÄzÁégÀ
गुलगुलो: ºÀÄAr UÀ¯Áè
गुलाब: UÀÄ¯Á©
गुलाब_अत्तर: UÀÄ¯Á©_ªÁ¸À£É_JuÉÚ UÀÄ¯Á©_CvÀÛgÀÄ
गुलाम: UÀÄ¯ÁªÀÄ zÁ¸À vÉÆvÀÄÛ fÃvÀzÁ¼ÀÄ fÃvÀzÁgÀ Cr0iÀiÁ¼ÀÄ
गुलामगिरी: UÀÄ¯ÁªÀÄVj fÃvÀUÁjPÉ zÁ¸Àå
गुल्ल्ताय: vÀ°èÃ£À
गुळो: UÉÆÃ¼À ªÀÄAqÀ®_(?)
गू: »PÉÌ ¦ZÉÑ
गूण: ®PÀët UÀÄt
गृह: ªÀÄ£É UÀÈºÀ ¸ÀzÀ£À ¤®AiÀÄ D®AiÀÄ zsÁªÀÄ
गृहमंत्री: UÀÈºÀªÀÄAwæ ºÉÆÃªÀiï_«Ä¤¸ÀÖgï
गृहोद्योग: PÀÄ®_PÀ¸À§Ä ¸Àé_GzÉÆåÃUÀ ªÀÄ£É_PÀ¸À§Ä UÀÄr_PÉÊUÁjPÉ
गॅलेरी: ¥ÀæzÀ±Àð£À_ªÀÄA¢gÀ avÀæ±Á¯É avÀæªÀÄA¢gÀ UÁå®j
गॅस: UÁå¸ÉÆÃ°Ã£ÀÄ_vÉÊ®
गॅस्टरूम: Cwy_UÀÈºÀ Cyw_PÉÆÃuÉ
गैरवेव्हार: zÀÄªÀðvÀð£É CAiÉÆÃUÀåªÀvÀð£É PÉlÖzÁV_£ÀqÉ¹PÉÆ¼ÀÄîªÀÅzÀÄ
गैरसमज: vÀ¥ÀÅöà_w¼ÀÄªÀ½PÉ vÀ¥ÀÅöà_UÀæ»PÉ vÀ¥ÀÅöà zÉÆÃµÀ
गोंदळ: PÁzÁl dUÀ¼À gÀA¥À_(?) UÀzÀÝ® UÀ¯ÁmÉ zÁAzsÀ¯É gÀUÀ¼É
गोड_खबर: M¼ÉîAiÀÄ¸ÀÄ¢Ý ±ÀÄ¨sÀ_¸ÀªÀiÁZÁgÀ
गोड_बातमी: M¼ÉîAiÀÄ¸ÀÄ¢Ý ±ÀÄ¨sÀ_¸ÀªÀiÁZÁgÀ
गोतावळो: ªÀA±À PÀÄ® eÁw ªÀUÀð
गोफीण: PÀªÉUÉÆÃ®Ä PÀªÀuÉUÉÆÃ®Ä PÁålgï_©®Äè
गोल: PÉÆgÀ¼ÀÄ¥ÀnÖ PÀvÀÄÛ¥ÀnÖ PÀÄwÛUÉ¥ÀnÖ PÁ®gï
गोलकी: UÉÆÃ®ÄUÁgÀ UÉÆÃ®ÄgÀPÀëPÀ
गोली: UÉÆÃ®ÄUÁgÀ UÉÆÃ®ÄgÀPÀëPÀ
गौतम_बुद्ध: UËvÀªÀÄ_§ÄzÀÞ §ÄzÀÞ ¨sÀUÀªÁ£ï_§ÄzÀÞ
गौरवहिणताय: CUËgÀªÀ
ग्रंथी: UÀæAy
ग्राम: UÁæ÷åªÀiï UÁæ÷åA
ग्राहक: UÁæºÀPÀ PÉÆ¼ÀÄîªÀªÀ RjÃ¢zÁgÀ VgÁQ
घंटा: UÀAmÉ
घंटी: PÀgÉUÀAmÉ
घटपण: zÀÈqsÀvÉ CZÀ®vÉ ¹ÜgÀvÉ PÀzÀ®zÉ C®ÄUÁqÀzÉ «Ä¸ÀÄPÁqÀzÉ
घटसाण: zÀÈqsÀvÉ CZÀ®vÉ ¹ÜgÀvÉ PÀzÀ®zÉ C®ÄUÁqÀzÉ «Ä¸ÀÄPÁqÀzÉ PÀoÉÆÃgÀvÉ PÁptåvÉ PÀoÉÆÃgÀvÉ PÁptåvÉ
घटस्फोट: «ZÉÑÃzÀ£À «ªÁºÀ_«ZÉÑÃzÀ£À
घडणूक: QæAiÀiÁ²Ã®vÉ GzÉÆåÃUÀ²Ã®vÉ WÀl£É
घडी: ¸ÀªÀÄAiÀÄ PÁ® UÀAmÉ §wÛ CªÀ¸ÀgÀ vÀégÉ DvÀÄgÀ zÁªÀAvÀ vÀgÁvÀÄj ªÀÄrPÉ ¥ÀzÀgÀÄ
घण: ¸ÀÄwÛUÉ PÉÆqÀw
घणघण: qÀtqÀt qÀuï
घनिश्टताय: ¤PÀl ¸Á«ÄÃ¥Àå
घबायंच: zÀ¥Àà£É zÀqÀªÀiï zÀqÀA
घब्ब: zÀ¥Àà£É zÀqÀªÀiï zÀqÀA
घर: ªÀÄ£É UÀÈºÀ ¸ÀzÀ£À ¤®AiÀÄ D®AiÀÄ zsÁªÀÄ ªÁ¸ÀªÁVgÀÄ«PÉ £É¯É¹gÀÄ«PÉ ªÁ¸ÀªÀiÁqÀÄ«PÉ ZÀZËÑPÀ ZÀzÀgÀ ZÀvÀÄgÀ¸Àæ_(?) ZÀzÀgÀ ZËPÀ½ ZÀZËÑPÀ ¸ÀªÀÄZÀvÀÄ¨sÀÄðd
घरकान्न: UÀÈ»tÂ ºÉAqÀw UÀÈºÀ¸ÉÜ
घरकार: ªÀÄ£ÉAiÉÆqÉAiÀÄ ªÀÄ£É_AiÀÄdªÀiÁ£À ªÀÄ£É_ªÀiÁ°PÀ
घरधनी: ªÀÄ£ÉAiÉÆqÉAiÀÄ ªÀÄ£É_AiÀÄdªÀiÁ£À ªÀÄ£É_ªÀiÁ°PÀ
घरमालक: ªÀÄ£ÉAiÉÆqÉAiÀÄ ªÀÄ£É_AiÀÄdªÀiÁ£À ªÀÄ£É_ªÀiÁ°PÀ
घरमुखेली: ªÀÄ£ÉAiÉÆqÉAiÀÄ ªÀÄ£É_AiÀÄdªÀiÁ£À ªÀÄ£É_ªÀiÁ°PÀ
घराणें: ªÀA±À PÀÄ® eÁw ªÀUÀð
घरावे: ¸ÀA§A¢üPÀgÀÄ ¥ÀjªÁgÀzÀªÀgÀÄ PÀÄlÄA§zÀªÀgÀÄ £ÉAlgÀÄ
घळ: PÀAzÀPÀ CUÀ¼ÀvÉ
घस: ªÀÄ¹ PÀ¥ÀÅöà PÀÄrPÀ¥ÀÅöà
घातकी: C«±Áé¹ £ÀA©UÀ¸ÀÜ£À®èzÀªÀ
घालमेल: vÉÆ¼À¯Ál vÀ¼ÀªÀÄ¼À
घुंगरू: UÉeÉÓ QgÀÄUÀAmÉ £ÀÆ¥ÀÅgÀ PÁ®AzÀÄUÉ
घुंवळे_वखद: ªÀiÁzÀPÀ_¥ÀzÁxÀð
घूस: ®AZÀ gÀÄµÀÄªÀvÀÄÛ
घेरो: ªÀÄÄwÛUÉ DPÀæªÀÄ zÁ½
घोंट: UÀÄlÄPÀÄ
घोंटेर: UÀÆqÀÄ ¤ÃqÀ
घोट: ¨Á¬Ä_ªÀÄÄPÀÌ½¸ÀÄªÀÅzÀÄ
घोडो: ZÁ¥ÀÅ_¸À£ÉßQÃ®Ä QÃ®Ä næUÀgï PÀÄzÀÄgÉ C±Àé
घोरेवणी: UÉÆgÀPÉ
घोल: UÀÄºÉ UÀ« ©® qÉÆUÀgÀÄ
घोशणा: WÉÆÃµÀuÉ §»gÀAUÀ_ºÉÃ½PÉ
चंचळटाय: DvÀAPÀ PÀ¼ÀªÀ¼À £ÉªÀÄä¢¬Ä®è¢gÀÄªÀÅzÀÄ ZÀAZÀ® ZÀ¥À®.vÀÄAl
चंदन: ²æÃUÀAzsÀ ZÀAzÀ£À
चकाटां: UÉÆÃ¶× ¸À¨sÉ ¸ÀºÀªÁ¸À
चक्र: ªÀvÀÄð® ªÀÈvÀÛ UÉÆÃ® ZÀPÀæ ZÀPÀæ UÁ° gÁmÉ ZÀPÀæ UÁ°
चक्रम: ªÀÄÆRð ¨ÉÃPÀÆ¥sóÀ
चक्रमपण: ªÀÄÆRðvÀ£À C«ªÉÃPÀ zÀqÀØvÀ£À
चट: ªÀå¸À£À ¯Á®¸É ZÀl
चडसाण: CvÀå¢üPÀ C¥Àj«ÄvÀvÉ ºÉÃgÀ¼ÀªÁVgÀÄ«PÉ «¥ÀÅ®vÉ ¥ÀÅµÀÌ®vÉ
चडसो_भाग: C¢üPÁA±À C¢üPÀ¨sÁUÀ ºÉZÀÄÑ¥Á®Ä §ºÀÄ¨sÁUÀ
चतूर: §Ä¢ÞªÀAvÀ §Ä¢ÞfÃ« eÁÕ£ÀªÀAvÀ ªÉÄÃzsÁ« ¥ÁædÕ
चत्राय: ªÀÄÄ£ÀÆìZÀ£É ¸ÀÆZÀ£É JZÀÑjPÉ ¸ÀÄ½ªÀÅ
चपरासी: dªÁ£À ¹¥Á¬Ä ¸ÉÃªÀPÀ QAPÀgÀ ¦ªÁ£À
चमक: ºÉÆ¼À¥ÀÅ «ÄgÀÄUÀÄ ¥ÀæPÁ±ÀªÀiÁ£À
चमत्कार: CZÀÑj ZÀªÀÄvÁÌgÀ «¸Àä0iÀÄ ¸ÉÆÃfUÀ PÀlÖZÀÑj ¤¨ÉâgÀUÀÄ EAzÀæeÁ® eÁzÀÆ
चर: PÀAzÀPÀ CUÀ¼ÀvÉ
चर्चा: ªÀiÁvÀÄPÀvÉ ¸ÀA¨sÁµÀuÉ ¸À¯Áè¥À «ZÁgÀ-«ªÀÄ±Éð «ªÀÄ±Éð
चलन: ZÀ®£ï ©¯ïè
चळवळ: DAzÉÆÃ®£À ZÀ¼ÀÄªÀ½ vÉÆ¼À¯Ál vÀ¼ÀªÀÄ¼À PÁæAw
चळवळी: PÁæAwPÁgÀ §AqÁAiÀÄPÁgÀ
चवकट: ZËPÀlÄÖ PÀlÄÖ ºÀAzÀgÀ ¥ÉæÃªÀiï
चवकशी: «ZÁgÀuÉ vÀ¤PÉ ±ÉÆÃzsÀ£É vÀ¤SÉ «ZÁgÀuÉ ¥ÀjÃPÉë
चवथी: ZËw £Á®ÄÌ £Á®Ì£É_vÁjÃRÄ_(?)
चवदा: ºÀ¢£Á®ÄÌ
चांचे: PÀqÀ®Î¼Àî
चाक: ZÀPÀæ UÁ° gÁmÉ ZÀPÀæ UÁ°
चाकर: dªÁ£À ¹¥Á¬Ä ¸ÉÃªÀPÀ QAPÀgÀ ¦ªÁ£À
चाकि: ªÀvÀÄð® ªÀÈvÀÛ UÉÆÃ® ZÀPÀæ
चाडी: UÁ½ªÀiÁvÀÄ ªÀzÀAw ¥ÀÅPÁgÀÄ
चाप: ZÁ¥ÀÅ_¸À£ÉßQÃ®Ä QÃ®Ä næUÀgï
चार: ZËw £Á®ÄÌ £Á®Ì£É_vÁjÃRÄ_(?)
चार_तारीख: ZËw £Á®ÄÌ £Á®Ì£É_vÁjÃRÄ_(?)
चारो: ªÉÄÃªÀÅ ºÀ¹_ºÀÄ®Äè ¸ÉÆ¥ÀÅöà-¸ÀzÉ PÁ¼ÀÄ §Æ¸Á
चाल: ¯ÉÆÃPÀgÀÆrü ¯ÉÆÃPÀ_ªÁåªÀºÁgÀ ªÀÄvÁZÀgÀuÉ zsÁ«ÄðPÀ«¢ü ¸ÀA¸ÁÌgÀ PÀªÀÄð AiÀÄÄQÛ G¥ÁAiÀÄ vÀAvÀæ ºÀÆl
चालक: ZÁ®PÀ qÉÊªÀgï qÉæöÊªÀgï
चालचलणूक: £ÀqÀªÀ½PÉ £ÀqÁªÀ½ ªÀvÀð£É
चाळे: ¸À£Éß PÉÊ¸À£Éß_¨ÁAiÀÄì£Éß
चावडी: PÀÆqÀÄgÀ¸ÉÛ PÀÆqÀÄºÁ¢
चावी: QÃ°PÉÊ wgÀÄ¥ÀÅPÉÊ
चिंतक: aAvÀPÀ «ZÁgÀªÀAvÀ PÀÄ±ÁUÀæ
चिंतन: aAvÀ£É AiÉÆÃZÀ£É D¯ÉÆÃZÀ£É
चिंता: aAvÉ ªÀåxÉ
चिकूपण: f¥ÀÅtÄvÀ£À PÀÈ¥ÀtvÀ£À PÁ¥Àðtå ¯ÉÆÃ©üvÀ£À
चिकोल: PÀ¸À aA¢ ªÉÃ¸ïÖ ¨ÉªÀgÀÄ_(?) PÉÆ¼É PÉÆ¼ÀPÀÄ ºÉÆ®¸ÀÄ PÀ®ä±À
चितना: «ZÁgÀ aAvÀ£É D¯ÉÆÃZÀ£À_«zsÁ£À LrAiÀiÁ
चित्त: ªÀÄ£À¸ÀÄì avÀÛ UÀªÀÄ£À
चित्र: avÀæ ¥ÉÇÃmÉÆÃ
चिन्न: UÀÄgÀÄvÀÄ aºÉß a£Éí ¸ÀAPÉÃvÀ
चींव: ªÉÆ¯ÉvÉÆlÄÖ ¸ÀÛ£ÀUÀæAy
चीर: ©gÀÄPÀÄ MqÀPÀÄ ¹Ã¼ÀÄ ¸ÀAzÀÄ ©gÀÄQ¤AzÁzÀ_eÁUÀ
चुकीची_खूण: vÀ¥ÀÅöàa£Éí zÉÆÃµÀzÀ_aºÉß
चुचू: ªÉÆ¯ÉvÉÆlÄÖ ¸ÀÛ£ÀUÀæAy
चूक_खूण: vÀ¥ÀÅöàa£Éí zÉÆÃµÀzÀ_aºÉß
चूल: CqÀÄUÉ_PÉ®¸À
चेतनाहीणटाय: ZÉÃvÀ£À_gÀ»vÀ CZÉÃvÀ¤ÃAiÀÄ
चेर: CvÀÛgÀÄ ¥À¤ßgÀÄ ªÁ¸À£É_JuÉÚ
चैतन्यताय: ZÉÊvÀ£Àå ZÉÃvÀ£À
चोर: zÀUÀ¯Áâf PÉÆ¼ÉîUÁgÀ ®ÆnUÁgÀ zÁ½UÁgÀ ¸ÀÄ°UÉ_ªÀiÁqÀÄªÀªÀ ¸ÀÆgÉ_ºÉÆqÉAiÀÄÄªÀ
चोरदरवटो: UÀÄ¥ÀÛzÁégÀ UÀÄ¥ÀÛzÁj PÀ¼ÀîQAr gÀºÀ¸Àå_ªÀiÁUÀð
चौक: PÀÆqÀÄgÀ¸ÉÛ PÀÆqÀÄºÁ¢
चौकट: ZÀzÀgÀ ZËPÀ½ ZÀZËÑPÀ ¸ÀªÀÄZÀvÀÄ¨sÀÄðd
चौकण: ZËPÀ½_§mÉÖ
चौकोनी_कंस: zÉÆqÀØ_DªÀgÀt zÉÆqÀØ_DªÀgÀt_aºÉß[.......]
चौदा: ºÀ¢£Á®ÄÌ
चौपाटो: PÀÆqÀÄgÀ¸ÉÛ PÀÆqÀÄºÁ¢
च्या: ZÀºÀzÀ_¥ÀÅr nÃ_¥ÀÅr
च्यापालो: ZÀºÀzÀ_¥ÀÅr nÃ_¥ÀÅr
छाप: ªÉÆºÀgÀÄ ªÀÄÄzÉæ oÀ¸Éì ¹Ã®Ä ªÀÄÄzÉæ CZÀÄÑ CZÀÄÑ ¥ÀrAiÀÄZÀÄÑ
जंतू: fÃªÀ ¥Áæt ZÉÃvÀ£À gÉÆÃUÁtÄ ¸ÀÆPÁë÷ätÄ_fÃ« ¨ÁåQÖÃjAiÀiÁ
जंतूनाशक: Ql£Á±ÀPÀ Qæ«Ä£Á±ÀPÀ
जग: ºÀÆf
जठराग्नी: doÀgÀ
जड_काम: PÀµÀÖzÀ_PÉ®¸À PÀpt_PÉ®¸À
जडसाण: ¨sÁgÀªÁVgÀÄ«PÉ vÀÆPÀ«gÀÄ«PÉ
जडाय: ªÉÄÊªÀÄÄjAiÀÄÄ«PÉ
जन: d£À d£ÀvÉ d£ÀgÀÄ d£ÀªÀiÁ£À¸À
जनक: d£ÀPÀ d£ÀäzÁvÀ ¸ÀA¸ÁÜ¥ÀPÀ
जनता: d£À d£ÀvÉ d£ÀgÀÄ d£ÀªÀiÁ£À¸À ¥ÀæeÉ £ÁUÀjPÀ ¸ÀézÉÃ²ÃAiÀÄ zÉÃ²ÃAiÀÄ
जनन_आंग: d£À£ÁAUÀ UÀÄ¥ÁÛAUÀ
जननांग: d£À£ÁAUÀ d£À£ÉÃA¢æAiÀÄ
जननेंद्रीय: d£À£ÁAUÀ d£À£ÉÃA¢æAiÀÄ
जनरेटर: d£ÀgÉÃlgï
जनसमूह: d£À¸ÉÆÛÃªÀÄ d£À_¸ÀªÀÄÆºÀ d£ÀdAUÀÄ½
जनसेवा: ¯ÉÆÃPÉÆÃ¥ÀPÁgÀ d£À_PÀ¯Áåt d£À_¸ÉÃªÉ ¯ÉÆÃPÁxÀð
जनावर: ¥ÁætÂ dAvÀÄ ªÀÄÈUÀ ¥À±ÀÄ
जनेल: QlQ QqÀQ UÀªÁQë ªÁvÁ0iÀÄ£À d£Àß®Ä
जबर: ¨ÉzÀjPÉ
जबाबदारी: dªÁ¨ÁÝj ºÉÆuÉUÁjPÉ
जमाखोर: ¸ÀAUÀæºÀPÁgÀ PÀÆrqÀÄªÀªÀ PÀ¯ÉºÁPÀÄªÀªÀ
जमीन: £É® ¸ÀÜ¼À ¨sÀÆ«Ä
जमीनदार: d«ÄÃ£ÁÝgÀ d«ÄÃ£ÀÄzÁgÀ »qÀÄªÀ½zÁgÀ ¨sÀÆªÀiÁ°ÃPÀ d«ÄÃ¤£À_MqÉ0iÀÄ
जम्मू-काश्मीर: PÁ²äÃgÀ dªÀÄÄä_PÁ²äÃgÀ
जलक्रिडा: d®QæÃqÉ d®«ºÁgÀ
जलचर: d®ZÀgÀ_¥ÁætÂ
जलराश: d®gÁ²
जल्म: GzÀAiÀÄ DgÀA¨sÀ GvÀàwÛ C«¨sÁðªÀ
जल्मभूंय: d£Àä¨sÀÆ«Ä ªÀiÁvÀÈ¨sÀÆ«Ä d£Àä¸ÁÜ£À d£Àä¸ÀÜ¼À
जल्मरास: gÁ² gÁ²_ZÀPÀæ
जल्मवेळ: d£ÀäPÁ® d£À£ÀzÀ_¸ÀªÀÄAiÀÄ ºÀÄnÖzÀ_¸ÀªÀÄAiÀÄ
जल्मसुवात: d£Àä¨sÀÆ«Ä ªÀiÁvÀÈ¨sÀÆ«Ä d£Àä¸ÁÜ£À d£Àä¸ÀÜ¼À
जल्माचो_वेळ: d£ÀäPÁ® d£À£ÀzÀ_¸ÀªÀÄAiÀÄ ºÀÄnÖzÀ_¸ÀªÀÄAiÀÄ
जहाज: zÉÆqÀØ_zÉÆÃtÂ £ÁªÉ_(?)
जांबय: DPÀ½PÉ dÈA¨sÀt
जागो: ¥ÀæzÉÃ±À ¥ÁæAvÀ ¤lÄÖ PÉëÃvÀæ
जाण: ¸ÀAªÉÃzÀ£É ¨sÁªÉÇÃzÉæÃPÀ
जाणटी: ªÀÈzÉÞ ªÀÄÄzÀÄQ CfÓ
जाती: eÁw ªÀUÀð
जादू: EAzÀæeÁ® eÁzÀÆ
जाप: GvÀÛgÀ dªÁ§Ä ªÀiÁ£ÀÄðr ªÀÄgÀÄªÀiÁvÀÄ
जापसालदारकी: dªÁ¨ÁÝj ºÉÆuÉUÁjPÉ
जायरात: «eÁÕ¥À£É ªÀÄ£À« ©ü£ÀßºÀ
जार्दीन: ºÀÆ_GzÁå£ÀªÀ£À
जाळ: eÉÃqÀgÀ§¯É
जिणेवर्णन: fÃªÀ£À_ZÀjvÉæ DvÀäPÀxÉ
जिद्द: ºÀoÀªÀiÁjvÀ£À
जिनस: ¥ÀzÁxÀð
जिराफ: fgÁ¥sóÉ
जिल्लोधिकारी: f¯Áè¢üPÁj f¯Áè_zsÀAqÁ¢PÁj PÀ¯ÉPÀÖgï
जिवन_चरित्र: fÃªÀ£À_ZÀjvÉæ DvÀäPÀxÉ
जिवाणू: ¨ÁåQÖÃjAiÀiÁ
जिवाश्म: ¥À¼ÉAiÀÄÄ½PÉ fÃªÀåªÀ±ÉÃµÀ_¥sóÁ¹¯ÁzÀ
जीव: ¥ÁætÂ dAvÀÄ ªÀÄÈUÀ ¥À±ÀÄ fÃªÀ ¥Áæt ZÉÃvÀ£À
जीवसाण: ZÉÊvÀ£Àå ZÉÃvÀ£À
जुगार: dÆdÄ.dÆeÁl
जून: dÆ£ï
जेझू: K¸ÀÄQæ¸ÀÛ fÃ¸À¸ï
जैत: ¸ÁzsÀ£É £ÉgÀªÉÃjPÉ FqÉÃjPÉ
जोंतगाडी: JwÛ£À_UÁr PÀÄzÀÄgÉ_UÁr
जोड_कुटुंब: PÀÆqÀÄ_PÀÄlÄA§ C«¨sÀPÀÛ_PÀÄlÄA§
जोडपें: eÉÆÃr eÉÆvÉ zÀA¥Àw
जोडी: eÉÆÃr eÉÆvÉ
जोश: GvÉÛÃd£À G¢ÝÃ¥À£À ¥ÀæZÉÆÃzÀ£À
ज्ञान: eÁÕ£À w½ªÀÅ CjªÀÅ CjAiÀÄÄ«PÉ UÀæºÀt ªÉÃzÀ£À UÀæ»PÉ CjAiÀÄÄªÀ_QæAiÉÄ ¤Ãw G¥ÀzÉÃ±À eÁÕ£À w½ªÀÅ
ज्ञानेंद्रीय: eÁÕ£ÉÃA¢æAiÀÄ
ज्योक: ºÁ¸ÉÆåÃQÛ vÀªÀiÁµÉ eÉÆÃPï
ज्वाळा: eÁé¯É Gj
झगडें: UÀ¯ÁmÉ dUÀ¼À ¨ÉÊUÀÄ¼À_(?)
झांपड: £À¸ÀÄ¤zÉæ
झाडणी: UÀÄr¸ÀÄªÀÅzÀÄ ¨ÁaºÁPÀÄªÀÅzÀÄ
झाडप: UÀÄr¸ÀÄªÀÅzÀÄ ¨ÁaºÁPÀÄªÀÅzÀÄ
झापड: ¥ÀgÀzÉ ¥ÉÇgÉ vÉÆUÀmÉ_(?)
झीळ: ¥ÉÇzÀgÀÄ ¥ÉÇzÉ PÀAmÉ PÀÄgÀÄZÀ®Ä_VqÀ UÀÄ®ä
झुजकैदी: AiÀÄÄzÀÞPÉÊ¢ AiÀÄÄzÀÞ§A¢ü
झुजबंदी: AiÀÄÄzÀÞPÉÊ¢ AiÀÄÄzÀÞ§A¢ü
झुजवाद्य: gÀt_PÀºÀ¼É 0iÀÄÄzÀÞ_PÀºÀ¼É
झुजांभूंय: gÀtgÀAUÀ 0iÀÄÄzÀÞgÀAUÀ 0iÀÄÄzÀÞ¨sÀÆ«Ä ¸ÀªÀÄgÁAUÀt
झूज_बावटो: AiÀÄÄzÀÞ¥ÀvÁPÉ AiÀÄÄzÀÞ_zÀéd
झूज_विराम_बावटो: AiÀÄÄzÀÞ«gÁªÀÄ_zÀéd AiÀÄÄzÀÞ«gÁªÀÄ_©½zÀéd
झेत: M£À¥ÀÅ_MAiÀiÁågÀ dA¨sÀ CºÀAPÁgÀ UÀªÀð Mt¥ÀæwµÉ× zÉÆqÀØ¹ÛPÉ
झोंप: ¥ÉÇzÀgÀÄ ¥ÉÇzÉ PÀAmÉ PÀÄgÀÄZÀ®Ä_VqÀ UÀÄ®ä
झोपां: ¥ÉÇzÉ PÀÄgÀÄZÀ®Ä_PÁqÀÄ
टंकार: oÉÃAPÁgÀ
टक: £ÉlÖ£ÉÆÃl ¢nÖ¹zÀ_£ÉÆÃl JªÉ¬ÄPÀÌzÀ_£ÉÆÃl
टकटक: lPïlPï
टणकसाण: PÀoÉÆÃgÀvÉ PÁptåvÉ
टणटण: qÀtqÀt qÀuï
टणत्कार: oÉÃAPÁgÀ
टप-टप: ¥Àmï_¥Àmï lPï_lPï_(?)
टपटप: ¥Àmï_¥Àmï lPï_lPï_(?)
टाळणी: PÁ®ºÀgÀt PÁ®vÀ¼ÀÄî«PÉ
टाळाटाळ: PÁ®ºÀgÀt PÁ®vÀ¼ÀÄî«PÉ
टिका: ¥ÀjºÁ¸À ºÀtPÀ «£ÉÆÃzÀ ZÉÃµÉÖ ¤AzÉ
टिकाकार: «ªÀÄ±ÀðPÀ «ªÉÃZÀPÀ «ZÁgÀPÀ
टिपणी: n¥ÀàtÂ £ÉÆÃmï Cr_n¥ÀàtÂ
टीका: ªÀåAUÀå ªÀåAUÉÆåÃQÛ PÀ»£ÀÄr Ej£ÀÄr PÉÆAPÀÄ£ÀÄr ªÀÄÆzÀ°PÉ
टेप: ¥ÀnÖ ¯Ár mÉÃ¥ÀÅ
टोपणनांव: CqÀØºÉ¸ÀgÀÄ G¥À£ÁªÀÄ
ट्रस्ट: læ¸ïÖ PÀÆqÀÄªÁå¥ÁgÀ_¸ÀA¸ÉÜ £Áå¸À
ठग: zÀUÀ¯Áâf
ठप्प: ¸ÀÜVvÀ ¤±ÀÑ®
ठसो: CZÀÄÑ ¥ÀrAiÀÄZÀÄÑ
ठांयबसणी: ªÀ¸ÁºÀvÀÄ ¥Á¼É0iÀÄ
ठाणेदार: E£ïì¥ÉPÀÖgï
ठेंगू: PÀÄ¼Àî VqÀØ ªÉÆÃl PÀÄ§Ó UÀÄeÁÓj ZÉÆÃl
ठोक: ¸ÀUÀlÄ ºÉÆÃ¯ï¸ÉÃ¯ï
डबो: ¸ÀtÚqÀ©â QgÀÄ_qÀ©â
डाव: ¨Áf ¥Àt ¥ÀAvÀ dÆdÄ
डावपेच: AiÀÄÄQÛ G¥ÁAiÀÄ vÀAvÀæ ºÀÆl
डिपो: §¸ï_¤¯ÁÝt §¸ï_¸ÁÖAqï
डेसीमल: zÀ±ÀªÀiÁA±À_©AzÀÄ ZÀÄPÉÌ
ड्रायवर: ZÁ®PÀ qÉÊªÀgï qÉæöÊªÀgï
ढब्ब: zÀ¥Àà£É zÀqÀªÀiï zÀqÀA
ढम्म: zÀ¥Àà£É zÀqÀªÀiï zÀqÀA
ढीग: gÁ² UÀÄA¥ÀÅ ¸ÀªÀÄÆºÀ
ढोंगीपण: PÀ¥Àl ªÉÆÃ¸À £Àl£É ¸ÉÆÃUÀÄ
तंत्र: ªÀåªÀ¸ÉÜ ªÀÇåºÀ ªÀÄAqÀ®
तक्रार: ¥ÀæwªÁzÀ RAqÀ£É «gÉÆÃzsÀ
तड: £À¢_zÀAqÉ
तत्व: vÀvÀé ¹zÁÞAvÀ zÁvÀÄ WÀlPÀ CA±À
तपशील: dªÀiÁ_Rað£À_¥ÀÅ¸ÀÛPÀ SÁvÉ_Q¢ð
तपास: ±ÉÆÃzsÀ ¥ÀvÉÛ ºÀÄqÀÄPÀÄ«PÉ C£ÉéÃµÀuÉ ±ÉÆÃzsÀ£É vÀ¥Á¸ÀuÉ
तपासणी: aQvÉì G¥ÀZÁgÀ «ZÁgÀuÉ vÀ¤PÉ ±ÉÆÃzsÀ£É ¸Àà¶ÖÃPÀgÀt zÀÈrüÃPÀgÀt ¥ÀæªÀiÁtÂÃPÀgÀt vÀ¤SÉ «ZÁgÀuÉ ¥ÀjÃPÉë
तबेलो: PÀÄzÀÄgÉ¯ÁAiÀÄ C±Àé±Á¯É
तयारी: vÀAiÀiÁj ¹zÀÝvÉ ¸ÀdÄÓ CtÂ ¸À£ÁßºÀ ¸ÀªÀgÀuÉ
तरणाटी: £ÀªÀAiÀÄÄªÀw AiÀÄÄªÀw
तरणाटे: AiÀÄÄªÀPÀ vÀgÀÄt AiÀiËªÀé£ÀzÀ
तरणाटो: ºÀ¢ºÀgÉAiÀÄzÀ_ºÀÄqÀÄUÀ £ÀªÀ_AiÀÄÄªÀPÀ ºÀgÉAiÀÄzÀ_AiÀÄÄªÀPÀ
तर्क: C£ÀÄªÀiÁ£À CAzÁdÄ HºÉ vÀPÀð ªÁzÀ ZÀZÉð
तळ: vÀ¼À PÉ¼À Cr PÉ¼À¨sÁUÀ §ÄqÀ Cr vÀUÀÄÎ
तळकूड: £É®ªÀiÁ½UÉ £É®ªÀÄ£É vÀ¼ÀªÀÄ£É
तळी: CuÉPÀlÄÖ d¯Á±ÀAiÀÄ DuÉPÀlÄÖ d¯Á±ÀAiÀÄ qÁåªÀiï
तळें: CuÉPÀlÄÖ d¯Á±ÀAiÀÄ DuÉPÀlÄÖ d¯Á±ÀAiÀÄ qÁåªÀiï
तवशें: ¸ËvÉÃPÁ¬Ä ¸ËvÉÃ§½î
तस्कर: PÀ¼Àî¸ÁUÀuÉUÁgÀ
तस्करी: PÀ¼Àî¸ÁUÀuÉ
तह: ¸ÀAzsÁ£À gÁf M¥ÀàAzÀ
तांक: §®±Á° ¸ÀªÀÄxÀðPÀ vÁPÀvï_EgÀÄªÀªÀ ±ÀQÛªÀAvÀ UÀnÖUÀ vÁ¼ÀÄªÀ_¸ÁªÀÄxÀåð ±ÀQÛ AiÉÆÃUÀåvÉ AiÉÆÃUÀåvÉ CºÀðvÉ PÀëªÀÄvÉ D¼À ºÀgÀªÀÅ «¸ÁÛgÀ ±ÀQÛ PÀ¸ÀÄªÀÅ D¥ÀÅ C¼ÀªÀÅ §®
तांदूळ: CQÌ
ताई: zÉÆqÀØPÀÌ
ताकतिकेन: ²ÃWÀæ ¨ÉÃUÀ vÀégÉ ªÉÃUÀ Që¥Àæ
ताकद: §®±Á° ¸ÀªÀÄxÀðPÀ vÁPÀvï_EgÀÄªÀªÀ ±ÀQÛªÀAvÀ UÀnÖUÀ
ताग: ¸Ét§Ä UÉÆÃtÂ dÆmï
तागडेचो_दांडो: vÀPÀÌr_zÀArUÉ
ताजमहाल: vÁdªÀÄºÀ¯ï vÁeï
ताबो: ¸ÀAAiÀÄªÀÄ
तामीळ: vÀ«Ä¼ÀgÀÄ
तामीळनाडू: vÀ«Ä¼ï£ÁqÀÄ vÀ«Ä¼ÀÄ_£ÁqÀÄ
तारूं: zÉÆqÀØ_zÉÆÃtÂ £ÁªÉ_(?)
तारो: £ÀPÀëvÀæ vÁgÉ ZÀÄQÌ DPÁ±À_PÁAiÀÄ
तालीम: ¥ÀÇªÁð¨Áå¸À jºÀ¸Àð¯ï ¸ÀégÀ_¸ÁzsÀ£É ¸ÀAVÃvÀ_C¨Áå¸À C¨Áå¸À vÀgÀ¥ÉÃvÀÄ vÀgÀ¨ÉÃw
ताळमेळ: ¸ÁªÀÄAd¸Àå ¸ÁAUÀvÀå
ताळो: PÀAoÀ PÉÆgÀ¼ÀÄ ªÀÄÄAUÉÆgÀ¼ÀÄ ªÀÄÄAUÀvÀÄÛ ªÉÄlgÉ UÉÆÃtÄ UÉÆÃ£Á½
तावेर्न: ¸ÁgÁ¬Ä_CAUÀr ªÀÄzÀåzÀAUÀr ¸ÁgÁ¬Ä_CAUÀr ºÉAqÀzÀAUÀr
तास: vÁ¸ÀÄ
तिकेट: nPÉÃmï wQÃlÄ zÀgÀ
तिजोरी: PÉÆÃ±ÁUÁgÀ ¨sÀAqÁgÀ
तिठो: ªÀÄÆgÀÄ_gÀ¸ÉÛUÀ¼ÀÄ_PÀÆqÀÄªÀ_¸ÀÜ¼À wgÀÄªÀÅ
तिडक: ¹lÄÖ PÉÆÃ¥À DPÉÆæÃ±À ¹nÖ£À_PÀÆUÁl ¹mÁÖUÀÄ«PÉ PÉÆÃ¦¹PÉÆ¼ÀÄî«PÉ PÉÆæÃzsÀUÉÆ¼ÀÄî«PÉ
तिबो: ZÀÄQÌ ©AzÀÄ
तिरायत: ¥ÀgÀQÃAiÀÄ C£Àå ºÉÆgÀV£ÀªÀ
तिस्क: ªÀÄÆgÀÄ_gÀ¸ÉÛUÀ¼ÀÄ_PÀÆqÀÄªÀ_¸ÀÜ¼À wgÀÄªÀÅ
तुरी: KªÀiÁj¸ÀÄ PÀÄvÀAvÀæ PÀÄAiÀÄÄQÛ ªÉÆÃ¸À
तुळा: ¸ÀªÀiÁ£ÀvÉ ¸ÀªÀÄvÉÆÃ®£À ¸ÀAvÀÄ®£À
तुस्त: GzÁÎgÀ
तुस्तगीत: UÀÄtUÁ£À 0iÀÄ±ÉÆÃUÁxÉ
तूळ: vÀÄ¯Á vÀÄ¯Á_gÁ²
तूळा: ºÉÆÃ°PÉ G¥ÀªÉÄ ¸ÁªÀÄå ¸ÁzÀÈµÀå
तृप्ती: vÀÈ¦Û ¸ÀAvÀÈ¦Û ¸ÀAvÀÄ¶Ö
तेंको: ¸ÀºÁAiÀÄ £ÉgÀªÀÅ ¸ÀºÀPÁgÀ MvÁÛ¸É
तेंगशी: ¥ÀªÀðvÀ_²RgÀ ¨ÉlÖzÀ_vÀÄ¢ »ªÀiÁ®AiÀÄzÀ_±ÀÈAUÀ ²RgÀ vÀÄ¢ vÀÄlÖvÀÄ¢ CUÀæ¸ÁÜ£ÀzÀ GvÀÛªÉÆÃvÀÛªÀÄ vÀÄvÀÛvÀÄ¢AiÀÄ ¢£Éß aPÀÌUÀÄqÀØ vÉªÀgÀÄ
तेंगशेचो_भाग: CUÀæ¸ÁÜ£ÀzÀ GvÀÛªÉÆÃvÀÛªÀÄ vÀÄvÀÛvÀÄ¢AiÀÄ
तेज: vÉÃd¹é PÁAwAiÀÄÄ¼ÀîªÀ ¸ÀªÀÄxÀð ¥Àæ¨sÁªÀ±Á° «ÄAZÀÄ ¥ÀæPÁ±À ºÉÆ¼À¥ÀÅ ¸ËAzÀAiÀÄð MAiÀiÁågÀ
तेजस्वीपण: vÉÃd¹é PÁAwAiÀÄÄ¼ÀîªÀ ¸ÀªÀÄxÀð ¥Àæ¨sÁªÀ±Á°
तेप: ¸ÀªÀÄAiÀÄ PÁ® UÀAmÉ 0iÀÄÄUÀ ±ÀPÀ
तेमूक: ¥ÀªÀðvÀ_²RgÀ ¨ÉlÖzÀ_vÀÄ¢ »ªÀiÁ®AiÀÄzÀ_±ÀÈAUÀ ²RgÀ vÀÄ¢ vÀÄlÖvÀÄ¢ CUÀæ¸ÁÜ£ÀzÀ GvÀÛªÉÆÃvÀÛªÀÄ vÀÄvÀÛvÀÄ¢AiÀÄ
तेल: JuÉÚ vÉÊ®
तोंक: ªÀÄÄA¨sÁUÀ ªÀÄÄAzÉ ªÉÆzÀ®¸ÁÜ£À ²RgÀ vÀÄ¢ vÀÄlÖvÀÄ¢ CAZÀÄ vÀÄ¢
तोंखणायगीत: 0iÀÄ±ÉÆÃUÁxÉ
तोखणाय: GzÁÎgÀ
तोखणायगीत: UÀÄtUÁ£À
तोडगो: ¥ÀjºÁgÀ
तोणको: PÉÆÃ®Ä §rUÉ zÀAqÀ zÉÆuÉÚ
तोमाताचें_झाड: mÉÆªÀiÁåmÉÆ
तोमाताचो_रोंपो: mÉÆªÀiÁåmÉÆ
तोमातीण: mÉÆªÀiÁåmÉÆ
त्यागपत्र: gÁf£ÁªÉÄ_¥ÀvÀæ
त्रास: vÉÆAzÀgÉ PÀoÉÆÃgÀvÉ ©gÀÄ¸ÀÄvÀ£À ¸ÀAPÀl PÀµÀÖ 0iÀiÁvÀ£É ¨ÉÃUÀÄ¢ PÀqÀÄ¸ÀAPÀl MqÀ®£ÉÆÃªÀÅ 0iÀiÁvÀ£É ªÉÃzÀ£É
थंडपेय: vÀA¥ÀÅ_¥Á¤ÃAiÀÄ vÀtÚ£É_gÀ¸À vÀtÚV£À_¥ÉÃAiÀÄ
थडगें: s¸ÀªÀiÁ¢ü UÉÆÃj
थडें: s¸ÀªÀiÁ¢ü UÉÆÃj
थलचर: £É®ZÀgÀ_¥ÁætÂ
थलयान: gÀ¸ÉÛ_¸ÁjUÉ ¨sÀÆ_¸ÁjUÉ_(?)
थळ: ¸ÁÜ£À ¸ÀÜ¼À ¥ÀæzÉÃ±À eÁUÀ
थळसेना: ¨sÀÆ_¸ÉÃ£É «Ä°lj
थाराव: M¥ÀàAzÀ M¦àUÉ PÀgÁgÀÄ ¸ÀAzsÁ£À gÁf M¥ÀàAzÀ
थारो: DgÁªÀÄ £ÉªÀÄä¢ ºÀUÀÄgÀ ±ÀªÀÄ£À
थिपको: ZÀÄQÌ ©AzÀÄ ºÉ¥ÀÅöà ªÀÄÄzÉÝ UÉqÉØPÀnÖzÀ_¥ÀzÁxÀð
थिरायपण: zÀÈqsÀvÉ CZÀ®vÉ ¹ÜgÀvÉ PÀzÀ®zÉ C®ÄUÁqÀzÉ «Ä¸ÀÄPÁqÀzÉ
थीर_चित्त: ¸ÀªÀÄavÀÛvÉ avÀÛ¸Áé¸ÀÜ÷å ¥Àæ±ÁAvÀvÉAiÀÄ_¨sÁªÀ ªÀÄ£À¸ÀìªÀiÁzsÁ£À
थीरताय: zÀÈqsÀvÉ CZÀ®vÉ ¹ÜgÀvÉ PÀzÀ®zÉ C®ÄUÁqÀzÉ «Ä¸ÀÄPÁqÀzÉ
थेंबोळी: PÀ¯É PÀgÉ
थोक_वेपारी: ¸ÀUÀlÄ_ªÁå¥Áj
दंगल: PÁzÁl dUÀ¼À gÀA¥À_(?)
दंडनिती: zÀAqÀ¤Ãw
दंडविधान: zÀAqÀ_¸ÀA»vÉ
दंडसंहिता: zÀAqÀ_¸ÀA»vÉ
दंतकथा: d£À¥ÀzÀ_PÀvÉ
दगडी_कोळसो: PÀ°è¢Ý®Ä
दगदग: PÀµÀÖ 0iÀiÁvÀ£É ¨ÉÃUÀÄ¢ PÀqÀÄ¸ÀAPÀl MqÀ®£ÉÆÃªÀÅ
दबाजो: ºÀ§â GvÀìªÀ eÁvÉæ ¥ÀªÀð
दरबार: zÀ¨ÁðgÀÄ gÁdzÀ¨ÁðgÀÄ
दर्शनालय: ¥ÀæzÀ±Àð£À_ªÀÄA¢gÀ avÀæ±Á¯É avÀæªÀÄA¢gÀ UÁå®j
दलाली: zÀ¯Áè½ ªÀÄzsÀå¸ÀÜ ¨ÉÆæÃPÀgÀÄ
दळ: ªÀÄAqÀ½ UÀÄA¥ÀÅ zÀ¼À_(?) ¸ÉÊ£Àå zÀAqÀÄ
दळनायिका: AiÉÆÃzsÉ £ÁAiÀÄQ_(?)
दळमुखेली: ªÀÄÄAzÁ¼ÀÄ ªÀÄÄRAqÀ zÀ¼À£ÁAiÀÄPÀ
दळाचो_मुखेली: ªÀÄÄAzÁ¼ÀÄ ªÀÄÄRAqÀ zÀ¼À£ÁAiÀÄPÀ
दहशदवाद: DvÀAPÀªÁzÀ ¨sÀAiÉÆÃvÁàzÀ£É
दांडी: gÀeÉ ¸ÀÆn ©qÀw
दांडो: PÉÊPÉÆÃ®Ä
दांपत्य: zÀA¥Àw
दाग: ºÉ¥ÀÅöà ªÀÄÄzÉÝ UÉqÉØPÀnÖzÀ_¥ÀzÁxÀð
दागिनो: D¨sÀgÀt MqÀªÉ
दाटसाण: ¸ËºÁzÀð ¸ÀºÀÈzÀAiÀÄvÉ ¤PÀl ¸Á«ÄÃ¥Àå
दादा: ¤ÃZÀ zÀÄµÀÖ._¥ÀÅAqÀ ¥sÀnAUÀ ¥ÉÇÃPÀj ¥ÉÇÃ°
दायजी: §AzsÀÄ £ÉAl ©ÃUÀ ¸ÀA§A¢ü
दारुगुळो: ªÀÄzÀÄÝUÀÄAqÀÄ ¹rªÀÄzÀÄÝ_(?)
दावो_हात: JqÀUÉÊ JqÀzÀ_PÉÊ
दास: UÀÄ¯ÁªÀÄ zÁ¸À vÉÆvÀÄÛ fÃvÀzÁ¼ÀÄ fÃvÀzÁgÀ Cr0iÀiÁ¼ÀÄ
दिकसुचक_यंत्र: ¢PÀÆìZÀPÀ_0iÀÄAvÀæ ¢PÀÆìa
दिका: ¢PÀÄÌ ¢±É ¨sÁUÀ
दिक्षांत: WÀnPÉÆÃvÀìªÀ
दिदी: zÉÆqÀØPÀÌ
दिनदर्शीका: PÁå®AqÀgï ¢£À¸ÀÆa ¥ÀAZÁAUÀ
दिपळो: ºÉAmÉ
दिवप: PÉÆqÀÄUÉ PÉÆqÀÄ«PÉ PÁtÂPÉ ¥ÀæzsÁ£À
दिवप-घेवप: «¤ªÀÄAiÀÄ CzÀ®Ä_§zÀ®Ä PÉÆqÀÄ_PÉÆ¼ÀÄ«PÉ
दिवपी: s¸Á®UÁgÀ ¸Á®UÁæºÀPÀ ¸Á®UÁæ» IÄtÂ
दिवाळें: ¢ªÁ½ ¢ªÁ½vÀ£À £ÁzÁjvÀ£À ¥Á¥ÀgÀÄVj
दिवोर्स: «ZÉÑÃzÀ£À «ªÁºÀ_«ZÉÑÃzÀ£À
दिशा: ¢PÀÄÌ ¢±É ¨sÁUÀ
दिशा_दाखोवपी: ªÀiÁUÀðzÀ±ÀðPÀ zÁj¢Ã¥ÀPÀ ªÀiÁUÀðzÀ²ð
दिशासुचक_यंत्र: ¢PÀÆìZÀPÀ_0iÀÄAvÀæ ¢PÀÆìa
दिसाळें: ¥ÀwæPÉ ¥ÉÃ¥Àgï ¸ÀÄ¢Ý¥ÀwæPÉ ¸ÀªÀiÁZÁgÀ_¥ÀwæPÉ
दीक: ¢PÀÄÌ ¢±É ¨sÁUÀ
दीर्घ: ¢ÃWÀð¸ÀégÀ ¢ÃWÀð
दीर्घ_स्वास: ¤lÄÖ¹gÀÄ ¤rzÁzÀ_ºÀÄ¹gÀÄ ¢ÃWÀð_ºÀÄ¹gÀÄ
दुकमेत: ¯ÉPÀÌ¥ÀvÀæ zÁ¸ÁÛªÉÃdÄ zÁR¯É DzsÁgÀ ¥ÀæªÀiÁt
दुकळ: §gÀUÁ® PÁëªÀÄ zÀÄ©üðPÀë
दुकां: PÀtÂÚÃgÀÄ PÀA§¤ C±ÀÄæ ¨ÁµÀà
दुख्ख: 0iÀiÁvÀ£É ªÉÃzÀ£É
दुख्खहिणटाय: zÀÄBR«®è¢gÀÄ«PÉ ±ÉÆÃPÀ«®è¢gÀÄ«PÉ
दुख्खावस्था: zÀÄBRªÀÄ0iÀÄ
दुबळेपण: zÀÄ§ð® C¸ÀªÀÄxÀð C±ÀPÀÛ ±ÀQÛ»Ã£À
दुयेंतीकक्ष: gÉÆÃVUÀ¼À_PÉÆÃuÉ ªÁqÀð
दुराचार: zÀÄªÀðvÀð£É CAiÉÆÃUÀåªÀvÀð£É PÉlÖzÁV_£ÀqÉ¹PÉÆ¼ÀÄîªÀÅzÀÄ
दुरीग: ¸ÀÄvÀÄÛUÉÆÃqÉ PÉÆÃmÉAiÀÄ_¸ÀÄvÀÄÛUÉÆÃqÉ DªÁgÀzÀUÉÆÃqÉ PÁA¥ÉÇÃAqÀÄ
दुरुस्ती: zÀÄgÀ¹Û £ÉÃ¥ÁðlÄ ¸Àj¥Àr¸ÀÄ«PÉ
दुर्जन: zÀÄµÀÖ PÉlÖªÀ ¤ÃZÀ zÀÄµÀÖ zÀÄgÀÄ¼À
दुर्जनताय: zÀÄgÀÄ¼À zÀÄdð£À zÀÄ£ÀðqÀvÉAiÀÄªÀ
दुर्दशा: zÀÄB¹Üw zÀÄzÀð±É D¥ÀvÀÄÛ
दुर्दैव: zË¨sÁðUÀå zÀÄzÉÊðªÀ zÀÄgÀzÀÈµÀ×
दुर्बळटाय: zÀÄ§ð® C¸ÀªÀÄxÀð C±ÀPÀÛ ±ÀQÛ»Ã£À
दुर्भाग्य: zË¨sÁðUÀå zÀÄzÉÊðªÀ zÀÄgÀzÀÈµÀ×
दुर्मीळटाय: C¨sÁªÀ PÉÆgÀvÉ
दुश्कर्म: ¥Á¥À_¥ÀÅtå zÀÄµÀÌöÈvÀå zÀÄµÁÌAiÀÄð PÉlÖ_PÉ®¸À
दुश्काळ: §gÀUÁ® PÁëªÀÄ zÀÄ©üðPÀë
दुश्टताय: zÀÄgÀÄ¼À zÀÄdð£À zÀÄ£ÀðqÀvÉAiÀÄªÀ
दूत: zÀÆvÀ ¸ÀAzÉÃ±À_ªÁºÀPÀ
दूद: ºÁ®Ä QëÃgÀ
दृड_प्रतिज्ञा: zÀÈqsÀ_¸ÀAPÀ®à UÀnÖ_¤zÁðgÀ ©üÃµÀä_¥ÀæweÉÕ
दृश्ट: ¤zÀð¬Ä_ªÀåQÛ ¤µÀÌgÀÄtÂ PÀÆæj
दृश्टी: zÀÈ¶× £ÉÆÃl
देंवणी: PÀrªÉÄ PÀqÀªÉÄ E½vÀ E½ªÉÄ vÀUÀÄÎ«PÉ E½eÁgÀÄ E¼ÀÄPÀ®Ä vÀUÀÄÎ
देंवतना: CªÀgÉÆÃºÀt E½AiÀÄÄ«PÉ E½vÀ CªÀgÉÆÃºÀ CªÀvÀgÀt
देंवती: E½eÁgÀÄ E¼ÀÄPÀ®Ä vÀUÀÄÎ
देखणी: ¸ËAzÀAiÀÄðªÀw ¸ÀÄAzÀj ZÉ®ÄªÉ gÀÆ¥À¹ gÀÆ¥ÀªÀAvÉ
देखणी_बायल: ¸ËAzÀAiÀÄðªÀw ¸ÀÄAzÀj ZÉ®ÄªÉ gÀÆ¥À¹ gÀÆ¥ÀªÀAvÉ
देग: vÀÄ¢ vÀÄlÖ_vÀÄ¢ CAZÀÄ CAZÀÄ vÀÄ¢ ¥Á±Àéð ¥Á±Àéð_¨sÁUÀ £À¢_zÀAqÉ
देणेकरी: s¸Á®UÁgÀ ¸Á®UÁæºÀPÀ ¸Á®UÁæ» IÄtÂ
देवाचें_देवूळ: zÉÃªÀgÀ_UÀÄr zÉÃªÁ®AiÀÄ zÉÃªÀ¸ÁÜ£À zÉÃªÀ_ªÀÄA¢gÀ
दोंगुल्ली: UÀÄqÀØ ¨ÉlÖ
दोणो: £À½UÉ PÉÆ½ªÉ UÉÆlÖ UË¸ÀtUÉ_(?)
दोतोर: ¤¥ÀÅt ZÀvÀÄgÀ eÁt ¥ÀjtvÀ vÀdÕ ¥Àæ«Ãt
दोन_माळी: JgÀqÀAvÀ¹Û£À_ªÀÄºÀ®Ä JgÀqÀAvÀ¹Û£À_ªÀÄ£É
दोमळो: UÉÆ¢ÝUÉ zÉÆqÀØ_EgÀÄªÉ PÀAngÀÄªÉ
दोर: ©V PÀlÄÖ PÀ¸É §A¢ü¸ÀÄªÀÅzÀÄ CAn¸ÀÄªÀÅzÀÄ
दोरी: ºÀUÀÎ ºÀÄj £ÉÃtÄ gÀdÄÓ ©V PÀlÄÖ PÀ¸É §A¢ü¸ÀÄªÀÅzÀÄ CAn¸ÀÄªÀÅzÀÄ
दोळो: ªÉÆ¼ÀPÉ_PÀtÄÚ ªÉÆ¼ÀPÉ_PÀÄr
दोशपूर्णताय: zÉÆÃµÀ¥ÀÇtð C¥ÀgÁ¢üvÀ
दोस्त: UÉ¼ÉAiÀÄ «ÄvÀæ ¸ÉßÃ»vÀ zÉÆÃ¸ÀÛ ¥ÉæAqï
द्रव_पदार्थ: zÀæªÀ_¥ÀzÁxÀð
द्राक्षां: zÁæQë zÁæPÁë§½î zÁæPÁë®vÉ
द्राक्षांची_वाल: zÁæQë zÁæPÁë§½î zÁæPÁë®vÉ
धंदो: ªÁå¥ÁgÀ GzÀåªÀÄ PÉÊUÁjPÉ GzÉÆåÃUÀ ªÀå¥ÁgÀ ¥Àæ0iÀÄvÀß
धग: ©¹®Ä gÀhÄ¼À ©¹ºÀªÉ GµÀÚUÁ½
धड: ªÀÄÄAqÀ £À¢_zÀAqÉ ¢£Éß aPÀÌUÀÄqÀØ vÉªÀgÀÄ
धनी: ªÀiÁ°PÀ AiÀÄdªÀiÁ£À
धनुर्विद्या: ©®Äè«zÉå ©®ÄèUÁjPÉ zsÀ£ÀÄ«ðzÉå
धनू: zsÀ£À¸ÀÄì zsÀ£ÀÄ_gÁ²
धनू_रास: zsÀ£À¸ÀÄì zsÀ£ÀÄ_gÁ²
धमकी: ¨ÉzÀjPÉ
धरणी: »rzÀÄPÉÆ¼ÀÄîªÀÅzÀÄ
धरतरी: £É® ¸ÀÜ¼À ¨sÀÆ«Ä
धर्म: zsÀªÀÄð ªÀÄvÀ
धर्म_प्रवर्तक: zsÀªÀÄð_¥ÀæªÀvÀðPÀ
धर्म_सुवात: zsÀªÀÄð¸ÀÜ¼À zsÀªÀÄð¸ÁÜ£À
धर्मग्रंथज्ञ: zsÀªÀÄð_±Á¸ÀÛçdÕ
धर्मझूज: zsÀªÀÄðAiÀÄÄzÀÞ
धर्मयुद्ध: zsÀªÀÄðAiÀÄÄzÀÞ
धर्मशास्त्रज्ञ: zsÀªÀÄð_±Á¸ÀÛçdÕ
धर्मसंकश्ट: zsÀªÀÄð_¸ÀAPÀl G¨sÀAiÀÄ_¸ÀAPÀl ¸ÀA¢UÀÞvÉ EPÀÌlÄÖ
धर्माचो_प्रवर्तक: zsÀªÀÄð_¥ÀæªÀvÀðPÀ
धर्मीक_सुवात: zsÀªÀÄð¸ÀÜ¼À zsÀªÀÄð¸ÁÜ£À
धवो_दाग: ©½_ªÀÄZÉÑ
धांकणें: PÀªÀZÀ PÁ¥ÀÅ gÀPÀëuÉ
धांपणें: PÀªÀZÀ PÁ¥ÀÅ gÀPÀëuÉ
धांवपळ: DvÀÄgÀ¥ÀqÀÄ«PÉ zÀÄqÀÄPÀÄªÀÅzÀÄ ®UÀÄ§UÉ CªÀ¸ÀgÀ vÀégÉ UÀr©r
धाक: DvÀAPÀ ºÉzÀjPÉ ¨ÉzÀjPÉ
धाडशी: «ÃgÀ ¢üÃgÀ ±ÀÆgÀ §®ªÀAvÀ dUÀdnÖ ¸ÁºÀ¹
धान्य: zsÁ£Àå ©Ãd PÁ¼ÀÄ
धान्य_विकपी: PÁ¼ÀÄ_ªÁå¥Áj
धान्यविक्रेतो: PÁ¼ÀÄ_ªÁå¥Áj
धान्यां_पेडी: zsÁ£ÀåzÀ_ªÀÄAr zÀªÀ¸À_zsÁ£ÀåzÀ_ªÀiÁPÉðmï
धान्यां_बाजार: zsÁ£ÀåzÀ_ªÀÄAr zÀªÀ¸À_zsÁ£ÀåzÀ_ªÀiÁPÉðmï
धान्याची_पेडी: zsÁ£ÀåzÀ_ªÀÄAr zÀªÀ¸À_zsÁ£ÀåzÀ_ªÀiÁPÉðmï
धान्याचो_बाजार: zsÁ£ÀåzÀ_ªÀÄAr zÀªÀ¸À_zsÁ£ÀåzÀ_ªÀiÁPÉðmï
धार्मीक_काम: zsÀªÀÄð_PÀªÀÄð
धुकलगाडो: vÀ¼ÀÄîUÁr zÉ§Äâ§Ar
धुपें: s¸ÀªÀiÁ¢ü UÉÆÃj
धुमशण: wgÀÄªÀÅ_ªÀÄÄgÀÄªÀÅ vÀ¯É_PÉ¼ÀUÁzÀ §ÄqÀªÉÄÃ¯ÁzÀ
धुमशेण: UÀzÀÝ® UÀ¯ÁmÉ zÁAzsÀ¯É gÀUÀ¼É
धुवट: ±ÀªÀ¸ÀA¥ÀÅl ±ÀªÁZÁÒzÀ£À
धुवणावळ: vÉÆ¼ÉAiÀÄÄªÀÅzÀÄ MUÉAiÀÄÄªÀÅzÀÄ ªÀiÁdð£À
धैर्यहीणटाय: CzÉÊAiÀÄðvÉ C¢üÃgÀvÉ
धोंग: §ÄUÀÄmÉ UÀzÀÄªÀÅ
धोको: C¥Á0iÀÄ UÀAqÁAvÀgÀ D¥ÀvÀÄÛ «¥ÀvÀÄÛ
धोणूविद्या: ©®Äè«zÉå ©®ÄèUÁjPÉ zsÀ£ÀÄ«ðzÉå
धोर: zÀ£À vÀÄgÀÄ UÉÆÃªÀÅ ¥À±ÀÄ
धोल: UÀÄºÉ UÀ« ¥ÉÇlgÉ ¥ÉÇ¼ÀÄî mÉÆ¼ÀÄî ©® qÉÆUÀgÀÄ
ध्यान: UÀªÀÄ¤¸ÀÄ«PÉ ®PÀë÷å«qÀÄ«PÉ zÁå£À zÁå£À¸ÀÜ
ध्यानपूर्ण: UÀªÀÄ£ÀªÀ»¸ÀÄ«PÉ ®PÀë÷å«qÀÄ«PÉ
ध्यानहीणटाय: ZÀAZÀ®vÉ zÁå£À«®è¢gÀÄ«PÉ zÁå£À»Ã£ÀvÉ
ध्रूव_तारो: zÀÄªÀ_£ÀPÀëvÀæ
ध्रूव_नक्षत्र: zÀÄªÀ_£ÀPÀëvÀæ
नक्कल: C£ÀÄPÀgÀt
नक्षत्र: £ÀPÀëvÀæ vÁgÉ ZÀÄQÌ DPÁ±À_PÁAiÀÄ
नखरो: M£À¥ÀÅ_MAiÀiÁågÀ
नखेत्र: £ÀPÀëvÀæ vÁgÉ ZÀÄQÌ DPÁ±À_PÁAiÀÄ
नग: ¸ÀASÉå CASÉå JtÂPÉ
नट: £Àl C©ü£À0iÀÄPÁgÀ PÀ¯Á«zÀ PÀ¯ÁPÁgÀ C©ü£ÉÃwæ
नदर: zÀÈ¶× £ÉÆÃl £ÉlÖ£ÉÆÃl ¢nÖ¹zÀ_£ÉÆÃl JªÉ¬ÄPÀÌzÀ_£ÉÆÃl
नदरेन: zÀÈ¶×PÉÆÃ£À zÀÈ¶×PÉÆÃt
नभयान: ªÁAiÀÄÄ_¸ÁjUÉ ªÁAiÀÄÄ_¸ÀAZÁgÀ
नमुनो: £ÀªÀÄÆ£É ªÀiÁzÀj CvÀÄåvÀÛªÀÄ_GzÁºÀgÀuÉ
नर्सरी: ²±ÀÄ«ºÁgÀ ¨Á®ªÀ£À £À¸Àðj
नवदांपत्य: £ÀªÀzÀA¥ÀwUÀ¼ÀÄ £ÀªÀ«ªÁ»vÀgÀÄ £ÀªÀªÀzsÀÄªÀgÀgÀÄ
नवल: «¸ÀäAiÀÄ PËvÀÄUÀ ¸ÉÆÃfUÀ ¨ÉPÀÌ¸À
नवलकाणयेकार: PÁzÀA§jPÁgÀ
नविनीकरण: £À«ÃPÀgÀt £À«Ã¨sÀªÀ£À ºÉÆ¸ÀzÁV¸ÀÄ«PÉ
नवें_जोडपें: £ÀªÀzÀA¥ÀwUÀ¼ÀÄ £ÀªÀ«ªÁ»vÀgÀÄ £ÀªÀªÀzsÀÄªÀgÀgÀÄ
नवो_शिकिल्लो_मनीस: ºÉÆ¸À§ ºÉÆ¸ÀzÁV_PÀ°AiÀÄÄwÛgÀÄªÀªÀ
नशीब: CzÀÈµÀÖ ¨sÁUÀå AiÉÆÃUÀ «¢ü £À¹Ã§ ¸Ë¨sÁUÀå
नशे_वखद: ªÀiÁzÀPÀ_¥ÀzÁxÀð
नशेबाज: ªÀÄzÀå_ªÀå¸À£À PÀÄqÀÄPÀÄvÀ£À_(?)
नांगरणी: ºÀgÀUÀÄ«PÉ G¼ÀÄ«PÉ ºÀÆqÀÄ«PÉ
नांव: ºÉ¸ÀgÀÄ £ÁªÀÄ £ÁªÀÄzsÉÃAiÀÄ
नांवलोकीक: ¥ÀæSÁåvÀ ºÉ¸ÀgÀÄªÁ¹ ¥Àæ¹zÀÞ SÁåvÀ QÃwð ºÉ¸ÀgÁzÀ
नाउमेद: ¤gÀÄvÁìºÀ G¯Áè¸ÀgÀ»vÀ
नाको: PÁªÀ®Ä_UÉÆÃ¥ÀÅgÀ (?)
नागरी_झूज: CAvÀAiÀÄÄðzÀÞ DAvÀjPÀ_AiÀÄÄzÀÞ
नाच: fVAiÀÄÄªÀÅzÀÄ PÀÄtÂAiÀÄÄªÀÅzÀÄ
नाचणी: fVAiÀÄÄªÀÅzÀÄ PÀÄtÂAiÀÄÄªÀÅzÀÄ
नाणे: ªÀÄÄzÁæ ¹PÁÌ ªÉÆºÀgÀÄ oÀ¸Éì_(?)
नाणें: ºÀt gÀÆ¥Á¬Ä ¥ÉÊ¸É
नात्यांतलें: §AzsÀÄ £ÉAl ©ÃUÀ ¸ÀA§A¢ü
नापसंती: ¥ÀæwªÁzÀ RAqÀ£É «gÉÆÃzsÀ
नाम: ºÉ¸ÀgÀÄ £ÁªÀÄ £ÁªÀÄzsÉÃAiÀÄ
नामना: ¥ÀæSÁåvÀ ºÉ¸ÀgÀÄªÁ¹ ¥Àæ¹zÀÞ SÁåvÀ QÃwð ºÉ¸ÀgÁzÀ
नायक: £ÉÃvÁgÀ DqÀ½vÀUÁgÀ £ÁAiÀÄPÀ
नालायकपण: ªÀÄÆRðvÀ£À C«ªÉÃPÀ zÀqÀØvÀ£À
नावड: EµÀÖ«®è¢gÀÄ«PÉ ¸ÉÃgÀ¢gÀÄ«PÉ DUÀ¢gÀÄ«PÉ »r¸À¢gÀÄ«PÉ C¦æAiÀÄ CgÀÄa C¦æÃw
नाश: ¥ÀvÀ£À CªÀ£Àw CzsÉÆÃUÀw
नाशाडी: «zÀéA¸ÀPÀ_PÀÈvÀå zÀÄµÀÌöÈvÀå
नासधूस: «zÀéA¸ÀPÀ_PÀÈvÀå zÀÄµÀÌöÈvÀå
नास्तिकवाद: £Á¹ÛPÀvÉ £Á¹ÛPÀå ¤jÃ±ÀégÀªÁzÀ
निकाल: ¥ÀjuÁªÀÄ ¤zsÁðgÀ ¤tðAiÀÄ wÃªÀiÁð£À EvÀåxÀð
नितळसाण: UÀÄr¸ÀÄªÀÅzÀÄ ¨ÁaºÁPÀÄªÀÅzÀÄ
नितीकताय: £ÉÊwPÀvÉ
नितीमत्ता: ¸ÀdÓ£À M¼ÉîAiÀÄªÀ
निबर_उदक: UÀqÀ¸ÀÄ_¤ÃgÀÄ
निबरताय: ¤zÀðAiÀÄ zÀAiÀÄ«®è¢gÀÄªÀÅzÀÄ PÀÈ¥É¬Ä®è¢gÀÄªÀÅzÀÄ
निबरसाण: PÀoÉÆÃgÀvÉ PÁptåvÉ
निमंत्रणपत्र: PÀgÉAiÉÆÃ¯É DªÀÄAvÀæt_¥ÀvÀæ «eÁÕ¥À£À_¥ÀvÀæ DºÁé£À_¥ÀvÀæ
निमंत्रणपत्रिका: PÀgÉAiÉÆÃ¯É DªÀÄAvÀæt_¥ÀvÀæ «eÁÕ¥À£À_¥ÀvÀæ DºÁé£À_¥ÀvÀæ
निमताळपण: ¸ÉÆÃUÀÄºÁPÀÄªÀÅzÀÄ £É¥À_ºÉÃ¼ÀÄªÀÅzÀÄ ¹QÌPÉÆ¼ÀîzÀAvÉ_ªÀwð¸ÀÄªÀÅzÀÄ
निमीत: PÁgÀt PÁgÀPÀ ¤«ÄvÀå ºÉÃvÀÄ
नियंत्रण: ¸ÀAAiÀÄªÀÄ
नियाळणी: «ªÉÃZÀ£É «ZÁgÀuÉ ¥ÀjÃPÉë vÀ¤PÉ
नियाळपी: «ªÀÄ±ÀðPÀ «ªÉÃZÀPÀ «ZÁgÀPÀ
नियुक्ती: £ÉÃªÀÄPÀ £ÉÃªÀÄPÁw ¤AiÀÄÄQÛ
निरिक्षण: «ZÁgÀuÉ vÀ¤PÉ ±ÉÆÃzsÀ£É
निरोप_सुवाळो: ¸ÀªÀiÁgÉÆÃ¥À ªÀÄÄPÁÛAiÀÄ ¸ÀªÀiÁ¦Û PÉÆ£ÉUÉÆ¼ÀÄî
निर्जीवसाण: ZÉÃvÀ£À_gÀ»vÀ CZÉÃvÀ¤ÃAiÀÄ
निर्णय: ¤zsÁðgÀ ¤tðAiÀÄ wÃªÀiÁð£À EvÀåxÀð
निर्दयपण: ¤zÀðAiÀÄ zÀAiÀÄ«®è¢gÀÄªÀÅzÀÄ PÀÈ¥É¬Ä®è¢gÀÄªÀÅzÀÄ
निर्दयी: ¤zÀð¬Ä_ªÀåQÛ ¤µÀÌgÀÄtÂ PÀÆæj
निर्देश: ¤zÉÃð±À£À ¤zÉÃð²¸ÀÄªÀÅzÀÄ
निर्दोशताय: ¤zÉÆÃðµÀvÉ ¤gÀ¥ÀgÁ¢üvÀ£À ¤µÀÌ¼ÀAPÀvÉ
निर्बळटाय: zÀÄ§ð® C¸ÀªÀÄxÀð C±ÀPÀÛ ±ÀQÛ»Ã£À
निर्बुद्ध: ªÀÄÆRð ¨ÉÃPÀÆ¥sóÀ
निर्मणी: gÀZÀ£É ¤ªÀiÁðt ¸ÀÈ¶×
निर्मिती: gÀZÀ£É ¤ªÀiÁðt ¸ÀÈ¶×
निर्शेवणी: C¸ÀªÀÄzsÁ£À C¸ÀAvÉÆÃµÀ CvÀÈ¦Û
निवड: £ÉÃªÀÄPÀ £ÉÃªÀÄPÁw ¤AiÀÄÄQÛ
निवडप: DAiÉÄÌ_ªÀiÁqÀÄªÀÅzÀÄ Dj¹PÉÆ¼ÀÄî«PÉ ZÀÄ£Á¬Ä¹PÉÆ¼ÀÄî«PÉ
निवळणी: C©üªÀÈ¢Þ ¸ÀÄzsÁgÀuÉ
निवळसाण: UÀÄr¸ÀÄªÀÅzÀÄ ¨ÁaºÁPÀÄªÀÅzÀÄ
निवास: ªÁ¸ÀªÁVgÀÄ«PÉ £É¯É¹gÀÄ«PÉ ªÁ¸ÀªÀiÁqÀÄ«PÉ
निवासी: ¤ªÁ¹ ªÁ¹UÀ
निवेदन: ¤ªÉÃzÀ£É PÉÆÃjPÉ ªÀÄ£À« ¥ÁæxÀð£É CºÀªÁ®Ä «£ÀAw
निशाणी: ¯ÁAbÀ£À PÀÄgÀÄºÀÄ UÀÄgÀÄvÀÄ ¸ÀAPÉÃvÀ
निश्कर्श: wgÀÄ¼ÀÄ ¸ÁgÁA±À ªÀÄÄSÁåA±À CAvÀ¸ÁìgÀ
निश्कर्ष: ¤zsÁðgÀ ¤tðAiÀÄ wÃªÀiÁð£À EvÀåxÀð
निश्ठूरपण: ¤zÀðAiÀÄ zÀAiÀÄ«®è¢gÀÄªÀÅzÀÄ PÀÈ¥É¬Ä®è¢gÀÄªÀÅzÀÄ
निस्तरो: ¥ÁgÀÄªÀiÁqÀÄ ©qÀÄUÀqÉUÉÆ½¸ÀÄ «ªÉÆÃZÀ£É_ªÀiÁr¸ÀÄ
नीच_पुरूश: PÉ¼ÀeÁwAiÀÄ_ªÀåQÛ PÉ¼ÀªÀÄlÖzÀ
नीत: £ÁåAiÀÄ ¤µÀàPÀë¥ÁvÀ
नुपूर: UÉeÉÓ QgÀÄUÀAmÉ £ÀÆ¥ÀÅgÀ PÁ®AzÀÄUÉ
नूतनीकरण: £À«ÃPÀgÀt £À«Ã¨sÀªÀ£À ºÉÆ¸ÀzÁV¸ÀÄ«PÉ
नेट: §®±Á° ¸ÀªÀÄxÀðPÀ vÁPÀvï_EgÀÄªÀªÀ ±ÀQÛªÀAvÀ UÀnÖUÀ dA¨sÀ CºÀAPÁgÀ UÀªÀð Mt¥ÀæwµÉ× zÉÆqÀØ¹ÛPÉ
नेटाचो_हांसो: ClÖºÁ¸À UÀºÀUÀ»¹_£ÀUÀÄ C§âj¹_£ÀUÀÄ
नेटान: PÉÆëÃ¨sÉ ¥ÀæPÀÄë§ÝvÉ vÀ¼ÀªÀÄ¼À ªÁåPÀÄ®
नेणारपण: CdÕvÉ Cj«®è¢gÀÄ«PÉ CeÁÕ£À C¸ÀAªÉÃ¢vÀé
नेतृत्व: £ÉÃvÀÈvÀé £ÁAiÀÄPÀvÀé ªÀÄÄAzÁ¼ÀvÀé ªÀÄÄRAqÀvÀé ªÀÄÄAzÁ¼ÀÄvÀ£À
नेतो: £ÉÃvÁgÀ DqÀ½vÀUÁgÀ £ÁAiÀÄPÀ ¥ÀæzsÁ£À_ªÀåQÛ ªÀÄÄRAqÀ £ÁAiÀÄPÀ ªÀÄÄAzÁ¼ÀÄ
नेत्रपटल: PÀtÂÚ£À_¥ÉÇgÉ CQël® £ÉÃvÀæ_¥Àl® gÉn£À
नेम: ¹zÁÝAvÀ ¤AiÀÄªÀÄ PÁAiÉÄÝ ¸ÀA¸ÉÜ ®PÀë÷å UÀÄj GzÉÝÃ±À ªÀÄvÁZÀgÀuÉ zsÁ«ÄðPÀ«¢ü ¸ÀA¸ÁÌgÀ PÀªÀÄð
नेम_तोडणी: ¤AiÀÄªÀÄ_«ÄÃjzÀ ¤AiÀÄªÀÄ_ªÀÄÄjzÀ
नेम_मोडणी: ¤AiÀÄªÀÄ_«ÄÃjzÀ ¤AiÀÄªÀÄ_ªÀÄÄjzÀ
नेमांचें_पालन: ²¸ÀÄÛ ¤0iÀÄªÀÄ¥Á®£É
नेमाळें: ¥ÀwæPÉ ¥ÉÃ¥Àgï ¸ÀÄ¢Ý¥ÀwæPÉ ¸ÀªÀiÁZÁgÀ_¥ÀwæPÉ
नैतीकताय: £ÉÊwPÀvÉ
नोकर: dªÁ£À ¹¥Á¬Ä ¸ÉÃªÀPÀ QAPÀgÀ ¦ªÁ£À
नोटी: £ÉÆÃlÄ £ÉÆÃmï
न्याय: £ÁåAiÀÄ ¤µÀàPÀë¥ÁvÀ
न्यायादेश: £ÁåAiÀiÁeÉÕ £ÁåAiÀiÁzÉÃ±À
न्हावप: ¸Áß£À ªÉÄÊ_vÉÆ¼ÉAiÀÄÄªÀÅzÀÄ
पंगड: ªÀÄAqÀ½ UÀÄA¥ÀÅ zÀ¼À_(?) ¸ÉÊ£Àå zÀAqÀÄ
पंगत: ¸Á®Ä ¥ÀAQÛ ºÀAvÀ ±ÉæÃtÂ PÀæªÀÄ
पंच: CA¥ÉÊgÀÄ wÃ¥ÀÅðUÁgÀ
पंचभुजा: ¥ÀAZÀ¨sÀÄd
पंचेचाळीस: £À®ªÀvÉÛöÊzÀÄ 45
पंडीतपण: «zÉå ¥ÁArvÀå eÁÕ£À w¼ÀÄªÀ½PÉ NzÀÄ
पकड: »rzÀÄPÉÆ¼ÀÄîªÀÅzÀÄ
पक्को_रंग: UÀnÖ§tÚ
पचपच: ºÀgÀmÉ ªÀåxÀðªÁzÀ_ªÀiÁvÀÄ C¸ÀA§zÀÞvÉ
पटी: PÀgÀ vÉjUÉ PÀAzÁ0iÀÄ mÁåPÀì
पडबिंब: ¥Àæw©A§ ¥ÀæwZÁáAiÉÄ
पडसाद: ¥ÀæwzsÀé¤ ªÀÄgÀÄzsÀé¤ ªÀiÁzÀð¤ C£ÀÄgÀt£À ªÀiÁgÀÄ°
पड्डो: ¥ÀgÀzÉ ¥ÉÇgÉ vÉÆUÀmÉ_(?)
पतकटो: DPÁ±À ¨Á£ÀÄ ¨ÁAzÀ¼À CA§gÀ CAvÀjPÀë UÀUÀ£À £À¨sÉÆÃªÀÄAqÀ®
पतकडो: ¥ÀgÀzÉ ¥ÉÇgÉ vÉÆUÀmÉ_(?)
पतन: ¥ÀvÀ£À £Á±À C½ªÀÅ CzsÉÆÃUÀw
पद: VÃvÉ ºÁqÀÄ UÁ£À ¥ÀzÀ ¸ÁÜ£À ºÀÄzÉÝ ¥ÀzÀ«
पद_नेमणूक: ºÀÄzÉÝAiÀÄ_¤AiÀÄÄQÛ PÉ®¸ÀzÀ_£ÉÃªÀÄPÀ
पदवी: ¥ÀzÀ£ÁªÀÄ ¥ÀzÀ« G¥Á¢ü
पदवीदान_सुवाळो: WÀnPÉÆÃvÀìªÀ
पदाधिकारी: ¥ÀzÁ¢üPÁj DqÀ½vÀUÁgÀ ºÀÄzÉÞUÁgÀ
पदार्थ: ¥ÀzÁxÀð ¸ÁªÀiÁ£ÀÄ ªÀ¸ÀÄÛ
पदावनती: »A§rÛ
पद्दत: ªÀÄvÁZÀgÀuÉ zsÁ«ÄðPÀ«¢ü ¸ÀA¸ÁÌgÀ PÀªÀÄð
पद्धत: ¥ÀæQæAiÉÄ ¤ªÀðºÀt
पयशे: ºÀt gÀÆ¥Á¬Ä ¥ÉÊ¸É
पयसो: ºÀt gÀÆ¥Á¬Ä ¥ÉÊ¸É
परंपरा: ¯ÉÆÃPÀgÀÆrü ¯ÉÆÃPÀ_ªÁåªÀºÁgÀ
परकी: ¥ÀgÀQÃAiÀÄ C£Àå ºÉÆgÀV£ÀªÀ
परपंरा: ªÀÄvÁZÀgÀuÉ zsÁ«ÄðPÀ«¢ü ¸ÀA¸ÁÌgÀ PÀªÀÄð
परब: ºÀ§â GvÀìªÀ eÁvÉæ ¥ÀªÀð
परमळ: ¸ÀÄUÀAzsÀ ¸ÀÄUÀAzsÀ_¥ÀjªÀÄ¼À
परमाणू: ¥ÀgÀªÀiÁtÄ ClªÀiï
परवरदिगार: C¯Áèºï C¯Áè
परवानगी: C£ÀÄªÀÄw ¸ÀªÀÄäw C£ÀÄªÉÆÃzÀ£É M¦àUÉ CªÀPÁ±À ªÀÄÄQÛ ©qÀÄUÀqÉ
परस्त्री: ¥ÀgÀ¹ÛçÃ ¥ÀgÀ£Áj ¥ÀgÀ¥Àwß
पराक: ¥ÀgÁUÀ ºÀÆzÀÆ¼ÀÄ ¥ÀÅµÀàzsÀÆ½
परागकण: ¥ÀgÁUÀ ºÀÆzÀÆ¼ÀÄ ¥ÀÅµÀàzsÀÆ½
परावलंबन: ¥ÀgÁªÀ®A©vÀ£À ¥ÀgÁ¢üÃ£ÀvÉ ¥ÁgÀvÀAvÀæ÷å
परिकल्पना: ¥ÀjPÀ®à£É ¥ÁæPÀ®à£É ¹zÁÞAvÀ
परिक्रमा: ¥ÀæzÀQëuÉ ¸ÀÄvÀÄÛ
परिक्षण: «ªÉÃZÀ£É «ZÁgÀuÉ ¥ÀjÃPÉë vÀ¤PÉ
परिक्षा: ¥ÀjÃPÉë JUÁÔªÀÄÄ
परिचर्चा: UÉÆÃ¶× ¸À¨sÉ ¸ÀºÀªÁ¸À
परिणाम: ¥ÀjuÁªÀÄ
परिमाण: §ÈºÀvï zÉÆqÀØzÁVgÀÄ«PÉ
परिवर्तन: ¥ÀjªÀvÀð£É ªÀiÁ¥ÁðqÀÄ §zÀ¯ÁªÀuÉ
परिसंवाद: «ZÁgÀUÉÆÃ¶× «ZÁgÀ¸ÀAQgÀt ¸É«Ä£Ágï
परिस्थिती: ¥Àj¹Üw ¸À¤ßªÉÃ±À ¹ÜwUÀw
परीघ: ¥Àj¢ü ¸ÀÄvÀÄÛUÉgÉ DªÀgÀtgÉÃSÉ
परोपकार: ¥ÀgÉÆÃ¥ÀPÁgÀ ¥ÀgÀ»vÀ
पर्यवेक्षक: ªÉÄÃ°éZÁgÀPÀ ¥Àj«ÃPÀëPÀ
पर्याप्तताय: s¸ÁPÁUÀÄªÀµÀÄÖ 0iÀÄxÉÃZÀá ¸ÁPÀµÀÄÖ vÀPÀÌµÀÄÖ CUÀvÀåªÁzÀµÀÄÖ ¨ÉÃPÁzÀµÀÄÖ
पर्याय: ¨ÉÃgÉ C£Àå §zÀ°
पर्स: eÉÃ§Ä Q¸É ºÀtzÀ_¥ÁPÉÃmï
पर्‍या_चवकी: PÁªÀ®Ä_UÉÆÃ¥ÀÅgÀ (?)
पलोव: ¸ÀºÁAiÀÄ £ÉgÀªÀÅ ¸ÀºÀPÁgÀ MvÁÛ¸É
पश्चाताप: SÉÃzÀ zÀÄBR §¼À°PÉ ¥ÀjvÁ¥À C£ÀÄvÁ¥À
पसंती: C©ügÀÄa D¸ÀQÛ M®ªÀÅ
पसरूं: zÀ£À vÀÄgÀÄ UÉÆÃªÀÅ ¥À±ÀÄ
पसारो: s¸ÁªÀiÁ£ÀÄ ¸ÀgÀPÀÄ ¸À£ÀUÀÄ ¸ÀgÀAeÁªÀÄÄ ¥ÀzÁxÀð ¸ÁªÀÄVæ PÀ¸À aA¢ ªÉÃ¸ïÖ
पांगरूण: ºÉÆ¢PÉ ºÉÆ¢ÝPÉ ºÉÆzÀPÉ
पांजरो: zÉÆqÀØ_¥ÀAdgÀ ªÀÄgÀzÀ_¥ÀAdgÀ PÀmÁAd£À
पांडित्य: «zÉå ¥ÁArvÀå eÁÕ£À w¼ÀÄªÀ½PÉ NzÀÄ
पांयांवस्त्र: PÁ®ÎªÀ¸ÀÄ PÁ®ÄaÃ®
पाकीट: eÉÃ§Ä Q¸É ºÀtzÀ_¥ÁPÉÃmï
पाग: PÀÄzÀÄgÉ¯ÁAiÀÄ C±Àé±Á¯É
पाडें_नशीब: zË¨sÁðUÀå zÀÄzÉÊðªÀ zÀÄgÀzÀÈµÀ×
पातकी_पुरूश: PÉ¼ÀeÁwAiÀÄ_ªÀåQÛ PÉ¼ÀªÀÄlÖzÀ
पातळ_पदार्थ: zÀæªÀ_¥ÀzÁxÀð
पात्र: ¥ÁvÉæ
पात्रता: CºÀðvÉ AiÉÆÃUÀåvÉ ¸ÁªÀÄxÀåð
पात्रताय: UËgÀªÁºÀð_¹Üw vÀPÀÄÌzÁVgÀÄªÀÅzÀÄ AiÉÆÃUÀåªÁVgÀÄªÀÅzÀÄ
पात्रांव: ªÀiÁ°PÀ AiÀÄdªÀiÁ£À
पाद: ºÀÆ¸ÀÄ
पानां_झडिल्लें: ¨ÉÆÃ¼ÀÄªÀÄgÀ ªÉÆÃlÄªÀÄgÀ
पानो: ªÉÆ¯É ¸ÀÛ£À PÀÄZÀ JzÉ ªÀPÀë
पाप: ¥Á¥À_¥ÀÅtå
पापी: ªÀÄÄvÀÄÛ ZÀÄA§£À
पापी_पुरूश: PÉ¼ÀeÁwAiÀÄ_ªÀåQÛ PÉ¼ÀªÀÄlÖzÀ
पापेलांव: ¨Á¬ÄArAUÀÄ ¨ÉÊArUï
पायण: ¸ÀA¢ NtÂ
पार: eÉÆÃr eÉÆvÉ
पारंपारीकताय: ¥ÁgÀA¥ÀjPÀvÉ ¸ÁA¥ÀæzÁAiÀÄ¤µÀ×vÉ_(?)
पारखणी: «ªÉÃZÀ£É «ZÁgÀuÉ ¥ÀjÃPÉë vÀ¤PÉ «ZÁgÀuÉ vÀ¤PÉ ±ÉÆÃzsÀ£É ¸Àà¶ÖÃPÀgÀt zÀÈrüÃPÀgÀt ¥ÀæªÀiÁtÂÃPÀgÀt ¥ÀjÃPÉë
पारसी: ¥ÁgÀ¹ ¥À¶ðAiÀÄ£ï
पारेकार: gÀPÀëPÀ ¸ÀAgÀPÀëPÀ
पार्टी: £Àl C©ü£À0iÀÄPÁgÀ PÀ¯Á«zÀ PÀ¯ÁPÁgÀ C©ü£ÉÃwæ ªÀÄAqÀ½ UÀÄA¥ÀÅ zÀ¼À_(?)
पार्श्वगायक: »£Éß¯É_UÁ0iÀÄPÀ
पाळी: ¨Áf ¥Àt ¥ÀAvÀ dÆdÄ
पावण्यांघर: Cwy_UÀÈºÀ Cyw_¤ªÁ¸À Cyw_¨sÀªÀ£À
पावती: ZÀ®£ï ©¯ïè
पास: nPÉÃmï wQÃlÄ ¥Á¸ÀÄ ¥Á¸ï C¥ÀàuÉ_aÃn C£ÀÄeÁÕ_¥ÀvÀæ ¥ÀgÀªÁ£É ©V PÀlÄÖ PÀ¸É §A¢ü¸ÀÄªÀÅzÀÄ CAn¸ÀÄªÀÅzÀÄ §AzsÀ£À »rvÀ
पाहूणचार: Cwy_¸ÀvÁÌgÀ DwxÀå
पिंजरो: zÉÆqÀØ_¥ÀAdgÀ ªÀÄgÀzÀ_¥ÀAdgÀ PÀmÁAd£À
पिकासावं: SÉÃzÀ zÀÄBR §¼À°PÉ ¥ÀjvÁ¥À C£ÀÄvÁ¥À
पिडा: PÀµÀÖ 0iÀiÁvÀ£É ¨ÉÃUÀÄ¢ PÀqÀÄ¸ÀAPÀl MqÀ®£ÉÆÃªÀÅ 0iÀiÁvÀ£É ªÉÃzÀ£É
पिडापीड: PÀµÀÖ 0iÀiÁvÀ£É ¨ÉÃUÀÄ¢ PÀqÀÄ¸ÀAPÀl MqÀ®£ÉÆÃªÀÅ
पित्त: ¦vÀÛgÀ¸À
पिराय: ªÀAiÀÄ¸ÀÄì DAiÀÄÄµÀå fÃªÀªÀiÁ£À
पिशवी: aÃ® PÉÊaÃ® ¸ÀAa ºÀqÀ¥À
पिशी: aÃ® PÉÊaÃ® ¸ÀAa ºÀqÀ¥À
पिशेपण: ªÀÄÆRðvÀ£À C«ªÉÃPÀ zÀqÀØvÀ£À
पिशोल: PÀÄAZÀ PÀÆZÀð §æµÀÄë ªÀtð_PÀÄAZÀ
पिसाविल्लें_सुणें: ºÀÄZÀÄÑ_£Á¬Ä ºÀÄZÁß¬Ä
पिसो: ªÀÄÆRð ¨ÉÃPÀÆ¥sóÀ
पीक: GvÁàzÀ£É ¥À¸À®Ä ¨É¼É MtVzÀ_¥À¸À®Ä
पुजेचें_सामान: ¥ÀÇeÁ_¸ÁªÀÄVæ ¥ÀÇeÁ_¸ÁªÀiÁ£ÀÄ
पुज्य: zÀ±ÀªÀiÁA±À_©AzÀÄ ZÀÄPÉÌ
पुज्या_सामान: ¥ÀÇeÁ_¸ÁªÀÄVæ ¥ÀÇeÁ_¸ÁªÀiÁ£ÀÄ
पुठ्ठो: ¨Á¬ÄArAUÀÄ ¨ÉÊArUï
पुडो: £À½UÉ PÉÆ½ªÉ UÉÆlÖ UË¸ÀtUÉ_(?)
पुनरुक्ती: ¥ÀÅ£ÀgÁªÀvÀð£É
पुनर्जागरण: ¥ÀÅ£ÀeÁðUÀÈw ¥ÀÅ£ÀgÀÄfÓÃªÀ£À
पुरकताय: s¸ÁPÁUÀÄªÀµÀÄÖ 0iÀÄxÉÃZÀá ¸ÁPÀµÀÄÖ vÀPÀÌµÀÄÖ CUÀvÀåªÁzÀµÀÄÖ ¨ÉÃPÁzÀµÀÄÖ
पुरस्कार: ¨sÀQëÃ¸ÀÄ E£ÁªÀÄÄ §ºÀÄªÀiÁ£À
पुराणीकताय: ¥ÁæaÃ£ÀvÉ LwºÁ¹PÀvÉ ¥ÀÅgÁvÀ£À_PÁ°Ã£À
पुराय: ¥Àj¥ÀÇtðvÉ
पुर्णांग: CRAqÀ ¥ÀÇwð ¸ÀA¥ÀÇtð
पुर्नजल्म: ¥ÀÅ£Àdð£Àä ªÀÄgÀÄd£Àä
पुर्वज: »jAiÀÄ »jÃPÀ ¥ÀÇªÀðd ¥ÀÇ«ðPÀ
पुर्विल्लेपण: ¥ÁæaÃ£ÀvÉ LwºÁ¹PÀvÉ ¥ÀÅgÁvÀ£À_PÁ°Ã£À
पुश्प: ºÀÆ ºÀÆªÀÅ ¥ÀÅµÀà PÀÄ¸ÀÄªÀÄ ¥Àæ¸ÀÆ£À
पुश्पकण: ¥ÀgÁUÀ ºÀÆzÀÆ¼ÀÄ ¥ÀÅµÀàzsÀÆ½
पुस्तक_दुकान: ¥ÀÅ¸ÀÛPÀ_ªÀÄ½UÉ ¥ÀÅ¸ÀÛPÀzÀ_CAUÀr ¥ÀÅ¸ÀÛPÁ®AiÀÄ
पुस्तकांचें_दुकान: ¥ÀÅ¸ÀÛPÀ_ªÀÄ½UÉ ¥ÀÅ¸ÀÛPÀzÀ_CAUÀr ¥ÀÅ¸ÀÛPÁ®AiÀÄ
पुस्तकालय: ¥ÀÅ¸ÀÛPÀ_ªÀÄ½UÉ ¥ÀÅ¸ÀÛPÀzÀ_CAUÀr ¥ÀÅ¸ÀÛPÁ®AiÀÄ
पूर्ण: ¥Àj¥ÀÇtðvÉ
पूर्णकाया: CRAqÀ ¥ÀÇwð ¸ÀA¥ÀÇtð
पूर्णचंद्र: ºÀÄtÂÚªÉÄ ¥ÀÇtÂðªÉÄ ¥ÀÇtðZÀAzÀæ ¥ÀÇtðZÀAzÀæªÀÄ
पूर्णचंद्रीम: ºÀÄtÂÚªÉÄ ¥ÀÇtÂðªÉÄ ¥ÀÇtðZÀAzÀæ ¥ÀÇtðZÀAzÀæªÀÄ
पूर्णताय: G¥À®§ÞvÉ zÉÆgÀPÀÄ«PÉ ¹PÀÄÌ«PÉ
पॅन: §gÀºÀzÀ_G¥ÀPÀgÀt
पॅराशूट: ¥ÁågÀ±ÀÆmï E½PÉÆqÉ zÀÄªÀÄÄPÀÄPÉÆqÉ CªÀvÀgÀt_bÀwæ
पेज: ¨sÁgÀ ºÉÆgÉ ºÉÃgÀÄ ©tÄà
पेट: eÁé¯É Gj
पेठ: ªÁå¥Áj_ªÀÄ½UÉ QgÁtÂ_CAUÀr GUÁæt
पेडी: ªÁå¥Áj_ªÀÄ½UÉ QgÁtÂ_CAUÀr GUÁæt
पेर: ¥ÉÃgÀ®_ºÀtÄÚ ¥ÉÃgÀ®_VqÀ
पेरणी: ©vÀÛ£É ©wÛUÉ
पेरीण: ¥ÉÃgÀ®_ºÀtÄÚ ¥ÉÃgÀ®_VqÀ
पेलो: ¯ÉÆÃl UÁè¸ÀÄ V¯Á¸ÀÄ UÁf£À_¯ÉÆÃl
पोंत: CAZÀÄ vÀÄ¢
पोंद: vÀ¼À PÉ¼À Cr PÉ¼À¨sÁUÀ §ÄqÀ Cr vÀUÀÄÎ
पोंवटी: «ÄÃ£ÀÄRAqÀ
पोकळी_धमकी: UÉÆqÀÄØ¨ÉzÀjPÉ UÀzÀjPÉ_ºÁPÀÄªÀÅzÀÄ ¨ÉzÀjPÉ_ºÁPÀÄªÀÅzÀÄ
पोजडेपण: C²èÃ®vÉ C¸À¨sÀåvÉ ¨sÀAqÀvÀ£À
पोटजाती: eÁw ªÀUÀð
पोटसरो_प्राणी: ¸ÀjÃ¸ÀÈ¥À_fÃ« ºÀjzÁqÀÄªÀ_fÃ« vÉªÀ¼ÀÄªÀ_fÃ«
पोटी: ¥Á¬ÄPÁ£É_¨ÉÃ¸À£ï ¥Á¬ÄPÁ£É_l¨ï
पोटींग: ¥Áæ£ï
पोती: aÃ® PÉÊaÃ® ¸ÀAa ºÀqÀ¥À
पोतें: aÃ® PÉÊaÃ® ¸ÀAa ºÀqÀ¥À
पोपटीण: ºÉtÄÚ_V½
पोपाय: ¥ÀgÀAV ¥À¥Áà¬Ä_ªÀÄgÀ
पोरसूं: ºÀÆ_GzÁå£ÀªÀ£À
पोसकोटो: §®Æ£ÀÄ
पोस्ट: CAZÉ_PÀbÉÃj
पोस्त: PÁªÀ®Ä_UÉÆÃ¥ÀÅgÀ (?)
प्रकट_वाचन: ¥ÀoÀt PÀ°PÉ ªÁZÀ£À_(?)
प्रक्रिया: ¥ÀæQæAiÉÄ ¤ªÀðºÀt
प्रगट_करप: C©üªÀåQÛ ¥ÀæPÀluÉ ºÉÆgÀUÉqÉvÀ
प्रगटावप: C©üªÀåQÛ ¥ÀæPÀluÉ ºÉÆgÀUÉqÉvÀ
प्रगटीकरण: GzÀãªÀ zÀ±Àð£À C«¨sÁðªÀ UÉÆÃZÀj¸ÀÄªÀÅzÀÄ PÁuÉÌ PÁtÂ¹PÉÆ¼ÀÄîªÀÅzÀÄ
प्रगती: G£Àßw »jªÉÄ K½UÉ JvÀÛgÀ C©üªÀÈ¢Þ ¸ÀÄzsÁgÀuÉ
प्रजा: ¥ÀæeÉ £ÁUÀjPÀ ¸ÀézÉÃ²ÃAiÀÄ zÉÃ²ÃAiÀÄ
प्रजासत्ताक_दीस: UÀtgÁdå_¢£À ¥ÀæeÁgÁdå_¢£À
प्रणाली: ¥ÀæQæAiÉÄ ¤ªÀðºÀt
प्रताप: ¥ÀævÁ¥À ¥ÀgÁPÀæªÀÄ
प्रतिक्रिया: ¥ÀæwQæ0iÉÄ ¥ÀæwªÀvÀð£É ¥Àæw¥ÀjuÁªÀÄ
प्रतिक्षा_करप: JzÀÄgÀÄ_£ÉÆÃqÀÄªÀªÀ zÁj_PÁAiÀÄÄªÀªÀ_(?)
प्रतिघात: ¥ÀæwzÁ½ ¥ÀæwºÁgÀ
प्रतिज्ञा: ¥ÀæweÉÕ ¥Àt ¤±ÀÑAiÀÄ
प्रतिध्वनी: ¥ÀæwzsÀé¤ ªÀÄgÀÄzsÀé¤ ªÀiÁzÀð¤ C£ÀÄgÀt£À ªÀiÁgÀÄ°
प्रतिबिंब: ¥Àæw©A§ ¥ÀæwZÁáAiÉÄ
प्रतिश्ठापना: ¥ÀæwµÁ×¥À£À
प्रतीक: ¯ÁAbÀ£À PÀÄgÀÄºÀÄ UÀÄgÀÄvÀÄ ¸ÀAPÉÃvÀ
प्रत्यंचा: ºÉzÉ ©°è£À_zÁgÀ
प्रदक्षिणा: ¥ÀæzÀQëuÉ ¸ÀÄvÀÄÛ
प्रदर्शन: ¥ÀæzÀ±Àð£À vÉÆÃj¸ÀÄ«PÉ
प्रदुशण: PÀ®Ä¶vÀ ªÀiÁ°£Àå
प्रदेशवाद: ¥ÀæzÉÃ±ÀªÁzÀ
प्रधान: CzÀåPÀë\ ªÀÄÄRå¸ÀÜ
प्रधानताय: ±ÉæÃµÀ×vÉ »jªÉÄ ºÉZÀÄÑUÁjPÉ
प्रमाण: §ÈºÀvï zÉÆqÀØzÁVgÀÄ«PÉ
प्रयाण: ¥Àæ0iÀiÁt_(?)
प्ररणेन: PÉÆëÃ¨sÉ ¥ÀæPÀÄë§ÝvÉ vÀ¼ÀªÀÄ¼À ªÁåPÀÄ®
प्रवर्तक: ¥ÀæªÀvÀðPÀ d£ÀPÀ
प्रवास: ¥ÀæAiÀiÁt ¥ÀæªÁ¸À AiÀiÁvÉæ ¥ÀAiÀÄðl£À ¥ÀAiÀÄt UÀÄ¼É ªÀ®¸É ¸ÀÜ¼ÁAvÀgÀ
प्रवास_वाहन: ¸ÀAZÁj_ªÁºÀ£À
प्रवाह: ¥ÀæªÁºÀ ºÀjªÀÅ ºÀjvÀ Nl
प्रवीणटाय: ¤¥ÀÅtvÉ ¥Àæ«ÃtvÉ §Ä¢ÞªÀAwPÉ
प्रवेशदार: ºÉ¨ÁâV®Ä zÉÆqÀÝ_¨ÁV®Ä ªÀÄÄRåzÁégÀ
प्रशंसागीत: UÀÄtUÁ£À
प्रशासन: C¢üPÁgÀ ¥Àæ¨sÀÄvÀé D½éPÉ DzÉÃ±À
प्रशिक्षण: vÀgÀ¥ÉÃvÀÄ vÀgÀ¨ÉÃw
प्रसिद्‍दी: ¥ÀæSÁåvÀ ºÉ¸ÀgÀÄªÁ¹ ¥Àæ¹zÀÞ SÁåvÀ QÃwð ºÉ¸ÀgÁzÀ
प्रस्तावना: ¥Àæ¸ÁÛªÀ£É ¦ÃpPÉ
प्रस्तुतूकरण: ¥Àæ¸ÀÄÛvÀ M¦à¸ÀÄªÀÅzÀÄ C¦ð¸ÀÄªÀÅzÀÄ ¤gÀÆ¦¸ÀÄªÀÅzÀÄ
प्रस्थान: ¥Àæ0iÀiÁt_(?)
प्रस्न: ¸ÀªÀÄ¸Éå
प्रस्नचिन्न: ¥Àæ±ÁßxÀðPÀ_aºÉß ¥Àæ±ÁßªÁZÀPÀ_aºÉß ?
प्रहार: KlÄ ¥ÉlÄÖ ºÉÆqÉvÀ
प्रांत: ¨sÀÆ¨sÁUÀ ¥ÀæzÉÃ±À ¥ÁæAvÀ
प्रांतवाद: ¥ÀæzÉÃ±ÀªÁzÀ
प्राचार्य: ªÀÄÄSÉÆåÃ¥ÀzsÁå¬Ä¤ ¥ÀæzsÁ£À_UÀÄgÀÄUÀ¼ÀÄ ªÀÄÄRå_²PÀëQ ªÀÄÄRå_CzÁå¥ÀQ ¥ÀæzsÁ£À_UÀÄgÀÄUÀ¼ÀÄ ¥ÁæZÁAiÀÄðgÀÄ ¥ÁæA±ÀÄ¥Á®gÀÄ ¦æ¤ì¥Á¯ï
प्राचीनताय: ¥ÁæaÃ£ÀvÉ LwºÁ¹PÀvÉ ¥ÀÅgÁvÀ£À_PÁ°Ã£À
प्राणवाय: DªÀÄèd£ÀPÀ DQìd£ï
प्राणी: ¥ÁætÂ dAvÀÄ ªÀÄÈUÀ ¥À±ÀÄ fÃªÀ ¥Áæt ZÉÃvÀ£À
प्राणीपाशाण: ¥À¼ÉAiÀÄÄ½PÉ fÃªÀåªÀ±ÉÃµÀ_¥sóÁ¹¯ÁzÀ
प्राथमीकताय: ±ÉæÃµÀ×vÉ »jªÉÄ ºÉZÀÄÑUÁjPÉ
प्राप्ती: ®©¸ÀÄ ¹PÀÌ zÉÆgÀQzÀ ºÀÄnÖzÀ ®§å ¥Áæ¥ÀÛ
प्रामाणीक: ¤µÁ×ªÀAvÀ ¸Áé«Ä¤µÀ× «±Áé¸À¥ÁvÀæ
प्रारंभ: ªÀÄÆ® ªÉÆzÀ®Ä DgÀA¨sÀ ¥ÁægÀA¨sÀ ±ÀÄgÀÄ
प्रार्थना: «£ÀAw ©£ÀßºÀ PÉÆÃjPÉ ¥ÁæxÀð£É
प्रिजम: ¦ædªÀiï C±ÀæUÀ
प्रिज्म: ¦ædªÀiï C±ÀæUÀ
प्रेतदहन_घर: ±ÀªÁUÁgÀ
प्रेतवस्त्र: ±ÀªÀ¸ÀA¥ÀÅl ±ÀªÁZÁÒzÀ£À
प्रेतांघर: ±ÀªÀzÀªÀÄ£É ºÉtzÀªÀÄ£É
प्रेतांलय: ±ÀªÀzÀªÀÄ£É ºÉtzÀªÀÄ£É
प्रेमासक्ती: ¥ÉæÃªÀiÁ¸ÀQÛ
प्रेमिका: ¥ÉæÃAiÀÄ¹ ¦æAiÀÄvÀªÉÄ ¸ÀT
प्रेमी: ¥ÉæÃ«Ä eÉÆvÉUÁgÀ MqÀ£Ár ¸ÀAUÀrUÀ UÉ¼ÉAiÀÄ ¸ÀºÀZÀgÀ
प्लुटो: ¥ÀÇèmÉÆÃ
फकांड: ¥ÀjºÁ¸À ºÀtPÀ «£ÉÆÃzÀ ZÉÃµÉÖ ¤AzÉ QÃl¯ÉUÁgÀ ZÀÄqÁ¬Ä¸ÀÄªÀªÀ gÉÃV¸ÀÄªÀ
फट: C¸ÀvÀå ¸ÀÄ¼ÀÄî ºÀÄ¹ ¸ÀmÉ C£ÀÈvÀ
फटींग: C«±Áé¹ £ÀA©UÀ¸ÀÜ£À®èzÀªÀ
फळ: ºÀtÄÚ ¥sÀ® ¥ÀjuÁªÀÄ
फळ_बागायत: GzÁå£ÀªÀ£À
फळबाग: GzÁå£ÀªÀ£À
फळांनी_भरिल्ली_वनस्पत: ¥sÀ®¥ÀÅµÀàUÀ¼ÀÄ
फाटलो_भाग: »A¨sÁUÀ »AzÉ
फाटीं_फूडें_जावप: »Adj0iÀÄÄ«PÉ »AzÉªÀÄÄAzÉ_£ÉÆÃqÀÄ«PÉ ¸ÀAzÉÃºÀ¥ÀqÀÄ«PÉ
फातर: ºÉAmÉ
फाम: ¥ÀæSÁåvÀ ºÉ¸ÀgÀÄªÁ¹ ¥Àæ¹zÀÞ SÁåvÀ QÃwð ºÉ¸ÀgÁzÀ
फायदो: »vÀ PÀ¯Áåt PÉëÃªÀÄ ¸ËRå PÀÄ±À®
फार्मास: OµÀ¢ü_CAUÀr OµÀzsÁ®AiÀÄ
फाल्यां: ¨sÀ«µÀå ¨sÀ«µÀå_PÁ®
फावोशी: C£ÀÄPÀÆ®_(?)
फास्की: ZËPÀlÄÖ PÀlÄÖ ºÀAzÀgÀ ¥ÉæÃªÀiï ªÀiÁzÀj «£Áå¸À
फिशाळकाय: §Ä¢ÝªÀAwPÉ eÁtvÀ£À eÁuÉä «ªÉÃPÀ
फीन: §Ä¢ÞªÀAvÀ §Ä¢ÞfÃ« eÁÕ£ÀªÀAvÀ ªÉÄÃzsÁ« ¥ÁædÕ
फुक्याचो_खर्च: C¥ÀªÀåAiÀÄ zÀÄAzÀÄªÉZÀÑ
फुगारो: §®Æ£ÀÄ
फुगो: §®Æ£ÀÄ
फुडारपण: £ÉÃvÀÈvÀé £ÁAiÀÄPÀvÀé ªÀÄÄAzÁ¼ÀvÀé ªÀÄÄRAqÀvÀé ªÀÄÄAzÁ¼ÀÄvÀ£À
फुडारी: ªÀÄÄRAqÀ £ÁAiÀÄPÀ ªÀÄÄRå¸ÀÜ £ÉÃvÁgÀ DqÀ½vÀUÁgÀ £ÁAiÀÄPÀ CzÀåPÀë\ ªÀÄÄRå¸ÀÜ ¥ÀæzsÁ£À_ªÀåQÛ ªÀÄÄRAqÀ £ÁAiÀÄPÀ ªÀÄÄAzÁ¼ÀÄ
फुडारीण: zsÀÄjÃuÉ AiÉÆÃzsÉ £ÁAiÀÄQ_(?)
फुतफूत: UÀÄ¸ÀÄ_UÀÄ¸ÀÄ ¦¸ÀÄ¦¸ÀÄ
फुतफूतणी: Q«ªÀiÁvÀÄ UÀÄ¥ÀÛªÀiÁvÀÄ ¦¸ÀÄ¦¸ÀÄ_ªÀiÁvÀÄ
फुलांघोस: ºÀÆ_UÀÄZÀá ºÀÆUÉÆAZÀ®Ä ¥ÀÅµÀàUÀÄZÀá
फुलांचो_जाणकार: ¥ÀÅµÀàdÕ
फुलांतज्ञ: ¥ÀÅµÀàdÕ
फुलांतुरो: ºÀÆ_UÀÄZÀá ºÀÆUÉÆAZÀ®Ä ¥ÀÅµÀàUÀÄZÀá
फुशारकी: dA¨sÀ_PÉÆZÀÄÑªÀÅzÀÄ §ÄgÀÄqÉ_©qÀÄªÀÅzÀÄ §rªÁgÀ dA¨sÀ CºÀAPÁgÀ UÀªÀð Mt¥ÀæwµÉ× zÉÆqÀØ¹ÛPÉ
फुसकी: ºÀÆ¸ÀÄ
फुसकुली: ºÀÆ¸ÀÄ
फूल: ºÀÆ ºÀÆªÀÅ ¥ÀÅµÀà PÀÄ¸ÀÄªÀÄ ¥Àæ¸ÀÆ£À
फेरो: ¥ÀæzÀQëuÉ ¸ÀÄvÀÄÛ
फोंड: PÀÄtÂ vÀUÀÄÎ UÀÄAr ºÉÆAqÀ
फोटो: avÀæ ¥ÉÇÃmÉÆÃ
फोर: PÀAzÁAiÀÄ vÉjUÉ ¨sÀÆ«ÄAiÀÄ_PÀgÀ ¨Á¬ÄArAUÀÄ ¨ÉÊArUï
फ्रेम: ªÀiÁzÀj «£Áå¸À
बंगलो: §AUÀ¯É ¸ËzÀ ªÀÄºÀ®Ä
बंदखण: PÁgÁUÀÈºÀªÁ¸À
बंध: §AzsÀ£À »rvÀ
बंधन: §AzsÀ£À »rvÀ
बकरो: ºÉÆÃvÀÄ
बकें: PÉÆPÀÌgÉ ¸ÁgÀ¸À §PÀ¥ÀQë
बक्षीस: ¨sÀQëÃ¸ÀÄ E£ÁªÀÄÄ §ºÀÄªÀiÁ£À
बगलांट: PÀ¼ÀAPÀ zÉÆÃµÀ PÀÄAzÀÄ_(?)
बचत: G½vÁ0iÀÄ «ÄUÀÄvÁ0iÀÄ PÀÆrqÀÄªÀÅzÀÄ
बटन: UÀÄAr §l£ï UÀÄAr §l£ï ¹éZï CzÀÄªÀÄÄ_UÀÄAr
बडटी: ¥ÀzÉÆÃ£Àßw ¥ÉÇæÃªÉÆÃµÀ£ï
बडबड: ºÀgÀmÉ ªÀåxÀðªÁzÀ_ªÀiÁvÀÄ C¸ÀA§zÀÞvÉ ¸ÀÄ¼ÀÄî §Æ¹ ¸ÀtÚ¸ÀÄ¼ÀÄî
बडाय: dA¨sÀ_PÉÆZÀÄÑªÀÅzÀÄ §ÄgÀÄqÉ_©qÀÄªÀÅzÀÄ §rªÁgÀ dA¨sÀ CºÀAPÁgÀ UÀªÀð Mt¥ÀæwµÉ× zÉÆqÀØ¹ÛPÉ
बडी: PÉÆÃ®Ä §rUÉ zÀAqÀ zÉÆuÉÚ ºÀÄ®Äè vÀÈt PÀgÀqÀÄ PÉÊPÉÆÃ®Ä
बडीची_दुस्मानकाय: D£ÀÄªÀA²PÀ_±ÀvÀÄævÀé ¥ÁgÀA¥ÀjPÀ_fzÀÄÝ
बडीचें: ªÀA±Àd ¸ÀAvÁ£À ¸ÀAvÀw
बतर: aA¢ CjªÉ ºÀjzÀ_ºÀjªÉ0iÀÄ_vÀÄAqÀÄ
बदनामी: PÀ¼ÀAPÀ zÀÆµÀuÉ C¥ÀQÃwð C¥ÀªÀiÁ£À
बदल: ¥ÀjªÀvÀð£É ªÀiÁ¥ÁðqÀÄ §zÀ¯ÁªÀuÉ
बदलो: ¥ÀæwPÁgÀ ªÀÄÄ¬Äå ¸ÉÃqÀÄwÃjPÉ ºÀUÉ_wÃj¹PÉÆ¼ÀÄî«PÉ
बरी_खबर: M¼ÉîAiÀÄ¸ÀÄ¢Ý ±ÀÄ¨sÀ_¸ÀªÀiÁZÁgÀ
बरी_गजाल: »vÀªÀZÀ£À M¼ÉîªÀiÁvÀÄ
बरी_बातमी: M¼ÉîAiÀÄ¸ÀÄ¢Ý ±ÀÄ¨sÀ_¸ÀªÀiÁZÁgÀ
बरे_गूण: GvÀÌöÈµÀÖvÉ CvÀÄåvÀÛªÀÄ M¼ÉîAiÀÄ
बरें: PÀ¯Áåt ¸ÀÄR_¸ÀªÀÄÈ¢Þ
बरें_आचरण: £ÁåAiÀÄ§zÀÞvÉ ¸ÀzÁZÁgÀ¤µÀ×vÉ ¸ÀzÀÄÎtvÉ
बरें_प्रशासन: zÀPÁëqÀ½vÀ zÀPÀëgÁeÁåqÀ½vÀ
बरें_शासन: zÀPÁëqÀ½vÀ zÀPÀëgÁeÁåqÀ½vÀ
बरें_सरकार: zÀPÁëqÀ½vÀ zÀPÀëgÁeÁåqÀ½vÀ
बरो_मनीस: ¸ÀdÓ£À ¸À¨sÀå M¼ÉîAiÀÄªÀ ¸ÀA¥À£Àß ¸ÀvÀÄàgÀÄµÀ
बरो_वेव्हार: £ÁåAiÀÄ§zÀÞvÉ ¸ÀzÁZÁgÀ¤µÀ×vÉ ¸ÀzÀÄÎtvÉ
बरोबर_खूण: ¸À» gÀÄdÄ ºÀ¸ÁÛPÀëgÀ
बरोबरी: ¸ÀªÀiÁ£ÀvÉ ¸ÀªÀÄvÉÆÃ®£À ¸ÀAvÀÄ®£À
बळ: §®±Á° ¸ÀªÀÄxÀðPÀ vÁPÀvï_EgÀÄªÀªÀ ±ÀQÛªÀAvÀ UÀnÖUÀ
बळीश्ट: «ÃgÀ ¢üÃgÀ ±ÀÆgÀ §®ªÀAvÀ dUÀdnÖ ¸ÁºÀ¹
बस_स्थानक: §¸ï_¤¯ÁÝt §¸ï_¸ÁÖAqï
बसका: D¸À£À ¦ÃoÀ
बांद: CuÉPÀlÄÖ d¯Á±ÀAiÀÄ
बांदणी: eÉÆÃqÀuÉ ¸ÀAAiÉÆÃd£É
बांदोळी: CuÉPÀlÄÖ d¯Á±ÀAiÀÄ
बाक: ¨ÁUÀÄªÀÅzÀÄ E¼ÀÄPÀ®Ä E½eÁgÀÄ
बागकाम: vÉÆÃnUÀ£À_PÉ®¸À
बागवणी: ¨ÁUÀÄªÀÅzÀÄ E¼ÀÄPÀ®Ä E½eÁgÀÄ
बाचाबाची: dUÀ¼À dmÁ¥Àn
बातमी: ¸ÀAzÉÃ±À
बादा: «dÕ CqÀZÀuÉ ¨sÁzÉ vÉÆAzÀgÉ
बायबल: ¨ÉÊ§®Äè ¨ÉÊ§¯ï
बायल_विलन: R¼À£ÁAiÀÄQ
बारिकसाण: aPÀÌzÁVgÀÄ«PÉ QjzÁVgÀÄ«PÉ ¥ÀÅlÖzÁVgÀÄ«PÉ
बार्र: ¸ÁgÁ¬Ä_CAUÀr ªÀÄzÀåzÀAUÀr ¸ÁgÁ¬Ä_CAUÀr ºÉAqÀzÀAUÀr
बाल_अपराध: ¨Á¯Á¥ÀgÁzsÀ
बाल_इश्टीण: ¨Á®åzÀ_UÉ¼Àw ¨Á®å_¸ÉßÃ»vÉ
बाल_चिकित्सक: ªÀÄPÀÌ¼À_ªÉÊzÀå ªÀÄPÀÌ¼À_qÁPÀÖgï
बालवीर: ¨Á®ZÀªÀÄÆ ¨Á0iÀiï¸ËÌmï
बाल्कनी: ¥ÀæzÀ±Àð£À_ªÀÄA¢gÀ avÀæ±Á¯É avÀæªÀÄA¢gÀ UÁå®j
बाळंटेर: ºÉjUÉ ¥Àæ¸ÀªÀ ¥Àæ¸ÀÆw
बाळंटेरघर: ¨ÁtAwªÀÄ£É ºÉjUÉªÀÄ£É ¸ÀÆwPÁUÀÈºÀ ¸ÀÆvÀPÀzÀªÀÄ£É
बाळी: GAUÀÄgÀÄ §¼É CAUÀÄ°Ã0iÀÄ
बासमती: ¨Á¸ÀÄªÀÄw ¨Á¸ÀªÀÄw_CQÌ
बासमती_तांदूळ: ¨Á¸ÀÄªÀÄw ¨Á¸ÀªÀÄw_CQÌ
बाह्यांग: ¥ÀAZÉÃA¢æAiÀÄUÀ¼ÀÄ ¨ÁºÉåÃA¢æAiÀÄUÀ¼ÀÄ
बिंदू: ZÀÄQÌ ©AzÀÄ
बिगाड: «PÁgÀ «gÀÆ¥À «PÀÈw ªÀPÀævÉ
बिजगणीत: ©ÃdUÀtÂvÀ
बिरूद: ¥ÀzÀ£ÁªÀÄ ¥ÀzÀ« G¥Á¢ü
बिशाणें: ºÁ¹UÉ ªÀÄAZÀ ¥À®èAUÀ
बिस्कूत: a£ÀßzÀ_©¸ÉÌÃmï
बिस्मिल्ला: DgÀA¨sÀ ¥ÁægÀA¨sÀ ±ÀÄgÀÄ
बीळ: ©® vÀÆvÀÄ gÀAzÀæ ©qÀÄªÀÅ vÀUÀÄÎ CªÀPÁ±À ©® qÉÆUÀgÀÄ
बुडबुडो: UÀÄ¼Éî ¤Ãj£À_UÀÄ¼Éî ¤ÃUÀÄð¼Éî
बुड्डी: ªÀÈzÉÞ ªÀÄÄzÀÄQ CfÓ
बुतांव: UÀÄAr §l£ï
बुदवंत: §Ä¢ÞªÀAvÀ §Ä¢ÞfÃ« eÁÕ£ÀªÀAvÀ ªÉÄÃzsÁ« ¥ÁædÕ
बुद्ध: UËvÀªÀÄ_§ÄzÀÞ §ÄzÀÞ ¨sÀUÀªÁ£ï_§ÄzÀÞ «ªÉÃPÀ «ªÉÃZÀ£É ¥ÀjeÁÕ£À w¼ÀÄªÀ½PÉ
बुद्धीमत्ता: §Ä¢ÝªÀAwPÉ eÁtvÀ£À eÁuÉä «ªÉÃPÀ
बुरखो: ªÀÄÄRªÁqÀ ªÉÆUÀªÁqÀ ªÉÆÃgÉªÀÄÄ¸ÀÄPÀÄ
बुरशेपण: ªÀiÁ°£Àå PÁ®ÄµÀå PÀ®ä²ÃPÀgÀt
बुराक: ©® vÀÆvÀÄ gÀAzÀæ ©qÀÄªÀÅ vÀUÀÄÎ CªÀPÁ±À ©® qÉÆUÀgÀÄ
बुराश: PÀªÉUÉÆÃ®Ä PÀªÀuÉUÉÆÃ®Ä PÁålgï_©®Äè
बुरो: ¨ÉªÀgÀÄ_(?)
बॅडमिण्टनाचें_फूल: µÀl¯ïPÁPï UÀjAiÀÄ_ZÉAqÀÄ ¥ÀÅPÀÌzÀ_ZÉAqÀÄ
बेकायदेशीरपण: PÁ£ÀÆ£ÀÄ¨Á»gÀ ¤AiÀÄªÀÄ¨Á»gÀ PÁ£ÀÆ¤UÉ_«gÀÄzÀÝªÁzÀ
बेगडीपण: PÀ¥Àl ªÉÆÃ¸À £Àl£É ¸ÉÆÃUÀÄ
बेगिबेगीन: ²ÃWÀæ ¨ÉÃUÀ vÀégÉ ªÉÃUÀ Që¥Àæ
बेडी: PÁ¯ÉâÃr ¨ÉÃr ¸ÀAPÀ¯É ±ÀÈAR¯É
बेरिस्टर: ¨Áåj¸ÀÖgï
बेरीज: PÀÆr¸ÀÄ«PÉ ¸ÀAPÀ®£À ¸ÉÃ¥ÀðqÉ ¸ÉÃjPÉ PÀÆqÀÄ«PÉ ¸ÀAAiÉÆÃUÀ
बेलिस्टर: ¨Áåj¸ÀÖgï
बेळ: ºÀÄ®Äè vÀÈt PÀgÀqÀÄ
बॉडिगार्ड: CAUÀgÀPÀëPÀ ªÉÄÊUÁªÀ®ÄUÁgÀ ¨ÉAUÁªÀ°UÀ
बोकड: ºÉÆÃvÀÄ
बोकडी: ªÉÄÃPÉ DqÀÄ
बोकडो: ºÉÆÃvÀÄ
बोट: zÉÆqÀØ_zÉÆÃtÂ £ÁªÉ_(?)
बोटवो: aÃ® PÉÊaÃ® ¸ÀAa ºÀqÀ¥À
बोटाची_कुरू: ¨ÉgÀ¼À_UÀÄgÀÄvÀÄ
बोडकें: ¨ÉÆÃ¼ÀÄªÀÄgÀ ªÉÆÃlÄªÀÄgÀ
बोडकें_झाड: ¨ÉÆÃ¼ÀÄªÀÄgÀ ¨ÉÆÃqÀÄªÀÄgÀ
बोडको_रूख: ¨ÉÆÃ¼ÀÄªÀÄgÀ ¨ÉÆÃqÀÄªÀÄgÀ
बोध: CjAiÀÄÄ«PÉ UÀæºÀt ªÉÃzÀ£À UÀæ»PÉ CjAiÀÄÄªÀ_QæAiÉÄ
बोमाडो: UÀÄ¼Éî ¤Ãj£À_UÀÄ¼Éî ¤ÃUÀÄð¼Éî §®Æ£ÀÄ
बोमाड्यायान: DPÁ±À§ÄnÖ ¥ÁågÁZÀÆmï
बोलस: eÉÃ§Ä Q¸É
बोली: ªÀZÀ£À ªÁtÂ ªÀiÁvÀÄ ºÉÃ½PÉ
बोवाळ: PÉÆÃ¯ÁºÀ® d£ÀdAUÀÄ½ CªÁAvÀgÀ UÀ¯ÁmÉ UÀzÀÝ® wgÀÄªÀÅ_ªÀÄÄgÀÄªÀÅ vÀ¯É_PÉ¼ÀUÁzÀ §ÄqÀªÉÄÃ¯ÁzÀ UÀzÀÝ® UÀ¯ÁmÉ zÁAzsÀ¯É gÀUÀ¼É DvÀÄgÀ¥ÀqÀÄ«PÉ zÀÄqÀÄPÀÄªÀÅzÀÄ ®UÀÄ§UÉ CªÀ¸ÀgÀ vÀégÉ UÀr©r
बौद्ध_धर्म_मानपी: ¨ËzÀÞ_zsÀªÀiÁðªÀ®A© ¨ËzÀÞ
बौद्ध_भिक्षुणी: ¨ËzÀÞ_©üPÀÄëtÂ ©üPÀÄëtÂ
बौद्ध_भिक्षूक: ¨ËzÀÞ_©üPÀÄÌ ¨ËzÀÞ_©üPÀÄë eÁvÀPÀ
बौद्धधर्मी: ¨ËzÀÞ_zsÀªÀiÁðªÀ®A© ¨ËzÀÞ
ब्रश: PÀÄAZÀ PÀÆZÀð §æµÀÄë ªÀtð_PÀÄAZÀ
ब्रह्मांड: §æºÁäAqÀ «±Àé
भंय: DvÀAPÀ ºÉzÀjPÉ C±ÁAw C¸ËRå £ÉªÀÄä¢UÉÃqÀÄ ¸ÀÄSÁ¨sÁªÀ
भगिनी: vÀAV ¸ÀºÉÆÃzÀj
भट्टी: ¨sÀnÖ
भयण: vÀAV ¸ÀºÉÆÃzÀj
भरणी: £ÉÃ0iÀÄÝ_PÀÆ° £ÉÃ0iÀÄÄªÀ_PÀÆ°
भरपकाम: PÀ¸ÀÆw UÉÆÃlÄ_PÉ®¸À
भरसण: PÉÆ¼ÀPÀÄ PÀ±Àä® ªÀiÁ°£Àå ªÀÄ°£ÀvÉ PÉÆ¼É C±ÀÄzÀÝvÉ
भरोवसो: £ÀA©PÉ «±Áé¸À ¨sÀgÀªÀ¸É
भलें: »vÀ PÀ¯Áåt PÉëÃªÀÄ ¸ËRå PÀÄ±À®
भविश्य: ¨sÀ«µÀå ¨sÀ«µÀå_PÁ®
भविश्य_काळ: ¨sÀ«µÀå ¨sÀ«µÀå_PÁ®
भविश्यकार: ¨sÀ«µÀåªÁ¢
भविश्यवाणी: ¨sÀ«µÀåªÁtÂ
भश्टपण: ªÀÄÄlÄÖ ªÀÄÄmÁÖUÀÄ«PÉ DvÀðªÀ gÀdB¸ÁæªÀ gÀeÉÆÃzÀ±Àð£À
भांग: ¨sÀAV UÁAeÁ
भांगराखण: §AUÁgÀzÀ_UÀtÂ a£ÀßzÀ_C¢gÀÄ
भांगरानाणें: §AUÁgÀzÀ_£Átå a£ÀßzÀ_£Átå
भांडार: ¨sÀAqÁgÀ ¨ÉÆPÀÌ¸À PÉÆÃ±À_(?)
भाकीत: ¨sÀ«µÀåªÁtÂ
भाकीतकार: ¨sÀ«µÀåªÁ¢
भाग: CAUÀ CªÀAiÀÄªÀ ±ÁjÃjPÀ_CAUÀ EA¢æAiÀÄ eÁÕ£ÉÃA¢æAiÀÄ ¥Á±Àéð ¥Á±Àéð_¨sÁUÀ ¨sÁUÀ CA±À RAqÀ ¥Á®Ä
भागाकार: ¨sÁUÁPÁgÀ ¨sÁUÁPÁgÀ ¨sÁV¸ÀÄ«PÉ
भागिदार: ¥Á®ÄzÁgÀ ¸ÀºÀ¨sÁV ¨sÁV
भागिरथी: UÀAUÁ UÀAUÁ£À¢ ¨sÁVgÀy eÁºÀß« ªÀÄAzÁQ¤ ªÀiÁ°¤ £ÀA¢¤ ªÉÊµÀÚ«
भागेली: ¥Á®ÄzÁgÀ ¸ÀºÀ¨sÁV ¨sÁV
भाग्य: CzÀÈµÀÖ ¨sÁUÀå AiÉÆÃUÀ «¢ü £À¹Ã§ ¸Ë¨sÁUÀå
भाजयेकार: vÀgÀPÁj_ªÀiÁgÀÄªÀªÀ PÁ¬Ä¥À®å_ªÀiÁgÀÄªÀªÀ
भाजी: VqÀ_ªÀÄÆ°PÉ OµÀ¢_¸À¸Àå
भाजी_विक्रेतो: vÀgÀPÁj_ªÀiÁgÀÄªÀªÀ PÁ¬Ä¥À®å_ªÀiÁgÀÄªÀªÀ
भाटकार: ªÀiÁ°PÀ AiÀÄdªÀiÁ£À d«ÄÃ£ÁÝgÀ d«ÄÃ£ÀÄzÁgÀ »qÀÄªÀ½zÁgÀ ¨sÀÆªÀiÁ°ÃPÀ d«ÄÃ¤£À_MqÉ0iÀÄ
भाडें: zÀgÀ
भाणशिरें: aA¢ CjªÉ ºÀjzÀ_ºÀjªÉ0iÀÄ_vÀÄAqÀÄ
भायलें_आंग: ¥ÀAZÉÃA¢æAiÀÄUÀ¼ÀÄ ¨ÁºÉåÃA¢æAiÀÄUÀ¼ÀÄ
भायलो: ¥ÀgÀQÃAiÀÄ C£Àå ºÉÆgÀV£ÀªÀ
भार: ¨sÁgÀ ºÉÆgÉ ºÉÃgÀÄ ©tÄà
भारीपण: ¨sÁgÀªÁVgÀÄ«PÉ vÀÆPÀ«gÀÄ«PÉ
भालो: CAPÀÄ±À w«UÉÆÃ®Ä ZÀÄZÀÄÑUÉÆÃ®Ä
भाव: «ÄAZÀÄ ¥ÀæPÁ±À ºÉÆ¼À¥ÀÅ ¸ËAzÀAiÀÄð MAiÀiÁågÀ
भाव_विस्तार: ªÁåSÁå£À nÃPÉ ¨sÁµÀå nÃPÀÄ ¸ÀÆvÀæªÀÈwÛ
भावना: ¨sÁªÀ£É ªÀÄ£ÉÆÃ¨sÁªÀ
भावार्थ: ±ÀæzÉÞ ¤µÉ× ¸ÁgÁA±À ¨sÁªÁxÀð vÀvÁéxÀð ¸ÀAPÉëÃ¥À ¸ÁgÀ
भाशण: ¨sÁµÀt G¥À£Áå¸À ªÀiÁvÀÄ ºÉÃ½PÉ GQÛ ¤gÀÆ¥ÀuÉ ¥ÀæPÀluÉ0iÀÄ_ªÀiÁvÀÄ
भास: ¨sÁµÉ ªÀiÁvÀÄ
भासाभस: UÉÆÃ¶× ¸À¨sÉ ¸ÀºÀªÁ¸À
भासाभास: «ªÉÃZÀ£É «ÄÃªÀiÁA¸É ªÀiÁvÀÄPÀvÉ ¸ÀA¨sÁµÀuÉ ¸À¯Áè¥À «ZÁgÀ-«ªÀÄ±Éð «ªÀÄ±Éð
भिझूड_मनीस: ¥ÀÅPÀÄÌ® CAdÄ§ÄgÀÄPÀ ºÉÃr
भितरलें_आंग: zÉÃºÀzÀ_M¼ÁªÀAiÀÄªÀ zÉÃºÀzÀ_DAvÀjPÀ_CAUÀ
भिवकुरो: ¥ÀÅPÀÄÌ® CAdÄ§ÄgÀÄPÀ ºÉÃr
भुंयभाग: ¥ÀæzÉÃ±À ¥ÁæAvÀ ¤lÄÖ PÉëÃvÀæ ¨sÀÆ¨sÁUÀ ¥ÀæzÉÃ±À ¥ÁæAvÀ
भुंयसेना: ¨sÀÆ_¸ÉÃ£É «Ä°lj
भुतकाळ: PÀ¼ÉzÀ »AzÀt ¸ÀAzÀ UÀvÀ
भुरगो: «zÁåyð¤ ²µÉå ªÀiÁtÂ bÁvÀæ
भुरग्यांगाडी: ªÀÄPÀÌ¼À_UÁr ªÀÄPÀÌ¼À_§Ar
भूंय: £É® ¸ÀÜ¼À ¨sÀÆ«Ä
भूंय_मालमत्ता: ¹ÜgÁ¹Ü
भूंय_संपत्ती: ¹ÜgÁ¹Ü
भेग: ©gÀÄPÀÄ MqÀPÀÄ ¹Ã¼ÀÄ ¸ÀAzÀÄ ©gÀÄQ¤AzÁzÀ_eÁUÀ
भेटोवप: PÉÆqÀÄUÉ PÉÆqÀÄ«PÉ PÁtÂPÉ ¥ÀæzsÁ£À
भेसळ: PÉÆ¼ÀPÀÄ PÀ±Àä® ªÀiÁ°£Àå ªÀÄ°£ÀvÉ PÉÆ¼É C±ÀÄzÀÝvÉ
भोंक: wPÀ UÀÄzÀ ªÀÄÄPÀÄ½ D¸À£ÀzÁégÀ
भोंवडी: ¥ÀæzÀQëuÉ ¸ÀÄvÀÄÛ ¥ÀæAiÀiÁt ¥ÀæªÁ¸À AiÀiÁvÉæ ¥ÀAiÀÄðl£À ¥ÀAiÀÄt
भोंवडे_गाडी: ¸ÀAZÁj_ªÁºÀ£À
भोंवडेकार: 0iÀiÁwæ ¥ÀæªÁ¹ £ÉÆÃqÀÄUÀ
भोंवाडो: ¥ÀæzÀQëuÉ ¸ÀÄvÀÄÛ
भोगविलास: ¨sÉÆÃUÀ«¯Á¸À_(?)
भोवमान: ªÀAzÀ£É ¥ÀæuÁªÀÄ C©üªÀAzÀ£É C©üªÁzÀ£À
भौस: d£À d£ÀvÉ d£ÀgÀÄ d£ÀªÀiÁ£À¸À
भ्रमण: ¥ÀæzÀQëuÉ ¸ÀÄvÀÄÛ
भ्रूणहत्या: §ÆætºÀvÉå
मंगल: »vÀ PÀ¯Áåt PÉëÃªÀÄ ¸ËRå PÀÄ±À® PÀ¯Áåt ¸ÀÄR_¸ÀªÀÄÈ¢Þ
मंच: ªÉÃ¢PÉ
मंजुरी: ¹éÃPÁgÀ ¹éÃPÀÈw CAVÃPÁgÀ
मंडळ: ªÀÄAqÀ½ UÀÄA¥ÀÅ zÀ¼À_(?)
मकबरो: UÉÆÃj ¸ÀªÀiÁ¢ü_ªÀÄAl¥À
मकर: ªÀÄPÀgÀ ªÀÄPÀgÀ_gÁ²
मकर_रास: ªÀÄPÀgÀ ªÀÄPÀgÀ_gÁ²
मखलाशी_करपी: ¸ÀªÀÄyð¸ÀÄªÀªÀ£ÀÄ ¥ÀPÀë¥Áw
मग्नताय: vÀ°èÃ£À
मजत: ¸ÀºÁAiÀÄ £ÉgÀªÀÅ ¸ÀºÀPÁgÀ MvÁÛ¸É
मजा: G¯Áè¸À ºÀµÀð D£ÀAzÀ £À°ªÀÅ ¸ÀAvÉÆÃµÀ
मडवळ_घांट: zÉÆÃ©ÃWÁmï
मड्यांकूड: ±ÀªÀzÀªÀÄ£É ºÉtzÀªÀÄ£É
मतदान: ªÀÄvÀzÁ£À
मतभेद: ªÀÄvÀ¨sÉÃzÀ ©ü£Áß©ü¥ÁæAiÀÄ C©ü¥ÁæAiÀÄ¨sÉÃzÀ
मदत: G¥ÀPÁgÀ zÀAiÀiÁ¥ÀgÀvÉ
मदरसो: ªÀÄzÀgÀ¸Á
मध्यंतर: ªÀÄzsÁåAvÀgÀ ªÀÄzsÀå_¨sÁUÀ
मध्यतंर: ªÀÄzsÀåAvÀgÀ £ÀqÀÄªÀt_CªÀ¢ü CAvÀgÀ ©qÀÄªÀÅ vÉgÀ¥ÀÅ
मध्यबिंदू: PÉÃAzÀæ_©AzÀÄ PÉÃAzÀæ ªÀÄzsÀå©AzÀÄ
मध्यम_पिरायेचो_मनीस: ªÀÄzsÀåªÀ0iÀÄ¸ÀÌ £ÀqÀÄªÀ0iÀÄ¸ÀÌ
मध्यमवयी: ªÀÄzsÀåªÀ0iÀÄ¸ÀÌ £ÀqÀÄªÀ0iÀÄ¸ÀÌ
मन: ªÀÄ£À¸ÀÄì avÀÛ UÀªÀÄ£À zÁå£À zÁå£À¸ÀÜ
मनन: aAvÀ£É AiÉÆÃZÀ£É D¯ÉÆÃZÀ£É
मनरिजवण: ªÀÄ£ÉÆÃgÀAd£É
मनशांचो_समूह: d£À¸ÉÆÛÃªÀÄ d£À_¸ÀªÀÄÆºÀ d£ÀdAUÀÄ½
मनाची_अवस्था: ªÀÄ£ÉÆÃªÀåxÉ PÉÆgÀUÀÄ C¼À®Ä ªÀå¸À£À zÀÄBR
मनीस: ªÀÄ£ÀÄµÀå ªÀiÁ£ÀªÀ ªÀÄ£ÀÄd ªÀåQÛ
मनोकामना: ªÀÄ£À¥ÀÇªÀðPÀ EZÁÑ¥ÀÇªÀðPÀ EµÀÖ¥ÀlÄÖ
मनोगाथा: ªÀÄ£ÉÆÃªÀåxÉ PÉÆgÀUÀÄ C¼À®Ä ªÀå¸À£À zÀÄBR
मनोरंजन: ªÀÄ£ÉÆÃgÀAd£É
मनोव्यथा: ªÀÄ£ÉÆÃªÀåxÉ PÉÆgÀUÀÄ C¼À®Ä ªÀå¸À£À zÀÄBR
मरण: CAvÀå¸ÀA¸ÁÌgÀ ±ÀªÀ¸ÀA¸ÁÌgÀ CAvÀåQæAiÉÄ C¥ÀgÀPÀªÀÄð GvÀÛgÀQæAiÉÄ
मरणकाळ: ¸ÁªÀÅ ªÀÄgÀt ¤zsÀ£À CªÀ¸Á£À ªÀÄÈvÀÄå CAvÀå
मरणघटिका: ¸ÁªÀÅ ªÀÄgÀt ¤zsÀ£À CªÀ¸Á£À ªÀÄÈvÀÄå CAvÀå
मरणविधी: CAvÀå¸ÀA¸ÁÌgÀ ±ÀªÀ¸ÀA¸ÁÌgÀ CAvÀåQæAiÉÄ C¥ÀgÀPÀªÀÄð GvÀÛgÀQæAiÉÄ
मरणसंस्कार: CAvÀå¸ÀA¸ÁÌgÀ ±ÀªÀ¸ÀA¸ÁÌgÀ CAvÀåQæAiÉÄ C¥ÀgÀPÀªÀÄð GvÀÛgÀQæAiÉÄ
मराठी: ªÀÄgÁp ªÀÄgÁp_¨sÁµÉ
मराठी_भास: ªÀÄgÁp ªÀÄgÁp_¨sÁµÉ
मर्यादा: ªÁå¦Û «¸ÁÛgÀ «¹ÛÃtð ºÀgÀªÀÅ
मलबार: PÉÃgÀ¼À
मलमपट्टी: ¥ÀnÖ PÀlÄÖ
मलमल: djdj_§mÉÖ_(?)
मल्लिनाथी: C£ÀÄªÉÆÃzÀ£É ¸ÀªÀÄäw M¦àUÉ
मल्लिनाथी_करपी: ¸ÀªÀÄyð¸ÀÄªÀªÀ£ÀÄ ¥ÀPÀë¥Áw
मळ: ¨ÉªÀgÀÄ_(?) PÉÆ¼É PÉÆ¼ÀPÀÄ ºÉÆ®¸ÀÄ PÀ®ä±À
मळणी: £ÉÃ0iÉÄÎ ºÉuÉ0iÀÄÄ«PÉ £ÉÃ0iÀÄÄ«PÉ
मळणेची_मोलमजुरी: £ÉÃ0iÉÄÎ_PÀÆ°_(?)
मवाली: ¤ÃZÀ zÀÄµÀÖ._¥ÀÅAqÀ ¥sÀnAUÀ ¥ÉÇÃPÀj ¥ÉÇÃ°
मशीन: 0iÀÄAvÀæ ªÀÄ¶Ã£ÀÄ
मसंड: ±ÀªÁUÁgÀ ¸Àä±Á£À ¸ÀÄqÀÄUÁqÀÄ gÀÄzÀæ¨sÀÆ«Ä
मस्करी: QÃl¯ÉUÁgÀ ZÀÄqÁ¬Ä¸ÀÄªÀªÀ gÉÃV¸ÀÄªÀ
महत्वहीणताय: CªÀÄÄRå ªÀÄºÀvÀéªÀ®èzÀ C¥ÀæªÀÄÄR
महत्वाकांक्षा: ªÀÄºÁvÁéPÁAPÉë ºÉ§âAiÀÄPÉ
महत्वाकांक्षाहीणटाय: ªÀÄºÁvÁéPÁAPÉë¬Ä®èzÀ ªÀÄºÁvÁéPÁAPÉë¬ÄgÀzÀ
मांडप: C©üªÀåQÛ ¥ÀæPÀluÉ ºÉÆgÀUÉqÉvÀ
मांयपाय: vÀAzÉ_vÁ¬Ä ªÀiÁvÀ_¦vÀÈ C¥Àà_CªÀÄä C¥Àà_CªÀé
माई: zÉÆqÀØPÀÌ
माक्न: 0iÀÄAvÀæ ªÀÄ¶Ã£ÀÄ
मागणी: «£ÀAw ©£ÀßºÀ PÉÆÃjPÉ ¥ÁæxÀð£É
मागणें: AiÀiÁZÀ£É PÉÆÃjPÉ
मागपी: ©üPÀÄëPÀ ¨ÉÃqÀÄªÀªÀ AiÀiÁZÀPÀ
मागलो_भाग: »A¨sÁUÀ »AzÉ
मागीलदार: »A¨sÁUÀ »AzÉ
माची: ªÉÃ¢PÉ
माणी: vÉÆqÉ CAPÀ HgÀÄ
माती: ºÉÆ® UÀzÉÝ
मात्रा: §ÈºÀvï zÉÆqÀØzÁVgÀÄ«PÉ
माथाळो: ²Ã¶ðPÉ vÀ¯É§gÀºÀ ²gÉÆÃ£ÁªÉÄ
माध्यम: ¸ÁzsÀ£À ¸ÁªÀÄVæ ¸À®PÀgÀuÉ
मान: ¥ÀæSÁåvÀ ºÉ¸ÀgÀÄªÁ¹ ¥Àæ¹zÀÞ SÁåvÀ QÃwð ºÉ¸ÀgÁzÀ ªÀAzÀ£É ¥ÀæuÁªÀÄ C©üªÀAzÀ£É C©üªÁzÀ£À
मानवीकरण: ªÀÄÆwÃðPÀgÀt ªÀiÁ£À«ÃPÀgÀt ªÀÄ£ÀÄµÀåvÁégÉÆÃºÀt
मानस: ªÀÄ£À¸ÀÄì avÀÛ UÀªÀÄ£À
मानसिकताय: ªÀÄ£ÉÆÃgÉÆÃV ªÀiÁ£À¹PÀ_C¸Àé¸ÀÜ
मानसीक_परिस्थिती: ªÀÄ£ÉÆÃgÉÆÃV ªÀiÁ£À¹PÀ_C¸Àé¸ÀÜ
मान्यताय: C£ÀÄªÀÄw ¸ÀªÀÄäw C£ÀÄªÉÆÃzÀ£É M¦àUÉ ¹éÃPÁgÀ ¹éÃPÀÈw CAVÃPÁgÀ CªÀPÁ±À ªÀÄÄQÛ ©qÀÄUÀqÉ
माप: ªÀiÁ¥ÀPÀ ªÀiÁ¥À£À_AiÀÄAvÀæ §ÈºÀvï zÉÆqÀØzÁVgÀÄ«PÉ C¼ÀvÉ ªÀiÁ¥À£À ¥ÀjªÀiÁt
माप_पट्टी: ¥ÀnÖ ¯Ár mÉÃ¥ÀÅ
मापणी: JtÂPÉ UÀt£É ¯ÉPÀÌ JtÂ¸ÀÄªÀÅzÀÄ UÀt£É UÀtw JtÂPÉ ¯ÉPÀÌ
माफ: PÀëªÉÄ ªÀiÁ¦üû PÀë«Ä¸ÀÄªÀÅzÀÄ
मामाआई: CfÓ
मामाई: CfÓ
मायबाप: vÀAzÉ_vÁ¬Ä ªÀiÁvÀ_¦vÀÈ C¥Àà_CªÀÄä C¥Àà_CªÀé
मार्ग: §UÉ jÃw ¸ÁzsÀ£À ªÀiÁUÀð G¥Á0iÀÄ ¨ÉÃgÉ C£Àå §zÀ°
मार्ग_प्रदर्शक: ªÀiÁUÀðzÀ±ÀðPÀ zÁj¢Ã¥ÀPÀ ªÀiÁUÀðzÀ²ð
माल: GvÀà£Àß ªÁtÂdå_¸ÀgÀPÀÄ ªÀiÁgÁlzÀ_¸ÀgÀPÀÄ ©PÀj_ªÀiÁ®Ä
मालक: ªÀiÁ°PÀ AiÀÄdªÀiÁ£À
मालीक: C¯Áèºï C¯Áè
मालीश: CAUÀªÀÄzsÀð£À ªÀiÁ°Ã¸ÀÄ ¤ÃªÀÅªÀÅzÀÄ ¤ÃAiÀÄÄªÀÅzÀÄ
माळ: ¸Á®Ä ¥ÀAQÛ ºÀAvÀ ±ÉæÃtÂ PÀæªÀÄ ¸ÀgÀtÂ ¥ÀAzÀå±ÉæÃtÂ
मासाहारी_प्राणी: ªÀiÁA¸ÀºÁj_¥ÁætÂ ªÀiÁA¸ÀºÁj_dAvÀÄ
माहिती: eÁÕ£À w½ªÀÅ CjªÀÅ w½¢gÀÄªÀ ¥ÀjavÀ UÉÆwÛgÀÄªÀ
मिजास: dA¨sÀ CºÀAPÁgÀ UÀªÀð Mt¥ÀæwµÉ× zÉÆqÀØ¹ÛPÉ
मिठी: D°AUÀ£À C¥ÀÅöàUÉ vÉPÉÌ vÀ§Äâ
मितव्यय: «ÄvÀªÀå0iÀÄ C®àªÀå0iÀÄ ºÁvÀ¼À f¥ÀÅtÄvÀ£À
मित्र: UÉ¼ÉAiÀÄ «ÄvÀæ ¸ÉßÃ»vÀ zÉÆÃ¸ÀÛ ¥ÉæAqï
मिथून: «ÄxÀÄ£À «ÄxÀÄ£À_gÁ²
मिलन: ¨sÉnÖ ¨sÉÃn «Ä®£À
मिलेर: ºÀÄAr UÀ¯Áè
मिश्रधातू: «Ä±Àæ¯ÉÆÃºÀ ¨ÉgÉPÉ¯ÉÆÃºÀ
मिस्तुराद_धातू: «Ä±Àæ¯ÉÆÃºÀ ¨ÉgÉPÉ¯ÉÆÃºÀ
मीठ: ¥ÀævÁåªÀÄè
मीठ_मसालो: Cw±ÀAiÉÆÃQÛ GvÉàçÃPÉë
मीन: «ÄÃ£À_gÁ² «ÄÃ£À
मीन_रास: «ÄÃ£À_gÁ² «ÄÃ£À
मुक्तताय: ©qÀÄUÀqÉ
मुक्ती_दीस: ¸ÁévÀAvÀæ÷å_¢£À
मुखवटो: ªÀÄÄRªÁqÀ ªÉÆUÀªÁqÀ ªÉÆÃgÉªÀÄÄ¸ÀÄPÀÄ
मुखा_वयलो_भाग: ªÀÄÄA¨sÁUÀ ªÀÄÄAzÉ ªÉÆzÀ®¸ÁÜ£À
मुखेल_अध्यापक: ¥ÁæZÁAiÀÄðgÀÄ ¦æ¤ì¥Á®gÀÄ
मुखेल_कचेरी: PÉÃAzÀæ_PÀbÉÃj ¥ÀæzsÁ£À_PÀbÉÃj PÉÃA¢æÃ0iÀÄ_PÁ0iÀiÁð®0iÀÄ ªÀÄÄRå_PÀZÉÃj
मुखेल_कार्यालय: PÉÃAzÀæ_PÀbÉÃj ¥ÀæzsÁ£À_PÀbÉÃj PÉÃA¢æÃ0iÀÄ_PÁ0iÀiÁð®0iÀÄ ªÀÄÄRå_PÀZÉÃj
मुखेल_गांवकार: UÁæªÀÄ¥ÀAZÁ¬ÄÛ_CzÀåPÀëgÀÄ
मुखेल_दरवटो: ºÉ¨ÁâV®Ä zÉÆqÀÝ_¨ÁV®Ä ªÀÄÄRåzÁégÀ
मुखेल_दार: ºÉ¨ÁâV®Ä zÉÆqÀÝ_¨ÁV®Ä ªÀÄÄRåzÁégÀ
मुखेल_रंग: ªÀÄÆ®§tÚ ¥ÀæªÀÄÄR_§tÚ
मुखेल_व्यक्ती: ¥ÀæzsÁ£À_ªÀåQÛ ªÀÄÄRAqÀ £ÁAiÀÄPÀ ªÀÄÄAzÁ¼ÀÄ
मुखेलपण: £ÉÃvÀÈvÀé £ÁAiÀÄPÀvÀé ªÀÄÄAzÁ¼ÀvÀé ªÀÄÄRAqÀvÀé ªÀÄÄAzÁ¼ÀÄvÀ£À
मुखेली: ªÀÄÄRAqÀ £ÁAiÀÄPÀ ªÀÄÄRå¸ÀÜ CzÀåPÀë\ ªÀÄÄRå¸ÀÜ ¥ÀæzsÁ£À_ªÀåQÛ ªÀÄÄRAqÀ £ÁAiÀÄPÀ ªÀÄÄAzÁ¼ÀÄ
मुख्य_कचेरी: PÉÃAzÀæ_PÀbÉÃj ¥ÀæzsÁ£À_PÀbÉÃj PÉÃA¢æÃ0iÀÄ_PÁ0iÀiÁð®0iÀÄ ªÀÄÄRå_PÀZÉÃj
मुख्य_कार्यालय: PÉÃAzÀæ_PÀbÉÃj ¥ÀæzsÁ£À_PÀbÉÃj PÉÃA¢æÃ0iÀÄ_PÁ0iÀiÁð®0iÀÄ ªÀÄÄRå_PÀZÉÃj
मुख्याध्यापक: ¥ÁæZÁAiÀÄðgÀÄ ¦æ¤ì¥Á®gÀÄ ¥ÀæzsÁ£À_UÀÄgÀÄUÀ¼ÀÄ ¥ÁæZÁAiÀÄðgÀÄ ¥ÁæA±ÀÄ¥Á®gÀÄ ¦æ¤ì¥Á¯ï
मुजत: ¸ÀªÀÄAiÀÄ ºÉÆvÀÄÛ ªÉÃ¼É ©qÀÄªÀÅ ¥ÀÅgÀÄ¸ÉÆvÀÄÛ PÁ¯ÁªÀ¢ü ªÀÄÄzÀÝvÀÄ
मुतखडो: ªÀÄÆvÀæ¦AqÀzÀ_C±Àäj
मुत्राशय: ªÀÄÆvÁæ®0iÀÄ ªÀÄÆvÀæ_«¸Àdð£Á®0iÀÄ ±ËZÁ®0iÀÄ
मुदत: ¸ÀªÀÄAiÀÄ ºÉÆvÀÄÛ ªÉÃ¼É ©qÀÄªÀÅ ¥ÀÅgÀÄ¸ÉÆvÀÄÛ PÁ¯ÁªÀ¢ü ªÀÄÄzÀÝvÀÄ
मुद्रा: ºÀt gÀÆ¥Á¬Ä ¥ÉÊ¸É
मुबलकताय: s¸ÁPÁUÀÄªÀµÀÄÖ 0iÀÄxÉÃZÀá ¸ÁPÀµÀÄÖ vÀPÀÌµÀÄÖ CUÀvÀåªÁzÀµÀÄÖ ¨ÉÃPÁzÀµÀÄÖ
मुभा: CªÀPÁ±À ªÀÄÄQÛ ©qÀÄUÀqÉ
मुर्खपण: ªÀÄÆRðvÀ£À C«ªÉÃPÀ zÀqÀØvÀ£À
मुल्ला: ªÀiË°é
मुसलमान: ªÀÄÄ¹èA ªÀÄÄ¸À¯Áä£À ªÀÄÄ¹èÃªÀiï ªÀÄºÀªÀÄ¢ÃAiÀÄ ¸Á§gÀÄ
मुस्लीम: ªÀÄÄ¹èA ªÀÄÄ¸À¯Áä£À ªÀÄÄ¹èÃªÀiï ªÀÄºÀªÀÄ¢ÃAiÀÄ ¸Á§gÀÄ
मूठ: »rPÉ PÉÊ PÁªÀÅ
मूर्ख: ªÀÄÆRð ¨ÉÃPÀÆ¥sóÀ
मूळ: UÉqÉØ_UÉt¸ÀÄ
मूळ_द्रव्य: vÀvÀé ¹zÁÞAvÀ
मूस्त: 0iÀÄÄUÀ ±ÀPÀ
मृदू_उदक: ±ÀÄzÀÞ_¤ÃgÀÄ
मेकळीक: CªÀPÁ±À ªÀÄÄQÛ ©qÀÄUÀqÉ ©qÀÄUÀqÉ
मेजपाचें_काम: UÀtw_PÁAiÀÄð JtÂPÉ_PÁAiÀÄð JtÂ¸ÉÆÃ_PÉ®¸À
मेर: UÀr ªÉÄÃgÉ J¯Éè ¸ÀgÀºÀzÀÄÝ ¹ÃªÀiÁ vÀÄ¢
मेळ: ¨sÉnÖ ¨sÉÃn «Ä®£À
मेळणी: ¨sÉnÖ ¨sÉÃn «Ä®£À G¥À®§ÞvÉ zÉÆgÀPÀÄ«PÉ ¹PÀÄÌ«PÉ
मेष: ªÉÄÃµÀ ªÉÄÃµÀ_gÁ²
मेस्त: PÀÄ±À®PÀ«Äð PÀgÀPÀÄ±À° PÀ¸À§ÄzÁgÀ ªÀÈwÛUÁgÀ
मेस्त्री: PÀÄ±À®PÀ«Äð PÀgÀPÀÄ±À° PÀ¸À§ÄzÁgÀ ªÀÈwÛUÁgÀ
मॉन्सून: ªÀiÁ£ï¸ÀÆ£ï PÁUÁð® ªÀµÁðPÁ® ªÀiÁ£ï¸ÀÆ£ï_ªÀiÁgÀÄvÀ
मोख: ®PÀë÷å UÀÄj GzÉÝÃ±À
मोगाश्रू: D£ÀAzÀ¨ÁµÀà
मोगिका: ¥ÉæÃAiÀÄ¹ ¦æAiÀÄvÀªÉÄ ¸ÀT
मोगी: ¥ÉæÃ«Ä eÉÆvÉUÁgÀ MqÀ£Ár ¸ÀAUÀrUÀ UÉ¼ÉAiÀÄ ¸ÀºÀZÀgÀ
मोजणी: JtÂPÉ UÀt£É ¯ÉPÀÌ JtÂ¸ÀÄªÀÅzÀÄ UÀt£É UÀtw JtÂPÉ ¯ÉPÀÌ
मोटवो: PÀÄ¼Àî VqÀØ ªÉÆÃl PÀÄ§Ó UÀÄeÁÓj ZÉÆÃl
मोटवो_स्वर: ºÀæ¸Àé__¸ÀégÀ ºÀæ¸Àé
मोटार: PÁgÀÄ ªÉÆÃlgï_PÁgÀÄ
मोटारगाडी: PÁgÀÄ ªÉÆÃlgï_PÁgÀÄ
मोटारबोट: ªÉÆÃmÁgï¨ÉÆÃmï ªÉÆÃmÁgÀÄzÉÆÃtÂ AiÀÄAvÀæZÁ°vÀ_zÉÆÃtÂ
मोड: «dÕ CqÀZÀuÉ ¨sÁzÉ vÉÆAzÀgÉ
मोडणी: M£À¥ÀÅ_MAiÀiÁågÀ
मोडतोड: «zÀéA¸ÀPÀ_PÀÈvÀå zÀÄµÀÌöÈvÀå
मोनेपण: ªÀiË£À vÉ¥ÀàVgÀÄªÀÅzÀÄ ¸ÀÄªÀÄä£ÁUÀÄ«PÉ ¤±Àå§ÝvÉ
मोनेळ: ªÀiË£À vÉ¥ÀàVgÀÄªÀÅzÀÄ ¸ÀÄªÀÄä£ÁUÀÄ«PÉ ¤±Àå§ÝvÉ
मोरपांख: £À«®ÄUÀj
मोरपीस: £À«®ÄUÀj
मोल_करपी: ªÀiË®åªÀiÁ¥ÀPÀ UÀÄtªÀiÁ¥ÀPÀ CAzÁdÄUÁgÀ
मोल_थारावणी: ¨É¯É_PÀlÄÖ«PÉ ªÀiË®å_¤zÁðgÀ
मोलावणी: ¨É¯É_PÀlÄÖ«PÉ ªÀiË®å_¤zÁðgÀ
मौलवी: ªÀiË°é
मौला: C¯Áèºï C¯Áè
म्युजियम: ªÀ¸ÀÄÛ_¸ÀAUÀæºÁ®AiÀÄ
म्हण: UÁzÉ £ÁtÄÚr ªÀZÀ£À ¯ÉÆÃPÉÆÃQÛ ¸ÁªÀÄw ¥ÀæºÉÃ½PÉ
म्हत्व: ªÀÄºÀvÀé »jªÉÄ UÀjªÉÄ
म्हयनाची_पाळी: ªÀÄÄlÄÖ ªÀÄÄmÁÖUÀÄ«PÉ DvÀðªÀ gÀdB¸ÁæªÀ gÀeÉÆÃzÀ±Àð£À
म्हयनो: wAUÀ¼ÀÄ ªÀiÁ¸À
म्हाजन: UÁæªÀÄ¥ÀAZÁ¬ÄÛ_CzÀåPÀëgÀÄ
म्हाझूज: ªÀÄºÁAiÀÄÄzÀÞ CAwªÀÄ_AiÀÄÄzÀÞ eÁUÀwPÀ_ªÀÄºÁAiÀÄÄzÀÞ «±Àé_¸ÀªÀÄgÀ
म्हातारी: ªÀÈzÉÞ ªÀÄÄzÀÄQ CfÓ
म्हान_पुरूश: ªÀÄºÁ¥ÀÅgÀÄµÀ ±ÉæÃµÀ×_ªÀåQÛ ªÀÄºÁ±ÀAiÀÄ
म्हानताय: ªÀÄºÀvÀé »jªÉÄ UÀjªÉÄ
म्हानपण: ªÀÄºÀvÀé »jªÉÄ UÀjªÉÄ
म्हापुरूश: ªÀÄºÁ¥ÀÅgÀÄµÀ ±ÉæÃµÀ×_ªÀåQÛ ªÀÄºÁ±ÀAiÀÄ
म्हाल: ¸ÁªÀiÁ£ÀÄ ªÀ¸ÀÄÛ
म्हावराक_प्राणी: ªÀiÁA¸ÀºÁj_¥ÁætÂ ªÀiÁA¸ÀºÁj_dAvÀÄ
म्हूर्त: CªÀ¸ÀgÀ vÀégÉ DvÀÄgÀ zÁªÀAvÀ vÀgÁvÀÄj
म्हेड: UÀÆl zÀ¹
म्हेळेपण: ªÀiÁ°£Àå PÁ®ÄµÀå PÀ®ä²ÃPÀgÀt
म्होर: §AUÁgÀzÀ_£Átå a£ÀßzÀ_£Átå ªÉÆºÀgÀÄ ªÀÄÄzÉæ oÀ¸Éì ¹Ã®Ä
यंत्र: 0iÀÄAvÀæ ªÀÄ¶Ã£ÀÄ
यंत्रमानव: AiÀÄAvÀæ_ªÀiÁ£ÀªÀ gÉÆÃ¨Ámï
यंत्रोपकरण: 0iÀÄAvÉÆæÃ¥ÀPÀgÀt
यश: ¸ÁzsÀ£É £ÉgÀªÉÃjPÉ FqÉÃjPÉ
यशोगान: 0iÀÄ±ÉÆÃUÁxÉ
यशोगीत: 0iÀÄ±ÉÆÃUÁxÉ
याचक: ©üPÀÄëPÀ ¨ÉÃqÀÄªÀªÀ AiÀiÁZÀPÀ
यात्रा: ¥ÀæAiÀiÁt ¥ÀæªÁ¸À AiÀiÁvÉæ ¥ÀAiÀÄðl£À ¥ÀAiÀÄt
यात्री: 0iÀiÁwæ ¥ÀæªÁ¹ £ÉÆÃqÀÄUÀ
याद: £É£À¥ÀÅ ¸ÀäöÈw ¸ÀägÀuÉ
याद_वचप: ªÀÄgÉAiÀÄÄªÀ_¸Àé¨sÁªÀzÀ ªÀÄgÉvÀÄ_ºÉÆÃUÀÄªÀ_(?)
युगांत: AiÀÄÄUÁAvÀ
युद्ध_ध्वज: AiÀÄÄzÀÞ¥ÀvÁPÉ AiÀÄÄzÀÞ_zÀéd
युद्ध_विराम_बावटो: AiÀÄÄzÀÞ«gÁªÀÄ_zÀéd AiÀÄÄzÀÞ«gÁªÀÄ_©½zÀéd
युद्धनाद: gÀtPÀºÀ¼É gÀtWÉÆÃµÀ gÀuÉÆÃzÁÏgÀ AiÀÄÄzÀÞPÀºÀ¼É
युद्धभूंय: gÀtgÀAUÀ 0iÀÄÄzÀÞgÀAUÀ 0iÀÄÄzÀÞ¨sÀÆ«Ä ¸ÀªÀÄgÁAUÀt
युनानी: CAiÉÆÃ¤AiÀÄ£ï_¨sÁµÉ VæÃPï__¨sÁµÉ
युनानी_भास: CAiÉÆÃ¤AiÀÄ£ï_¨sÁµÉ VæÃPï__¨sÁµÉ
युपी: GvÀÛgÀ_¥ÀæzÉÃ±À 0iÀÄÄ¦
युरेनस: AiÀÄÄgÉÃ£À¸ï
युवक: ºÀ¢ºÀgÉAiÀÄzÀ_ºÀÄqÀÄUÀ £ÀªÀ_AiÀÄÄªÀPÀ ºÀgÉAiÀÄzÀ_AiÀÄÄªÀPÀ AiÀÄÄªÀPÀ vÀgÀÄt AiÀiËªÀé£ÀzÀ
युवती: £ÀªÀAiÀÄÄªÀw AiÀÄÄªÀw
युवराज: 0iÀÄÄªÀgÁd
युवराज्ञी: 0iÀÄÄªÀgÁtÂ
युवराणी: 0iÀÄÄªÀgÁtÂ
यूग: 0iÀÄÄUÀ ±ÀPÀ
येवकार: ¸ÁéUÀvÀ §gÀªÀiÁrPÉÆ¼ÀÄî«PÉ ¥ÀæªÉÃ±ÀªÀiÁrPÉÆ¼ÀÄîªÀÅzÀÄ
येवप: DUÀªÀÄ£À §gÀÄ«PÉ §gÀÄªÀÅzÀÄ §gÉÆÃt
येवपी_वेळ: ¨sÀ«µÀå ¨sÀ«µÀå_PÁ®
येशू: K¸ÀÄQæ¸ÀÛ fÃ¸À¸ï
येसाय: ¥ÀÇªÁð¨Áå¸À jºÀ¸Àð¯ï
योगायोग: ¸ÀAAiÉÆÃUÀ ¸ÉÃgÀÄ«PÉ PÀÆqÀÄ«PÉ ºÉÆA¢PÉ
योग्य: C£ÀÄPÀÆ®_(?)
योग्यखर्च: «ÄvÀªÀå0iÀÄ C®àªÀå0iÀÄ ºÁvÀ¼À f¥ÀÅtÄvÀ£À
योग्यताय: CºÀðvÉ AiÉÆÃUÀåvÉ ¸ÁªÀÄxÀåð AiÉÆÃUÀåvÉ CºÀðvÉ PÀëªÀÄvÉ UËgÀªÁºÀð_¹Üw vÀPÀÄÌzÁVgÀÄªÀÅzÀÄ AiÉÆÃUÀåªÁVgÀÄªÀÅzÀÄ
यौगीक_पदार्थ: ¸ÀAAiÀÄÄPÀÛ_¥ÀzÁxÀð
रंग: (?)
रकाद: ¸ÀAzÉÃ±À ªÉÄ¸ÉÃeï
रक्कम: zsÀ£ÀgÁ² ºÀtzÀ_gÁ²
रक्तदान: gÀPÀÛ_PÉÆqÀÄ«PÉ
रक्षक: gÀPÀëPÀ ¸ÀAgÀPÀëPÀ
रचणूक: gÀZÀ£É ¤ªÀiÁðt ¸ÀÈ¶×
रचना: ¸Á»vÀå_PÀÈw ¸Á»wåPÀ_gÀZÀ£É gÀZÀ£É ¤ªÀiÁðt ¸ÀÈ¶×
रजा: DzÉÃ²vÀ_gÀeÉ gÀeÉ ¸ÀÆn ©qÀw
रज्जाक: C¯Áèºï C¯Áè
रड: C¼ÀÄªÀÅzÀÄ gÉÆÃ¢ü¸ÀÄªÀÅzÀÄ
रडणी: C¼ÀÄªÀÅzÀÄ gÉÆÃ¢ü¸ÀÄªÀÅzÀÄ
रडणें: C¼ÀÄªÀÅzÀÄ gÉÆÃ¢ü¸ÀÄªÀÅzÀÄ
रडार: gÉÃqÁgï
रणभूंय: gÀtgÀAUÀ 0iÀÄÄzÀÞgÀAUÀ 0iÀÄÄzÀÞ¨sÀÆ«Ä ¸ÀªÀÄgÁAUÀt
रणवाद्य: gÀt_PÀºÀ¼É 0iÀÄÄzÀÞ_PÀºÀ¼É
रद्दी: gÀ¢Ý gÀ¢Ý_¥ÉÃ¥Àgï gÀ¢Ý_¸ÁªÀiÁ£ÀÄ ªÉÃ¸ïÖ
रफू: vÉÃ¥É
रब: C¯Áèºï C¯Áè
रयवाशी: ¤ªÁ¹ ªÁ¹UÀ
रवथ: ªÉÄ®ÄPÀÄ ZÀªÀðt
रसायन: zÁvÀÄ WÀlPÀ CA±À
रसायनीक_जिनस: gÁ¸ÁAiÀÄ¤PÀ_ªÀ¸ÀÄÛ gÁ¸ÁAiÀÄ¤PÀ_¥ÀzÁxÀð
रसायनीक_तत्व: zÁvÀÄ WÀlPÀ CA±À
रसायनीक_पदार्थ: gÁ¸ÁAiÀÄ¤PÀ_ªÀ¸ÀÄÛ gÁ¸ÁAiÀÄ¤PÀ_¥ÀzÁxÀð
रसायनीक_वस्तू: gÁ¸ÁAiÀÄ¤PÀ_ªÀ¸ÀÄÛ gÁ¸ÁAiÀÄ¤PÀ_¥ÀzÁxÀð
रस्तो_दाखोवपी: ªÀiÁUÀðzÀ±ÀðPÀ zÁj¢Ã¥ÀPÀ ªÀiÁUÀðzÀ²ð
रहमान: C¯Áèºï C¯Áè
रहिवासी: ¤ªÁ¹ ªÁ¹UÀ
रांक: ¸Á®Ä ¥ÀAQÛ ºÀAvÀ ±ÉæÃtÂ PÀæªÀÄ
रांग: ¸Á®Ä ¥ÀAQÛ ºÀAvÀ ±ÉæÃtÂ PÀæªÀÄ
रांदपागॅस: ¤¸ÀUÁð¤® £ÉÊ¸ÀVðPÀ_C¤®
रांदपाचें_साधन: CqÀÄUÉ_¸ÁzÀ£À
रांदपावाय: ¤¸ÀUÁð¤® £ÉÊ¸ÀVðPÀ_C¤®
राखण: ¸ÀÄgÀQëvÀ
राखणदार: gÀPÀëPÀ ¸ÀAgÀPÀëPÀ
राग: ¹lÄÖ PÉÆÃ¥À DPÉÆæÃ±À ¹nÖ£À_PÀÆUÁl ¹mÁÖUÀÄ«PÉ PÉÆÃ¦¹PÉÆ¼ÀÄî«PÉ PÉÆæÃzsÀUÉÆ¼ÀÄî«PÉ
राजतीलक: ¥ÀmÁÖ©üµÉÃPÀ ¹AºÁ¸À£ÁgÉÆÃºÀt UÀzÀÄÝUÉAiÉÄÃjPÉ ¥ÀlÖPÀlÄÖªÀÅzÀÄ
राजदरबार: zÀ¨ÁðgÀÄ gÁdzÀ¨ÁðgÀÄ
राजा: ¤ÃwdÕ ²¸ÀÄÛ_¥Àj¥Á®PÀ PÀlÖ¥ÀàuÉUÁgÀ ¤AiÀÄªÀÄ_¤µÀÄ×gÀ
राजांगण: PÁA¥ËAqÀÄ ¥Ë½ ¥ÁUÁgÀ ªÁr ¨ÉÃ°
राजिनामो: gÁf£ÁªÉÄ_¥ÀvÀæ
राजू: ºÀUÀÎ ºÀÄj £ÉÃtÄ gÀdÄÓ
राज्यकारभार: C¢üPÁgÀ ¥Àæ¨sÀÄvÀé D½éPÉ DzÉÃ±À
राज्याभिषेक: ¥ÀmÁÖ©üµÉÃPÀ ¹AºÁ¸À£ÁgÉÆÃºÀt UÀzÀÄÝUÉAiÉÄÃjPÉ ¥ÀlÖPÀlÄÖªÀÅzÀÄ
राणी: ±Á¸ÀQ gÁtÂ
रातकुड्डेपण: EgÀÄ¼ÀÄUÀtÄÚ gÁwæUÀÄgÀÄqÀÄ
राताधंळेपण: EgÀÄ¼ÀÄUÀtÄÚ gÁwæUÀÄgÀÄqÀÄ
रातेर: E°_¨ÉÆÃ£ÀÄ E°_§¯É
राबितो: ªÁ¸ÀªÁVgÀÄ«PÉ £É¯É¹gÀÄ«PÉ ªÁ¸ÀªÀiÁqÀÄ«PÉ
राबित्याची_सुवात: ªÁ¸À¸ÀÜ¼À ªÁ¸ÀzÀ£É¯É ªÁ¹¸ÀÄªÀ_¸ÀÜ¼À
रावणी: ªÁ¸ÀªÁVgÀÄ«PÉ £É¯É¹gÀÄ«PÉ ªÁ¸ÀªÀiÁqÀÄ«PÉ
रावपी: ¤ªÁ¹ ªÁ¹UÀ
राष्ट्रध्वज: gÁµÀÖç_zÀéd gÁ¶ÖçÃAiÀÄ__zÀéd
राष्ट्रपती: gÁµÀÖç¥Àw
राष्ट्रीय_बावटो: gÁµÀÖç_zÀéd gÁ¶ÖçÃAiÀÄ__zÀéd
रास: gÁ² gÁ²_ZÀPÀæ gÁ² UÀÄA¥ÀÅ ¸ÀªÀÄÆºÀ
रित: ¯ÉÆÃPÀgÀÆrü ¯ÉÆÃPÀ_ªÁåªÀºÁgÀ
रियाज: ¸ÀégÀ_¸ÁzsÀ£É ¸ÀAVÃvÀ_C¨Áå¸À C¨Áå¸À
रियाझ: C¨Áå¸À gÀÆrü
रिवाज: ¸ÀA¸ÉÜ
रीण: ¸Á® PÀqÀ IÄt zÉÃtÂ
रीत: ªÀÄvÁZÀgÀuÉ zsÁ«ÄðPÀ«¢ü ¸ÀA¸ÁÌgÀ PÀªÀÄð
रुची: ªÀå¸À£À ¯Á®¸É ZÀl C©ügÀÄa D¸ÀQÛ M®ªÀÅ
रुढी: ¯ÉÆÃPÀgÀÆrü ¯ÉÆÃPÀ_ªÁåªÀºÁgÀ
रूपडें: ªÀÄÄRªÁqÀ ªÉÆUÀªÁqÀ ªÉÆÃgÉªÀÄÄ¸ÀÄPÀÄ
रूपरेखा: £ÀªÀÄÆ£É ¥ÀæwgÀÆ¥À
रूपरेशा: £ÀªÀÄÆ£É ¥ÀæwgÀÆ¥À
रूपवती: ¸ËAzÀAiÀÄðªÀw ¸ÀÄAzÀj ZÉ®ÄªÉ gÀÆ¥À¹ gÀÆ¥ÀªÀAvÉ
रूपवान_बायल: ¸ËAzÀAiÀÄðªÀw ¸ÀÄAzÀj ZÉ®ÄªÉ gÀÆ¥À¹ gÀÆ¥ÀªÀAvÉ
रूप्याउत्सव: ªÀÄºÉÆÃvÀìªÀ
रेखणी: £ÀªÀÄÆ£É ¥ÀæwgÀÆ¥À
रेल्वे_जंक्शन: gÉÊ¯Éé_gÀhÄAPÀë£ï
रेल्वे_स्टेशन: gÉÊ¯Éé_¤¯ÁÝt gÉÊ¯Éé_¸ÉÖÃµÀ£ï gÉÊ¯Éé_gÀhÄAPÀë£ï
रेल्वे_स्थानक: gÉÊ¯Éé_¤¯ÁÝt gÉÊ¯Éé_¸ÉÖÃµÀ£ï gÉÊ¯Éé_gÀhÄAPÀë£ï
रेल्वेडबो: gÉÊ®ÄqÀ©â
रेशा: ¸Á®Ä ¥ÀAQÛ ºÀAvÀ ±ÉæÃtÂ PÀæªÀÄ
रोंपणी: £Án_ªÀiÁqÀÄªÀÅzÀÄ ¸À¹_ºÀZÀÄÑªÀÅzÀÄ ¸À¹_£ÉqÀÄªÀÅzÀÄ
रोबण: PÀªÉUÉÆÃ®Ä PÀªÀuÉUÉÆÃ®Ä PÁålgï_©®Äè
रोबोट: AiÀÄAvÀæ_ªÀiÁ£ÀªÀ gÉÆÃ¨Ámï
र्‍हस्व: ºÀæ¸Àé__¸ÀégÀ ºÀæ¸Àé
र्‍हास: PÉÆ¼ÉvÀ PÀë0iÀÄ fÃtðvÉ
लंगोटीयार: ¨Á®åzÀ_UÉ¼ÉAiÀÄ ¨Á®åzÀ_«ÄvÀæ
लकणी: £À¸ÀÄ¤zÉæ
लकलक: ºÉÆ¼À¥ÀÅ «ÄgÀÄUÀÄ ¥ÀæPÁ±ÀªÀiÁ£À
लक्ष: UÀªÀÄ¤¸ÀÄ«PÉ ®PÀë÷å«qÀÄ«PÉ ®PÀë÷å UÀÄj GzÉÝÃ±À
लक्षण: ®PÀët UÀÄt
लग्न: «ªÁºÀ ªÀÄzÀÄªÉ ®UÀß
लग्न_जाल्लो_दादलो: «ªÁ»vÀ «ªÁ»vÀ_¥ÀÅgÀÄµÀ
लटकेपण: C¸ÀºÀd C¸Áé¨sÁ«PÀ PÀÈwæªÀÄ PÀÈvÀPÀvÉ ¸ÉÆÃUÀÄ
लटीकपण: C¸ÀºÀd C¸Áé¨sÁ«PÀ PÀÈwæªÀÄ PÀÈvÀPÀvÉ ¸ÉÆÃUÀÄ
लांकडाकोळसो: ªÀÄgÀzÀ_E¢Ý®Ä ªÀÄgÀzÀ_EzÀÄè
लांकूड: PÀnÖUÉ ªÀÄgÀzÀ_vÀÄAqÀÄ vÉÆ¯É
लांकूड_कोळसो: ªÀÄgÀzÀ_E¢Ý®Ä ªÀÄgÀzÀ_EzÀÄè
लांच: ®AZÀ gÀÄµÀÄªÀvÀÄÛ
लांब_स्वर: ¢ÃWÀð¸ÀégÀ ¢ÃWÀð
लांब_स्वास: ¤lÄÖ¹gÀÄ ¤rzÁzÀ_ºÀÄ¹gÀÄ ¢ÃWÀð_ºÀÄ¹gÀÄ
लाग: M£À¥ÀÅ_MAiÀiÁågÀ
लागीं: ¥ÀPÀÌ ¥Á±Àéð ªÀÄUÀÎ®Ä §¢
लिखणेपात्र: ¯ÉPÀÌtÂPÉ
लिपयेकरण: °TvÀgÀÆ¥À §gÀºÀgÀÆ¥À CPÀëgÀgÀÆ¥À
लिपी: °¦ §gÀºÀ
लिपीबद्ध: °TvÀgÀÆ¥À §gÀºÀgÀÆ¥À CPÀëgÀgÀÆ¥À
लिपीशैली: ªÀiÁvÀæPÀëgÀªÀiÁ¯É ªÀiÁvÁæ°¦ªÀiÁ¯É
लुंवणी: PÉÆAiÀÄÄè PÀmÁªÀÅ
लुकसाण: £ÀµÀÖ ®ÄPÁì£À PÀ¼ÉvÀ
लुगट: §mÉÖ ªÀ¸ÀÛç
लुटपी: PÉÆ¼ÉîUÁgÀ ®ÆnUÁgÀ zÁ½UÁgÀ ¸ÀÄ°UÉ_ªÀiÁqÀÄªÀªÀ ¸ÀÆgÉ_ºÉÆqÉAiÀÄÄªÀ
लेख: §gÀªÀtÂUÉ PÉÊ§gÀºÀ ºÀ¸ÁÛPÀëgÀ
लेखणी: §gÀºÀzÀ_G¥ÀPÀgÀt
लेखन: §gÀªÀtÂUÉ PÉÊ§gÀºÀ ºÀ¸ÁÛPÀëgÀ
लेखा_परिक्षक: ¯ÉPÀÌ_¥Àj±ÉÆÃzsÀPÀ ¯ÉPÀÌ_¥ÀjÃPÀëPÀ ¯ÉÃSÁ¥ÀjÃPÀëPÀ
लोक: ¥ÀgÀQÃAiÀÄ C£Àå ºÉÆgÀV£ÀªÀ d£À d£ÀvÉ d£ÀgÀÄ d£ÀªÀiÁ£À¸À ¥ÀæeÉ £ÁUÀjPÀ ¸ÀézÉÃ²ÃAiÀÄ zÉÃ²ÃAiÀÄ
लोककल्याण: ¯ÉÆÃPÉÆÃ¥ÀPÁgÀ d£À_PÀ¯Áåt d£À_¸ÉÃªÉ ¯ÉÆÃPÁxÀð
लोककाणी: d£À¥ÀzÀ_PÀvÉ
लोकसंख्या: d£À¸ÀASÉå
लोकसभा: d£À¸À¨sÉ ¸À¨sÁ¸ÁÜ£À
लोकसेवा: ¯ÉÆÃPÉÆÃ¥ÀPÁgÀ d£À_PÀ¯Áåt d£À_¸ÉÃªÉ ¯ÉÆÃPÁxÀð
लोकांची_बसका: d£À¸À¨sÉ ¸À¨sÁ¸ÁÜ£À
लोकाचार: ¯ÉÆÃPÀgÀÆrü ¯ÉÆÃPÀ_ªÁåªÀºÁgÀ
लोकोपकार: ¯ÉÆÃPÉÆÃ¥ÀPÁgÀ d£À_PÀ¯Áåt d£À_¸ÉÃªÉ ¯ÉÆÃPÁxÀð
लोणचें: G¦à£ÀPÁ¬Ä HgÀÄUÁ¬Ä
ल्हान_आंतकडी: ¸ÀtÚ_PÀgÀÄ¼ÀÄ
ल्हान_कंस: C¯ÁàªÀgÀt C¯ÁàªÀgÀt_aºÉß_(.......)
ल्हान_कुडको: C®à._¸Àé®à vÀÄ¸ÀÄ PÀrªÉÄ PÉÆAZÀ
ल्हान_दोंगर: UÀÄqÀØ ¨ÉlÖ
वंश: ªÀA±À PÀÄ® eÁw ªÀUÀð
वंशज: ªÀA±Àd ¸ÀAvÁ£À ¸ÀAvÀw
वकील: £ÁåAiÀÄ±Á¸ÀÛçdÕ £ÁåAiÀÄ±Á¸ÀÛçªÉÃvÀÛ £ÁåAiÀÄ±Á¸ÀÛç_¥ÀrvÀ
वकृत्व: ºÉÃ½PÉ GQÛ ¤gÀÆ¥ÀuÉ ¥ÀæPÀluÉ0iÀÄ_ªÀiÁvÀÄ
वक्तव्य: ºÉÃ½PÉ GQÛ ¤gÀÆ¥ÀuÉ ¥ÀæPÀluÉ0iÀÄ_ªÀiÁvÀÄ
वखदालय: OµÀ¢ü_CAUÀr OµÀzsÁ®AiÀÄ
वज: ªÀå¸À£À ¯Á®¸É ZÀl
वजन: ¨sÁgÀ ºÉÆgÉ ºÉÃgÀÄ ©tÄà
वजाबाकी: PÀ¼ÉAiÀÄÄ«PÉ ªÀåªÀPÀ®£À
वजें: ¨sÁgÀ ºÉÆgÉ ºÉÃgÀÄ ©tÄà
वट: ¥Á±Àéð ¥Á±Àéð_¨sÁUÀ
वडी: ©¯Éè vÀÄAqÀÄ UÀÄ½UÉ ªÀiÁvÉæ
वध: ºÀvÉå RÆ¤ PÉÆ¯É ªÀzsÉ
वयर_येवप: GPÀÄÌ
वयली_सुवात: CUÀæ¸ÁÜ£ÀzÀ GvÀÛªÉÆÃvÀÛªÀÄ vÀÄvÀÛvÀÄ¢AiÀÄ
वयलो_पदाधिकारी: GZÀÒ_C¢üPÁj G£ÀßvÀ_C¢üPÁj
वयलो_भाग: CUÀæ¸ÁÜ£ÀzÀ GvÀÛªÉÆÃvÀÛªÀÄ vÀÄvÀÛvÀÄ¢AiÀÄ
वर्ग: ªÀUÀð ±ÉæÃtÂ §UÉ ¥ÀAUÀqÀ vÁ¸ÀÄ
वर्ण: CPÀëgÀ ªÀtð °¦ §gÀºÀ
वर्णमाळ: ªÀtðªÀiÁ¯É CPÀëgÀªÀiÁ¯É
वर्णावळ: ªÀtðªÀiÁ¯É CPÀëgÀªÀiÁ¯É
वर्तमान_काळ: ªÀvÀðªÀiÁ£À_PÁ®
वर्तूळ: ªÀvÀÄð® ªÀÈvÀÛ UÉÆÃ® ZÀPÀæ
वर्सां: ªÀAiÀÄ¸ÀÄì DAiÀÄÄµÀå fÃªÀªÀiÁ£À
वळेरी: ¸ÀÆa C£ÀÄPÀæªÀÄtÂPÉ
वसणूक: ªÀ¸ÁºÀvÀÄ ¥Á¼É0iÀÄ
वसाहत: ªÀ¸ÁºÀvÀÄ ¥Á¼É0iÀÄ
वस्त: D¨sÀgÀt MqÀªÉ
वस्तु: ¸ÁªÀiÁ£ÀÄ ªÀ¸ÀÄÛ
वस्तू: ¥ÀzÁxÀð ¥ÀzÁxÀð ªÀ¸ÀÄÛ
वांगडीपण: ¸ÀzÀ¸Àå ªÉÄA§gï
वांटेकार: ¥Á®ÄzÁgÀ ¸ÀºÀ¨sÁV ¨sÁV
वाक्य: G¯ÉèÃR GzÀÞgÀt GzÁºÀgÀuÉ DzsÁgÀ Crn¥ÀàtÂ
वाक्यार्थ: ªÁPÁåxÀð_(?)
वाखाणणी: GzÁÎgÀ
वागणुक: £ÀqÀªÀ½PÉ £ÀqÁªÀ½ ªÀvÀð£É
वाचा: ªÀZÀ£À ªÁtÂ ªÀiÁvÀÄ ºÉÃ½PÉ
वाजोवपी: ªÁzÀPÀ
वाट: §UÉ jÃw ¸ÁzsÀ£À ªÀiÁUÀð G¥Á0iÀÄ
वाट_दाखोवपी: ªÀiÁUÀðzÀ±ÀðPÀ zÁj¢Ã¥ÀPÀ ªÀiÁUÀðzÀ²ð
वाट_पळोवप: JzÀÄgÀÄ_£ÉÆÃqÀÄªÀªÀ zÁj_PÁAiÀÄÄªÀªÀ_(?)
वाटकूळ: ªÀvÀÄð® ªÀÈvÀÛ UÉÆÃ® ZÀPÀæ
वाटय_खबर: PÉlÖ¸ÀÄ¢Ý C¥À±ÀPÀÄ£À C±ÀÄ¨sÀ_¸ÀªÀiÁZÁgÀ
वाटसरो: 0iÀiÁwæ ¥ÀæªÁ¹ £ÉÆÃqÀÄUÀ
वाटाघाटी: ZËPÁ²
वाठार: ¥ÀæzÉÃ±À ¥ÁæAvÀ ¤lÄÖ PÉëÃvÀæ ¨sÀÆ¨sÁUÀ ¥ÀæzÉÃ±À ¥ÁæAvÀ
वाड: ¸ÀªÀÄAiÀÄ ºÉÆvÀÄÛ ªÉÃ¼É ©qÀÄªÀÅ ¥ÀÅgÀÄ¸ÉÆvÀÄÛ PÁ¯ÁªÀ¢ü ªÀÄÄzÀÝvÀÄ
वाडणी: Hl_§r¸ÀÄªÀÅzÀÄ HlQÌPÀÄÌªÀÅzÀÄ
वाडो: ªÉÆºÀ®è ªÁqÀð £ÀUÀgÀ NtÂ zÉÆqÀØªÀÄ£É ¸ËzsÀ ªÁqÉ ¨sÀªÀ£À ªÀÄºÀ®Ä
वाणी: ªÀZÀ£À ªÁtÂ ªÀiÁvÀÄ ºÉÃ½PÉ
वात: §wÛ
वातावरण: ¥Àj¹Üw ¸À¤ßªÉÃ±À ¹ÜwUÀw
वाद: dUÀ¼À dmÁ¥Àn UÀ¯ÁmÉ dUÀ¼À ¨ÉÊUÀÄ¼À_(?)
वापर: C£ÀÄ¨sÉÆÃUÀ G¥À¨sÉÆÃUÀ ªÀiÁgÁl RZÁðUÀÄ«PÉ s¸ÀÄSÁ£ÀÄ¨sÀªÀ_(?)
वाय: UÁå¸ÉÆÃ°Ã£ÀÄ_vÉÊ®
वायकोश: ªÁAiÀÄÄPÉÆÃ±À_(?)
वायट_उतर: ¨ÉÊUÀÄ¼À PÉlÖ_ªÀiÁvÀÄ §AiÀÄÄå«PÉ ¤AzÀ£É zÀÆµÀuÉ ¨ÉÊUÀ¼ÀÄ ±Á¥À ¤AzÉ C¥ÀzÀÞ
वायट_उलोवप: PÀlÄ_¨sÁµÀt_(?)
वायट_कर्म: zÀÄµÀÌöÈvÀå zÀÄµÁÌAiÀÄð PÉlÖ_PÉ®¸À
वायट_बातमी: PÉlÖ¸ÀÄ¢Ý C¥À±ÀPÀÄ£À C±ÀÄ¨sÀ_¸ÀªÀiÁZÁgÀ
वायट_भाशण: PÀlÄ_¨sÁµÀt_(?)
वायट_वज: zÀÄ±ÀÑl zÀÄgÀ¨Áå¸À ªÀå¸À£À ZÀl VÃ¼ÀÄ ZÁ½
वायट_वेसन: zÀÄ±ÀÑl zÀÄgÀ¨Áå¸À ªÀå¸À£À ZÀl VÃ¼ÀÄ ZÁ½
वायट_व्यक्ती: zÀÄµÀÖ PÉlÖªÀ ¤ÃZÀ zÀÄµÀÖ zÀÄgÀÄ¼À
वायट_शासन: zÀÄgÁqÀ½vÀ CAzsÀ_zÀ¨ÁðgÀÄ
वायट_सपन: PÉlÖPÀ£À¸ÀÄ zÀÄ¸Àé¥Àß WÉÆÃgÀ¸Àé¥Àß
वायस_प्रेसिडेण्ट: G¥À_gÁµÀÖç¥Àw ªÉÊ¸ï_¥Àæ¹qÉAmï
वायूसेना: ªÁAiÀÄÄ_¸ÉÃ£É
वार: KlÄ ¥ÉlÄÖ ºÉÆqÉvÀ
वारांद: ¥ÀæzÀ±Àð£À_ªÀÄA¢gÀ avÀæ±Á¯É avÀæªÀÄA¢gÀ UÁå®j
वावूरपी: PÁ0iÀÄðPÀvÀð
वाष्प_इंजीन: GV_§Ar GV_AiÀÄAvÀæ D«_AiÀÄAvÀæ
वास: ¸ÀÄUÀAzsÀ ¸ÀÄUÀAzsÀ_¥ÀjªÀÄ¼À
वासीन: ®¹PÉ ZÀÄZÀÄÑªÀÄzÀÄÝ
विकास: G£Àßw »jªÉÄ K½UÉ JvÀÛgÀ
विक्रम: zÁR¯É gÉPÁqïð
विखारी_दात: «µÀzÀ_ºÀ®Äè
विखाळ_दात: «µÀzÀ_ºÀ®Äè
विचार: aAvÀ£É AiÉÆÃZÀ£É D¯ÉÆÃZÀ£É ¨sÁªÀ£É ªÀÄ£ÉÆÃ¨sÁªÀ «ZÁgÀ aAvÀ£É D¯ÉÆÃZÀ£À_«zsÁ£À LrAiÀiÁ
विचारवंत: aAvÀPÀ «ZÁgÀªÀAvÀ PÀÄ±ÁUÀæ
विचारी: aAvÀPÀ «ZÁgÀªÀAvÀ PÀÄ±ÁUÀæ
विजेचें_इंजीन: «zÀÄåvïZÁ°vÀ_AiÀÄAvÀæ «zÀÄåvïZÁ°vÀ_ªÁºÀ£À
विज्ञानीक: «eÁÕ¤
विण्णी: £ÉÃ0iÀÄÝ_PÀÆ° £ÉÃ0iÀÄÄªÀ_PÀÆ°
विद्यापीठ: ±Á¯É «zÁå®AiÀÄ «zÁå_ªÀÄA¢gÀ ¸ÀÆÌ®Ä
विद्यार्थिनी: ²µÉå «zÁåyð¤ C¨sÁå¹¤
विद्यार्थी: NzÀÄUÀ CzÀåAiÀÄ£ÀPÁgÀ
विद्यालय: ±Á¯É «zÁå®AiÀÄ «zÁå_ªÀÄA¢gÀ ¸ÀÆÌ®Ä
विद्यूत_इंजीन: «zÀÄåvïZÁ°vÀ_AiÀÄAvÀæ «zÀÄåvïZÁ°vÀ_ªÁºÀ£À
विद्रूप_बायल: PÀÄgÀÆ¦_ºÉAUÀ¸ÀÄ
विद्वत्ता: «zÉå ¥ÁArvÀå eÁÕ£À w¼ÀÄªÀ½PÉ NzÀÄ
विधान: ¸ÀA¸ÉÜ G¯ÉèÃR GzÀÞgÀt GzÁºÀgÀuÉ DzsÁgÀ Crn¥ÀàtÂ
विनंती: «£ÀAw ©£ÀßºÀ PÉÆÃjPÉ ¥ÁæxÀð£É
विनाश: ¥ÀvÀ£À CªÀ£Àw CzsÉÆÃUÀw
विनीमय: «¤ªÀÄAiÀÄ CzÀ®Ä_§zÀ®Ä PÉÆqÀÄ_PÉÆ¼ÀÄ«PÉ
विनोद: ºÁ¸ÉÆåÃQÛ vÀªÀiÁµÉ eÉÆÃPï
विपक्षी: «¥ÀQëÃAiÀÄ «gÉÆÃzsÀ_¥ÀQëÃAiÀÄ
विभाग: ªÀUÀð ±ÉæÃtÂ §UÉ ¥ÀAUÀqÀ
विमान: «ªÀiÁ£À KgÉÆÃ¥ÉèÃ£ï
विमानतळ: «ªÀiÁ£À_¤¯ÁÝt
विमानशाळा: «ªÀiÁ£ÀSÁ£É
विरक्ती: «gÀQÛ ªÉÊgÁUÀå
विरामचिन्न: «gÁªÀÄ_aºÉß_(_._)
विरोध: ¥ÀæwgÉÆÃzsÀ «gÉÆÃzsÀ ¥ÀæwªÁzÀ RAqÀ£É «gÉÆÃzsÀ
विरोधक: «¥ÀQëÃAiÀÄ «gÉÆÃzsÀ_¥ÀQëÃAiÀÄ
विरोधी: «¥ÀQëÃAiÀÄ «gÉÆÃzsÀ_¥ÀQëÃAiÀÄ
विरोधी_पक्षाचो_वांगडी: «¥ÀQëÃAiÀÄ «gÉÆÃzsÀ_¥ÀQëÃAiÀÄ
विर्धाथी: «zÁåyð¤ ²µÉå ªÀiÁtÂ bÁvÀæ
विलन: R¼À£ÁAiÀÄPÀ
विलाप: UÉÆÃ¼Ál «¯Á¥À ¥Àæ¯Á¥À gÉÆÃzÀ£À
विवरण: ¸ÁgÁA±À MmÁÖgÉ_ºÉÃ¼ÀÄ«PÉ vÁvÀà0iÀÄð
विवाहीत_पुरूश: «ªÁ»vÀ «ªÁ»vÀ_¥ÀÅgÀÄµÀ
विशारी_दात: «µÀzÀ_ºÀ®Äè
विशिश्टताय: «²µÀ×vÉ CºÀðvÉ
विशेशज्ञ: ¤¥ÀÅt ZÀvÀÄgÀ eÁt ¥ÀjtvÀ vÀdÕ ¥Àæ«Ãt
विशेशाधिकार: «±ÉÃµÁ¢üPÁgÀ
विश्टा: »PÉÌ ¦ZÉÑ
विश्फोट: ¸ÉÆàÃl «¸ÉÆàÃl ¹rvÀ
विश्लेशण: «ÄÃªÀiÁA¸É
विश्वस्तमंडळ: læ¸ïÖ PÀÆqÀÄªÁå¥ÁgÀ_¸ÀA¸ÉÜ £Áå¸À
विश्वास: £ÀA©PÉ «±Áé¸À ¨sÀgÀªÀ¸É
विश्वासघात: £ÀA©PÉzÉÆæÃºÀ «±Áé¸ÀWÁvÀÄPÀvÉ C«±Áé¸À¤Ã0iÀÄvÉ ªÉÆÃ¸ÀUÁjPÉ
विश्वासू: ¤µÁ×ªÀAvÀ ¸Áé«Ä¤µÀ× «±Áé¸À¥ÁvÀæ
विसव: ¥ÀÅgÀ¸ÀvÀÄÛ ©qÀÄªÀÅ «gÁªÀÄ DgÁªÀÄ £ÉªÀÄä¢ ºÀUÀÄgÀ ±ÀªÀÄ£À
विसवासुवात: «±ÁæAvÀ_PÉÆoÀr «±ÁæAvÀ_¸ÀÜ¼À
विस्तार: «¸ÀÛgÀuÉ ºÀgÀrPÉ
विस्वासू: ¤µÁ×ªÀAvÀ ¸Áé«Ä¤µÀ× «±Áé¸À¥ÁvÀæ
वीख: «µÀ £ÀAdÄ
वीर: «ÃgÀ ¢üÃgÀ ±ÀÆgÀ §®ªÀAvÀ dUÀdnÖ ¸ÁºÀ¹
वृद्ध: ªÀÈzÉÞ ªÀÄÄzÀÄQ CfÓ
वृशण: CAqÀPÉÆÃ±À ªÀÈµÀt vÀgÀqÀÄ_(©Ãd)
वृशभ_राशीचो: ªÀÈµÀ¨sÀ_gÁ²0iÀÄªÀ
वृशभी: ªÀÈµÀ¨sÀ_gÁ²0iÀÄªÀ
वृश्चीक: ªÀÈ²ÑPÀ ªÀÈ²ÑPÀ_gÁ²
वृषभ: ªÀÈµÀ¨sÀ ªÀÈµÀ¨sÀ_gÁ²
वेंग: D°AUÀ£À C¥ÀÅöàUÉ vÉPÉÌ vÀ§Äâ
वेंचणूक: ZÀÄ£ÁªÀuÉ DAiÉÄÌ Nn£À_ªÀÄÆ®PÀ_Dj¸ÀÄªÀÅzÀÄ
वेंचप: DAiÉÄÌ_ªÀiÁqÀÄªÀÅzÀÄ Dj¹PÉÆ¼ÀÄî«PÉ ZÀÄ£Á¬Ä¹PÉÆ¼ÀÄî«PÉ
वेगळेपण: ®PÀët UÀÄt
वेद: ªÉÃzÀ
वेदना: 0iÀiÁvÀ£É ªÉÃzÀ£É
वेदी: ªÉÃ¢PÉ
वेपार: ªÁå¥ÁgÀ
वेर: ©gÀÄPÀÄ MqÀPÀÄ ¹Ã¼ÀÄ ¸ÀAzÀÄ ©gÀÄQ¤AzÁzÀ_eÁUÀ
वेळ: ¸ÀªÀÄAiÀÄ PÁ® UÀAmÉ ¸ÀªÀÄAiÀÄ ºÉÆvÀÄÛ ªÉÃ¼É ©qÀÄªÀÅ ¥ÀÅgÀÄ¸ÉÆvÀÄÛ PÁ¯ÁªÀ¢ü ªÀÄÄzÀÝvÀÄ CªÀ¸ÀgÀ vÀégÉ DvÀÄgÀ zÁªÀAvÀ vÀgÁvÀÄj
वेळमर्यादा: PÁ¯ÁªÀ¢ ¤¢ðµÀ×_¸ÀªÀÄAiÀÄ
वेळाची_शीम: PÁ¯ÁªÀ¢ ¤¢ðµÀ×_¸ÀªÀÄAiÀÄ
वेवसात: GzÉÆåÃUÀ ªÀå¥ÁgÀ ¥Àæ0iÀÄvÀß
वेवसाय: GzÀåªÀÄ PÉÊUÁjPÉ
वेवस्था: ªÀåªÀ¸ÉÜ K¥ÁðlÄ ¥ÀÇªÀð¹zÀÞvÉ ¥ÀÇªÀðAiÉÆÃd£É vÀAiÀiÁj
वेव्हार: £ÀqÀªÀ½PÉ £ÀqÁªÀ½ ªÀvÀð£É
वेव्हार_कुशळटाय: OavÀå¥ÀæeÉÕ ¸ÀªÀÄAiÉÆÃavÀ ¸ÀªÀÄAiÉÆÃ¥ÁAiÀÄ
वेव्हारीकताय: OavÀå¥ÀæeÉÕ ¸ÀªÀÄAiÉÆÃavÀ ¸ÀªÀÄAiÉÆÃ¥ÁAiÀÄ
वेस: CAZÀÄ UÀrUÉgÉ
वेसन: zÀÄ±ÀÑl zÀÄgÀ¨Áå¸À ªÀå¸À£À ZÀl VÃ¼ÀÄ ZÁ½
वैराग्य: «gÀQÛ ªÉÊgÁUÀå
वैराग्यपण: «gÀQÛ ªÉÊgÁUÀå
वॉर्ड: gÉÆÃVUÀ¼À_PÉÆÃuÉ ªÁqÀð
व्यंग: ªÀåAUÀå ªÀåAUÉÆåÃQÛ PÀ»£ÀÄr Ej£ÀÄr PÉÆAPÀÄ£ÀÄr ªÀÄÆzÀ°PÉ
व्यंजन: ªÀåAd£À ªÀåAd£ÁPÀëgÀ
व्यक्त_करप: C©üªÀåQÛ ¥ÀæPÀluÉ ºÉÆgÀUÉqÉvÀ
व्यक्ती: ªÀÄ£ÀÄµÀå ªÀiÁ£ÀªÀ ªÀÄ£ÀÄd ªÀåQÛ
व्यक्तीत्व: ªÀåQÛvÀé
व्यक्तीमत्व: ªÀåQÛvÀé
व्यभिचारी: ªÀå©üZÁj ªÀå©üZÁj_ªÀåQÛ
व्यय: RZÀÄð ªÀå0iÀÄ ªÉZÀÑ
व्यर्थ_खर्च: C¥ÀªÀåAiÀÄ zÀÄAzÀÄªÉZÀÑ
व्यसन: ªÀå¸À£À ¯Á®¸É ZÀl
व्यस्तताय: PÁAiÀÄð¤gÀvÀ PÉ®¸ÀzÀ°è_ªÀÄUÀß vÀ°èÃ£À
व्याकूळटाय: ¥ÀæPÀÄë§ÝvÉ C¸ÀÛªÀå¸ÀÛvÉ CªÀåªÀ¸ÉÜ G¢éUÀßvÉ
व्याख्या: ªÁåSÁå£À nÃPÉ ¨sÁµÀå nÃPÀÄ ¸ÀÆvÀæªÀÈwÛ
व्यापकताय: ªÁå¥ÀPÀ ªÁå¥ÀPÀvÉ
व्हंवर: zÀA¥Àw
व्हड_आंतकडी: zÉÆqÀØ_PÀgÀÄ¼ÀÄ CAvÀæ
व्हड_भयण: zÉÆqÀØPÀÌ
व्हडपण: GvÀÌöÈµÀÖvÉ CvÀÄåvÀÛªÀÄ M¼ÉîAiÀÄ
व्हडली_भयण: zÉÆqÀØPÀÌ
व्हडें: zÉÆqÀØ_zÉÆÃtÂ £ÁªÉ_(?)
व्हांवणी: ¥ÀæªÁºÀ ºÀjªÀÅ ºÀjvÀ Nl
शक्त: §®±Á° ¸ÀªÀÄxÀðPÀ vÁPÀvï_EgÀÄªÀªÀ ±ÀQÛªÀAvÀ UÀnÖUÀ
शक्ती: ±ÀQÛ PÀ¸ÀÄªÀÅ D¥ÀÅ C¼ÀªÀÅ §®
शक्यताय_शक्यताय: ¸ÀA¨sÀªÀ ±ÀPÀåvÉ ¸ÁzÀåvÉ
शटल_कॉक: µÀl¯ïPÁPï UÀjAiÀÄ_ZÉAqÀÄ ¥ÀÅPÀÌzÀ_ZÉAqÀÄ
शपत: ¥ÀæweÉÕ ¥Àt ¤±ÀÑAiÀÄ
शरीर_रचणूक: zÉÃºÀzÀ_ªÉÄÊPÀlÄÖ ±ÀjÃjPÀ_¤®Ä«PÉ_(?)
शल्यचिकित्सक: ±À¸ÀÛçaQvÉì
शस्त्र: ±À¸ÀÛç ±À¸ÁÛç¸ÀÛç DAiÀÄÄzsÀ
शस्त्रचिकित्सा_कक्ष: ±À¸ÀÛçaQvÁì_PÉÆÃuÉ ±À¸ÀÛçaQvÉìAiÀÄ_PÉÆoÀr D¥ÀgÉÃµÀ£ï_yAiÉÄÃlgï
शाकजिवी: ¸À¸ÀåºÁj_¥ÁætÂ ¸À¸ÀåºÁj_dAvÀÄ
शाकाहारी: ¸À¸ÀåºÁj_¥ÁætÂ ¸À¸ÀåºÁj_dAvÀÄ
शासन: C¢üPÁgÀ ¥Àæ¨sÀÄvÀé D½éPÉ DzÉÃ±À C¢ü¥ÀvÀå MqÉvÀ£À ¸ÁéªÀÄå C¢üPÁgÀ
शासन__चलोवपी: ¤ÃwdÕ ²¸ÀÄÛ_¥Àj¥Á®PÀ PÀlÖ¥ÀàuÉUÁgÀ ¤AiÀÄªÀÄ_¤µÀÄ×gÀ
शासनकर्ती: ±Á¸ÀQ gÁtÂ
शासिका: ±Á¸ÀQ gÁtÂ
शिंपयेजीव: ªÀÄÈzÀéAV_fÃªÀdAvÀÄ ªÀÄ®¸ÀÌ
शिकपी: «zÁåyð¤ ²µÉå ªÀiÁtÂ bÁvÀæ NzÀÄUÀ CzÀåAiÀÄ£ÀPÁgÀ
शिकवण: G¥ÀzÉÃ±À ¤Ãw¨sÉÆÃzÉ zsÀªÉÆðÃ¥ÀzÉÃ±À ¤Ãw G¥ÀzÉÃ±À eÁÕ£À w½ªÀÅ
शिकार: ¨ÉÃmÉ ²PÁj ªÀÄÈUÀAiÀiÁ«ºÁgÀ
शिकोवपाचें_काम: ²PÀët «zÉå CzÀåAiÀÄ£À
शिक्को: ªÉÆºÀgÀÄ ªÀÄÄzÉæ oÀ¸Éì ¹Ã®Ä CZÀÄÑ ¥ÀrAiÀÄZÀÄÑ
शिक्षण: ²PÀët «zÉå CzÀåAiÀÄ£À
शिक्षण_उपाधी: (?)
शिक्षण_पदवी: (?)
शिक्षिका: ²PÀëQ UÀÄgÀÄªÀiÁvÉ ²PÀëQ UÀÄgÀÄªÀiÁvÉ CzÁå¥ÀQ
शिखर: ²RgÀ vÀÄ¢ vÀÄlÖvÀÄ¢
शिघ्रताय: ²ÃWÀæ ¨ÉÃUÀ vÀégÉ ªÉÃUÀ Që¥Àæ
शिटकावणी: ªÀÄÄ£ÀÆìZÀ£É ¸ÀÆZÀ£É JZÀÑjPÉ ¸ÀÄ½ªÀÅ
शिपणावळ: ¤ÃgÁªÀj
शिपाय: dªÁ£À ¹¥Á¬Ä ¸ÉÃªÀPÀ QAPÀgÀ ¦ªÁ£À
शिमातिक्रमण: UÀr_DPÀæªÀÄt ¹ÃªÀiÁ_G®èAUÀ£É
शिरशिरी: GvÉÛÃd£À G¢ÝÃ¥À£À ¥ÀæZÉÆÃzÀ£À
शिरशीर: vÀÄAvÀÄgÀÄªÀÄ¼É ¸ÉÃZÀ£À ¹A¥ÀrPÉ
शिराप: £ÀgÀ¼Ál ªÀÄÄ®ÄPÀÄ zÀÄBR±Áé¸À DvÀð£ÁzÀ
शिर्षक: ²Ã¶ðPÉ vÀ¯É§gÀºÀ ²gÉÆÃ£ÁªÉÄ
शिवराक: ¸À¸ÀåºÁj_¥ÁætÂ ¸À¸ÀåºÁj_dAvÀÄ
शिश्य: C£ÀÄAiÀiÁ¬Ä C£ÀÄªÀwð C£ÀÄZÀgÀ ¥ÀjZÁgÀPÀ
शिश्या: ²µÉå «zÁåyð¤ C¨sÁå¹¤
शीतपेय: vÀA¥ÀÅ_¥Á¤ÃAiÀÄ vÀtÚ£É_gÀ¸À vÀtÚV£À_¥ÉÃAiÀÄ
शीतयुद्ध: ²ÃvÀ®_¸ÀªÀÄgÀ ²ÃvÀAiÀÄÄzÀÞ
शीम: CAZÀÄ UÀrUÉgÉ ªÁå¦Û «¸ÁÛgÀ «¹ÛÃtð ºÀgÀªÀÅ
शीमरक्षक: UÀr_PÁªÀ®ÄUÁgÀ UÀr_gÀPÀëPÀ ¸ÉÊ¤PÀ AiÉÆÃzsÀ
शुक्रजंतू: «ÃAiÀiÁðtÄ «ÃAiÀÄð ±ÀÄPÁætÄ gÉÃvÀ¸ÀÄì zÁvÀÄ
शुक्राणू: «ÃAiÀiÁðtÄ «ÃAiÀÄð ±ÀÄPÁætÄ gÉÃvÀ¸ÀÄì zÁvÀÄ
शुद्धताय: ¸ÀéZÀá ±ÀÄzÀÞvÉ ±ÀÄ¢Þ £ÉÊªÀÄð®å
शूभ: PÀ¯Áåt ¸ÀÄR_¸ÀªÀÄÈ¢Þ
शृखंला: ¸ÀgÀtÂ ¥ÀAzÀå±ÉæÃtÂ
शेंपडी: ¨Á® ¯ÁAUÀÆ®
शेंपाडो: ¨Á® ¯ÁAUÀÆ®
शेंपूट: ¨Á® ¯ÁAUÀÆ®
शेंपो: ¨Á® ¯ÁAUÀÆ®
शेजारी: CPÀÌ¥ÀPÀÌ £ÉgÉºÉÆgÉ £ÉgÉAiÀÄªÀ £ÉgÉºÉÆgÉAiÀÄªÀ CPÀÌ¥ÀPÀÌzÀªÀ
शेटीचें_दुकान: ¨É½î_§AUÁgÀzÀ_¥ÉÃmÉ CPÀÌ¸Á°UÀgÀ_NtÂ
शेण: ¸ÉUÀtÂ UÉÆÃªÀÄAiÀÄ ¸ÀUÀtÂ
शेत: MtVzÀ_¥À¸À®Ä
शेतकिडो: Qæ«Ä_QÃl ºÀÄ¼À_G¥Ààr
शेतकी_खातें: PÀÈ¶_«¨sÁUÀ
शेतकी_विज्ञान: PÀÈ¶_«eÁÕ£À
शेतकी_विभाग: PÀÈ¶_«¨sÁUÀ
शेतभूंय: ¥sÀ®ªÀvÁÛzÀ_¨sÀÆ«Ä PÀÈ¶¨sÀÆ«Ä
शेती: PÀÈ¶ ¨ÉÃ¸ÁAiÀÄ ªÀåªÀ¸ÁAiÀÄ MPÀÌ®ÄvÀ£À
शेव: CAZÀÄ vÀÄ¢
शेवट: ¸ÀªÀiÁ¦Û ªÀÄÄPÁÛAiÀÄ ¸ÀªÀiÁgÉÆÃ¥À CAvÀå Ew CAvÀå PÉÆ£É ¸ÀªÀiÁ¦Û
शो: ¸ÁºÀ¸À_¥ÀæzÀ±Àð£À PÀ¸ÀgÀwÛ£À_¥ÀæzÀ±Àð£À
शोकपूर्णताय: zÀÄBRªÀÄAiÀÄªÁzÀ ±ÉÆÃPÀ§jvÀªÁzÀ
शोकहीणताय: zÀÄBR«®è¢gÀÄ«PÉ ±ÉÆÃPÀ«®è¢gÀÄ«PÉ
शोफेर: ZÁ®PÀ qÉÊªÀgï qÉæöÊªÀgï
शोशण: »ÃgÀÄ«PÉ ZÀÆµÀt CªÀ±ÉÆÃµÀt
शौक: ªÀå¸À£À ¯Á®¸É ZÀl
श्रद्धा: ±ÀæzÉÞ ¤µÉ×
श्रीगणेशा: DgÀA¨sÀ ¥ÁægÀA¨sÀ ±ÀÄgÀÄ
श्रेश्टताय: GvÀÌöÈµÀÖvÉ CvÀÄåvÀÛªÀÄ M¼ÉîAiÀÄ
श्रेश्ठताय: M¼ÉîAiÀÄvÀ£À ±ÉæÃµÀ×vÉ
संकल्प: zÀÈqsÀ¸ÀAPÀ®à ¹ÜgÀ¤±ÀÑAiÀÄ
संकेत: ¸À£Éß ¸ÀAeÉÕ ¸ÀAPÉÃvÀ
संख्या: ¸ÀASÉå CAPÉ
संगमरवर: CªÀÄÈvÀ_²¯É ºÁ®UÀ®Äè ¸ÀAUÀªÀÄªÀj_PÀ®Äè
संगीत_तज्ञ: ¸ÀAVÃvÀ_«zÁé£ï
संगीत_वाद्य: ¸ÀAVÃvÀ_ªÁzÀåUÀ¼ÀÄ ¸ÀAVÃvÀ_G¥ÀPÀgÀtUÀ¼ÀÄ
संगीतकार: ªÁzÀPÀ
संग्रहालय: ªÀ¸ÀÄÛ_¸ÀAUÀæºÁ®AiÀÄ
संघ: ªÀÄAqÀ½ UÀÄA¥ÀÅ zÀ¼À_(?)
संचार: s¸ÀAªÀºÀ£À w½0iÀÄ¥Àr¸ÀÄ«PÉ vÀ®Ä¦¸ÀÄªÀÅzÀÄ ¸ÀA¥ÉæÃµÀt
संज्ञा: ºÉ¸ÀgÀÄ £ÁªÀÄ £ÁªÀÄzsÉÃAiÀÄ
संदेश: ¸ÀAzÉÃ±À ¸ÀAzÉÃ±À ªÉÄ¸ÉÃeï G¥ÀzÉÃ±À ¤Ãw¨sÉÆÃzÉ zsÀªÉÆðÃ¥ÀzÉÃ±À
संदेश_वाहक: zÀÆvÀ ¸ÀAzÉÃ±À_ªÁºÀPÀ
संन्यासिणी: ¸À£Áå¹¤ AiÉÆÃV¤ ªÉÊgÁV¤
संबोधन: ¸ÀA¨sÉÆÃzÀ£É PÀÆUÀÄ«PÉ PÀgÉAiÀÄÄ«PÉ JZÀÑj¸ÀÄ«PÉ w½¸ÀÄ«PÉ
संभाव्यताय: ®§åvÉ ±ÀPÀåvÉ ¸ÀÄ®¨sÀvÉ ¸ÀÄUÀªÀÄvÉ C£ÀÄPÀÆ®vÉ
संमती: ¸ÀºÀªÀÄvÀ
संमान: ªÀAzÀ£É ¥ÀæuÁªÀÄ C©üªÀAzÀ£É C©üªÁzÀ£À
संयम: ¸ÀAAiÀÄªÀÄ
संयोग: ¨sÉnÖ ¨sÉÃn «Ä®£À
संवसारीक_झूज: eÁUÀwPÀ_ªÀÄºÁAiÀÄÄzÀÞ «±Àé_¸ÀªÀÄgÀ
संवाद: ªÀiÁvÀÄPÀvÉ ¸ÀA¨sÁµÀuÉ ¸À¯Áè¥À
संवेदना: ¸ÀAªÉÃzÀ£É ¨sÁªÉÇÃzÉæÃPÀ
संशोधन: wzÀÄÝ¥Àr wzÀÄÝ¥ÁlÄ
संस्था: ¸ÀA¸ÁÜ£À ¸ÀA¸ÉÜ ¥ÀæwµÁ×£À
संस्थान: ¸ÀA¸ÁÜ£À ¸ÀA¸ÉÜ ¥ÀæwµÁ×£À
संस्थापक: ¸ÀA¸ÁÜ¥ÀPÀ ¥ÀæwµÁ×¥ÀPÀ d£ÀPÀ d£ÀäzÁvÀ ¸ÀA¸ÁÜ¥ÀPÀ
सकयलो_ओंठ: PÉ¼ÀzÀÄn CªÀÅqÀÄ
सगल्याचे_मान्यताय: ¸ÀªÁð£ÀÄªÀÄvÀ MªÀÄävÀ KPÁ©ü¥Áæ0iÀÄ
सज्जन: ¸ÀdÓ£À ¸À¨sÀå M¼ÉîAiÀÄªÀ ¸ÀA¥À£Àß ¸ÀvÀÄàgÀÄµÀ
सज्जनताय: ¸ÀdÓ£À M¼ÉîAiÀÄªÀ
सण: ºÀ§â GvÀìªÀ eÁvÉæ ¥ÀªÀð
सत्ता: C¢ü¥ÀvÀå MqÉvÀ£À ¸ÁéªÀÄå C¢üPÁgÀ
सत्य: ¸ÀvÀå ¤d AiÀÄxÁxÀðvÉ ªÁ¸ÀÛ«PÀ_¸ÀAUÀw
सत्री: PÉÆqÉ bÀwæ
सत्संग: ¸ÀvÀìAUÀ ¸Àvï¸ÀAUÀ ¸Àvï¸ÀªÀiÁUÀªÀÄ
सदाचरण: £ÁåAiÀÄ§zÀÞvÉ ¸ÀzÁZÁgÀ¤µÀ×vÉ ¸ÀzÀÄÎtvÉ
सप्तक: ªÁgÀ ¸Á¥ÁÛºÀ
सभाध्यक्ष: ¸À¨sÁ¥Àw ¸À¨sÁzÀåPÀë
सभापती: ¸À¨sÁ¥Àw ¸À¨sÁzÀåPÀë
सभासदताय: ¸ÀzÀ¸Àå ªÉÄA§gï
सभ्यताय: £ÁUÀjPÀvÉ £ÁUÀjPÀ_¸ÀªÀiÁd
समजणी: CAzÁdÄ JtÂPÉ UÀæºÀt
समजाती: ¸ÀeÁwAiÀÄ ¸ÀéeÁwAiÀÄ
समजूतदारपण: ¸ÁªÀÄAd¸Àå ¸ÁAUÀvÀå «ªÉÃPÀ «ªÉÃZÀ£É ¥ÀjeÁÕ£À w¼ÀÄªÀ½PÉ
समर्थक: ¸ÀªÀÄyð¸ÀÄªÀªÀ£ÀÄ ¥ÀPÀë¥Áw
समर्थन: C£ÀÄªÉÆÃzÀ£É ¸ÀªÀÄäw M¦àUÉ
समस्या: «dÕ CqÀZÀuÉ ¨sÁzÉ vÉÆAzÀgÉ ¸ÀªÀÄ¸Éå aAvÉ PÀ¼ÀªÀ¼À ªÁåPÀÄ®
समाजशास्त्र: ¸ÁªÀiÁd_«eÁÕ£À ¸ÀªÀiÁd±Á¸ÀÛç
समाजीक_विज्ञान: ¸ÁªÀiÁd_«eÁÕ£À ¸ÀªÀiÁd±Á¸ÀÛç
समाधान: vÀÈ¦Û ¸ÀAvÀÈ¦Û ¸ÀAvÀÄ¶Ö ¥ÀjºÁgÀ
समानताय: ¸ÀªÀiÁ£ÀvÉ ¸ÀªÀÄvÉÆÃ®£À ¸ÀAvÀÄ®£À
समाप्ती: ¸ÀªÀiÁ¦Û ªÀÄÄPÁÛAiÀÄ ¸ÀªÀiÁgÉÆÃ¥À CAvÀå Ew
समारोप: ¸ÀªÀiÁgÉÆÃ¥À ªÀÄÄPÁÛAiÀÄ ¸ÀªÀiÁ¦Û PÉÆ£ÉUÉÆ¼ÀÄî
समारोप_सुवाळो: ¸ÀªÀiÁgÉÆÃ¥À ªÀÄÄPÁÛAiÀÄ ¸ÀªÀiÁ¦Û PÉÆ£ÉUÉÆ¼ÀÄî
समिक्षक: «ªÀÄ±ÀðPÀ «ªÉÃZÀPÀ «ZÁgÀPÀ
समिती: DAiÉÆÃUÀ PÀ«ÄÃµÀ£ï
सया: «ÄAZÀÄ ¥ÀæPÁ±À ºÉÆ¼À¥ÀÅ ¸ËAzÀAiÀÄð MAiÀiÁågÀ
सर: ºÉÆÃ°PÉ G¥ÀªÉÄ ¸ÁªÀÄå ¸ÁzÀÈµÀå
सरकटपी_प्राणी: ¸ÀjÃ¸ÀÈ¥À_fÃ« ºÀjzÁqÀÄªÀ_fÃ« vÉªÀ¼ÀÄªÀ_fÃ«
सरकार: C¢üPÁgÀ ¥Àæ¨sÀÄvÀé D½éPÉ DzÉÃ±À
सरकारी_आदवोगाद: ¸ÀgÀPÁj_ªÀQÃ® ¸ÀgÀPÁj_£ÁåAiÀÄªÁ¢
सरकारी_वकील: ¸ÀgÀPÁj_ªÀQÃ® ¸ÀgÀPÁj_£ÁåAiÀÄªÁ¢
सरपळी: ¸ÀgÀ¥À½ ¸ÀAPÉÆÃ¯É
सरबराय: Cwy_¸ÀvÁÌgÀ DwxÀå
सराफ_बाजार: ¨É½î_§AUÁgÀzÀ_¥ÉÃmÉ CPÀÌ¸Á°UÀgÀ_NtÂ
सर्कस: ¸ÀPÀð¸ï
सर्त: ¥ÉÊ¥ÉÇÃn ¥Àæw¸ÀàzsÉð ¸ÀàzsÉð ¸ÀàzsÉð ¥Àæw¸ÀàzsÉð
सर्वमान्यताय: ¸ÀªÁð£ÀÄªÀÄvÀ MªÀÄävÀ KPÁ©ü¥Áæ0iÀÄ
सर्वांग: CRAqÀ ¥ÀÇwð ¸ÀA¥ÀÇtð
सर्वोच्च_न्यायालय: ¸ÀªÉÇÃðZÀÑ_£ÁåAiÀiÁ®AiÀÄ ¸ÀÄ¦æªÀiï__PÉÆÃmïð
सल्ल: ¹¥Éà vÉÆUÀmÉ
सवंय: ªÀå¸À£À ¯Á®¸É ZÀl
सवतीबापूय: ªÀÄ®vÀAzÉ
सवलत: j0iÀiÁ¬Äw ©qÀÄªÀ½ ©lÄÖPÉÆqÀÄªÀÅzÀÄ ¸ÉÆÃr_©qÀÄªÀÅzÀÄ
सवार: ¸ÀªÁgÀ
सवारी_गाडी: ¸ÀAZÁj_ªÁºÀ£À
सस्तन: ¸À¸ÀÛ¤ ¸À¸ÀÛ¤_ªÀUÀðzÀ_¥ÁætÂ
सहनटी: G¥À_£ÁAiÀÄQ
सहनायक: G¥À_£ÁAiÀÄPÀ
सहनायिका: G¥À_£ÁAiÀÄQ
सहमती: ¸ÀºÀªÀÄvÀ CªÀPÁ±À ªÀÄÄQÛ ©qÀÄUÀqÉ
सहयोगी_मनीस: ¸ÀºÁAiÀÄPÀ
सांगता_तें: DeÉÕ DzÉÃ±À ºÀÄPÀÄªÀÄÄ PÀlÄÖ¥ÁqÀÄ PÀlÖ¼É
सांगाती: UÉ¼ÉAiÀÄ «ÄvÀæ ¸ÉßÃ»vÀ zÉÆÃ¸ÀÛ ¥ÉæAqï
सांत्वन: s¸ÁAvÁé£À ¸ÀAvÉÊ¹PÉ ¸ÀAvÉÊ¸ÀÄªÀÅzÀÄ ¸ÀªÀÄzsÁ£À
साकळी: ¸ÀgÀ¥À½ ¸ÀAPÉÆÃ¯É
सातत्य: ¤gÀAvÀgÀªÁV JqÉ©qÀzÉ
साथी: UÉ¼ÉAiÀÄ «ÄvÀæ ¸ÉßÃ»vÀ zÉÆÃ¸ÀÛ ¥ÉæAqï
साद: ¸ÀA¨sÉÆÃzÀ£É PÀÆUÀÄ«PÉ PÀgÉAiÀÄÄ«PÉ JZÀÑj¸ÀÄ«PÉ w½¸ÀÄ«PÉ
सादरीकरण: ¥Àæ¸ÀÄÛvÀ M¦à¸ÀÄªÀÅzÀÄ C¦ð¸ÀÄªÀÅzÀÄ ¤gÀÆ¦¸ÀÄªÀÅzÀÄ
सादारणताय: ¸ÁªÀiÁ£ÀåvÉ ¸ÁzsÁgÀtªÁzÀ
साधन: ¸ÁzsÀ£À ¸ÁªÀÄVæ ¸À®PÀgÀuÉ ¸ÁªÀiÁ£ÀÄ ¸ÁzsÀ£À ¸À®PÀgÀuÉ
साधवी: ¸À£Áå¹¤ AiÉÆÃV¤ ªÉÊgÁV¤
साफसफाय: UÀÄr¸ÀÄªÀÅzÀÄ ¨ÁaºÁPÀÄªÀÅzÀÄ
सामान: ¸ÁªÀiÁ£ÀÄ ªÀ¸ÀÄÛ GvÀà£Àß ªÁtÂdå_¸ÀgÀPÀÄ ªÀiÁgÁlzÀ_¸ÀgÀPÀÄ ©PÀj_ªÀiÁ®Ä s¸ÁªÀiÁ£ÀÄ ¸ÀgÀPÀÄ ¸À£ÀUÀÄ ¸ÀgÀAeÁªÀÄÄ ¥ÀzÁxÀð ¸ÁªÀÄVæ
सामान्यताय: ¸ÁªÀiÁ£ÀåvÉ ¸ÁzsÁgÀtªÁzÀ
सायड_हिरो: G¥À_£ÁAiÀÄPÀ
सायड_हिरोयीण: G¥À_£ÁAiÀÄQ
सार: ¸ÁgÀ ¸ÁgÁA±À n¥ÀàtÂ ¸ÁgÁA±À ¨sÁªÁxÀð vÀvÁéxÀð ¸ÀAPÉëÃ¥À ¸ÁgÀ
सारकी_खूण: ¸À» gÀÄdÄ ºÀ¸ÁÛPÀëgÀ
सारांश: ¸ÁgÁA±À ¨sÁªÁxÀð vÀvÁéxÀð ¸ÀAPÉëÃ¥À ¸ÁgÀ
साल: s¸À¨sÁ_¨sÀªÀ£À ¸À¨sÁ_ªÀÄA¢gÀ_(?) ¹¥Éà vÉÆUÀmÉ
साळीक: PÀªÀÄ® vÁªÀgÉ
साव: ¸ÀdÓ£À ¸À¨sÀå M¼ÉîAiÀÄªÀ ¸ÀA¥À£Àß ¸ÀvÀÄàgÀÄµÀ
सावकार: d«ÄÃ£ÁÝgÀ d«ÄÃ£ÀÄzÁgÀ »qÀÄªÀ½zÁgÀ ¨sÀÆªÀiÁ°ÃPÀ d«ÄÃ¤£À_MqÉ0iÀÄ
सावत्र_बापूय: ªÀÄ®vÀAzÉ
सावळी: £ÉgÀ¼ÀÄ bÁAiÉÄ
साहित्य: ¸Á»vÀå
साहित्यकृती: ¸Á»vÀå_PÀÈw ¸Á»wåPÀ_gÀZÀ£É
साहित्यीक_रचना: ¸Á»vÀå_PÀÈw ¸Á»wåPÀ_gÀZÀ£É
सिद्धांत: ¹zÁÝAvÀ ¤AiÀÄªÀÄ PÁAiÉÄÝ
सींह: ¹AºÀ ¹AºÀ_gÁ²
सीख: ¹Pï ¹PÀÌgÀÄ ¹Pï_ªÀÄvÁªÀ®A©
सीट: PÁ¬ÄÝj¹zÀ_D¸À£À jdªÀðqï_¹Ãmï
सुंगट: ¥Áæ£ï
सुंदरकाय: CAzÀ ZÉAzÀ ¸ÉÆ§UÀÄ ¸ÉÆUÀ¸ÀÄ gÀªÀÄåvÉ ªÀÄ£ÉÆÃºÀgÀvÉ
सुंदरी: ¸ËAzÀAiÀÄðªÀw ¸ÀÄAzÀj ZÉ®ÄªÉ gÀÆ¥À¹ gÀÆ¥ÀªÀAvÉ
सुकतडो: ªÉÄvÀÄ_ªÀÄÆ¼ÉgÉÆÃUÀ PÀÄn®_ªÁvÀ UÀæºÀtÂ ªÀÄÄgÀÄlÄ ªÀÄÄqÀÄ_zÉÆÃµÀ
सुकसाण: MtPÀ®Ä MtVzÀÄzÀÄ
सुकेपण: MtPÀ®Ä MtVzÀÄzÀÄ
सुको_दुश्काळ: C£ÁªÀÈ¶× d®PÁëªÀÄ
सुक्षीमताय: aPÀÌzÁVgÀÄ«PÉ QjzÁVgÀÄ«PÉ ¥ÀÅlÖzÁVgÀÄ«PÉ
सुख: ¸ÀÄR ¸ÀAvÉÆÃµÀ £ÉªÀÄä¢
सुगंध: ¸ÀÄUÀAzsÀ ¸ÀÄUÀAzsÀ_¥ÀjªÀÄ¼À
सुटका: DgÁªÀÄ £ÉªÀÄä¢ ºÀUÀÄgÀ ±ÀªÀÄ£À ©qÀÄUÀqÉ
सुटकेझुजारी: PÁæAwPÁgÀ §AqÁAiÀÄPÁgÀ
सुटले: ©qÀÄªÀÅ
सुटी: DzÉÃ²vÀ_gÀeÉ gÀeÉ ¸ÀÆn ¸ÁªÀðd¤PÀ_gÀeÉ gÀeÉ ¸ÀÆn ©qÀw
सुटोवणी: ¥ÀjºÁgÀ
सुदार: C©üªÀÈ¢Þ ¸ÀÄzsÁgÀuÉ
सुदारणा: zÀÄgÀ¹Û £ÉÃ¥ÁðlÄ ¸Àj¥Àr¸ÀÄ«PÉ
सुपरिटेंडेण्ट: ªÉÄÃ°éZÁgÀPÀ ¥Àj«ÃPÀëPÀ
सुप्रीम_कोर्ट: ¸ÀªÉÇÃðZÀÑ_£ÁåAiÀiÁ®AiÀÄ ¸ÀÄ¦æªÀiï__PÉÆÃmïð
सुमन: ºÀÆ ºÀÆªÀÅ ¥ÀÅµÀà PÀÄ¸ÀÄªÀÄ ¥Àæ¸ÀÆ£À
सुरक्षा: ¸ÀÄgÀQëvÀ
सुरक्षा_वणत: ¸ÀÄvÀÄÛUÉÆÃqÉ PÉÆÃmÉAiÀÄ_¸ÀÄvÀÄÛUÉÆÃqÉ DªÁgÀzÀUÉÆÃqÉ PÁA¥ÉÇÃAqÀÄ
सुरवात: DgÀA¨sÀ ¥ÁægÀA¨sÀ ±ÀÄgÀÄ ªÀÄÆ® ªÉÆzÀ®Ä DgÀA¨sÀ ¥ÁægÀA¨sÀ ±ÀÄgÀÄ
सुलभताय: ®§åvÉ ±ÀPÀåvÉ ¸ÀÄ®¨sÀvÉ ¸ÀÄUÀªÀÄvÉ C£ÀÄPÀÆ®vÉ
सुळको: ¥ÀªÀðvÀ_²RgÀ ¨ÉlÖzÀ_vÀÄ¢ »ªÀiÁ®AiÀÄzÀ_±ÀÈAUÀ
सुवचन: »vÀªÀZÀ£À M¼ÉîªÀiÁvÀÄ
सुवात: ¸ÁÜ£À ¸ÀÜ¼À ¥ÀæzÉÃ±À eÁUÀ ¥ÀæzÉÃ±À ¥ÁæAvÀ ¤lÄÖ PÉëÃvÀæ JqÉ vÉgÀ¥ÀÅ CªÀPÁ±À ¸ÀÜ¼À eÁUÀ ¸ËPÀAiÀÄð ¸ÁÜ£À ºÀÄzÉÝ ¥ÀzÀ«
सुसाध्यताय: ®§åvÉ ±ÀPÀåvÉ ¸ÀÄ®¨sÀvÉ ¸ÀÄUÀªÀÄvÉ C£ÀÄPÀÆ®vÉ
सुसेग: ¥ÀÅgÀ¸ÀvÀÄÛ ©qÀÄªÀÅ «gÁªÀÄ DgÁªÀÄ £ÉªÀÄä¢ ºÀUÀÄgÀ ±ÀªÀÄ£À ¸ÀÄR ¸ÀAvÉÆÃµÀ £ÉªÀÄä¢
सुसेगासुवात: «±ÁæAvÀ_PÉÆoÀr «±ÁæAvÀ_¸ÀÜ¼À
सुस्कार: ªÀÄÄ®ÄPÀÄ £ÀgÀ¼Ál £ÀgÀ½PÉ
सुस्कारो: ªÀÄÄ®ÄPÀÄ £ÀgÀ¼Ál £ÀgÀ½PÉ
सुस्ती: ªÉÄÊªÀÄÄjAiÀÄÄ«PÉ D®¸Àå ¸ÀÄ¸ÀÄÛ
सुस्वर_वाचन: ¥ÀoÀt PÀ°PÉ ªÁZÀ£À_(?)
सूज: ¨ÁªÀÅ ºÀÆvÀ zÀÄªÀiÁðA¸À
सूट: j0iÀiÁ¬Äw ©qÀÄªÀ½ ©lÄÖPÉÆqÀÄªÀÅzÀÄ ¸ÉÆÃr_©qÀÄªÀÅzÀÄ
सूड: ¥ÀæwPÁgÀ ªÀÄÄ¬Äå ¸ÉÃqÀÄwÃjPÉ ºÀUÉ_wÃj¹PÉÆ¼ÀÄî«PÉ
सॅटेलायट: PÀÈvÀPÀ_G¥ÀUÀæºÀ ªÀiÁ£ÀªÀPÀÈvÀ_PÁAiÀÄ
सॅण्ट: CvÀÛgÀÄ ¥À¤ßgÀÄ ªÁ¸À£É_JuÉÚ
सेगीतपण: ¤gÀAvÀgÀªÁV JqÉ©qÀzÉ
सैनीक_न्यायालय: s¸ÉÊ¤PÀ_£Áå0iÀiÁ®0iÀÄ
सोकणी: »ÃgÀÄ«PÉ ZÀÆµÀt CªÀ±ÉÆÃµÀt
सोडवणूक: ©qÀÄUÀqÉ
सोद: ±ÉÆÃzsÀ ¥ÀvÉÛ wzÀÄÝ¥Àr wzÀÄÝ¥ÁlÄ ºÀÄqÀÄPÀÄ«PÉ C£ÉéÃµÀuÉ ±ÉÆÃzsÀ£É vÀ¥Á¸ÀuÉ vÀ¤SÉ «ZÁgÀuÉ ¥ÀjÃPÉë
सोदवावर: wzÀÄÝ¥Àr wzÀÄÝ¥ÁlÄ
सोपूत: ¥ÀæweÉÕ ¥Àt ¤±ÀÑAiÀÄ
सोपो: PÀgÀ vÉjUÉ PÀAzÁ0iÀÄ mÁåPÀì
सोबीतकाय: CAzÀ ZÉAzÀ ¸ÉÆ§UÀÄ ¸ÉÆUÀ¸ÀÄ gÀªÀÄåvÉ ªÀÄ£ÉÆÃºÀgÀvÉ
सोयरें: §AzsÀÄ £ÉAl ©ÃUÀ ¸ÀA§A¢ü
सोयर्‍यांघर: Cwy_UÀÈºÀ Cyw_¤ªÁ¸À Cyw_¨sÀªÀ£À
सौदो: ZËPÁ²
सौभाग्य: ¸Ë¨sÁUÀå
स्टेज: ªÉÃ¢PÉ
स्टेशन: ¤¯ÁÝt ¸ÉÖÃµÀ£ï_(?)
स्तन: ªÉÆ¯É ¸ÀÛ£À PÀÄZÀ JzÉ ªÀPÀë
स्त्री_विलन: R¼À£ÁAiÀÄQ
स्थळ: ¸ÁÜ£À ¸ÀÜ¼À ¥ÀæzÉÃ±À eÁUÀ
स्थळसेना: ¨sÀÆ_¸ÉÃ£É «Ä°lj
स्थानक: ¤¯ÁÝt ¸ÉÖÃµÀ£ï_(?)
स्थिरताय: ¸ÀÜVvÀ ¤±ÀÑ®
स्थीरताय: zÀÈqsÀvÉ CZÀ®vÉ ¹ÜgÀvÉ PÀzÀ®zÉ C®ÄUÁqÀzÉ «Ä¸ÀÄPÁqÀzÉ
स्पर्धा: ¥ÉÊ¥ÉÇÃn ¥Àæw¸ÀàzsÉð ¸ÀàzsÉð ¸ÀàzsÉð ¥Àæw¸ÀàzsÉð
स्पश्टताय: ¸ÀàµÀÖvÉ RavÀvÉ
स्पश्टपण: ¸ÀàµÀÖvÉ RavÀvÉ
स्पश्टीकरण: ¸Àà¶ÖÃPÀgÀt ¸ÀàµÀÖ£É «±À¢ÃPÀgÀt
स्पिडोमिटर: ªÉÃUÀ_ªÀiÁ¥ÀPÀ
स्फूर्त: ZÀÆn ZÀ¼ÀPÀ ¸ÀÄn ²ÃWÀæUÀw ZÀÄgÀÄPÀÄ
स्फोट: ¸ÉÆàÃl «¸ÉÆàÃl ¹rvÀ
स्मग्लर: PÀ¼Àî¸ÁUÀuÉUÁgÀ
स्मरण: £É£À¥ÀÅ ¸ÀäöÈw ¸ÀägÀuÉ
स्मृती: £É£À¥ÀÅ ¸ÀäöÈw ¸ÀägÀuÉ
स्वंणत्रताय_दीस: ¸ÁévÀAvÀæ÷å_¢£À
स्वजन: ¸ÀA§A¢üPÀgÀÄ ¥ÀjªÁgÀzÀªÀgÀÄ PÀÄlÄA§zÀªÀgÀÄ £ÉAlgÀÄ
स्वतंत्रसैनीक: PÁæAwPÁgÀ §AqÁAiÀÄPÁgÀ
स्वदेश: ¸ÀézÉÃ±À ¸ÀégÁµÀÖç
स्वर: ¸ÀégÀ ¸ÀégÁPÀëgÀ
स्वरातलें_वाचन: ¥ÀoÀt PÀ°PÉ ªÁZÀ£À_(?)
स्वल्पविराम: C®à«gÁªÀÄ C®à«gÁªÀÄ_aºÉß_" "
स्वागत: ¸ÁéUÀvÀ §gÀªÀiÁrPÉÆ¼ÀÄî«PÉ ¥ÀæªÉÃ±ÀªÀiÁrPÉÆ¼ÀÄîªÀÅzÀÄ
स्वाभिमान: ¸Áé©üªÀiÁ£À DvÁä©üªÀiÁ£À
स्वार: ¸ÀªÁgÀ
स्वार्थपुर्णताय: ¸ÁéxÀðvÉ ¸ÁéxÀð_¥ÀgÀvÉ ¸ÁéxÀðªÀÄAiÀÄ
स्वार्थहीणताय: ¤¸ÁéxÀðvÉ ¸ÁéxÀð»Ã£ÀvÉ
स्वावलंबन: ¸ÁéªÀ®A§£É
स्विकारणी: ¸ÁéUÀvÀ §gÀªÀiÁrPÉÆ¼ÀÄîªÀÅzÀÄ ¥ÀæªÉÃ±ÀªÀiÁr¹PÉÆ¼ÀÄîªÀÅzÀÄ
स्वीच: UÀÄAr §l£ï ¹éZï CzÀÄªÀÄÄ_UÀÄAr
हज: ºÀeï ºÀeï_0iÀiÁvÉæ
हट्ट: ºÀoÀªÀiÁjvÀ£À
हतयांशाळा: UÀd±Á¯É D£É¯ÁAiÀÄ C¹Û¯ÁAiÀÄ
हती_सेना: UÀd_¸ÉÃ£É UÀd_zÀ¼À D£É_zÀ¼À
हतीशाळ: UÀd±Á¯É D£É¯ÁAiÀÄ C¹Û¯ÁAiÀÄ
हत्या: ºÀvÉå RÆ¤ PÉÆ¯É ªÀzsÉ
हत्यार: G¥ÀPÀgÀt ¸À®PÀgÀuÉ ¸ÁzsÀ£À ±À¸ÀÛç ±À¸ÁÛç¸ÀÛç DAiÀÄÄzsÀ
हद्दपार: UÀr¥ÁgÀÄ zÉÃ±À¨sÀæµÀÖvÉ
हद्यपार_देशा__भायरो: UÀr¥ÁgÀÄ zÉÃ±À¨sÀæµÀÖvÉ
हरकत: ¥ÀæwªÁzÀ RAqÀ£É «gÉÆÃzsÀ
हलकेपण: ºÀUÀÄgÀvÉ ®WÀÄvÀé ºÀUÀÄgÀªÁVgÀÄªÀÅzÀÄ
हळद: Cj²£À ±ÀÄAp
हवामान: ºÀªÁUÀÄt ªÁAiÀÄÄUÀÄt ªÁvÁªÀgÀt
हवायसत्री: ¥ÁågÀ±ÀÆmï E½PÉÆqÉ zÀÄªÀÄÄPÀÄPÉÆqÉ CªÀvÀgÀt_bÀwæ
हवालदार: E£ïì¥ÉPÀÖgï
हवेली: zÉÆqÀØªÀÄ£É ¸ËzsÀ ªÁqÉ ¨sÀªÀ£À ªÀÄºÀ®Ä
हस्तलिपी: PÉÊ§gÀºÀ §gÀªÀtÂUÉ ºÀ¸ÁÛPÀëgÀ
हस्तवस्त्र: PÉÊUÀªÀ¸ÀÄ PÉÊPÀªÀZÀ
हांशें: ¥ÀjºÁ¸À ºÀtPÀ «£ÉÆÃzÀ ZÉÃµÉÖ ¤AzÉ
हातगाडो: vÀ¼ÀÄîUÁr zÉ§Äâ§Ar
हातबरप: PÉÊ§gÀºÀ §gÀªÀtÂUÉ ºÀ¸ÁÛPÀëgÀ
हातबार_लावप: G¥ÀPÁgÀ zÀAiÀiÁ¥ÀgÀvÉ
हातभार: ¸ÀºÁAiÀÄ £ÉgÀªÀÅ ¸ÀºÀPÁgÀ MvÁÛ¸É
हातवस्त्र: PÉÊUÀªÀ¸ÀÄ PÉÊPÀªÀZÀ
हातवारे: ¸À£Éß ¸ÀAeÉÕ ¸ÀAPÉÃvÀ
हाय: £ÀgÀ¼Ál ªÀÄÄ®ÄPÀÄ zÀÄBR±Áé¸À DvÀð£ÁzÀ
हायड्रोजन: d®d£ÀPÀ ºÉÊqÉÆæÃd£ï
हार: ¸Á®Ä ¥ÀAQÛ ºÀAvÀ ±ÉæÃtÂ PÀæªÀÄ
हाल: zÀÄB¹Üw zÀÄzÀð±É D¥ÀvÀÄÛ PÀµÀÖ 0iÀiÁvÀ£É ¨ÉÃUÀÄ¢ PÀqÀÄ¸ÀAPÀl MqÀ®£ÉÆÃªÀÅ
हालचाल: QæAiÀiÁ²Ã®vÉ GzÉÆåÃUÀ²Ã®vÉ
हालत: ¥Àj¹Üw ¸À¤ßªÉÃ±À ¹ÜwUÀw
हिंसा: »A¸ÁZÁgÀ zËdð£Àå
हिमालय: »ªÀiÁ®AiÀÄ »ªÀiÁZÀ® »ªÀiÁ¢æ
हिशोब: JtÂPÉ UÀt£É ¯ÉPÀÌ JtÂ¸ÀÄªÀÅzÀÄ
हिशोब_तपासपी: ¯ÉPÀÌ_¥Àj±ÉÆÃzsÀPÀ ¯ÉPÀÌ_¥ÀjÃPÀëPÀ ¯ÉÃSÁ¥ÀjÃPÀëPÀ
हिसबापटी: SÁvÉ_¥ÀÅ¸ÀÛPÀ dªÀiÁ_Rað£À_¥ÀÅ¸ÀÛPÀ ªÀ» Q¢ð_¥ÀÅ¸ÀÛPÀ ¯ÉPÀÌzÀ_¥ÀÅ¸ÀÛPÀ
हिसोबपटी: SÁvÉ_¥ÀÅ¸ÀÛPÀ dªÀiÁ_Rað£À_¥ÀÅ¸ÀÛPÀ ªÀ» Q¢ð_¥ÀÅ¸ÀÛPÀ ¯ÉPÀÌzÀ_¥ÀÅ¸ÀÛPÀ
हीत: »vÀ PÀ¯Áåt PÉëÃªÀÄ ¸ËRå PÀÄ±À®
हुंदराचो_पांजरो: E°_¨ÉÆÃ£ÀÄ E°_§¯É
हुंदरीण: ºÉtÂÚ°
हुकूमशाह: zÀ¨Áâ½PÉAiÀÄ ¤gÀAPÀÄ±Á¢üPÁgÀzÀ
हुयेली: PÉÆÃ¯ÁºÀ® d£ÀdAUÀÄ½ CªÁAvÀgÀ UÀ¯ÁmÉ UÀzÀÝ®
हुशार: §Ä¢ÞªÀAvÀ §Ä¢ÞfÃ« eÁÕ£ÀªÀAvÀ ªÉÄÃzsÁ« ¥ÁædÕ
हुशारकाय: «ªÉÃPÀ «ªÉÃZÀ£É ¥ÀjeÁÕ£À w¼ÀÄªÀ½PÉ
हुशारी: §Ä¢ÝªÀAwPÉ eÁtvÀ£À eÁuÉä «ªÉÃPÀ
हुस्को: aAvÉ ªÀåxÉ
हेडमास्तर: ¥ÁæZÁAiÀÄðgÀÄ ¦æ¤ì¥Á®gÀÄ
हेलिपॅड: J°¥Áåqï
हॉटेल: ¥sÀ®ºÁgÀªÀÄA¢gÀ ¨sÉÆÃd£ÀªÀÄA¢gÀ
होंडको: PÀÄtÂ vÀUÀÄÎ UÀÄAr ºÉÆAqÀ
होंवळीक: PÀgÉAiÉÆÃ¯É DªÀÄAvÀæt_¥ÀvÀæ «eÁÕ¥À£À_¥ÀvÀæ DºÁé£À_¥ÀvÀæ
होलसेल: ¸ÀUÀlÄ ºÉÆÃ¯ï¸ÉÃ¯ï
होशोखातें: SÁvÉ_¥ÀÅ¸ÀÛPÀ dªÀiÁ_Rað£À_¥ÀÅ¸ÀÛPÀ ªÀ» Q¢ð_¥ÀÅ¸ÀÛPÀ ¯ÉPÀÌzÀ_¥ÀÅ¸ÀÛPÀ
