190: একশ_নব্বই
300: তিনশত
6: ছয়
अंकीत: লিখিত লিপিবদ্ধ অঙ্কিত লেখা চিহ্নিত অঙ্কিত
अंतर्गत: অন্তর্গত অন্তর্ভুক্ত মধ্যস্থ
अंतर्निश्ट: অন্তর্নিহিত
अंदेल्लें: রুদ্রনিঃশ্বাষে_অপেক্ষা_করা
अंधश्रद्धाळू: মতান্ধ কট্টরবাদী কট্টরপন্থী
अंयशीं: আশি
अंशीक: আংশিক অংশত সমাংশিত
अकथनीय: অকথনীয় অকথ্য অব্যক্তব্য অবাচ্য
अकल्याणकारी: অকল্যাণকারী অনিষ্টকর অমঙ্গলকারী অমাঙ্গলিক অকুশল অশুভকারী অনভিষ্ট অহিতকারী অহিতকর
अकस्मात: আকস্মিক অনপেক্ষিত অপ্রত্যাশিত আচম্বিত চকিত অভাবনীয় অভাবিত
अकार्यक्षम: অকর্মা নিষ্কর্মা অকর্মণ্য অকম্মা অপদার্থ অকেজো অযোগ্য
अकाळीक: অজাত অকালজাত অকাল_প্রসূত অসাময়িক অকালিক
अकुळीन: অকুলীন নিম্ন_বংশীয় অকুল অকুলী
अकूशळ: অপটু অদক্ষ আনাড়ি অনিপুণ অশক্ত অপারদর্শী কাঁচা অপ্রবীণ অপরিণত
अकृत: অকৃত অনকীয়া অকৃত অনকীয়্‌অসম্পন্ন অসম্পাদিত অকৃত অসম্পন্ন অসম্পাদিত
अकृतज्ञ: কৃতঘ্ন অকৃতজ্ঞ নিমকহারাম
अकृत्य: অকরণীয় অকর্তব্য অকার্য
अक्षय: অমর অক্ষয় অনশ্বর শাশ্বত অক্ষুন্ন অক্ষর অনষ্ট অবিনাশী অভঙ্গ অনাশ অনাশ্য অনাশবান অভঙ্গুর
अखंड: অভেদ্য দুর্ভেদ্য অছেদ্য অপরিচ্ছিন্ন অভঞ্জনশীল অভঞ্জনীয় বেজোড় জোড়হীন বিজোড় অভঙ্গ
अखंडीत: অখণ্ডডনীয় অভজ্ঞনীয় অখন্ড্য অক্ষত অখন্ডিত খন্ডহীন অনবচ্ছিন্ন অভগ্ন অক্ষুণ্ণ অবিভাজ্য অবিভাজিত অখন্ড অখন্ডিত অবিভক্ত অভিন্ন অটুট অনবচ্ছিন্ন অভগ্ন আভাঙা
अखाद्य: অভক্ষ্য অখাদ্য খাওয়ার_অযোগ্য অনাহার্য
अखेरच्या: অন্তিম অন্তিম শেষ সমাস্তিক চরম অন্ত অন্ত্য
अग्निशामक: অগ্নিনির্বাপক
अग्नीमुखी: অগ্নিপ্রভ অনলপ্রভ অনলোজ্জ্বল অনলমুখ
अग्नीशामक: প্রশামক শান্তিকর
अग्रगामी: অগ্রগণ্য অগ্রগামী পূর্বগামী
अग्रणी: পুরোগামী পুরোবর্তী অগ্রগামী অগ্রগত অগ্রবর্তী
अग्राह्य: অগ্রহনীয় অগ্রাহ্য গ্রহনের_যোগ্য_নয়_এমন
अघटीत: অঘটিত অনঘটা অঘটা
अघारी: অঘারি
अचंचळ: অবিচলিত অবিচল
अचंबीत: বিলক্ষণ অদ্ভুত বিচিত্র আশ্চর্যজনক
अचकीत: আকস্মিক অনপেক্ষিত অপ্রত্যাশিত আচম্বিত চকিত অভাবনীয় অভাবিত
अचल: অচল নিশ্চল স্থাণু স্থায়ী স্থাবর গতিহীন অগতিক অচল অবিচল নিশ্চল স্থির দৃঢ় অনঢ় অটল স্থাণু
अचेतन: জড় নির্জীব অজৈব ভৌতিক অচেতন চেতনাহীন
अजय: অজেয় অজিত অপরাজেয় দুর্জেয় অজীত
अजरंवर: অমর মৃত্যু_বিজেতা কালজয়ী কালাতীত মৃত্যুজ্ঞয় অমর্ত্য চিরজ্ঞীব চিরজ্ঞীবী চিরজীবী চিরঞ্জীব চিরঞ্জবী চিরজীবী দীর্ঘজীবী দীর্ঘায়ু আযুষ্মান চিরায়ু
अजरबॅजानी: আজারবাইজানী আজারবাইজানী
अजाण: অজ্ঞেয় অপরিজ্ঞেয় জ্ঞানাতীত অনধিগম্য অবোধ্য দুর্বোধ্য অগম্য অবিবকী অবিবেক বিবেকহীন নির্বিবেক অবোধ অবুঝ অবুধ বিবেকদংশনহীণ অজ্ঞাত অজানা অজানিত অপরিচিত
अजातशत्रू: শত্রুহীন অজাতশত্রু শত্রুবিহীন অরিহীন
अजाप: সৌর সৌরি সৌরীয় সুরীয়
अजापाचें: অভূতপূর্ব অপূর্ব
अजापीत: অপ্রত্যাশিত অভাবনীয় অনপেক্ষিত অভাবিত নিরপেক্ষিত
अजैत: অপরাজিত অবিজিত অপরাস্ত অপ্রতিহত অনভিভূত অজেয় অজিত অপরাজেয় দুর্জেয় অজীত
अज्ञात: অজ্ঞাত অজানা অজানিত অবিজ্ঞাত অপরিচিত অপরিজ্ঞাত অচেনা অনবগত অবিদিত অঞ্জাত অজানা অবিদিত অপরিচিত অনভিঞ্জ অনাগত অঞ্জ অবিপশ্চিত অবিদ্বান অপ্রাঞ্জ
अज्ञानी: অজ্ঞেয় অপরিজ্ঞেয় জ্ঞানাতীত অনধিগম্য অবোধ্য দুর্বোধ্য অগম্য
अज्ञेय: অজ্ঞেয় অপরিজ্ঞেয় জ্ঞানাতীত অনধিগম্য অবোধ্য দুর্বোধ্য অগম্য
अटूट: ঘনিষ্ঠ অন্তরঙ্গ অভিন্ন আত্মীয় গাঢ় অন্যতম অখণ্ডডনীয় অভজ্ঞনীয় অখন্ড্য অভঞ্জনশীল অভঞ্জনীয়
अठरा: অঠারহ অষ্টাদশ
अडांगी: উদ্ধত উগ্র জেদী উচ্ছৃঙ্খল অকুতোভয় দুঃসাহসী বেপরোয়া
अडाणी: অপটু অদক্ষ আনাড়ি অনিপুণ অশক্ত অপারদর্শী কাঁচা অপ্রবীণ অপরিণত নির্বোধ বোকা বুদ্ধিহীন বুদ্ধিশূন্য আহাম্মক
अडेचें: নকল কৃত্তিম অপ্রকৃত কর্তৃত্বময় প্রবল সাড়াম্বর
अडेज: আড়াই
अणकार_करपाचें: অনূদিত অনুবাদিত ভাষান্তরিত তর্জমাকৃত প্রতিবর্ণীকৃত
अणकार_करी_सारकें: অনূদিত অনুবাদিত
अणकाराचें: অনূদিত অনুবাদিত
अणभव: সংবিদিত অনুভূত চেতিত বিভাবিত
अणभवशुन्य: অনভিজ্ঞ অদক্ষ অপারগ অনুপযুক্ত অনুপযোগী কাঁচা
अणभवहीण: অনভিজ্ঞ অদক্ষ অপারগ অনুপযুক্ত অনুপযোগী কাঁচা
अणभवी: অভিজ্ঞ অনুভবী পরিপক্ব অভ্যস্ত আদী জানকার জ্ঞাতা বিজাতা ভিজ্য
अणभावी: অনুভাবী
अतिक्रमीत: অতিক্রমিত অতিক্রান্ত অধিকৃত অধিগত অধিকারগত দখলি অধিকারভুক্ত অধিকারস্থ অধিগৃহীত
अती: ভীষণ ভয়ানক অত্যধিক অত্যন্ত প্রচণ্ড প্রবল ঘোরতর
अती_धाडशी: দসাহসী টীঠ দুঃসাহসী
अतीरागिश्ट: অতি_আবিষ্ট অত্যূগ্র ক্রোধাবিষ্ট অতি_ক্রুদ্ধ ক্রোধান্বিত রেগে_আগুন
अतुलनीय: অতুলনীয় অতুল্য
अतुल्य: অতুলনীয় অতুল্য
अतुळीत: অতুল্য
अतूट: অভেদ্য দুর্ভেদ্য অছেদ্য অপরিচ্ছিন্ন অটুট এক অভিন্ন অপৃথক ভেদরহিত বিকল্পহীন
अतृप्त: অতৃপ্ত অসন্তুষ্ট অতুষ্ট অগতিক অগতি গতিহীন স্হির নিশ্চল নিরুপায়
अत्तर_लायिल्लें: অনুরন্জিত অনুলিপ্ত প্রলিপ্ত উপলিপ্ত
अत्याचारी: অত্যাচারী নৃশংস নিষ্ঠুর নির্দয় নির্মম ক্রূর বর্বর পীড়ক উত্পীড়ক নিগ্রহকারী নির্যাতক জুলুমবাজ জালিম
अत्याधुनीक: অত্যাধুনিক অতি-আধুনিক
अथक: অক্লান্ত ক্লান্তিহীন
अथांग: অগাধ অপার তল_পাওয়া_যায়_না_এমন অথই অতল অতিশয়_গভীর বিপুল অপরিসীম গভীর অথই অতল অতলস্পর্শী অতলস্পর্শ সুগভীর গহন গহীন
अदमासाचें: অনুমানিত অনুমিত
अदृश्य: অদৃশ্য অদৃষ্টিগোচর অদৃষ্টয়মান বিলীন নাদেখা অন্তরহিত
अद्वैत: অদ্বৈত
अधर्मी: ধর্মহীন অধার্মিক অধর্মী অদার্মাত্মা অধর্মিষ্ট
अधिकार: শাসিত প্রশাসিত অভিশাসিত
अधिकारहीण: অধিকারচ্যুত চ্যুতাধিকার বেদখলি অনধিকৃত অনায়ত্ত অকবজ
अधिकारा_भायरें: বেদখলি অনধিকৃত অনায়ত্ত অকবজ৷ অধিকারচ্যুত চ্যুতাধিকার বেদখলি অনধিকৃত অনায়ত্ত অকবজ
अधिकाराची: অধিকারপূর্ণ সাধিকার
अधिकारी: অধিকারী অধিকার_প্রাপ্ত অধিকারযুক্ত অধিকারিক হকদার অধিকারক
अधीन: অধিনস্থ অধীন অধিশ্রিত অধীন আধীন
अधोगामी: অধোগামী অধোগত নিম্নগামী অধোনমিত আপতিত
अध्यक्ष: অনুশাসক অনুশাসী
अध्यात्मज्ञानी: অধ্যাত্মতত্ত্ববিদ ব্রহ্মজ্ঞানী সিদ্ধ অধ্যাত্মজ্ঞ
अनंत: অসীম অপরিসীম অপার অগাধ অনন্ত অপরিমিত
अनंताचो: অসীম নিঃসীম অপার অনন্ত অন্তহীন অনবসান অকূল
अनधिकृत: বেদখলি অনধিকৃত অনায়ত্ত অকবজ৷
अनपेक्षीत: অপ্রত্যাশিত অভাবনীয় অনপেক্ষিত অভাবিত নিরপেক্ষিত অপ্রত্যাশিত আশাতীত প্রত্যাশাতীত
अनभिप्रेत: অনভিপ্রেত অনভিমত
अनमननासपी: অনিবর্তী
अनमन्या_बगर: নিঃসঙ্কোচ নিসঙ্কোচ সঙ্কোচহীন অসঙ্কোচী
अनर्थकारी: অনর্থকারী
अनवळखी: অজ্ঞাত অজানা অজানিত অবিজ্ঞাত অপরিচিত অপরিজ্ঞাত অচেনা অনবগত অবিদিত অঞ্জাত অজানা অবিদিত অপরিচিত অনভিঞ্জ অনাগত অঞ্জ অবিপশ্চিত অবিদ্বান অপ্রাঞ্জ পর অপর অন্য ভিন্ন অনাত্মীয়
अनवाळें: বাসি
अनसाचें: আনারসী অনন্য অসাধারণ অনন্যসাধারণ অসামান্য অদ্বিতীয় অনন্যপূর্ব অবিকল্প
अनाज्ञाकारी: অনাজ্ঞাকারী
अनात्म: পর অপর অন্য ভিন্ন অনাত্মীয় অনাত্ম
अनाथ: অনাথ এতিম বেওয়ারিশ মাতাপিতাহীন মাতৃপিতৃহীন অনাথ
अनादरीत: অনাদৃত অনাদরিত
अनामी: অনামী অনামীজ অনামী অনামীজ
अनामीक: বেনামদার বেনামী বেনামী নামবিহীন
अनासक्त: অনাসক্ত অলিপ্ত নির্লিপ্ত
अनिंदनी: অনিন্দনীয় অনিন্দ্য প্রশংসনীয় প্রশংসিতব্য প্রশংসার্হ অনিন্দিত
अनितीक: অনৈতিক নীতিবিরুদ্ধ নীতিবহির্ভূত অন্যায় অনুচিত
अनित्सूक: অনিচ্ছুক অনভিলাষী নিস্পৃহী অনিচ্ছু নিরাকাঙক্ষী অভিলাষারহিত
अनियंत्रीत: লাগামছাড়া বল্গাহীন উদ্দাম বন্ধনহীন অসংযত অনিয়ন্ত্রিত উচ্ছৃঙ্খল স্বেচ্ছাচারী বেকাবু অপরিমিত অপ্রমিত অপ্রমেয়
अनियमीत: অনিয়ত অনিশ্চিত অনিয়মিত অনির্দিষ্ট অধ্রুব অনিয়মিত অনিয়ত কাকতালীয় অভাব্য অভাবিত অনিশ্চিত অভাবনীয় অনির্দিষ্ট
अनिर्धारीत: অনির্ধারিত অনিশ্চিত বৈকল্পিক অপ্রতিপন্ন অপ্রতীযমান
अनिर्मीत: অকৃত অনকীয়্‌অসম্পন্ন অসম্পাদিত
अनिश्चीत: অনভিলাষিত অকাম্য অবাঞ্ছিত অবাঞ্ছনীয় অনীপ্সিত অনপেক্ষিত অনৈচ্ছিক অনিচ্ছাকৃত অনিয়ত অনিশ্চিত অনিয়মিত অনির্দিষ্ট অধ্রুব
अनुकरण_करपी: অনুকর্তা অনুকরনকর্তা অনুকারক অনুকারী অনুসারী
अनुकरणावपी: অনুকর্তা অনুকরনকর্তা অনুকারক অনুকারী অনুসারী
अनुक्रमान: ক্রমিক অনুক্রমিক ক্রমবদ্ধ বিন্যস্ত ক্রমানুসার ক্রমানুকুল শৃঙ্খলাবদ্ধ অনুপূর্ব
अनुचीत: অনুচিত অন্যায় অন্যায্য অসংগত অসমীচীন ন্যায়বিরুদ্ধ
अनुत्तीर्ण: অনুত্তীর্ণ ফেল
अनुपकारादीक: অপকারী অপকর্তা অনিষ্টকারী অনুপকারী অনর্থকারী
अनुपचारीक: অনৌপচারিক
अनुपलब्ध: অলব্ধ অপ্রাপ্ত দুর্লভ অলভ্য অপ্রাপ্য দুষ্প্রাপ্য
अनुपस्थीत: অনুপস্থিত গরহাজির অবিদ্যমান অবর্তমান অবিরাজমান
अनुपेगी: অনাবশ্যক অপ্রয়োজনীয় অদরকারি অনর্থক অনুপযোগী অবান্তর মূল্যহীন বেকার ফালতু
अनुमतीत: স্বীকৃত সম্মত প্রতীষ্ঠ অনুমোদিত সমর্থিত অনুমোদনপ্রাপ্ত
अनुमतीप्राप्त: স্বীকৃত সম্মত প্রতীষ্ঠ অনুমোদিত সমর্থিত অনুমোদনপ্রাপ্ত
अनुयायी: অনুগামী অনুগ অনুবর্তী অনুগমনকারী অনুসারক অনুযাত
अनुवंशीक: বংশগত বংশানুক্রমিক বংশপরম্পরায় বংশপরম্পরাগত পৈতৃক পারিবারিক
अनुशासक: অনুশাসক অনুশাসী
अनुशीक: নুন্যতম একটু সামন্য
अनुसरण_करपी: অনুগামী সহানুগামী অনুগমনকারী অনুগ
अनुसरपी: অনুগামী সহানুগামী অনুগমনকারী অনুগ
अनेक: অনেক কই বিবিধ নানা একাধিক কতিপয় অনেকানেক তমাম অনোগ
अनैतीक: অনৈতিক নীতিবিরুদ্ধ নীতিবহির্ভূত অন্যায় অনুচিত
अन्न_खावपी: অন্নাহারী
अन्न_मागपी: অন্নার্থী
अन्नहारी: অন্নাহারী
अन्य.: অন্য অপর ভিন্ন দোসরা দুসরা
अन्याय_संबंदी: অনৈতিক অন্যায়_বিষয়ক
अन्यायपुर्ण: অন্যায় ন্যায়হীন
अपंग: বিকলাঙ্গ পঙ্গু পঙ্গু
अपंगूळ: বিকলাঙ্গ পঙ্গু বিকলাঙ্গ পঙ্গু বিকলাঙ্গ পঙ্গু
अपक्ष.: নির্দল নির্দলীয় নির্দলী অপক্ষ পক্ষপাতরহিত
अपक्षपाती: পক্ষপাতহীন ভেদভাবহীন নিষ্পক্ষ
अपठनीय: অপঠনীয় অপাঠ্য অপঠিতব্য
अपतीत: অপতিত
अपथ्य: অপথ্য কুপথ্য অস্বাস্থ্যকর অহিতকর অনিষ্টকর ক্ষতিকর অনিষ্টজনক হানিকর
अपभ्रंश: খারাপ বিকল অস্বাভাবিক অপ্রকৃতিস্থ বিকারগ্রস্থ বিকৃত
अपभ्रंशीत: অপভ্রংশ অপভ্রংশ অপভ্রংশিত অপভ্রষ্ট বিকৃত অশুদ্ধ বিচ্যুত
अपमान: অপমানিত অবমানিত অসন্মানিত অপবাদিত অপমানগ্রস্ত হৃতমান নিন্দিত অপদস্থ অনাদৃত বেইজ্জত অনাদরিত অপকৃত
अपमान_करपी: অপধ্বংসী অপমানকারী অপমানকর্তা
अपमानकर्तो: অপধ্বংসী অপমানকারী অপমানকর্তা
अपमानकारक: অপমানজনক অপমানাত্মক অপমানসুচক গ্লানিকর অবমাননাকর অশ্রদ্ধেয়
अपमानकारी: অপবাদমূলক নিন্দনীয় নিন্দার্হ নিন্দাজনক নিন্দাকর গর্হিত বিগর্হিত ন্যক্কারজনক কলঙ্কজনক অপমানজনক অপমানাত্মক অপমানসুচক গ্লানিকর অবমাননাকর অশ্রদ্ধেয়
अपमानाचें: অপবাদমূলক নিন্দনীয় নিন্দার্হ নিন্দাজনক নিন্দাকর গর্হিত বিগর্হিত ন্যক্কারজনক কলঙ্কজনক
अपरंपार: অপরিমিত অপ্রমিত অপ্রমেয়
अपराजीत: অপরাজিত অবিজিত অপরাস্ত অপ্রতিহত অনভিভূত
अपराधी: আসামী অপরাধী দোষী অপরাধশীল অপরাধিক অপরাধপ্রবণ অপরাধিক অপরাধী
अपरिपक्व: অপরিণত অপরিপক্ক অপূর্ণ অপক্ক অপ্রৌঢ়
अपरिवर्तनशील: অপরিবর্তনীয় অপরিবর্তনশীল
अपरूप: অনুপম অনূপিত তুলনাহীন অতুলনীয় নিরূপম উপমারহিত অদ্বিতীয় অসাধারণ অতুল অতুল্য তুলনারহিত অতুলিত অনন্যসাধারণ অনুপ অপূর্ব
अपरोक्त: অকথিত অনূক্ত অবিবৃত অবর্ণিত অব্যক্ত অধ্বনিত
अपवादीत: অপবাদমূলক নিন্দনীয় নিন্দাজনক নিন্দাকর অপবাদক অভিযুক্ত অভিযোগ্য অনুযোগ্য নালিশযোগ্য অপবাদী অপবাদক
अपवित्र: অপরিণত কাঁচা আপাকা অপবিত্র অপুন্য অশুদ্ধ অশুচি অপরিশুদ্ধ নাপাক শুদ্ধিহীন দূষিত অপুণ্য পাপ
अपसव्य: ডান_দিক
अपहरण_केल्लें: অপহৃত হৃত লুন্ঠিত অপহারিত বিহৃত
अपात्र: অযোগ্য অনুপযুক্ত অপারগ অপ্রভু অনির্বাচিত অনির্ধারিত অমনোনীত
अपुज्य: অপূজ্য অপূজিত অসমাদৃত অসন্মান্য অস্তবনীয় অবরেণ্য
अपुण्य: অপুণ্য পাপ
अपुरें: অপূর্ণ অপরিপূর্ণ অপূর্ণ অপরিপূর্ণ অপর্যাপ্ত
अपूर्ण: অপূর্ণ অপরিপূর্ণ অধুরা অর্ধেক বাকী শেষ অসমাপ্ত অনিষ্পাদিত অসম্পাদিত অপূর্ণ অসম্পন্ন অসিদ্ধ
अपेक्षा_नासतना: অপ্রত্যাশিত অভাবনীয় অনপেক্ষিত অভাবিত নিরপেক্ষিত
अपेक्षीत: ইচ্ছিত অভিলষিত
अपेक्षे_भायलें: অপ্রত্যাশিত আশাতীত প্রত্যাশাতীত
अपेक्षेचें: প্রত্যাশিত যথাবাঞ্ছিত আশানুকূল
अपेशी: অযশস্বী যশোহীন গৌরবহীন
अप्रकाशीत: অপ্রকাশিত
अप्रचलीत: অপ্রচলিত অপ্রচরিত অপ্রযুক্ত পুরাতন
अप्रतिकार: নিরুপায় অপ্রতিকার অপরিশোধ্য অপরিশোধনীয় অপরিশোধিত
अप्रतिकारी: অপ্রতিকারী ক্ষমাকারী ক্ষমাদাতা মার্জনাকারী মার্জক
अप्रतिघात: অক্ষত অবিক্ষত অক্ষতশরীর অক্ষতদেহ
अप्रतिभा: অপ্রতিভ হতবুদ্ধি প্রতিভাহীন
अप्रतिश्ठीत: অপ্রতিষ্ঠিত অপ্রতিষ্ঠ প্রতিষ্ঠারহিত
अप्रतीबंद: অবাধ্য
अप्रतीम: অন্যতম
अप्रत्यक्ष: অলক্ষ্য অসমক্ষ অপ্রত্যক্ষ অপ্রত্যক্ষ পরোক্ষ ইন্দ্রিয়াতীত
अप्रभावी: প্রভাবহীন
अप्रमाणीक: অপ্রমাণিত অসিদ্ধ অপ্রমাণীকৃত
अप्रमाणीत: সত্যাসত্য অপ্রমাণিত অপরীক্ষিত অপ্রমাণিত অপ্রমিত অসিদ্ধ
अप्रयोजक: অপ্রাসঙ্গিক প্রসঙ্গহীন
अप्रवेश्य: অপ্রবেশ্য অগম্য অগম
अप्रसन्न: উদাস উদাসীন অন্যমনা আনমনা অন্যমনস্ক বিমনা উন্মনা
अप्राकृतीक: অপ্রাকৃতিক অপ্রাকৃত
अप्राप्त: অপ্রাপ্ত অলব্ধ অলভ্য অপ্রাপ্য অপ্রাপনীয় অপ্রাপ্ত অলব্ধ
अप्रामाणीक: অসভ্য অভদ্র অশিষ্ঠ অভব্য বেয়াদব আচারহীন
अप्रासंगीक: অপ্রাসঙ্গিক প্রসঙ্গহীন অপ্রাসঙ্গিক প্রক্ষিপ্ত
अप्रीय: অপছন্দ অপছন্দের অমনোনীত অনির্বাচিত অমনঃপূত অপ্রিয় অপ্রিয় অপ্রীতিকর অহৃদ্য অসন্তোষজনক
अफगाणी: আফগানী আফগানী
अबध्य: অবধ্য অবধ্য
अबादीत: অনাহত অক্ষত ক্ষতিহীন অনুপহত
अबाध्य: অবাধ্য
अबुद्ध: অবিবকী অবিবেক বিবেকহীন নির্বিবেক অবোধ অবুঝ অবুধ বিবেকদংশনহীণ
अबोल: নীরব নিশ্চুপ নির্বাক অবোলা অবোল
अब्ज: শ-কোটি একশো_কোটি
अभंग: অভঙ্গ
अभंगी: অভঙ্গ অক্ষত অবিচ্ছিন্ন অক্ষুণ্ণ৷
अभक्ष्य: অভক্ষ্য অখাদ্য খাওয়ার_অযোগ্য অনাহার্য অভক্ষ্য অখাদ্য খাওয়ার_অযোগ্য অনাহার্য
अभागी: দুর্ভাগ্যশালী অভাগা ভাগ্যহীন মন্দভাগ্য অভাগী
अभिनंदीत: অভিন্দিত অভিনন্দিত বন্দিত
अभिनयीत: অভিনীত
अभिप्राया_आड: অনভিপ্রেত অনভিমত
अभिव्यक्त: অভিব্যক্ত প্রকাশিত প্রকটিত জাহির বিকশিত প্রদর্শিত প্রকট ব্যক্ত
अभिशेक_केल्लें: অভিষিক্ত গাহিত কৃতাভিষেক
अभिशेक_घातिल्लें: অভিষিক্ত গাহিত কৃতাভিষেক
अभिशेकाचें: অভিষিক্ত গাহিত কৃতাভিষেক
अभिशेकीत: অভিষিক্ত গাহিত কৃতাভিষেক
अभेद्य: অভেদ্য দুর্ভেদ্য অছেদ্য অপরিচ্ছিন্ন অভেদ্য
अभोज्य: অভক্ষ্য অখাদ্য খাওয়ার_অযোগ্য অনাহার্য
अभौतीक: নশ্বর
अभ्यसा_बगरचें: অনভস্ত অভ্যাসহীন
अभ्यासमोगी: অধ্যয়নশীল অধ্যয়নার্থী অধীয়মান পাঠশীল
अभ्यासहीण: অনভস্ত অভ্যাসহীন অনভস্ত অভ্যাসহীন
अभ्यासू: অভ্যস্ত আদী অধ্যয়নশীল অধ্যয়নার্থী অধীয়মান পাঠশীল অধ্যয়নরত অধ্যয়ননিরত পাঠরত
अभ्यासोपयोगी: অনুশীলনীয় অভ্যসনীয় চর্চ্য আলোচ্য
अमर: অমর অক্ষয় অনশ্বর শাশ্বত অক্ষুন্ন অক্ষর অনষ্ট অবিনাশী অভঙ্গ অনাশ অনাশ্য অনাশবান অভঙ্গুর অমর মৃত্যু_বিজেতা কালজয়ী কালাতীত মৃত্যুজ্ঞয় অমর্ত্য চিরজ্ঞীব চিরজ্ঞীবী চিরজীবী চিরঞ্জীব চিরঞ্জবী চিরজীবী দীর্ঘজীবী দীর্ঘায়ু আযুষ্মান চিরায়ু
अमानवी: অমানবিক পাশবিক পৈশাচিক বর্বর অতিমানবীয় অতিমানবিক মানবাতীত মনুষ্যাতীত অলৌকিক
अमानूश: অমানবিক পাশবিক পৈশাচিক বর্বর
अमान्य: মানা নিষিদ্ধ বর্জিত প্রতিবন্ধিত হারাম নিষিদ্ধ
अमापीत: অতুল্য
अमिश्रीत: বিশুদ্ধ খাঁটি অমিশ্র অমিশ্রিত
अमीट: অবিনশ্বর অবিনাশী
अमुरपिकें: আধপাকা আপাকা অপরিপক্ক দরকচা আধকাঁচা অপুষ্ঠ
अमुर्त: নিরাকার অমূর্ত নিরঙ্কার
अमुल्य: বহুমূল্য দামী মূল্যবান অমূল্য অনমোল অনমোল অমূল্য অমোল দামী
अमूर्त: অশরীরী অশারীরীক আত্মিক
अमेरिकन: অমরীকী অমেরীকী
अमेरिकी: অমরীকী অমেরীকী
अयशस्वी: অসফল বিফল নিষ্ফল অযশস্বী যশোহীন গৌরবহীন
अयोग्य: অযোগ্য অনুপযুক্ত অপারগ অপ্রভু অনুচিত অন্যায় অন্যায্য অসংগত অসমীচীন ন্যায়বিরুদ্ধ বিপরীত প্রতিকুল অমান্য উল্টো অকর্মা নিষ্কর্মা অকর্মণ্য অকম্মা অপদার্থ অকেজো অযোগ্য
अरचीत: অকৃত অনকীয়্‌অসম্পন্ন অসম্পাদিত
अरमेनियायी: আর্মেনিয়ান আর্মেনিয়াই
अरसीक: অরসিক খুষ্ক খুষ্ক
अराजक: অরাজক রাজহীন অরাজক
अरुचीक: অরুচিকর রসহীন নীরস অরস রুচিহীন অসার ফিকে
अरूंद: সংকীর্ণ সংকুচিত অনতিবিস্তৃত অপরিসর পাতলা অপ্রশস্ত
अर्ज_करपी: প্রার্থী অভ্যর্থী নিবেদক প্রার্থনা_কর্তা ফরিযাদী যাচী
अर्ज_केल्लें: আবেদক আবেদন_কর্তা
अर्जदार: আবেদক আবেদন_কর্তা প্রার্থী অভ্যর্থী নিবেদক প্রার্থনা_কর্তা ফরিযাদী যাচী
अर्थपूर्ण: সার্থক অর্থযুক্ত অর্থপূর্ণ
अर्थशुन्य: নিরর্থক অনর্থক বৃথা অর্থহীন ব্যর্থ অর্থশূন্য নিষ্প্রয়োজন
अर्थहीन: নিরর্থক অনর্থক বৃথা অর্থহীন ব্যর্থ অর্থশূন্য নিষ্প্রয়োজন
अर्थाचें: সার্থক অর্থযুক্ত অর্থপূর্ণ
अर्थीक: আর্থিক আর্থ অর্থনৈতিক আর্থনীতিক বৈষয়িক বিত্তীয়
अर्द: আধা অর্ধেক অর্ধ
अर्दकच्चें: আধসিদ্ধ আধসেদ্ধ অর্ধসিদ্ধ আধকাঁচা
अर्दकुटिल्लें: অর্ধকাটা অর্ধপিষ্ট
अर्दकुटें: অপূর্ণ অপরিপূর্ণ অধুরা অর্ধেক বাকী শেষ অসমাপ্ত অনিষ্পাদিত অসম্পাদিত অপূর্ণ অসম্পন্ন অসিদ্ধ
अर्दपिकें: আধপাকা আপাকা অপরিপক্ক দরকচা আধকাঁচা অপুষ্ঠ
अर्दवट: অপূর্ণ অপরিপূর্ণ
अर्दशिक्षीत: অল্পশিক্ষিত
अर्दशिजिल्लें: কাঁচা আধকাঁচা আধপাকা অপরিপক্ক অসিদ্ধ অর্ধসিদ্ধ আধসিদ্ধ
अर्दुकुटें: অপূর্ণ অপরিপূর্ণ
अर्धपारदर्शक: প্রকাশমান
अर्पीत: অর্পিত
अलंकृत: অলঙ্কৃত উপাধিত বিভূষিত
अलबानियन: আলবানীয় আলবানিয়ান আলবানীয় আলবানিয়ান
अलभ्य: অপ্রাপ্ত অলব্ধ অলভ্য অপ্রাপ্য অপ্রাপনীয়
अलिखीत: অলিপিবদ্ধ অলিখিত
अलोकीक: পারলৌকিক আমুষ্মিক অলৌকিক লোকোত্তর
अलौकीक: অতিমানবীয় অতিমানবিক মানবাতীত মনুষ্যাতীত অলৌকিক
अल्पआहारी: অল্পাহারী অল্পহারী অল্পভোজী মিতাহারী স্বল্পাহারী
अल्पशिक्षीत: অল্পশিক্ষিত
अल्पसंख्यांक: অল্পসংখ্যক অল্পসংখ্য
अल्पायुशी: অল্পাযু স্বল্পাযু অল্প_জীবী
अळंकारीत: অলংকৃত ভুষিত আভুষিত সজ্জিত
अवगुणी: নির্গুণ গুণরহিত গুণহীন গুণশূন্য নির্গুণ গুণরহিত গুণহীন গুণশূন্য
अवताराचें: অবতারীয় অবতারী
अवतारी: অবতারীয় অবতারী অবতার
अवध्य: অবধ্য
अवयस्क: নাবালক অল্পবয়স্ক অপৌঢ় অপ্রাপ্তযৌবন
अवर्णनीय: অবর্ণণীয় অকথনীয় শব্দাতীত বর্ণনাতীত অকথ্য অনির্বচনীয় অবোল
अवश: অবশ্য অবাধ্য৷
अवाचनीय: অপঠনীয় অপঠ্য অপাঠ্য অপঠমান
अविकारी: অপরিবর্তনশীল অব্যয় অক্ষ্য় অজয় অমর
अविकृत: অবিকৃত প্রকৃত অপরিবর্তিত অবিকার অক্ষুণ্ণ
अविचारी: অমঙ্গলসূচক ক্ষতিকর অনিষ্টকর অনর্থসূচক
अविचारीक: অবিচারণীয় অচিন্তনীয় অবিচার্য অবিচারিত অচিন্তিত অনুহ
अविज्ञानीक: অবৈজ্ঞানিক বিজ্ঞান_বিরূদ্ধ অবৈজ্ঞানিক অবিজ্ঞানীয়
अविवाहीत: অবিবাহিতা কুমারি অনব্যহী অপরিনীতা কুআরি কুবারি বিনব্যায়ী ক্কারী
अविश्वासी: অবিশ্বাসী
अविश्वासू: অবিশ্বাসী অপ্রত্যয়কারী মুনকির অবিশ্বস্ত অবিশ্বাসভাজন
अवेवस्थीत: অব্যবস্থিত ব্যবস্থাহীন অনবস্হা
अवेव्हारी: অব্যবহারিক ব্যবহার_অকুশল
अवेव्हारीक: অব্যবহৃত অপ্রযুক্ত অনিযুক্ত কোরা আনকোরা
अव्यक्त: অকথিত অনূক্ত অবিবৃত অবোলা অবর্ণিত অব্যক্ত অনভিব্যক্ত
अव्यय: অপরিবর্তনশীল অব্যয় অক্ষ্য় অজয় অমর
अव्यस्त: খালি কর্মহীন কর্মশূন্য
अशक्त: কমজোরি পলকা অশক্ত ঠুনকো অমজবুত অদৃঢ্ পাতলা পাতলা রোগা রুগণ ক্ষীণ কৃশকায় কৃশ শীর্ণ
अशक्य: অসম্ভব অসম্ভাবিত অসম্ভাবী অসম্ভাব্য অঘটিত অসাধ্য
अशांत: অশান্ত চঞচল অস্থিরচিত্ত উৎকন্ঠিত বিচলিত অস্থির
अशीम: অসীম অপরিসীম অপার অগাধ অনন্ত অপরিমিত
अशीर: সংকীর্ণ সংকুচিত অনতিবিস্তৃত অপরিসর পাতলা অপ্রশস্ত ছোট চাপা হ্রস্ব অল্পক অল্পস্বল্প ক্ষুদ্র সংক্ষিপ্ত
अशुद्ध: অপরিণত কাঁচা আপাকা অশুদ্ধ মিশ্রিত ভেজালযুক্ত অশোধিত অপরিশুদ্ধ অবিশুদ্ধ অখাঁটি অপমিশ্রিত অপরিচ্ছন্ন অপরিষ্কৃত অপরিষ্কার মলিন কলুষিত ময়লা নোংরা অস্বচ্ছ অপবিত্র অশুদ্ধ অশুদ্ধ ভুল ভ্রান্ত অযথার্থ ত্রুটিপূর্ণ
अशूभ: অকল্যাণকারী অনিষ্টকর অমঙ্গলকারী অমাঙ্গলিক অকুশল অশুভকারী অনভিষ্ট অহিতকারী অহিতকর
अशे_तरेचो: অবিকল অবিকৃত হুবহু অনুরুপ সদৃশ
अशें-तशें: নগন্য ছোট মামুলি তুচ্ছ যে-সে অগন্য নাচীজ যে-সে
अश्टांगी: অষ্টাঙ্গ
अश्राव्य: অশ্রাব্য অশ্রবণীয় অশ্লীল
अश्र्वारोही: অশ্বারোহী
अश्लील: অশ্লীল কামুকতাপূর্ণ গন্দা
असंख्य: অজস্র অগণত অগণনীয় অগণিত অগন্য অগনতি অগুন্তি অসংখ্য সংখ্যাতীত অনন্ত বেশুমার
असंतुश्ट: অতৃপ্ত অসন্তুষ্ট অতুষ্ট
असंबंदीत: অনন্বিত অসম্বন্ধ অসম্বদ্ধ অসংলগ্ন অসংবদ্ধ সম্বন্ধরহিত অপ্রাসঙ্গিক
असंबंद्द: অপ্রাসঙ্গিক প্রক্ষিপ্ত
असंस्कृत: মোটা অসূক্ষ্ম অমার্জিত অভব্য অশিষ্ট
असत्य: মিথ্যা অসত্য মিছা ঝুট ঝুটা ভুয়া ভুয়ো অনৃত অতথ্য অপ্রকৃত
असत्यपणाचें: মিথ্যা অসত্য মিছা ঝুট ঝুটা ভুয়া ভুয়ো অনৃত অতথ্য অপ্রকৃত
असत्यापीत: সত্যাসত্য অপ্রমাণিত অপরীক্ষিত
असफळ: অসফল বিফল নিষ্ফল নিষ্ফল বিফল ব্যর্থ অসফল অকৃতকার্য অসার্থক নিরর্থক অকৃতার্থ অফলদায়ী অফলদায়ক
असभावीक: অস্বাভাবিক অপ্রাকৃতিক অনৈসর্গিক অপ্রকৃত
असभ्य: অসভ্য অভদ্র অশিষ্ঠ অভব্য বেয়াদব আচারহীন
असमंजस: নির্বোধ বোকা বুদ্ধিহীন বুদ্ধিশূন্য আহাম্মক
असमक्ष: অলক্ষ্য অসমক্ষ অপ্রত্যক্ষ
असमजिकाय: সামঞ্জস্যহীন অসামঞ্জস্য অসামঞ্জস্যপূর্ণ
असमजुतदार: অবিবকী অবিবেক বিবেকহীন নির্বিবেক অবোধ অবুঝ অবুধ বিবেকদংশনহীণ
असमतल: অসমতল উঁচুনিচু এবড়ো-খেবড়ো চড়াই-উত্ রাই৷
असमाधानी: অমীমাংসিত অসমাধানিত
असमृद्धिदिणें: অসমৃদ্ধিপ্রদ অনৈশ্বর্যপ্রদ
असलें: বৈসা
असलो: অবিকল অবিকৃত হুবহু অনুরুপ সদৃশ
असहमत: অসম্মত গররাজি অনিচ্ছুক অসম্মত অস্বীকৃত অসমর্থিত অননুমোদিত অনভিমত
असहाय्य: অসহ্য অসহ অসহনীয় দুঃসহ দুর্বিষহ দুর্বহ
असादारण: অসামান্য অসাধারন বিশেষ
असाध्य: অসাধ্য অচিকিৎস্য চিকিৎসাতীত দুস্সাধ্য অসাধ্য
असामान्य: অসামান্য অসাধারন বিশেষ
असुरी: আসুরিক আসুর অসুরসম্বন্ধীয় দানবিক দানবীয় পৈশাচিক অমানুষিক রাক্ষুসে ভয়ঙ্কর
असुसंस्कृत: অসভ্য অভদ্র অশিষ্ঠ অভব্য বেয়াদব আচারহীন
असैमीक: অপ্রাকৃতিক অপ্রাকৃত
असोच: অবিকল অবিকৃত হুবহু অনুরুপ সদৃশ
अस्कळीत: অব্যবস্থিত ব্যবস্থাহীন অনবস্হা
अस्तंती: পাশ্চাত্য পশ্চিমি পচ্ছিমী পশ্চিমী পচ্ছিমী
अस्ताचें: অস্তায়মান অস্তগামী অস্তোন্মুখ সমাপ্তপ্রায়
अस्ताव्यस्त: অব্যবস্থিত ব্যবস্থাহীন অনবস্হা
अस्तित्व_नाशिल्लें: অস্তিত্বহীন অবিদ্যমান অসত্য অলীক কাল্পনিক
अस्तित्वहीण: অস্তিত্বহীন অবিদ্যমান অসত্য অলীক কাল্পনিক
अस्तुरेचें: মেয়েলী
अस्तूंक_नाशिल्लें: অনস্ত অনস্তমিত
अस्थायी: অস্থায়ী সাময়িক স্বল্পকালীন ক্ষণস্থায়ী স্বল্পমেয়াদি
अस्थिहीण: অস্থিহীন
अस्थीमय: অস্থিময় অস্থিনির্মিত অস্থি_নির্মিত
अस्थीर: গতিশীল সচল চলমান অস্থির অবিরাম গতিময় জঙ্গম চঞ্চল অধীর অধৈর্যবান চপল
अस्पर्शीत: অচ্ছুত অস্পৃশ্য
अस्पश्ट: অস্পষ্ট অপ্রতীত
अस्पृश्य: অস্পৃশ্য অচ্ছুত
अस्वस्थ: উদ্বিগ্ন উদগ্রীব উদ্বেল উত্কন্ঠিত উতলা ব্যাকুল আকুল
अस्विकृत: অস্বীকৃত অসমর্থিত অননুমোদিত অসম্মত নামঞ্জুর অপলাপিত
अस्सल: বিশুদ্ধ শুদ্ধ পরিষ্কার খাঁটি নির্ভেজাল নিখাদ ভেজালহীন অমিশ্রিত বাছাই বিশুদ্ধ খাঁটি আসল প্রকৃত যথার্থ শুদ্ধ
अहंकारी: দর্প অনম্র অবিনিত অনম অবিনয়শীল প্রগল্ভ দাম্বিক
आंकरिल्लें: পল্লবিত
आंकवार: অবিবাহিত অপরিণীত অবিবাহিতা কুমারি অনব্যহী অপরিনীতা কুআরি কুবারি বিনব্যায়ী ক্কারী কুমারি যে_মেয়ের_বিয়ে_হয়_নি_এমন
आंगाचे: বিজ্ঞান_সঙ্গত বিজ্ঞানানুকূল
आंगीक: বিজ্ঞান_সঙ্গত বিজ্ঞানানুকূল
आंतरराष्ट्रीय: অন্তর্রাষ্ট্রীয অন্তর্দেশীয়
आंतरीक: আন্তরিক অন্তর্বর্তী অন্তরঙ্গ আন্তরীণ অন্তরিত অন্তর্নিহিত
आंतर्जातीय: মিশ্র অবচ্ছিন্ন মিশ্রিত সংযোজিত মিলিত
आंतर्राष्ट्रीय: অন্তর্রাষ্ট্রীয বহুদেশীয় বহুরাষ্ট্রীয়
आंबट: টক অম্ল অম্বল খাট্টা চুকা
आंवुळिल्ल्या: সংকুচিত কুঞ্চিত কুঁচকানো সংক্ষিপ্ত
आकर्शक: মনোরম সুন্দর ভালো মনোলোভা মনোমোহিনী মনোহারিনী আকর্ষণীয় রমণীয় আকর্ষক চিত্তাকর্ষক মনোরম মঞ্জু মঞ্জুল সুন্দর মনোহর মনোহারী চিত্তহারী মনোলোভা সুদর্শণ মনহোর মনরোম সুন্দর আকর্ষণী আকর্ষক আকর্ষিক
आकर्शीत: মুগ্ধ বিমুগ্ধ মোহিত বিমোহিত সন্মোহিত বিহ্বল অভিভূত আত্মহারা মোহময় মোহন মোহিনী
आकस्मीक: আকস্মিক অনপেক্ষিত অপ্রত্যাশিত আচম্বিত চকিত অভাবনীয় অভাবিত
आकाराचें: গড়া আকার_প্রদত্ত আরূপিত
आकाशी: আসমানী আকাশী
आक्रमक: আক্রামক আক্রামকতাপূর্ণ
आक्रमणकारी: আক্রমণকারী আক্রামক আক্রমণকর্তা
आक्रमणा_बगरचें: অনাক্রান্ত আক্রান্ত_রহিত
आक्रमणा_विरयत: অনাক্রান্ত আক্রান্ত_রহিত
आक्रांत: আক্রান্ত অভিগ্রস্ত আক্রমনীয়
आख्खें: পুরো সম্পূর্ণ সমগ্র সব সমুদয় সমস্ত গোটা আস্ত অখণ্ড অখণ্ডিত পূর্ণ পরিপূর্ণ ভর্তি
आगळें: আলাদা পৃথক ভিন্ন অসম বিভিন্ন অসমান বিসম
आगळो: অনুপম অনূপিত তুলনাহীন অতুলনীয় নিরূপম উপমারহিত অদ্বিতীয় অসাধারণ অতুল অতুল্য তুলনারহিত অতুলিত অনন্যসাধারণ অনুপ অপূর্ব
आगामी: ভবিষ্যতের আগামীকালের ভাবী আগামী অনাগত ভবিতব্য
आग्नेयी: দক্ষীণ-পূর্ব দক্ষীণ-পূর্বী
आग्रही: আগ্রহী আগ্রহান্বিত আগ্রহশীল অত্যুত্সাহী সমুত্সুক মহোত্সাহী
आचारवान: সভ্য শিষ্ট শালীন সুশীল সুব্যবহার
आजापीत: বিলক্ষণ অদ্ভুত বিচিত্র আশ্চর্যজনক
आज्ञा_करपी: আজ্ঞাকারী আজ্ঞাদাতা আদেশক
आज्ञा_पाळपी: আজ্ঞাকারী আজ্ঞাবহ আজ্ঞাধীন আজ্ঞানুবর্তী আজ্ঞাপালক অনুকারী অনুগামী
आज्ञाकारी: আজ্ঞাকারী আজ্ঞাদাতা আদেশক আজ্ঞাকারী আজ্ঞাবহ আজ্ঞাধীন আজ্ঞানুবর্তী আজ্ঞাপালক অনুকারী অনুগামী
आज्ञापाळक: আজ্ঞাকারী আজ্ঞাবহ আজ্ঞাধীন আজ্ঞানুবর্তী আজ্ঞাপালক অনুকারী অনুগামী
आज्ञाभंगी: অনাজ্ঞাকারী
आठ_कुशींचें: অষ্টাঙ্গ অষ্টতল
आठ_म्हयन्यांचें: আটাশে অষ্টম_মাসে
आठवड्याचें: সাপ্তাহিক
आठवें: অষ্টম
आठोळें: আটাশে অষ্টম_মাসে
आडंबराचें: কর্তৃত্বময় প্রবল সাড়াম্বর
आडखळहीण: অবরোধহীন অকংটক অবাধ অবাধিত অনবরুদ্ধ বাধাহীন নির্বিগ্ন নিষ্কন্টক অখন্ড অখন্ডিত বাধারহিত অপ্রতিহত
आडखळिल्लें: ফেঁসে_যাওয়া
आडखळिल्लो: আটকানো বদ্ধ বাঁধা বন্ধ রুদ্ধ অবরুদ্ধ আটকা চাপা বাধাপ্রাপ্ত
आडखळीबगरचें: অবরোধহীন অকংটক অবাধ অবাধিত অনবরুদ্ধ বাধাহীন নির্বিগ্ন নিষ্কন্টক অখন্ড অখন্ডিত বাধারহিত অপ্রতিহত
आडनदर: উপেক্ষিত
आतांचें: বর্তমান
आतिरिक्त: অতিরিক্ত
आतूर: অধীর ব্যাকুল আকুল ব্যগ্র কাতর উদ্বিগ্ন উদ্বেল উত্কন্ঠিত অস্থির অধৈর্য
आते: পিসতুতো
आत्मनिर्भर: স্বনির্ভর আত্মনির্ভর
आत्म्या_विशींचें: আত্মবিষয়ক আত্মমান আত্মিক
आदखळीचे: দুর্গম দুরগম্য দুরধিগম্য অগম্য অগম অগমনীয় দুস্তর অসুগম কঠিন
आदर्श: আদর্শ
आदर्शवादी: আদর্শবাদী
आदलें: জর্জর জীর্ণ প্রাচীন পুরোনো পুরাতন পুরাকালীন পূর্বকালীন আদিম প্রাগৈতিহাসিক
आदलो: প্রথম প্রারম্ভিক প্রাথমিক পয়লা
आदारहीण: অনাধার অনাধাররহিত
आदारहीन: নিরাধার আধারহীন অবলম্বনহীন অনালম্ব নিরালম্ব নিরবলম্ব
आदारा_बगर: নিরাধার আধারহীন অবলম্বনহীন অনালম্ব নিরালম্ব নিরবলম্ব
आदारा_बगरचें: অনাধার অনাধাররহিত
आदारीत: আশ্রিত অবলম্বিত নির্ভর আধারিত
आदिवासी: জনজাতীয় কাবীলা
आदी: আদি
आधीन: অধীন আধীন
आधुनीक: আধুনিক অর্বাচীন সাম্প্রতিক আজকের
आध्यात्मीक: আধ্যাত্মিক আত্মা
आनंददायी: আনন্দপ্রদ আনন্দ-দায়ক আহ্লাদক সুখপ্রদ আনন্দদায়ক আনন্দ
आनंदी: প্রসন্নচিত্ত প্রসন্ন আনন্দিত প্রফুল্ল উল্লসিত উৎসাহী উৎসাহযুক্ত উৎসাহিত অধ্যাবসায়ী
आनंदीत: আনন্দপূর্ণ আনন্দময় উল্লাসপূর্ণ সানন্দ প্রসন্ন সুপ্রসন্ন আনন্দিত প্রফুল্ল উল্লসিত উত্ফুল্ল আহ্লাদিত পুলকিত হর্ষিত হৃষ্ট প্রমোদিত মনোরজ্ঞিত আনন্দিত বিনোদিত
आनिकूय: অন্য অপর
आनीक: অন্য অপর
आनीक_कोणूय: অন্য অপর
आनुश्ठानीक: আনুষ্ঠানিক
आपणायिल्ली: স্বীকৃত মঞ্জুর সম্মত সম্মতি অনুমোদিত সমর্থিত
आपणायिल्लें: অঙ্গীকৃত অঙ্গীকারবদ্ধ প্রতিজ্ঞাবদ্ধ সত্যবদ্ধ গৃহীত স্বীকৃত পরিগ্রহীত
आपयिल्लें: সংবোধিত বিবোধিত সম্বোধ্য
आपरोसहीण: অসার সারহীন অন্তঃসারশূন্য শূন্যগর্ভ
आपलें: নিজস্ব নিজের ব্যক্তিগত স্বকীয় আত্ম
आपल्या_पक्षाचो: সপক্ষীয় নিজস্ব ব্যক্তিগত
आपार: অপরিমিত অপ্রমিত অপ্রমেয়
आफडूंक_नाशिल्लें: অচ্ছুত অস্পৃশ্য অস্পর্শিত
आफताबी: রৌদ্রপক্ক রৌদ্রতপ্ত সূর্যতপ্ত রোদে_পোড়া রৌদ্রদগ্ধ
आफ्रिकी: অফ্রীকান
आबुझाद: বিচলিত
आबूज: হতভম্ব কিংকর্তব্যবিমূঢ় হতবুদ্ধি ভ্যাবাচাকা
आबूझ: বিচলিত
आभारी: কৃতজ্ঞ উপকৃত অনুগৃহীত
आभुशीत: অলংকৃত ভুষিত আভুষিত সজ্জিত
आम: সামান্য সাধারন অবশেষ অবশিষ্ট
आमल: অম্লযুক্ত
आमिझाद: বন্ধুত্বপূর্ণ বন্ধুত্বমূলক মৈত্রীমূলক মিত্রবত মিত্রচিত
आम्लीक: অম্লযুক্ত
आयकपा_सारको: শ্রবনীয় শ্রব্য
आयकुपा_सारकें: শ্রবনীয় শ্রব্য
आयकूंक_नाशिल्ली: অশ্রুত
आयचो_काळ: বর্তমান_কালের সাময়িক আধুনিক বর্তমান
आयच्या_काळांतलें: আধুনিক অর্বাচীন সাম্প্রতিক আজকের
आयताकार: আয়তাকার
आयरिश: আইরিশ
आयातीत: আমদানি_করা_হয়ছে_এমন
आयिल्लो: আগত সমাগত
आयुर्वेदीक: আযুর্বেদিক আযুর্বেদীয
आयोजीत: আয়োজিত
आरक्षीत: আরক্ষিত ব্যাসসিদ্ধ
आरमेनियी: আর্মেনিয়ান আর্মেনিয়াই
आराधीत: দেমাগী অহঙ্কারপূর্ণ
आरामदिणी: আরামদেহ আরমদায়ক
आरास: সাজানো
आरूढ: সওয়ার আরূঢ়
आरोग्याक_बरें: স্বাস্থ্যপ্রদ আরোগ্যপ্রদ নীরোগকর
आरोपमुक्त: অপরাধ_মুক্ত নির্দোষ
आरोपी: আরোপিত স্থাপিত ন্যস্ত
आर्थीक: আর্থিক আর্থ অর্থনৈতিক আর্থনীতিক বৈষয়িক বিত্তীয়
आलमपेड्ड्यार: অকর্মণ্য অকর্মা বেকার নিষ্কর্মা অপদার্থ অকেজো অকম্মার_ঢেঁকি ঠুঁটো_জগন্নাথ
आलायतें: অতিরিক্ত
आल्मीखुशाल: নিঃশঙ্ক অশঙ্কিত আশঙ্কাহীন সংশয়হীন
आळशी: অলস আলস্যপরায়ণ আলসে শ্লথ ঢিলে ঢিলেডালা কাহিল
आवटें: মূর্খ আকাটমূর্খ মুখ্যু মূঢ় অজ্ঞ অশিক্ষিত অজ্ঞান আহাম্মক বোকা নির্বোধ অবুদ্ধি নির্বুদ্ধি বুদ্ধিহীন গবেট উজবুক পাগল পাগলা উন্মত্ত উন্মাদ মত্ত খ্যাপা বাউরা বাওরা বাতুল অপ্রকৃতিস্থ বিকৃতমস্তিষ্ক ছিটিয়াল মানসিক_ভারসাম্যহীন দেওয়ানা
आवटो: পাগল উন্মত্ত উন্মাদ মত্ত খ্যাপা বাউরা বাওরা
आवडना_अशें: অরুচিকর অরোচক অপ্রীতিকর অপ্রীতিপ্রদ অপ্রিয় অমনঃপূত অতৃপ্তিকর
आवडनाशिल्लें: অপছন্দ অপছন্দের অমনোনীত অনির্বাচিত অমনঃপূত অপ্রিয় অরুচিকর রসহীন নীরস অরস রুচিহীন অসার ফিকে অরুচিকর অরোচক অপ্রীতিকর অপ্রীতিপ্রদ অপ্রিয় অমনঃপূত অতৃপ্তিকর
आवडीचें: ইচ্ছিত অভিলষিত মনঃপূত মনের_মত পছন্দ_মত প্রিয় মনোনয়ন নির্বাচন মনঃপূত মনের_মত পছন্দ_মত প্রিয় মনোনয়ন নির্বাচন রুচিকর রুচিকারক মনমতন
आवरणहीण: খোলা অনাবৃত অনাচ্ছাদিত অঢাকা আবরণহীন আবরণরহিত অনাবেষ্টিত অপ্রচ্ছন্ন
आवेगपूर्ण: আবিষ্ট আবেশগ্রস্ত আবেশপূর্ণ
आशियायी: এশিয়ান
आशेल्लो: লালায়িত লালসী
आश्चर्य: সৌর সৌরি সৌরীয় সুরীয়
आश्चर्याचें: অভূতপূর্ব অপূর্ব
आश्रमहीण: অনাশ্রামী অনাশ্রমিক
आश्रमा_बगरचें: অনাশ্রামী অনাশ্রমিক
आसक्त: অনুরাগী অনুরক্ত আসক্ত সংসক্ত অনুষক্ত মুগ্ধ বিমুগ্ধ মোহিত বিমোহিত
आसपाविल्लें: সন্নিহিত সমাহিত
आसपावीत: সন্নিহিত সমাহিত
आसा: স্থিত অধিষ্ঠিত অবস্থিত
आसामी: অসমিয়া আসামী আসামী
आस्ट्रियायी: অস্ট্রীয় অস্ট্রিয়ান
आस्पाविल्ले: সমাবিষ্ট সমাহিত অঙ্গভুত
आहाराचें: খাদ্য ভোজ্য আহার্য গ্রাহ্য
इंग्रजी: ইংরেজী ইংরেজ
इंग्लीश: ইংরেজ
इंग्लेज: ইংরেজী ইংরেজ
इकरा: এগারো একাদশ
इक्कें: এতটা
इजिप्ती: মিশরীয় ইজিপ্শিয়ন
इटाली: ইটালীয় ইটালীদেশীয়
इटालीयन: ইটালীয় ইটালীয় ইটালীদেশীয়
इण्डोनेशियन: ইন্দোনেশিয়া
इतकें: এতটা
इतलें: সমান তুল্য বরাবর স্পষ্ট সদৃশ এতটা
इतिहासीक: ঐতিহাসিক
इत्शीक: বৈকল্পিক বিকল্পযুক্ত বিকল্পী ঐচ্ছিক
इत्शीत: ঐচ্ছিক
इत्साहीण: ইচ্ছাহীন অকাম আকাংক্ষাহীন নিষ্কাম অনভিলাষা অনিচ্ছুক অনভিলাষী নিস্পৃহী অনিচ্ছু নিরাকাঙক্ষী অভিলাষারহিত
इत्सीत: ইচ্ছিত অভিলষিত
इत्सुक: ইচ্ছুক অভিলাষী আকাঙ্ক্ষী অভিলাষুক ইচ্ছালু অভিকাঙ্ক্ষী
इबाडिल्लें: পচা
इबाडिल्लो: খারাপ বিকল অস্বাভাবিক অপ্রকৃতিস্থ বিকারগ্রস্থ বিকৃত
इराणी: ইরানী পার্সিয়ান ইরানী ইরানিয়ান
इर्शेन_भरिल्लें: ঈর্ষ্যাপূর্ণ দ্বেষপূর্ণ সাবিদ্বেষ বিদ্বেশপূর্ণ
इलेक्ट्रॉनीक: ইলেকট্রনিক তড়িদ্বৈজ্ঞানিক বিদ্যুতিনীয়
इल्लें: কম একটু ছোট অল্প অপ্রচুর অবহু সামান্য
इल्लेशें: অত্যল্প
इशान्यी: উত্তর-পূর্ব
इश्कोलाचें: বিদ্যালয়ের স্কুলের পাঠশালার
इश्टागत: বন্ধুত্বপূর্ণ বন্ধুত্বমূলক মৈত্রীমূলক মিত্রবত মিত্রচিত
इश्टाबगरचो: মিত্রহীন সখাহীন অবন্ধু বন্ধুরহিত অবন্ধু বন্ধুরহিত মিত্ররহিত বন্ধুহীন
इश्टाविरयतचो: মিত্রহীন সখাহীন অবন্ধু বন্ধুরহিত অবন্ধু বন্ধুরহিত মিত্ররহিত বন্ধুহীন
इश्वर_बगरचें: অনীশ অনীশ্বর
इश्वरहीण: অনীশ অনীশ্বর
इश्वरी: ঈশ্বরীয় ঐশ্বরিক দৈবী পরমেশ্বরী খুদাঈ
इश्वरीदेणें: ঈশ্বর_প্রদত্ত ভগবান_দত্ত
इस्लामी: ইসলামি
इहलोकीक: ইহলৌকিক সাংসারিক লৌকিক দুনিয়াদারী
ईश्वरी: দেবত্ত দেবদত্ত
उंचलो: উপর
उंचल्या_कुळातलो: অভিজাত সম্ভ্রান্ত কুলীন উচ্চবংশীয় খানদানি বনেদি
उंचवटो: উঁচু উচ্চ অত্যুচ্চ তুঙ্গ উন্নত
उंचेलें: উঁচু উচ্চ উন্নত উর্ধ্ব
उकतायिल्लें: অভিব্যক্ত প্রকাশিত প্রকটিত জাহির বিকশিত প্রদর্শিত প্রকট ব্যক্ত
उकतें: খোলা অনাবৃত অনাচ্ছাদিত অঢাকা আবরণহীন আবরণরহিত অনাবেষ্টিত অপ্রচ্ছন্ন প্রকাশিত প্রকটিত প্রকট আবির্ভূত স্ফুট পরিস্ফুট খোলা উন্মুক্ত অবারিত
उकतेपणीचें: অনাবৃত্ত
उकतो: নগ্ন আবরণহীন অনাবৃত নিরাবরণ উন্মুক্ত বিবস্ত্র বস্ত্রহীন
उकत्या_हाताचें: মুক্তহস্ত মুক্তকর
उगडास_नाशिल्लें: অসম্পূর্ণ অপূর্ণ_রচিত
उगडें: খোলা অনাবৃত অনাচ্ছাদিত অঢাকা আবরণহীন আবরণরহিত অনাবেষ্টিত অপ্রচ্ছন্ন
उग्रवादी: উগ্রবাদী উগ্রপন্থি
उचांबळ: উদ্বিগ্ন উদগ্রীব উদ্বেল উত্কন্ঠিত উতলা ব্যাকুল আকুল অধীর ব্যাকুল আকুল ব্যগ্র কাতর উদ্বিগ্ন উদ্বেল উত্কন্ঠিত অস্থির অধৈর্য
उचांबळीत: চঞ্চল অধীর অধৈর্যবান চপল
उचीत: উচিত ন্যায্য সংগত ঠিক সঠিক যোগ্য যথোচিত সমুচিত যথার্থ উপযুক্ত ঠিক সঠিক যথার্থ অভ্রান্ত নির্ভুল শুদ্ধ ত্রুটিহীন
उच्च: বরিষ্ঠ প্রবর
उजबेकी: উজবেকী
उजळ: শ্বেত শুভ্র সাদা উজ্জ্বল ধবল ধলা শ্বেতকায় শ্বেতাভ রজতশুভ্র তেজোময় জাজ্বল্যমান দীপ্যমান দিব্য জ্যোতির্ময় কান্তিমান দেদীপ্যমান প্রকাশমান
उजवाडायिल्लें: প্রকাশিত
उजवें: ডান_দিক
उजू: ইমানদার বিশ্বস্ত সত্ অকপটচিত্ত নিষ্কপট সজ্জন সাচ্চা
उजो_पालोवपी: প্রশামক শান্তিকর অগ্নিনির্বাপক
उठवणेचें: তোতলা
उडयिल्लें: বরবাদ পরিত্যক্ত বর্জিত নিক্ষিপ্ত ফেলা নিক্ষিপ্ত নিক্ষেপিত
उडिया: উড়িয়া উড়িয়া
उणे_पिरायेचें: অল্পাযু স্বল্পাযু অল্প_জীবী
उणें: অপূর্ণ অপরিপূর্ণ অপর্যাপ্ত কম একটু ছোট অল্প অপ্রচুর অবহু সামান্য ঊনিশ-বিশ প্রায়_সমান অত্যল্পপ্রভেদযুক্ত সামান্য
उणें_केल्लें: পদচ্যুত বরখাস্ত
उणें_जाल्लें: মন্দা কম অবনত
उण्या_आयुश्याचें: অল্পাযু স্বল্পাযু অল্প_জীবী
उण्यांतउणें: ন্যূনতম সামান্যতম নগণ্য
उतरांखेळाचो: একেলা নির্জন_স্থান জনহীন জনশূন্য
उतरांचें: আগামী ভবিষ্যতের আগামীকালের ভাবী অনাগত আসন্ন
उताणें: সাদা সরল সোজা
उतावळें: ব্যস্তবাগিশ হড়বড়ে
उतावळो: চঞ্চল অধীর অধৈর্যবান চপল
उत्कृश्ट: ভালো সু
उत्कृश्ठ: সর্বোত্তম সর্বোশ্রেষ্ঠ সর্বোৎকৃষ্ট অনুত্তম অনুত্তর পুষ্কল
उत्तम: উত্কৃষ্ট অত্যুত্কৃষ্ট উত্তম শ্রেষ্ঠ সেরা প্রকৃষ্ট প্রশস্ত ভালো সু
उत्तर_अस्तंती: উত্তর-পশ্চীম উত্তর_পশ্চিমী
उत्तर_मध्यवर्ती: উত্তর-মধ্যবর্তী উত্তর-মধ্য
उत्तरदायी: উত্তরদায়ী উত্তরাধিকারী ওয়ারিশ হকদার
उत्तरी: হাতকাটা ছিন্নহস্ত হস্তহীন নুলো ঠুঁটো
उत्तीर्ण: উত্তীর্ণ পাস
उत्तेजक: উত্তেজক উত্তেজনাপ্রদ ভডকদার
उत्तेजीत: উত্তেজিত বিক্ষুব্ধ উদ্দীপ্ত উত্তেজনাপূর্ণ গরম অনুপ্রাণিত প্রণোদিত প্রাণিত
उत्पन्न: উড়িয়া
उत्पादीत: উত্পাদিত উত্পন্ন উপপন্ন উদ্ভূত জাত
उत्साही: উৎসাহী উৎসাহযুক্ত উৎসাহিত অধ্যাবসায়ী যার_মধ্যে_প্রেরনা_আছে প্রেরনাপূর্ণ আবেশপূর্ণ
उत्सुक: জিজ্ঞাসু উৎসুক
उथळ: অনাপ্লুত
उदक_भरशिल्लें: যার_মধ্যে_জলের_মাত্রা_অনেক_বেশি
उदका_कोराचें: নীলচে-বেগুনি লাজুলি_রঙা
उदकाचें: যার_মধ্যে_জলের_মাত্রা_অনেক_বেশি
उदकाभरवण: জলমগ্ন প্লাবিত
उदकाळ: জলীয় জলজ যার_মধ্যে_জলের_মাত্রা_অনেক_বেশি আনূপ জলাশয় জলাভূমি জলা জলাজায়গা বিল খালবিল বাদা কচ্ছ
उदय_जाल्लो: উদিত উদ্ভূত উন্মেষিত বিকশিত প্রস্ফুটিত
उदार: উদার উদারতাবাদী উদারমনস্ক উদার বিশালহৃদয় উদারচরিত দরিয়াদিল উদরচিত্র উদারমনা অকৃপণ বাকি
उदारें: সাদা সরল সোজা
उदेल्लो: উদিত উদ্ভূত উন্মেষিত বিকশিত প্রস্ফুটিত
उद्धट: উদ্ধত উগ্র জেদী উচ্ছৃঙ্খল অকুতোভয় দুঃসাহসী বেপরোয়া
उद्येगीक: শিল্পিক শৈল্পিক শিল্পসম্মত শিল্পমন্ডিত শিল্পশোভিত
उद्येगीकरण: প্রযৌক্তিক
उध्वस्त: নষ্ট ধ্বংস বরবাদ বিনষ্ট সমাপ্ত প্রনষ্ট বিহত নাশপ্রাপ্ত ধসে_পড়া বিধ্বস্ত
उन्नत: উন্নত বিকশিত সুবিকশিত
उपकारादीक: উপকারী উপকর্তা উপকর্ত্তা উপকারক উপকার_কর্ত্তা উপকার_কর্তা অনুগ্রাহক অনুগ্রাহী
उपकारी: কৃতজ্ঞ উপকৃত অনুগৃহীত কৃতার্থ
उपद्रवी: উপদ্রবকারী উপদ্রবী অত্যাচারী বদমাস পীড়ক উত্পীড়ক নির্যাতক নিগ্রহকারী উত্ত্যক্তকারী হাঙ্গামাকারী
उपभोक्ता: গ্রাহক উপভোক্তা
उपयुक्त: উচিত ন্যায্য সংগত ঠিক সঠিক যোগ্য যথোচিত সমুচিত যথার্থ উপযুক্ত
उपयोगी: উপযোগী উপাদেয়
उपरांतचें: পরবর্তী পিছনের পরবর্তী অনুবর্তী
उपरो: উঁচু উচ্চ অত্যুচ্চ তুঙ্গ উন্নত
उपस्थीत: উপস্থিত আগত সমাগত হাজির বিদ্যমান স্থিত অবস্থিত বিরাজমান
उपाट: অত্যাধিক প্রচুর অধিক অনেক অটুট বিপুল বহুত অধিক অতিশয় অগাধ অনেক অতি প্রচুর অদম্য সম্পূর্ণ পুরো ভরপুর সার্বিক সামগ্রিক ভরপুর ভরতি পূর্ণ পরিপূর্ণ
उपाड्यांत_घातिल्लें: ছাঁচে_তৈরি ছাঁচের
उपाधीत: অলঙ্কৃত উপাধিত বিভূষিত
उपाशी: অনাহারী উপবাসী উপবাসক উপোষিত উপোসি সোপবাস উপাসি অভুক্ত ক্ষুধার্ত
उपासमारो: ক্ষুধার্ত
उपेक्षित: অনাদরিত তিরস্কৃত অনাদৃত উপেক্ষিত
उपेक्षीत: উপেক্ষিত অনাদৃত উপেক্ষিত অবহেলিত পরাকৃত
उपेगाचें: লাভদাযক লাভপ্রদ লাভকর লাভকারী লাভজনক গুণকারী উপযোগী হিতকারী
उपेगी: যোগ্য সুযোগ্য কাবিল উপযুক্ত পারগ পারঙ্গম সক্ষম সমর্থ উপযোগী উপাদেয় ব্যবহারযোগ্য ব্যবহার্য ব্যবহর্তব্য
उपोश्णकटीबंधीय: অন্যলোক
उप्राशिल्लें: সমাগত সঙ্গমিত
उप्रासपी: পরিবাহক পরিবাহিত সঞ্চালিত
उबगणें: উদাসীন্ উন্মনা উদাস্ নির্লিপ্ত আপনভোলা বেখেয়াল৷
उबगल्लें: ক্লান্ত
उबें: সোজা খাড়া উল্লম্ব ওলন ঋজু ভারটিকাল
उबें_केल्लें: নির্মিত রচিত গঠিত প্রস্তুত সৃষ্ট সৃজিত কৃত সংরচিত
उबेवपी: ভাষা
उबो: দণ্ডায়মান খাড়া
उभयचर: উভচর জল-স্থলচর
उमथें: আধো উল্টা আধোমুখ পট
उमेदी: প্রসন্ন সুপ্রসন্ন আনন্দিত প্রফুল্ল উল্লসিত উত্ফুল্ল আহ্লাদিত পুলকিত হর্ষিত হৃষ্ট প্রমোদিত প্রসন্নচিত্ত প্রসন্ন আনন্দিত প্রফুল্ল উল্লসিত মনোরজ্ঞিত আনন্দিত বিনোদিত উৎসাহী উৎসাহযুক্ত উৎসাহিত অধ্যাবসায়ী
उरफाटे: বিপরীত প্রতিকুল অমান্য উল্টো বিরুদ্ধ
उरफाटें: বিপরীত উল্টো
उरफाट्या_काळजाचो: নিষ্ঠুর নির্দয় নির্মম ন্Rরিশংস নিঠুর নিকরুণ হৃদয়হীন অকৃপ পাষাণ
उरबेवंत: যার_মধ্যে_প্রেরনা_আছে প্রেরনাপূর্ণ আবেশপূর্ণ
उरमट: অনম্য অনমনীয় অনড় কঠোর দৃঢ়্ শক্ত
उरिल्लें: অব্যতীত বকেয়া বাকী শেষ স্থগিত থামা বন্ধ মুলতুবি স্থির গতিহীন
उरिल्लें_रीण: দেয় বকেয়া দাতব্য দায়
उर्दू: উর্দূ
उर्मट: ডীঠ গৃস্তাখ সরচড়া ধৃষ্ট গ্রৃস্তাখ উদ্ধত উগ্র জেদী উচ্ছৃঙ্খল অকুতোভয় দুঃসাহসী বেপরোয়া
उलटें: বিপরীত প্রতিকুল অমান্য উল্টো বিরুদ্ধ
उलटें_सुलटें: অর্থহীন অনর্থক নিরর্থক অসংগত অহেতুক বাজে আজেবাজে খাপছাড়া
उलयतें: মুখর
उलोवपी: সবাক সরব মুখর বাঙ্ময় বাঙ্ময়
उल्लेखनीय: উল্লেখযোগ্য উল্লেখণীয় দৃষ্টান্তমূলক উল্লেখনীয় উল্লেখ্য উল্লেখযোগ্য
उल्लेखीत: উল্লিখিত কথিত অপদিষ্ট নির্দিষ্ট নির্দেশিত আজ্ঞাপিত আদিষ্ট উপদিষ্ট অনুজ্ঞাত
उशीर: দেরি বিলন্বিত লেট
उशीर_जाल्लें: বিলম্বিত
उश्टायिल्लें: ভক্ষিত খাওয়া_হয়েছে_এমন ভক্ষ্য
उश्टें: এঁটো ভক্ষিত খাওয়া_হয়েছে_এমন ভক্ষ্য
उश्ट्याचें: এঁটো ভক্ষিত খাওয়া_হয়েছে_এমন ভক্ষ্য
उश्ण: গরম তপ্ত উষ্ণ উত্তপ্ত গরম
उश्णकटिबंधी: গ্রীষ্মমন্ডলীয় উষ্ণমন্ডলীয়
उश्मागतीक: উত্সর্গকারী নিবেদক উত্সর্জক
ऊंच: উঁচু উচ্চ উন্নত উর্ধ্ব উচু উচচ উঁচু উচ্চ উন্নত সুউচ্চ
ऊंच_इमारतीचें: অট্টালিকা-যুক্ত ইমারত-যুক্ত
एक: এক
एक_करोड: কৌটি
एक_चतुर्तांश: চতুর্থ চার_সংখ্যক চার_সংখ্যার_পূরক
एकक: একক সঙ্গিহীন একাকী একল একলা
एकचित्त: একাগ্রচিত্ত একাগ্র অনন্যমনা অনন্যমনস্ক অনন্যচিত্ত একনিষ্ঠ অভিনিবিষ্ট তদ্গতচিত্ত তন্ময় তন্মনস্ক তন্মনা তন্নিষ্ঠ নিমগ্ন
एकछत्र: একচ্ছত্র একতন্ত্র
एकट्याचें: একতরফ
एकठांय: একত্রিত একত্র জমা সমগ্রীকৃত এক_গোছা একজোট একতাড়া
एकतर्फी: একতরফ একই একতরফ একতরফ
एकतीस: একত্রিশ
एकतोंडी: একমুখী
एकत्र: একত্রিত একত্র জমা সমগ্রীকৃত এক_গোছা একজোট একতাড়া
एकत्रीत: একত্রিত একত্র জমা সমগ্রীকৃত এক_গোছা একজোট একতাড়া
एकदम: আনন্দী সদানন্দ
एकदेशी: একদেশীয় একদেশী
एकनिश्ठ: অকলঙ্ক অকলঙ্কিত অকলঙ্কী গ্লানিহীন অকলুষ নিষ্কলঙ্ক নিষ্পাপ নির্দোষ নির্দোষী অদণ্ডনীয় অনন্য অসাধারণ বিশেষ সবিশেষ অসামান্য অবিকল্প অদ্বিতীয় অতিদ্বয়
एकमत: একমত সহমত একরায়
एकमुखी: একমুখী
एकमुळी: একাকী একেলা সঙ্গহীন
एकमुळो: অযূথচর একাকী
एकरुपी: প্রতিরূপী অনুরূপী সমরূপী
एकलें: এক
एकलें-दुकलें: ইক্কা-দুক্কা ইক্কা_দুক্কা এক্কা-দুক্কা এক্কা_দুক্কা
एकलेंच: একমাত্র
एकल्याचें: একতরফ
एकवंशी: অন্বয়ী
एकवटिल्लें: একত্রিত একত্র জমা সমগ্রীকৃত এক_গোছা একজোট একতাড়া
एकशिवडी: একহরা
एकशें_णव्वद: একশ_নব্বই
एकशें_पंच्यात्तर: একশপচাত্তর ১৭৫
एकसारकें_येवपी: ঘন
एकसुरी: একাকী একেলা সঙ্গহীন
एकसुरो: অযূথচর একাকী
एकांत: নির্জন জনহীন জনবিরল জনশুন্য শুনশান ফাঁকা নিভৃত বিজন নিরিবিলি নিরালা
एकांतवासी: একান্তবাসী একান্তসেবী অপাশ্রিত
एकाक्षरी: হিব্রু
एकाग्रताय: একাগ্রচিত্ত একাগ্র অনন্যমনা অনন্যমনস্ক অনন্যচিত্ত একনিষ্ঠ অভিনিবিষ্ট তদ্গতচিত্ত তন্ময় তন্মনস্ক তন্মনা তন্নিষ্ঠ নিমগ্ন
एकाच_काळांतलें: সাময়িক ক্ষণস্থায়ী
एकावडो: একহরা
एकासारकें: সদৃশ্য একইরকম সমান অনুরুপ সমরুপ
एकुणतीस: উনত্রিশ ঊনত্রিশ
एकुणपन्नास.: উনপঞ্চাশ ঊনপঞ্চাশ
एकुणसत्तर: উনসত্তর ঊনসত্তর
एकुणसाठ: উনষাট ঊনষাট
एकुणीस: উনিশ
एकुलयो: অযূথচর একাকী
एकूच: একমাত্র
एकूय_ना: না ন নঞর্থক
एकूलगी: একাকী একেলা সঙ্গহীন
एकूलयी: একাকী একেলা সঙ্গহীন
एके_वटेनचें: একতরফ
एकोडें: একহরা
एकोणअंयशीं: উনআশি ঊনআশি
एण्डोरी: এনডোরী
एतिहासीक: ঐতিহাসিক
ऐंद्रजालीक: মনোমুগ্ধকর আনন্দদায়ক চমৎকার মোহিনী সম্মোহক জাদু
ऑनलायन: অনলাইন
ऑफिसाचें: অপসরী৷
ऑस्ट्रियन: অস্ট্রিয়ান
ऑस्ट्रेलियायी: অস্ট্রেলিয়ান
ओंपिल्लें: সমর্পিত অর্পিত
ओंविल्लें: অনুস্যুত
ओगोत_जाल्लें: বিলম্বিত
ओग्गी: নিঃশব্দ শান্ত নিঃশ্চুপ
ओजस्वी: তেজস্বী তেজী
ओडलायणें: আকর্ষণীয় রমণীয় আকর্ষক চিত্তাকর্ষক মনোরম মঞ্জু মঞ্জুল সুন্দর মনোহর মনোহারী চিত্তহারী মনোলোভা সুদর্শণ মনহোর মনরোম সুন্দর আকর্ষণী আকর্ষক আকর্ষিক
ओबड_धोबड: খরখরে রুক্ষ কর্কশ অমসৃণ
ओबडधोबड: অসমতল উঁচুনিচু এবড়ো-খেবড়ো চড়াই-উত্ রাই৷
ओमथें: আধো উল্টা আধোমুখ পট
ओरिया: উড়িয়া
ओवळें: অনাপ্লুত
औपचारीक: আনুষ্ঠানিক
कंपुचियन: কম্বোডিয়া_বাসী
कंबोडियन: কম্বোডিয়া_বাসী
कच्चें: কাঁচা অপক্ক অপরিপক্ক আপাকা অপরিণত অপুষ্ট কাঁচা কাঁচা অসংষ্কৃত কাঁচা আধকাঁচা আধপাকা অপরিপক্ক অসিদ্ধ অর্ধসিদ্ধ আধসিদ্ধ অগঠিত অকর্তিত নাকাটা অখন্ড অখন্ডিত
कच्छी: কচ্ছী কচ্ছীয়
कट्टर: উগ্র চরমপন্থী আপসবিরোধী কট্টরপন্থী
कट्टरवादी: মতান্ধ কট্টরবাদী কট্টরপন্থী
कट्ट्या_विणें: কবচহীন আবরণহীন
कठीण: দুর্গম দুরগম্য দুরধিগম্য অগম্য অগম অগমনীয় দুস্তর অসুগম কঠিন দুর্বোধ্য দুরূহ জটিল অবোধ্য গূঢ় গম্ভীর প্যাঁচালো শক্ত কঠিন সুকঠিন দুরূহ গভীর মুশকিল জটিল বিকট প্রচণ্ড গূঢ় দুর্জ্ঞেয় দুর্বোধ দুর্বোধ্য দুর্বেদ বোধাতীত দুরভিগ্রহ কঠিন দুরূহ দুষ্কর শক্ত সূক্ষ অবোধগম্য
कठोर: ক্রূর নিষ্ঠুর নির্দয় নির্মম নিঠুর কঠোর কঠিন নৃশংস দয়াহীন করুণাহীন মমতাহীন অদয় পাষাণ কর্কশ কঠোর কঠিন শক্ত কড়া কটু উগ্র
कडक: তীক্ষ্ণ প্রখর সুতীক্ষ্ণ ধারালো সূক্ষ তেজ খর তীব্র কুশাগ্র দারুণ ভীষণ ভয়ংকর ঘোর প্রবল তীব্র অতিশয় কঠোর কঠিন কড়া শক্ত খর দৃঢ় অনমনীয় কঠোর কঠিন শক্ত কড়া অনমনীয় ভীষণ ভয়ংকর ঘোর সঙ্গীন বিকট সাংঘাতিক ঘোরতর গুরুতর
कडकडीत: গরমাগরম গরম_গরম
कडयिल्लें: অভিতপ্ত তপ্ত উত্তপ্ত প্রতপ্ত
कडेनचें: কাছের নিকটতম নিকটবর্তী নিকটস্থ সন্নিকট সমীপস্থ সমীপবর্তী
कणखर: তীব্র প্রখর প্রচণ্ড প্রবল উচ্চ জোরালো বাদশাহী রাজকীয় রাজোচিত
कणीक: দুরদুরা
कथनीय: কথনীয় কথা বাচ্য
कदें: মোটা স্থূল্কায় বিরাটাকার ফোলা
कनवाळू: দয়ালু দয়াল দয়াশীল সদয় দয়াময় দয়াবান দয়াবন্ত সহৃদয় কৃপালু কৃপাময় কারুণিক করুণাময় অকঠোর
कनिश्ट: কনিশষ্ট অবর
कनिश्ठ: অনুজ ছোট অনুজন্মা অনুজাত কণিষ্ট
कन्नड: কন্নড় কন্নড় কন্নড়
कपटी: দুরাশয় কুবিচারী কপট অন্তর্দুষ্ঠ কপটচারী অসত্ অসাধু অসজ্জন ধোঁকাবাজ ধূর্ত চালবাজ চালু চতুর চালাক হুঁশিয়ার শঠ ধড়িবাজ মন্দমতি ধাঁপ্পাবাজ ছলনাকারী
कफल्लक: নির্ধন ধনহীন গরিব দরিদ্র দীন দীনহীন হতদরিদ্র নিঃস্ব সম্পদহীন দুস্থ সংগতিশূন্য মুফলিস বিত্তহীন কাঙাল অসম্পন্ন
कबलातीचें: অনুবদ্ধ
कबाब_खावपी: মাংসভোজী মাংসাশী কাবাবখোর
कबाब_विकपी: কাবাবওয়ালা মাংসওয়ালা
कमयिल्लें: অর্জিত
कमी: অপূর্ণ অপরিপূর্ণ অপর্যাপ্ত কম একটু ছোট অল্প অপ্রচুর অবহু সামান্য ঊনিশ-বিশ প্রায়_সমান অত্যল্পপ্রভেদযুক্ত সামান্য
कम्युनिस्ट: সাম্যবাদী সমানতাবাদী কমিউনিস্ট সাম্যবাদী সোসালিস্ট কমিউনিস্ট্
करंगळी: কনিশষ্ট
करपाचें: করণীয় সাধ্য
करपी: कारक
करमुक्त: মকুব করমুক্ত নিষ্কর করমুক্ত নিষ্কর আবদা শুল্কহীন
करहीण: মকুব করমুক্ত নিষ্কর
करामती: কেরামতী
कराराचें: অনুবদ্ধ
करी_सारकें: করণীয় সাধ্য
करूंक_नाशिल्लें: অকৃত অনকীয়া
करूंकनाशिल्लें: অকৃত অসম্পন্ন অসম্পাদিত
कर्तव्याची_जाण_नाशिल्लें: কর্তব্যজ্ঞানহীন দায়িত্বজ্ঞানহীন দায়িত্বহীন
कर्तो: कारक
कर्नाटकी: কর্ণাটকী
कर्मकांडी: কর্মনিষ্ট
कर्मनिश्ठ: কর্মনিষ্ট
कलंकीत: লাঞ্ছিত কলঙ্কিত কলুষিত দাগী
कलम: কলমী
कलात्मक: কলাবিদ কলাকুশল কলাভৃত্ কলাকার শিল্পদক্ষ
कलापूर्ण: কলাবিদ কলাকুশল কলাভৃত্ কলাকার শিল্পদক্ষ
कल्पनेंतलें: কাল্পনিক কল্পিত কল্পনীয় মিথ্যা অপ্রকৃত অবাস্তবিক
कल्पीत: কল্পিত মনগড়া আকাশকুসুম
कळवळप: বিগলিত গদগদ দ্রবিভূত
कळाव: দেরি বিলন্বিত লেট
कळाव_जाल्लें: বিলম্বিত
कवच_घाल्लें: কবচধারী কবচী
कवचधारी: কবচধারী কবচী
कवचाळ: শক্ত কাঠ
कवितामोगी: কাব্যরসিক কাব্যপ্রেমী কাব্যানুরাগী
कशे_तरेचें: কিরকম কিভাবের
कशें: কিরকম কিভাবের
कश्टकरी: পরিশ্রমী মেহনতি কর্মঠ কর্মশীল
कश्टाची: দুঃখজনক দুঃখদায়ী দুঃখকর কষ্টদায়ক কষ্টদায়ী দুখময় দুঃখপূর্ণ দুখপূর্ণ দুখভরা
कश्टी: কষ্টগ্রস্থ কাতর দুঃক্ষিত বিপন্ন
कसलें: কিরকম কিভাবের
कस्तुरी_कोराचें: কস্তুরীরঙা কালো
कस्तुरीत: কস্তুরীযুক্ত
कांटे_नाशिल्लें: কন্টকহীন অকন্টক শূলহীন
कांटेहीण: কন্টকহীন অকন্টক শূলহীন
कांट्याबगरचें: কন্টকহীন অকন্টক শূলহীন
कांठाचें: কানা_উঁচু কানাওয়ালা
कांतिमान: তেজোময় জাজ্বল্যমান দীপ্যমান দিব্য জ্যোতির্ময় কান্তিমান দেদীপ্যমান প্রকাশমান
कांतीमय: তেজস্বী তেজী
कांय: অনেক কই বিবিধ নানা একাধিক কতিপয় অনেকানেক তমাম অনোগ কম একটু ছোট অল্প অপ্রচুর অবহু সামান্য নুন্যতম একটু সামন্য কিছু কয়েক অল্প সামান্য কিয়ত্
कांयच: বিরলা বিরলা কোঈ-কোঈ ইক্কা-দুক্কা
काकुटी: সহানুভূতিশীল সমব্যথী সমমর্মী
कागदी: কাগজী কাগজী কাগজী কাগজী কাগজী কাগজী
कागाळ: অভিযুক্ত অভিযোগ্য অনুযোগ্য নালিশযোগ্য অপবাদী অপবাদক
काचाबूल: হতভম্ব কিংকর্তব্যবিমূঢ় হতবুদ্ধি ভ্যাবাচাকা
काजळ_घातिल्ले: কাজল_কালো
काजळाचे: কাজল_কালো
काजळी: সুরমার_রঙ হল্কানীলা
काजारी: বিবাহিত পরিণীত
काडपी: নিবারক
काडिल्लें: পদচ্যুত বরখাস্ত
काणो: একচক্ষু এক_চোখ_কানা
कातरिल्लें: কাটা ছিন্ন খন্ডিত
कात्या_कोरचें: খয়েরি
कात्र्यांचें: প্যাঁচানো পাকানো
कादंबरीक: ঔপ-ন্যাসিক
कादंबरेचें: ঔপন্যাসিক উপন্যাস_সম্বন্ধীয়
कादयेचे: কারাগারের জেলখানার
कानडी: কর্ণাটকী কন্নড় কন্নড়
कापरा_कोराचें: কপুরি
कापराचें: কপুরি কপুরি
कापरें: সংকুচিত কুণ্ঠিত দ্বিধাগ্রস্ত
कापिल्लें: কাটা ছিন্ন খন্ডিত
कापूंक_नाशिल्लें: অখন্ডিত অখন্ড অকর্তিত না_কাটা অটুট অবিচ্ছিন্ন
काफीर: শ্যামলা কালচে কালো-কালো
काबार: সমাপ্ত পরিসমাপ্ত সাঙ্গ সম্পন্ন সমাপিত নিষ্পাদিত শেষ খতম পূর্ণ সম্পূর্ণ পরিপূর্ণ পুরো ধসে_পড়া বিধ্বস্ত
काबीज: অধিকৃত অধিগত অধিকারগত দখলি অধিকারভুক্ত অধিকারস্থ অধিগৃহীত
काबुली: কাবুলি কাবুলি কাবুলি
कामनेचें: ইচ্ছিত অভিলষিত
कामहीण: কামহীন বাসনাহীন নিষ্কাম নির্মম
कायदेशीर: ন্যায়পূর্ণ ন্যায়সংগত ন্যায়োচিত
कायद्याचें: বৈধ_কানুন বিধিমান্য বিধিক আইণ_সম্বন্ধীয়
कायम: স্থায়ী পাকা পোক্ত পাকাপোক্ত
कायरोचें: অদাহ্য অদহনীয় অদহনযোগ্য
कारक: कारक
कारबारी: ব্যবহারযোগ্য ব্যবহার্য ব্যবহর্তব্য
कार्यकारी: স্থানাপন্ন কার্যবাহক
कार्यरत: কার্যকরী
कालजयी: অমর মৃত্যু_বিজেতা কালজয়ী কালাতীত মৃত্যুজ্ঞয় অমর্ত্য চিরজ্ঞীব চিরজ্ঞীবী চিরজীবী
काल्पनीक: কাল্পনিক কল্পিত কল্পনীয় মিথ্যা অপ্রকৃত অবাস্তবিক কল্পিত মনগড়া আকাশকুসুম
काळ_सोंपिल्लें: মেয়াদুত্তীর্ণ
काळखी: অন্ধকার আঁধার অন্ধকারপূর্ণ তমস্বী অপ্রকাশিত অপ্রকাশমান
काळजांतल्यान: হার্দিক আন্তরিক
काळजाक_लागपी: ভাবপুর্ণ মার্মিক ভাবানাত্মক ভাবনাপুর্ণ হৃদয়স্পর্শি
काळजाथावन: হার্দিক আন্তরিক
काळजेचें: চিন্তাজনক চিন্তাকর চিন্তনীয় চিন্ত্য ভাবনীয় চিন্তনযোগ্য অনুধাবনীয় শোচনীয় অনুশোচনীয় গম্ভীর
काळवाचक: কালবাচক সময়বাচক কালবাচী সময়বাচী
काळींगकार: ধন্যায় ধণী আমীর দৌলতবান ধনবান মালদার ধনবত বৈবভশালী মালামাল সমুদ্রশালী ধনধ্যানপূর্ণ সম্পতিবান ধনী
काळीज_चिरपी: হৃদয়-বিদারক মর্মভেদী মার্মিক
काळीज_पिंजपी: বিদারক
काळें: কালা কৃষ্ণ শ্যাম
काळो: অসিত কালো কৃষ্ণ কৃষ্ণবর্ণ শ্যাম
काव्यप्रेमी: কাব্যরসিক কাব্যপ্রেমী কাব্যানুরাগী
काव्यमोगी: কাব্যরসিক কাব্যপ্রেমী কাব্যানুরাগী
काव्यात्मक: কবিত্বপূর্ণ রসাত্মক
काश्मिरी: কাশ্মীরি কাশ্মীরি কাশ্মীরি কাশ্মীরি
कासादोर: শিকারী শিকারী
कास्तिसांवाचें: দুর্বোধ্য দুরূহ জটিল অবোধ্য গূঢ় গম্ভীর প্যাঁচালো শক্ত
किक्के: কত
किजिली: কর্কশা উগ্রা ঝগরাটে ঝগড়ুটে কলহপরায়ণ কলহপ্রিয় কলহকারী বিবাদকারী বিবাদী কর্কশ হুজ্জতি দাঙ্গাবাজ
किटभक्षी: কীটভোজী
किडकिडीत: অস্থিময় হাড়গিলে রোগা কৃশ শীর্ণ ক্ষীণ ছিপছিপে রোগা-পাতলা পাতলা রোগা রুগণ ক্ষীণ কৃশকায় কৃশ শীর্ণ
किडकिडें: কমজোরি পলকা অশক্ত ঠুনকো অমজবুত অদৃঢ্ পাতলা
किडेल्लें: পচা নষ্ট খারাপ
किण्ण: নীরব নিঃশব্দ নিস্তব্ধ শান্ত সমাহিত নিথর চুপ নিঃস্তর নিঃসাড়
कितले: কত
कितल्योश्योच: অনেক কই বিবিধ নানা একাধিক কতিপয় অনেকানেক তমাম অনোগ
किमती: দামি মূল্যবান মহামূল্য ব্যয়সাধ্য অনর্ঘ
किरंगळी: কনিশষ্ট
किरकिरो: চিড়চিড়ে খেয়ালী
किरकोळ: ছোটো_খাটো অল্প_বিস্তর হালকা_ফুলকা
किरणोत्सर्गी: তেজস্ক্রিয় রেডিয়োএক্টিভ
किसमिसाचें: কিশমিশি কিশমিশি
किसमीश_कोराचें: কিশমিশি
कुकुलें: কচিকাঁচা শিশু কাচ্চাবাচ্চা ছানাপোনা বাচ্চা ছোট ছোট্ট
कुचकुचीत: সঘন ঘনা ঘরেরা গহন গুজান অবিকল অবিকল
कुटनितीक: কুটনীতী কুটনৈতীক
कुटील: দুর্জ্ঞেয় দুর্বোধ দুর্বোধ্য দুর্বেদ বোধাতীত দুরভিগ্রহ
कुटुंबहीण: পরিবারহীন কুটুম্বহীন
कुटुंबीक: পারিবারিক ধরালু পরিবারিয় পৈতৃক পৈত্রিক পৈত্র পুরুষানুক্রমিক পারিবারিক মৌরুসি
कुड्डो_विस्वासू: মতান্ধ কট্টরবাদী কট্টরপন্থী
कुतां_काडपी: ছিদ্রান্বেষক ছিদ্রান্বেষী
कुतां_काडिनासपी: অছিদ্রান্বেষী অনসূয় অছিদ্রান্বেষক
कुपथ्य: অপথ্য কুপথ্য অস্বাস্থ্যকর অহিতকর অনিষ্টকর ক্ষতিকর অনিষ্টজনক হানিকর
कुपां_नाशिल्लें: স্বচ্ছ মেঘহীন নিরভ্র মেঘরহীন অনাকাশ অপঘন
कुपां_बगरचें: স্বচ্ছ মেঘহীন নিরভ্র মেঘরহীন অনাকাশ অপঘন
कुपां_विरयत: স্বচ্ছ মেঘহীন নিরভ্র মেঘরহীন অনাকাশ অপঘন
कुपांवीण: স্বচ্ছ মেঘহীন নিরভ্র মেঘরহীন অনাকাশ অপঘন
कुपात्र: কুপাত্র অপাত্র অনধিকারী অভাজন
कुप्रसिद्द: কুখ্যাত কুনামা কুপ্রসিদ্ধ নিন্দিত অখ্যাত দুর্নামগ্রস্ত বদনামের_ভাগী অপকৃত
कुमारिका: কুমারি যে_মেয়ের_বিয়ে_হয়_নি_এমন
कुमारी: কুমারি যে_মেয়ের_বিয়ে_হয়_নি_এমন
कुरकुरीत: খাস্তা মুচমুচে
कुरूप: কুরূপ কুশ্রী অসুন্দর কদাকার কুতনু কুদর্শন শ্রীহীন কুতসিত
कुळपरंपरा: খানদানী খানদানী কলীয় বংশীয়
कुळवंत: কুলীন খানদানী আর্য
कुळाची_परंपरा: খানদানী খানদানী কলীয় বংশীয়
कुळीन: কুলীন খানদানী আর্য
कुविख्यात: কুখ্যাত কুনামা কুপ্রসিদ্ধ নিন্দিত অখ্যাত দুর্নামগ্রস্ত বদনামের_ভাগী অপকৃত
कुशळ: প্রবীণ নিপুণ সুনিপুণ দক্ষ পাকা কাবিল পটু অভিজ্ঞ পরিপক্ব সিদ্ধ পারদর্শী পারঙ্গম বিচক্ষণ যোগ্য সুযোগ্য কাবিল উপযুক্ত পারগ পারঙ্গম সক্ষম সমর্থ
कुशिल्लें: পচা নষ্ট খারাপ পচা
कुशीक: চ্যুত সরানো অপগত
कुशीक_काडिल्लें: অপসৃত অপহত
कुशीक_केल्लें: অপসৃত
कुशीकचें: কাছের নিকটতম নিকটবর্তী নিকটস্থ সন্নিকট সমীপস্থ সমীপবর্তী
कुशीचें: অন্তরিত অন্তর্হিত গৃহবন্দি
कुसकें: পচা
कुसयिल्लें: চোলাইকৃত
कूपाळू: দয়ালু দয়াল দয়াশীল সদয় দয়াময় দয়াবান দয়াবন্ত সহৃদয় কৃপালু কৃপাময় কারুণিক করুণাময় অকঠোর
कूळहीण: অকুলীন নিম্ন_বংশীয় অকুল অকুলী অকূল অপার কূলহীন
कृतघ्न: কৃতঘ্ন অকৃতজ্ঞ নিমকহারাম
कृतज्ञ: কৃতজ্ঞ উপকৃত অনুগৃহীত
कृतार्थ: কৃতার্থ
कृत्रीम: নকল কৃত্তিম অপ্রকৃত
कृपापात्र: প্রিয়_ব্যাক্তি_বা_বস্তু অর্পণ_করা ব্যবস্থা_গ্রহণ_বা_সিদ্ধান্তের_জন্য_পাঠানো আদর_করা
कॅटेलनी: এনডোরী
कॅथोलीक: ক্যাথোলিক
केंद्रीय: কেন্দ্রস্থ কেন্দ্রিত কেন্দ্রীভূত কেন্দ্রীয় কৈন্দ্র্রিক কেন্দ্রগত
केनियायी: কেনিয়ান কেনিয়া_সম্বন্ধিত
केल्लें: কৃত নিষ্পন্ন নিষ্পাদিত
केशरी: জাফরানি
केस्तांवी: দাঙ্গাবাজ
केस्ताळ: ঝগরাটে ঝগড়ুটে কলহপরায়ণ কলহপ্রিয় কলহকারী বিবাদকারী বিবাদী কর্কশ হুজ্জতি
कैदी: কয়েদী হবালাতী আসামী
कोंकणी: কোকণী কোকনী কোকণী কোকনী কোকণী কোকনী
कोंगरे: কোঁকড়ানো কুঞ্চিত কুঁকড়ানো কোঁচকানো
कोंडिल्लें: রুদ্রনিঃশ্বাষে_অপেক্ষা_করা
कोंत्रायिल्ले: উৎকীর্ণ গর্তকরা
कोंबरेल्लें: পল্লবিত
कोडू: কষা তেতো কর্কশ কটু কড়া কাঠখোট্টা কাটা_কাটা
कोडू_काजरो: অতি_কড়া অতি_কটু অতি_কড়া অতি_কটু
कोडू_वीख: অতি_কড়া অতি_কটু
कोत्रायिल्लें: খুদিত
कोप्रकार: ঋণপ্রদাতা ঋণদাতা ঋণ-প্রদাতা ঋণ-দাতা
कोमेल्ले: অঙ্কুরিত
कोरांतिल्ले: উৎকীর্ণ গর্তকরা
कोरातिल्लें: খুদিত
कोरियन: কোরিয়ান কোরীয় কোরিয়ান
कोरियी: কোরিয়ান কোরীয় কোরিয়ান
कोरी: অব্যবহৃত অপ্রযুক্ত অভুক্ত অপ্রহত
कोरें: সাদা অলিখিত আলেখা অলেখনীয়
कोलंबियी: কোলম্বিয়ন
क्रमान: ক্রমিক অনুক্রমিক ক্রমবদ্ধ বিন্যস্ত ক্রমানুসার ক্রমানুকুল শৃঙ্খলাবদ্ধ অনুপূর্ব
क्रिस्ती: ক্যাথোলিক
क्रुर: ক্রূর নিষ্ঠুর নির্দয় নির্মম নিঠুর কঠোর কঠিন নৃশংস দয়াহীন করুণাহীন মমতাহীন অদয় পাষাণ
क्रूर: অত্যাচারী নৃশংস নিষ্ঠুর নির্দয় নির্মম ক্রূর বর্বর পীড়ক উত্পীড়ক নিগ্রহকারী নির্যাতক জুলুমবাজ জালিম
क्रॅऑली: ক্রিওল ক্রিয়োল
क्रोएशियन: ক্রোড়েশীয়া_সংক্রান্ত ক্রোড়েশীয়
क्षणजिवी: নশ্বর অশাশ্বত ক্ষণজীবী ক্ষয়শীল নাশবান ভঙ্গুর বিনাশী অনিত্য
क्षणभंगूर: নশ্বর অশাশ্বত ক্ষণজীবী ক্ষয়শীল নাশবান ভঙ্গুর বিনাশী অনিত্য
क्षितिजी: ক্ষৈতিজ
क्षीण: পাতলা রোগা রুগণ ক্ষীণ কৃশকায় কৃশ শীর্ণ
क्षुद्र: অকুলীন নিম্ন_বংশীয় অকুল অকুলী
क्षुद्र_कुळाचें: নিম্ন_কুলীন নিম্ন_বংশীয়
क्षेत्रीय: আঞ্চলিক স্থানিয় লোকাল অঞ্চলীয় স্থলীয়
क्षेपक: ক্ষেপক
क्षेपणक: ক্ষেপক
क्षेम: শুভজনক হিতকর মাঙ্গল্য মাঙ্গলিক শুভদ ক্ষেমকর
खंडक: খণ্ডক
खंडणीय: খন্ডনীয় পাপযোগ্য মাফযোগ্য
खंडी: মহাদ্বীপীয়
खंडीत: ভগ্ন ভাঙ্গা বিচ্ছিন্ন বিখন্ডি
खंतदिणी: দুঃখজনক দুঃখদায়ী দুঃখকর কষ্টদায়ক কষ্টদায়ী
खंती: হতাশা নিরাশা মায়ুস খিন্ন
खंतीची: দুঃখজনক দুঃখদায়ী দুঃখকর কষ্টদায়ক কষ্টদায়ী দুখময় দুঃখপূর্ণ দুখপূর্ণ দুখভরা
खंबीर: অটল অনঢ় অবিচল অপরিবর্তনশীল দৃঢ় স্থির
खगोली: খগোলীয় নভোমন্ডলীয়
खटखटीत: কড়া কড়কড়ে শক্ত জমাট কঠোর
खडकाळ: ছিদ্রান্বেষী দোষগ্রাহী দোষদর্শী ছিদ্রদর্শী ছলগ্রাহী দোষোরোপকারী বিদূষক
खडतर: দুর্গম দুরগম্য দুরধিগম্য অগম্য অগম অগমনীয় দুস্তর অসুগম কঠিন
खडपाळ: ছিদ্রান্বেষী দোষগ্রাহী দোষদর্শী ছিদ্রদর্শী ছলগ্রাহী দোষোরোপকারী বিদূষক
खडबडीत: অসমতল উঁচুনিচু এবড়ো-খেবড়ো চড়াই-উত্ রাই৷ খরখরে রুক্ষ কর্কশ অমসৃণ
खड्डो: ন্যাড়া টাক নেড়া চুলহীন
खणखणीत: মিহি মৃদু কোমল পাতলা সূক্ষ্ম
खणपी: উত্খাত অপসারিত অপসৃত
खतखतीत: গরমাগরম গরম_গরম
खतेवल्लें: দাগি
खबर_आशिल्लें: অবগত অধিগত জ্ঞাত অবহিত বিদিত সুবিদিত বিজ্ঞাত পরিজ্ঞাত
खबर_नाशिल्लें: অজ্ঞাত অজানা অজানিত অবিজ্ঞাত অপরিচিত অপরিজ্ঞাত অচেনা অনবগত অবিদিত
खर: অদম্য তীক্ষ্ণ প্রখর সুতীক্ষ্ণ ধারালো সূক্ষ তেজ খর তীব্র কুশাগ্র দারুণ ভীষণ ভয়ংকর ঘোর প্রবল তীব্র অতিশয় শক্ত দৃঢ় সুদৃঢ় দ্রঢ়িষ্ঠ মজবুত টেঁকসই পোক্ত পাকাপোক্ত শক্তপোক্ত কর্কশ কঠোর কঠিন শক্ত কড়া কটু উগ্র যার_মধ্যে_প্রেরনা_আছে প্রেরনাপূর্ণ আবেশপূর্ণ তীব্র প্রখর প্রচণ্ড প্রবল উচ্চ জোরালো ভীষণ ভয়ংকর ঘোর সঙ্গীন বিকট সাংঘাতিক ঘোরতর গুরুতর মিহি মৃদু কোমল পাতলা সূক্ষ্ম
खरकटें: এঁটো ভক্ষিত খাওয়া_হয়েছে_এমন ভক্ষ্য
खरखरीत: শুখা শুখো করকরে শুকনো
खरसाणीचे: প্রবল প্রচন্ড উগ্র তেজ কড়া তীব্র সুতীব্র অত্যন্ত
खरी: বিশুদ্ধ খাঁটি আসল প্রকৃত যথার্থ শুদ্ধ বাস্তব বাস্তবিক প্রকৃত যথার্থ সত্য নিশ্চিত অকাল্পনিক অকল্পিত
खरें: সত্য প্রকৃত ঠিক হক যথার্থ ঠিক সঠিক যথার্থ অভ্রান্ত নির্ভুল শুদ্ধ ত্রুটিহীন সাচ্চা খাঁটি প্রকৃত আসল যথার্থ সত
खरो: ইমানদার বিশ্বস্ত সত্ অকপটচিত্ত নিষ্কপট সজ্জন সাচ্চা
खर्चीक: অপব্যযী ব্যয়শীল অতিব্যয়ী অতি-ব্যয়ী ব্যয়ী
खळबळीत: চটকদার
खांपें: প্রবীণ নিপুণ সুনিপুণ দক্ষ পাকা কাবিল পটু অভিজ্ঞ পরিপক্ব সিদ্ধ পারদর্শী পারঙ্গম বিচক্ষণ
खाजगी: নিজস্ব নিজের ব্যক্তিগত স্বকীয় আত্ম নিজস্ব নিজের ব্যক্তিগত
खाजराचें: খজুরা খজুরী খরজুরি খজুরা খজুরী খরজুরি
खाणा_बगरचें: অনাহারী উপবাসী উপবাসক উপোষিত উপোসি সোপবাস উপাসি অভুক্ত ক্ষুধার্ত
खादाड: পেটূক অত্যাহারী অতিভোজী
खाद्य: খাদ্য ভোজ্য আহার্য গ্রাহ্য
खानदानी: পৈতৃক পৈত্রিক পৈত্র পুরুষানুক্রমিক পারিবারিক মৌরুসি
खायलें: নগন্য ছোট মামুলি তুচ্ছ যে-সে অগন্য নাচীজ যে-সে অধিনস্থ অধীন অধিশ্রিত নিচু নিম্নস্থ অনুচ্চ অতুঙ্গ নিম্ন
खायलो: নিচু নিম্ন অনুচ্চ অবনত অনুন্নত অতুঙ্গ্
खायल्या_कुळाचें: অকুলীন নিম্ন_বংশীয় অকুল অকুলী নিম্ন_কুলীন নিম্ন_বংশীয়
खालचें: নীচ নিম্ন পতিত অন্ত্য অন্ত্যবর্ণ অন্ত্যজ ব্রাত্য
खालते_मानेचें: অধোবদন অধোমুখ
खाली: রিক্ত খালি শূন্য ফাঁকা শূন্যগর্ভ ফাঁপা খালি ফাঁকা
खाल्लें: হজম হজম হজম হজম
खावंक_नाशिल्लें: অভুক্ত অনুপভুক্ত অনাস্বাদিত অখাদিত
खावगें: পেটূক অত্যাহারী অতিভোজী
खावपाचें: খাদ্য ভোজ্য আহার্য গ্রাহ্য
खाशेलें: বিশিষ্ট বিশিষ্ট অন্যতম অনন্য বিশেষ
खास: বিশিষ্ট অসামান্য অসাধারন বিশেষ অসামান্য অসাধারন বিশেষ
खीणयाळें: নশ্বর অশাশ্বত ক্ষণজীবী ক্ষয়শীল নাশবান ভঙ্গুর বিনাশী অনিত্য
खुटें: হাল্কা ফিকা পানসে জোলো
खुनी: খুনি খুনে ঘাতক হত্যাকারী হাত্যারা সংহারক নিহন্তা অপঘাতক বধকারী ঘাতী অপঘাতী
खुळो: পাগল উন্মত্ত উন্মাদ মত্ত খ্যাপা বাউরা বাওরা
खूब: অনেক কই বিবিধ নানা একাধিক কতিপয় অনেকানেক তমাম অনোগ বহুত অধিক অতিশয় অগাধ অনেক অতি প্রচুর সম্পূর্ণ পুরো ভরপুর সার্বিক সামগ্রিক ভরপুর ভরতি পূর্ণ পরিপূর্ণ
खूब_कोडू: অতি_কড়া অতি_কটু
खूब_चड: অত্যাধিক প্রচুর অধিক অনেক অটুট বিপুল
खूब_व्हड: এমনি
खेरीज: আলাদা পৃথক ভিন্ন অসম বিভিন্ন অসমান বিসম
खोटे: ত্রুটিপূর্ণ জাল অচল নকল দুনম্বরি কৃত্রিম
खोटें: মিথ্যা অসত্যবাদী লবরা অনৃতভাষী অসত্যভাষী মিথ্যাভাষী অন্যবাদী অনেরা মিথ্যা অসত্য মিছা ঝুট ঝুটা ভুয়া ভুয়ো অনৃত অতথ্য অপ্রকৃত তথ্যহীন অপ্রামাণিক আধারহীন নির্মূল অনাধার আধাররহিত যথার্থহীন
खोटो: দুরাশয় কুবিচারী কপট অন্তর্দুষ্ঠ কপটচারী অসত্ অসাধু অসজ্জন
खोडपी: খণ্ডক
खोडून_काडपी: খণ্ডক
खोल: গহন গভীর অথই অতল অতলস্পর্শী অতলস্পর্শ সুগভীর গহন গহীন
खोशी: প্রসন্ন সুপ্রসন্ন আনন্দিত প্রফুল্ল উল্লসিত উত্ফুল্ল আহ্লাদিত পুলকিত হর্ষিত হৃষ্ট প্রমোদিত প্রসন্নচিত্ত প্রসন্ন আনন্দিত প্রফুল্ল উল্লসিত মনোরজ্ঞিত আনন্দিত বিনোদিত
खोसदिणें: আনন্দপ্রদ আনন্দ-দায়ক আহ্লাদক সুখপ্রদ আনন্দদায়ক আনন্দ মনোরম সুন্দর ভালো মনোলোভা মনোমোহিনী মনোহারিনী
खोसयाळें: আনন্দপূর্ণ আনন্দময় উল্লাসপূর্ণ সানন্দ
ख्यास्तपात्र: দন্ডনীয়
ख्यास्ती_बगरचें: অদণ্ডিত
ख्यास्ती_विणें: অদণ্ডিত
गंदाचें: চন্দনরঙা
गंदीत: সুবাসিত অনুবাসিত
गच्च: সঘন ঘনা ঘরেরা গহন গুজান অবিকল অবিকল
गजबजिल्लें: ব্যস্ত কর্মব্যস্ত
गटखळ: দুষ্কর দুরূহ কঠিন সুকঠিন শক্ত অসাধ্য দুঃসাধ্য
गडखळ: দুষ্কর দুরূহ কঠিন সুকঠিন শক্ত অসাধ্য দুঃসাধ্য
गडद: গাঢ়্ প্রগাঢ় চড়া গভীর
गडबडें: ব্যস্তবাগিশ হড়বড়ে
गडबडो: চঞ্চল অধীর অধৈর্যবান চপল
गणतंत्री: প্রজাতন্ত্রীয় গনতান্ত্রিক লোকতান্ত্রিক
गतिहीण: অচল অবিচল নিশ্চল স্থির দৃঢ় অনঢ় অটল স্থাণু
गतीचें: গতিশীল সচল চলমান অস্থির অবিরাম গতিময় জঙ্গম
गतीशील: গতিশীল সচল চলমান অস্থির অবিরাম গতিময় জঙ্গম
गतीहीण: স্থগিত থামা বন্ধ মুলতুবি স্থির গতিহীন
गदगदीत: গদগদ গদ্দদ
गद्यात्मक: গদ্যাত্মক
गप: নিঃশব্দ শান্ত নিঃশ্চুপ
गरजू: অভাবী অপেক্ষী অপেক্ষক
गरजे_भायर: অনাবশ্যক অবাঞ্ছিত অবাঞ্ছ্নীয় নিষ্প্রয়োজন অপ্রয়োজনীয় অতিরিক্ত বাড়তি বাজে ফালতু
गरजेचें: আবশ্যক জরূরী অপেক্ষিত অনিবার্য
गरजेवंत: অভাবী অপেক্ষী অপেক্ষক
गरम: গরম তপ্ত উষ্ণ উত্তপ্ত গরম গরম তপ্ত উত্তপ্ত আতপ্ত
गरमागरम: গরমাগরম গরম_গরম
गराचें: চিরঞ্জী
गरीब: নির্ধন ধনহীন গরিব দরিদ্র দীন দীনহীন হতদরিদ্র নিঃস্ব সম্পদহীন দুস্থ সংগতিশূন্য মুফলিস বিত্তহীন কাঙাল অসম্পন্ন
गर्भीत: নিহিত গর্ভিত
गर्वहीण: নিরভিমানী অনভিমানী গর্বহীন দর্পহীন নিরহঙ্কারী অহংকারহীন দর্ভহীন
गर्विश्ट: অভিমানী অহংকারী দর্প দর্ভ দাম্ভিক গর্ব দর্প অনম্র অবিনিত অনম অবিনয়শীল প্রগল্ভ দাম্বিক
गवाय: প্রত্যক্ষদর্শী
गांजपी: স্বরিত নর্দিত ধ্বনিত গুঞ্জরিত গুঞ্জিত
गांधीवादी: গান্ধীবাদী গাঁধীবাদী গান্ধীবাদী গাঁধীবাদী
गांबियायी: গাম্বিয়ান
गांवगिरी: গ্রামীন গ্রাম্য গ্রামিক
गांवगिरे: গ্রামিন দেহাতি গ্রামবাসি গ্রাম্ম গাবার
गांवटी: পালতু ঘরেলু
गाड: গাঢ়্ প্রগাঢ় চড়া গভীর গভীর সুগভীর গাঢ় প্রগাঢ়
गाढ: অতরল গাঢ় ঘন জমাট
गायब: অদৃশ্য অদৃষ্টিগোচর অদৃষ্টয়মান বিলীন নাদেখা অন্তরহিত
गार्फ: কলমী
गाळाचें: তলানি জমাট গাঁদ
गिड्डो: ঠিগনা ছোট বেনা নাটা ঠিগনা বামন
गिन्यानी: বিদ্বান জ্ঞানী জ্ঞানবান পন্ডিত বুদ্ধ বিজ্ঞ অভিজ্ঞ বিদ্যবান সম্বুদ্ধ প্রবুদ্ধ জানকার জ্ঞাতা বিজাতা ভিজ্য
गिरेस्त: ধনী বড়মানুষ ওমরাও ধন্যায় ধণী আমীর দৌলতবান ধনবান মালদার ধনবত বৈবভশালী মালামাল সমুদ্রশালী ধনধ্যানপূর্ণ সম্পতিবান ধনী
गिळिल्लें: গ্রস্থ গ্রাসিত
गुंथिल्ले: অনুস্যুত
गुजराती: গুজরাতী গুজরাতি গুজরাতি
गुजराथी: গুজরাতি গুজরাতি
गुणकारक: প্রভাবশালী কার্যকরী উপযোগী ফলদায়ক
गुणगुणपी: গুঞ্জরিত গুঞ্জিত
गुणयुक्त: গুণযুক্ত গুণান্বিত গুণবাচক ভালো
गुणरहीत: নির্গুণ গুণরহিত গুণহীন গুণশূন্য
गुणवंत: সদগুণী গুণবন্ত গুণবান গুণশালী গুণী
गुणवत्तायुक्त: গুণযুক্ত গুণান্বিত গুণবাচক ভালো
गुणी: সদগুণী গুণবন্ত গুণবান গুণশালী গুণী গুণী গুণবান গুণাকর গুণনিধান
गुन्यांवकार: আসামী অপরাধী দোষী
गुन्यांवकारी: অপরাধিক অপরাধী অপরাধশীল অপরাধপ্রবণ
गुन्यांवी: অপরাধী
गुन्यावंकार: অপরাধশীল অপরাধিক অপরাধপ্রবণ
गुपीत: গোপনীয় অপ্রকট্য অপ্রকাশ্য প্রচ্ছন্ন লুকানো গুপ্ত গূঢ় নিগূঢ় গুপ্ত গোপন প্রচ্ছন্ন অন্তরিত নিভৃত আচ্ছন্ন অজ্ঞাত অপ্রকাশিত রহশ্যপূর্ণ রহশ্যময় রহশ্যাত্মক গুড় নিহিত গর্ভিত
गुप्त: গোপনীয় অপ্রকট্য অপ্রকাশ্য প্রচ্ছন্ন লুকানো গুপ্ত গূঢ় নিগূঢ় গুপ্ত গোপন প্রচ্ছন্ন অন্তরিত নিভৃত আচ্ছন্ন অজ্ঞাত অপ্রকাশিত
गुबगुबीत: মাঁসল
गुरुकूलवासी: গুরুকুলবাসী অন্তেবাসী
गुरू_नाशिल्लें: নিগুরা অগুরু
गुरूहीण: নিগুরা অগুরু
गुलाबाचें: গুলাবি
गुलाबी: গুলাবি
गुल्ल: অন্তঃপ্রবিষ্ট নিমজ্জিত_জলমগ্ন বিভোর_আনন্দে_মগ্ন চিন্তামগ্ন
गूढ: গোপনীয় অপ্রকট্য অপ্রকাশ্য প্রচ্ছন্ন লুকানো গুপ্ত গূঢ় নিগূঢ় গুপ্ত গোপন প্রচ্ছন্ন অন্তরিত নিভৃত আচ্ছন্ন অজ্ঞাত অপ্রকাশিত রহশ্যপূর্ণ রহশ্যময় রহশ্যাত্মক গুড় নিহিত গর্ভিত
गेल्लें: রওনা রওয়ানা
गेल्लो: রওনা রওয়ানা
गैरहजर: অনুপস্থিত গরহাজির অবিদ্যমান অবর্তমান অবিরাজমান
गोंदळिल्लो: হতভম্ব কিংকর্তব্যবিমূঢ় হতবুদ্ধি ভ্যাবাচাকা
गोड: শ্রুতি_মধুর সুন্দর মিস্টি_আওয়াজ মধুর_আওয়াজ মিস্টি মধু মিস্টি মধু
गोत्रा_भायलो: অন্যগোত্র ভিন্নগোত্র
गोथिक: গৌথিক গথিক
गोथीक: গথিক
गोबर: ভস্ম ভস্মীভূত ভস্মিত
गोबरें: স্লেট_রং
गोल: গোল গোলাকার গোলাকৃতি বৃত্তাকার বর্তুলাকার মন্ডলাকার গোলালো বর্তুলিক অখন্ডমন্ডলাকার বলয়াকার সুগোল চক্রাকার গোল গোলাকার গোলাকৃতি বৃত্তাকার বর্তুলাকার মন্ডলাকার গোলালো বলয়াকার সুগোল
गौण: অপ্রধান অপ্রমুখ আনুষাঙ্গিক গৌণ দুই দ্বিতীয় দো দ্বি
गौरवपूर्ण: গৌরবশালী গৌরবান্বিত গৌরবদীপ্ত গৌরবোজ্জ্বল গরিমান্বিত
गौरवशीळ: গৌরবশালী গৌরবান্বিত গৌরবদীপ্ত গৌরবোজ্জ্বল গরিমান্বিত
ग्रंथिकी: বই_সম্বন্ধীয় পুস্তকীয় পূস্তক_সম্বন্ধীয়
ग्रस्त: ব্যথিত পীড়িত দুঃখিত আর্ত শোকার্ত গ্রাসিত গ্রস্থ
ग्रिनलॅण्डी: গ্রীনল্যান্ডী
ग्रीक: য়ুনানী গ্রীক ইউনানি গ্রীক
घट: ঘনিষ্ঠ অন্তরঙ্গ অভিন্ন আত্মীয় গাঢ় অন্যতম অটল অনঢ় অবিচল অপরিবর্তনশীল দৃঢ় স্থির নিডর অভয় নির্ভয় নির্ভীক বেডর ভয়হীন নির্ভীত নিঃশঙ্ক অপশঙ্ক কঠিন কঠোর কঠিন কড়া শক্ত খর দৃঢ় অনমনীয় শক্ত দৃঢ় সুদৃঢ় দ্রঢ়িষ্ঠ মজবুত টেঁকসই পোক্ত পাকাপোক্ত শক্তপোক্ত সন্ন সজ্ঞাশূন্য নিধেশঠ জড় অচেশষ্ট স্তম্ভিত হতচকিত কড়া কড়কড়ে শক্ত জমাট কঠোর ভালো খুব_ভালো চমত্কার বেশ বেশ_ভালো ঠিকঠাক
घट_काळजाचो: নিষ্ঠুর নির্দয় নির্মম ন্Rরিশংস নিঠুর নিকরুণ হৃদয়হীন অকৃপ পাষাণ
घटमूट: তাগড়াই বলিষ্ঠ বলবান বলশালী লম্বা-চওড়া মোটাসোটা পুষ্ট হৃষ্টপুষ্ট নধর দশাসই বৃংহিত
घडयिल्लें: কল্পিত মনগড়া আকাশকুসুম নির্মিত রচিত গঠিত প্রস্তুত সৃষ্ট সৃজিত কৃত সংরচিত
घडिल्लें: ঘটিত
घडूंक_नाशिल्लें: অঘটিত অনঘটা অঘটা
घणघणीत: মিহি মৃদু কোমল পাতলা সূক্ষ্ম
घन: কঠিন
घमेंडी: অভিমানী অহংকারী দর্প দর্ভ দাম্ভিক গর্ব দর্প অনম্র অবিনিত অনম অবিনয়শীল প্রগল্ভ দাম্বিক আকড়বাজ পেঠদার
घरगुती: পারিবারিক ধরালু পরিবারিয় পালতু ঘরেলু
घरहीण: আবাসহীন আশ্রয়হীন গৃহহীন
घरावें: পারিবারিক ধরালু পরিবারিয় পালতু ঘরেলু
घसरिल्लें: মন্দা কম অবনত
घाई_करपी: ব্যস্তবাগিশ হড়বড়ে
घाणयारें: অপরিচ্ছন্ন অপরিষ্কৃত অপরিষ্কার মলিন কলুষিত ময়লা নোংরা অস্বচ্ছ অপবিত্র অশুদ্ধ
घाणीचें: দুর্গন্ধপূর্ণ দুর্গন্ধযুক্ত দুর্গন্ধিত
घातक: হিংসুটে হিংসাত্মক ঘাতক বর্বর নৃশংস
घातकी: হিংসক হিংসাপরায়ণ হিংস্রক হিংস্র ঘাতক বর্বর নৃশংস জালিম বিশ্বাসঘাতী দাঙ্গাবাজ দগাবাজ হারমী গহার বেবাফা অপঘাতক অপঘাতী সংকটজনক বিপজ্জনক সংকটপূর্ণ সংকটময় বিঘ্নময় ধোঁকাবাজ ধূর্ত চালবাজ চালু চতুর চালাক হুঁশিয়ার শঠ ধড়িবাজ মন্দমতি ধাঁপ্পাবাজ ছলনাকারী
घातमारें: ধোঁকাবাজ ধূর্ত চালবাজ চালু চতুর চালাক হুঁশিয়ার শঠ ধড়িবাজ মন্দমতি ধাঁপ্পাবাজ ছলনাকারী
घातिल्लें: আরোপিত স্থাপিত ন্যস্ত
घानायी: ঘানান
घायाळ: ঘায়েল আহত ক্ষত জখমী অপচারিত বিদ্ধ বেধিত
घार्मिक: ধার্মিক ধর্মশীল ধর্মী ধর্মনিষ্ঠ ধর্ম_পরায়ণ ধর্মাত্মা
घालप: বিলীন অদৃশ্য অদৃষ্টিগোচর অদৃষ্টয়মান নাদেখা অন্তরহিত
घालपा_सारकें: পরিধেয় পরিধানযোগ্য ধেয়
घाळ: অসবধান অসতর্ক গাফিলতি
घुमपी: স্বরিত নর্দিত ধ্বনিত গুঞ্জরিত গুঞ্জিত
घुरी_घालपी: ছাপামার
घुवळी_वखदां: আফিমী
घुवळीचें: মাদক নেশাগ্রস্থ নেশাদার
घुसपटिल्लें: ফেঁসে_যাওয়া
घुसपलिल्लो: আটকানো বদ্ধ বাঁধা
घुसपल्लें: ফেঁসে_যাওয়া
घुसपागोंदळ: জটিল প্যাঁচালো
घुस्पागोंदळाचें: দুর্বোধ্য দুরূহ জটিল অবোধ্য গূঢ় গম্ভীর প্যাঁচালো শক্ত
घुस्पूंक_नाशिल्लें: ঝামেলাহীন ঝামেলাবিহীন ঝামেলারহিত
घृणास्पद: ঘৃণিত কুৎসিত জঘন্য বিভৎস্য অপকৃষ্ট
घृणीत: ঘৃণিত কুৎসিত জঘন্য বিভৎস্য অপকৃষ্ট
घोगरें: সংকুচিত কুণ্ঠিত দ্বিধাগ্রস্ত
घोडदळ: অশ্বারোহী
घोनें: মূর্খ আকাটমূর্খ মুখ্যু মূঢ় অজ্ঞ অশিক্ষিত অজ্ঞান আহাম্মক বোকা নির্বোধ অবুদ্ধি নির্বুদ্ধি বুদ্ধিহীন গবেট উজবুক
घोर: ভীষণ ভয়ংকর ঘোর সঙ্গীন বিকট সাংঘাতিক ঘোরতর গুরুতর
घोळटी: প্রচলিত চালু চলিত বহুপ্রচলিত চলতি প্রবর্তিত
घोळटें: পরিব্রাজক পরিক্রমণকারী প্রব্রাজক পরিযায়ী বাঞ্জারা
घोळोवप: বিলীন অদৃশ্য অদৃষ্টিগোচর অদৃষ্টয়মান নাদেখা অন্তরহিত
घोशीत: ঘোষিত
घोस्ताचें: মনঃপূত মনের_মত পছন্দ_মত প্রিয় মনোনয়ন নির্বাচন
चंचळ: বিচলিত চঞ্চল অধীর অধৈর্যবান চপল অশান্ত চঞচল অস্থিরচিত্ত উৎকন্ঠিত বিচলিত অস্থির
चंदनाचें: চন্দন
चंदनी: চন্দন চন্দনরঙা
चंदेरी: চাঁদনি জ্যোত্স্না
चकचकपी: আলোকিত উজ্জ্বলিত কান্তিমান চমকতা দমকতা দীপ্ত চমকদার চাকচিক্য স্ফুরিত চকচকে ঝিকিমিকি
चकचकीत: উজ্জ্বল উজল প্রোজ্জ্বল স্বচ্ছ সাফ পরিষ্কার স্পষ্ট চমকদার চমকতা
चक्रम: মূর্খ আকাটমূর্খ মুখ্যু মূঢ় অজ্ঞ অশিক্ষিত অজ্ঞান আহাম্মক বোকা নির্বোধ অবুদ্ধি নির্বুদ্ধি বুদ্ধিহীন গবেট উজবুক পাগল উন্মত্ত উন্মাদ মত্ত খ্যাপা বাউরা বাওরা
चड: অনেক কই বিবিধ নানা একাধিক কতিপয় অনেকানেক তমাম অনোগ বহুত অধিক অতিশয় অগাধ অনেক অতি প্রচুর ভীষণ ভয়ানক অত্যধিক অত্যন্ত প্রচণ্ড প্রবল ঘোরতর
चड_कोडो: অতি_কড়া অতি_কটু
चड_गरजेचें: অত্যাবশ্যক অতি_আবশ্যক অপরিহার্য
चड_रागीश्ट: অতি_আবিষ্ট অত্যূগ্র ক্রোধাবিষ্ট
चडशे: অধিকের_বেশি
चडांत_चड: অধিকতম সর্বাধিক অধিকের_বেশি
चडिल्लें: অধিরূঢ় আরূঢ় সমারূঢ় আস্থিত
चतुर्भुजी: চতুর্ভুজ
चतूर: প্রফুল্ল উত্ফুল্ল প্রসন্ন আনন্দিত আনন্দবিহ্বল সহর্ষ উচ্ছ্বসিত উল্লসিত চালাক চতুর হুঁশিয়ার সেয়ানা পটু চালাকচতুর প্রখরবুদ্ধি
चपळ: চালাক চতুর হুঁশিয়ার সেয়ানা পটু চালাকচতুর প্রখরবুদ্ধি
चमत्कारी: চমৎকারী চমৎকারপূর্ণ চামৎকারিক কেরামতী
चरम: চরম
चरित्रवान: সচচরিত্র চরিত্রবান শিষ্টাচারী সুশীল
चरित्रहीण: ব্যভিচারিণী কুলটা চরিত্রহীনা ছিনাল ভ্রষ্টা দুঃচরিত্র চরিত্রহীন ভ্রষ্টাচার কদাচারদুষ্ট দুরাচারি দোষযুক্তব্যাভিচারী ধর্মপথ_থেকে_বিচ্যুতি
चर्चीत: অনুশীলিত চর্চিত অভ্যস্ত পরিশীলিত ধাতস্থ
चलणुकेंत_नाशिल्लो: অপ্রচলিত অপ্রচরিত অপ্রযুক্ত পুরাতন
चलणुकेची: প্রচলিত চালু চলিত বহুপ্রচলিত চলতি প্রবর্তিত
चलपाचें: পায়ে_চলবার পায়ে-চলা পায়ে-হাঁটা
चलपी: চালিত পরিচালিত প্রচালিত পথচারী পথিক পান্হ রাহি পাদবিক চলন্ত চলমান সচল
चलयिल्लें: সঞ্চালিত চালিত আন্দোলিত
चळवळें: বিদ্রোহি বাগী বলবাই গহার
चवताळिल्लें: পাগল উন্মাদ অস্হির_মস্তিষ্ক
चवद्याण्णव: চুরানব্বুই চুরানব্বই
चवद्यात्तर: চুয়াত্তর
चांदीचें: রুপালি
चांद्र: চান্দ্র
चाटिल्लें: ভক্ষিত খাওয়া_হয়েছে_এমন ভক্ষ্য
चान्नी: চাঁদনি জ্যোত্স্না
चामाराचें: অদরকারি ফালতু মামুলি বাজে বেকার
चायनीस: চীনী
चार: চার
चार_रंगी: চাররঙ্গা
चारचाकी: চারচাকা
चारपट: চারগুন চতুর্গুণ
चारित्र्यवान: সচচরিত্র চরিত্রবান শিষ্টাচারী সুশীল
चालंत: গতিশীল সচল চলমান অস্থির অবিরাম গতিময় জঙ্গম
चालाक: চালাক চতুর হুঁশিয়ার সেয়ানা পটু চালাকচতুর প্রখরবুদ্ধি
चालू: গতিশীল সচল চলমান অস্থির অবিরাম গতিময় জঙ্গম চালিত পরিচালিত প্রচালিত কামুক কামী লম্পট বিলাসী বিষয়ী ভোগী কামচারী কামকূট লম্পট প্রোজ্জ্বল উজ্জ্বল সমুজ্জ্বল দীপ্তিযুক্ত
चाहतें: ইচ্ছিত প্রত্যাশিত অভিলাষিত ঈপ্সিত বাঞ্ছিত অভিপ্রেত প্রার্থিত সংকল্পিত আকাঙ্ক্ষিত
चिंतनहीण: অভাবনীয় অচিন্তনীয় চিন্তাতীত অকল্পনীয়
चिंतना_बगरचें: অভাবনীয় অচিন্তনীয় চিন্তাতীত অকল্পনীয়
चिंतपाचें: বিচারণীয় বিচার্য চিংতনীয় চিন্ত্য অনুশীলনীয়
चिंताजनक: চিন্তাজনক চিন্তাকর চিন্তনীয় চিন্ত্য ভাবনীয় চিন্তনযোগ্য অনুধাবনীয় শোচনীয় অনুশোচনীয় গম্ভীর
चिंताहीण: অবিচারণীয় অচিন্তনীয় অবিচার্য
चिंतेबगरची: অবিচারিত অচিন্তিত অনুহ
चिंतेस्त: চিন্তিত চিন্তাযুক্ত চিংতাগ্রস্ত
चिकित्सा: চিকিত্সা চিকিত্সা-সুল
चिकें: কম একটু ছোট অল্প অপ্রচুর অবহু সামান্য
चिखलामेकळें: কর্দমামুক্ত
चिडचिडो: চিড়চিড়ে খেয়ালী
चिडिल्लें: পদদলিত
चिड्डयिल्लें: দমিত
चित्रांकीत: চিহ্নিত অঙ্কিত সূচিত অঙ্শাঙ্কিত চিত্রিত
चित्रायिल्लें: চিহ্নিত অঙ্কিত সূচিত অঙ্শাঙ্কিত চিত্রিত
चित्रीत: চিহ্নিত অঙ্কিত সূচিত অঙ্শাঙ্কিত চিত্রিত চিহ্নিত অঙ্কিত
चिनी: চীনী চীনী
चिन्हीत: চিহ্নিত অঙ্কিত
चिप्प_भिजील्लेंप: সিক্ত ভেজা ভিজে সিঞ্চিত নিষিক্ত
चिरंजीव: অমর মৃত্যু_বিজেতা কালজয়ী কালাতীত মৃত্যুজ্ঞয় অমর্ত্য চিরজ্ঞীব চিরজ্ঞীবী চিরজীবী চিরঞ্জীব চিরঞ্জবী চিরজীবী দীর্ঘজীবী দীর্ঘায়ু আযুষ্মান চিরায়ু
चिरिल्लें: কাটা ছিন্ন খন্ডিত
चिलखता_वीण: বর্মহীণ কবচহীন কবজহীন সাঁজোয়াহীন তনুত্রাণহীন
चीनी: চিনি চিনির
चुकिल्लें: অকৃত অসম্পন্ন অসম্পাদিত
चुकीची: অনুচিত অন্যায় অন্যায্য অসংগত অসমীচীন ন্যায়বিরুদ্ধ
चुकीचें: অশুদ্ধ ভুল ভ্রান্ত অযথার্থ ত্রুটিপূর্ণ
चुरगळिल्ल्या: সংকুচিত কুঞ্চিত কুঁচকানো সংক্ষিপ্ত
चुलत: খুড়তুতো
चेंचिल्लें: পদদলিত
चेंपिल्लें: পদদলিত
चेडी: ব্যভিচারিণী কুলটা চরিত্রহীনা ছিনাল ভ্রষ্টা
चेतन: জীবিত সজীব চেতন জীবন্ত প্রাণবান জীবধারী জানদার তনুধারী
चेतनायुक्त: চেতনাযুক্ত চেতন সংজ্ঞাযুক্ত
चैत्री: চৈতি চৈতালি
चोंचरें: তোতলা তোতলা
चोंपिल्लें: হত নিহত অপহত খতম
चोरपाचें: অপরিহার্য
चोरपी: চোর পকেটমার
चोरिल्लें: অপহরণীয় অপহরণযোগ্য অপহৃত হৃত লুন্ঠিত লুঠিত অপহারিত বিহৃত অপহৃত হৃত চোরিত লুন্ঠিত অপহারিত বিহৃত অপহৃত হৃত চোরিত লুন্ঠিত অপহারিত বিহৃত
चोवीस: চৌব্বিশ
चौकस: জিজ্ঞাসিত জিজ্ঞাস্য জিজ্ঞাসনীয় জিজ্ঞাসার্হ
चौपट: চারগুন চতুর্গুণ
चौरंगी: চাররঙ্গা
छंदबद्ध: আবদ্ধ নিবদ্ধ বদ্ধ অনুবদ্ধ
छापो_मारपी: ছাপামার
छाप्पन: ছাপ্পান্ন
जंगम: সচল জঙ্গম অস্থাবর
जंगली: বন্য জঙ্গলী বুনো বনজাত বনচর বনবাসী আরণ্য জংলি অরণ্যময় অরণ্যসংকুল বনাবৃত জঙ্গলাবৃত বনময় জঙ্গুলে বন্য জংলি জঙ্গুলে বুনো জংলা বনজ বনজাত অরণ্যজাত
जखमी: ঘায়েল আহত ক্ষত জখমী অপচারিত বিদ্ধ বেধিত
जखमे_विरयतचें: অচোট অপ্রহত
जगजाहीर: সর্ব_সংজ্ঞাত সর্বজ্ঞাত
जड: ভারী ভারি ওজনদার বোঝাই গুরুত্ব ভারী গম্ভীর গভীরতা ওজন
जड_जाल्लें: ভারগ্রস্ত ভারাক্রান্ত বোঝাক্রান্ত
जप_करपी: বেওয়ারিশ মালিকহীন ছন্নছাড়া ভবঘুরে অপালিত
जप_करिनासपी: অজপা
जपानाचो: জাপানী
जपानी: জাপানী জাপানী জাপানী
जपूंक_जायनाशिल्लें: অজপা
जप्त_केल्लें: বাজেয়াপ্ত ক্রোক
जप्पी: বেওয়ারিশ মালিকহীন ছন্নছাড়া ভবঘুরে অপালিত
जप्य: আসামী
जमनींतलें: ভূ-মধ্যস্থ ভূ-গর্ভস্থ ভূমিজ ক্ষিতিজ
जमातीचें: উপজাতিয়
जयी: সফল সফলকাম সার্থক সিদ্ধ কৃতকার্য
जर्मन: জার্মান জার্মান
जलस्थलचर: উভচর জল-স্থলচর
जल्म_घेवंकना_असो: অজন্মা অজাত অসম্ভূত অনুত্পন্ন অজ স্বয়ংভূ অনাগত
जल्मजात: জন্মগত জন্মজাত
जल्मा_सावन: জন্মগত জন্মজাত
जल्मूक_नाशिल्लो: অজন্মা অজাত অসম্ভূত অনুত্পন্ন অজ স্বয়ংভূ অনাগত
जळयिल्लें: জারক জ্বলিত পোড়া
जळिल्लें: দগ্ধ পোড়া
जांतव: জৈব
जांबियायी: জাম্বিয়ার জাম্বিয়ন জাম্বিয়াই
जागरूक: জাগৃত জাগ্রত জাগ্রত্ অনিদ্রিত
जागृत: জাগৃত জাগ্রত জাগ্রত্ অনিদ্রিত
जागें: জাগৃত জাগ্রত জাগ্রত্ অনিদ্রিত
जाड: মোটা স্থূল অসূক্ষ্ম পৃথুল
जाणकार: অভিজ্ঞ অনুভবী পরিপক্ব বিদ্বান জ্ঞানী জ্ঞানবান পন্ডিত বুদ্ধ বিজ্ঞ অভিজ্ঞ বিদ্যবান সম্বুদ্ধ প্রবুদ্ধ জানকার জ্ঞাতা বিজাতা ভিজ্য
जाणटें: বৃদ্ধ বূড়া বয়স্ক
जाणा_आशिल्लें: অবগত অধিগত জ্ঞাত অবহিত বিদিত সুবিদিত বিজ্ঞাত পরিজ্ঞাত
जाणा_जाल्लें: জানকার জ্ঞাতা বিজাতা ভিজ্য
जाणाजाल्लें: অবগত অধিগত জ্ঞাত অবহিত বিদিত সুবিদিত বিজ্ঞাত পরিজ্ঞাত
जातहीण: অজাত কুজাত জাতিহীন অজাতি অপজাতি
जातिभायरें: অজাত কুজাত পামর জাতিভ্রষ্ট জাতিচ্যুত সমাজচ্যুত
जाती_बगरचो: অজাত কুজাত জাতিহীন অজাতি অপজাতি
जाती_भितरलें: সজাতীয় সমবর্গীয় সজাতি স্বজাতীয় স্বজাতি
जाती_विशींचें: জাতীয
जातीचें: জাতীয
जापसालदार: উত্তরদায়ী উত্তরাধিকারী ওয়ারিশ হকদার
जाफरानी: জাফরানি
जाबाबदार: উত্তরদায়ী উত্তরাধিকারী ওয়ারিশ হকদার
जाम: ক্ষমতাহীন অক্ষম অশক্ত শক্তিহীন অসমর্থ
जाम_जाल्लें: ক্লান্ত পরিশ্রান্ত
जायत_सावन: জন্মগত জন্মজাত
जायत्यो: অনেক কই বিবিধ নানা একাধিক কতিপয় অনেকানেক তমাম অনোগ
जाल्लें: কৃত নিষ্পন্ন নিষ্পাদিত ঘটিত
जाळयेचें: জালীদার জালদার
जाळीदार: জালীদার জালদার
जावन_गेल्लें: ঘটিত
जावायी: জাভানী জাভানী
जाहीर: অভিব্যক্ত প্রকাশিত প্রকটিত জাহির বিকশিত প্রদর্শিত প্রকট ব্যক্ত
जिखिल्लें: বিজিত জীতে_যাওয়া
जिखिल्लो: বিজেতা বিজয়ী অপধ্বংসী অভিজিত
जिज्ञासु: জিজ্ঞাসু উৎসুক
जिज्ञासू: জিজ্ঞাসিত জিজ্ঞাস্য জিজ্ঞাসনীয় জিজ্ঞাসার্হ
जिती: প্রোজ্জ্বল উজ্জ্বল সমুজ্জ্বল দীপ্তিযুক্ত
जितेंजागतें: জীবন্ত সজীব
जितो: জীবিত সজীব চেতন জীবন্ত প্রাণবান জীবধারী জানদার তনুধারী চেতনাযুক্ত চেতন সংজ্ঞাযুক্ত
जिद्दी: জেদী একগুঁয়ে গোঁয়ার
जिवंत: জীবিত সজীব চেতন জীবন্ত প্রাণবান জীবধারী জানদার তনুধারী জীবন্ত সজীব
जिवघेणें: প্রাণহারী প্রাণহারক প্রাণঘাতী জীবনান্তক
जिवी: প্রোজ্জ্বল উজ্জ্বল সমুজ্জ্বল দীপ্তিযুক্ত
जिवीक: জৈব জৈবিক
जिवीत: জীবিত সজীব চেতন জীবন্ত প্রাণবান জীবধারী জানদার তনুধারী
जिवें: জীবন্ত সজীব
जिवो: জীবিত সজীব চেতন জীবন্ত প্রাণবান জীবধারী জানদার তনুধারী চেতনাযুক্ত চেতন সংজ্ঞাযুক্ত
जीण_वाडोवपी: ভাজা
जीर्ण: জীর্ণ জর্জর
जुंव्याचें: দ্বীপীয়
जुगारी: অপকৃষ্ট নিকৃষ্ট অশ্রেষ্ট অপ্রকৃষ্ট হীন জঘন্য
जुनें: জর্জর জীর্ণ
जुल्मी: অত্যাচারী নৃশংস নিষ্ঠুর নির্দয় নির্মম ক্রূর বর্বর পীড়ক উত্পীড়ক নিগ্রহকারী নির্যাতক জুলুমবাজ জালিম
जुवळीं: যমজ জোড়া
जुवान: যুবক তরুণ
जेवणा_बगरचें: অনাহারী উপবাসী উপবাসক উপোষিত উপোসি সোপবাস উপাসি অভুক্ত ক্ষুধার্ত
जेवपाचें: খাদ্য ভোজ্য আহার্য গ্রাহ্য
जेश्ठ: অগ্রজ অগ্রজাত অগ্রজন্মা বড় বয়োজ্যেষ্ঠ জ্যেষ্ট বয়োজ্যেষ্ঠ বড় অগ্রজ
जैतवंत: সফল সফলকাম সার্থক সিদ্ধ কৃতকার্য
जैतीवंत: বিজেতা বিজয়ী অপধ্বংসী অভিজিত
जैनी: জৈন্য জৈন্য_ধর্ম
जैवीक: জৈব জৈবিক
जॉर्जियायी: জর্জিয়ান জর্জিয়াই জর্জিয়ান জর্জিয়াই
जोखप: ভেদ্য ভেদনীয়
जोडिल्लें: সংলগ্ন অনুলম্ব পাশাপাশি সন্নিহিত আদেয় আদেয় ক্ষেপক অর্জিত
जोडूंक_नाशिल्लें: অসংশ্লিষ্ট অসংলগ্ন অসম্বদ্ধ আলাদা পৃথক বিচ্ছিন্ন অসংযুক্ত অযুক্ত ভিন্ন
ज्वलंत: প্রোজ্জ্বল উজ্জ্বল সমুজ্জ্বল দীপ্তিযুক্ত
ज्वालामुखी: নরম লঘু_পাক
झगझगीत: জমকালো জাঁকজমকপূর্ণ
झगडपी: কর্কশা উগ্রা
झगडाळ: কর্কশা উগ্রা ঝগরাটে ঝগড়ুটে কলহপরায়ণ কলহপ্রিয় কলহকারী বিবাদকারী বিবাদী কর্কশ হুজ্জতি
झगडाळू: দাঙ্গাবাজ
झगडूल: কর্কশা উগ্রা
झगड्याचें: বিতর্কিত মতৈনক্
झणझणीत: কড়া
झरनासपी: না-ঝরা না-পড়া
झरयिल्लें: একঘেয়ে বৈচিত্রহীন গতানুগতিক নতুনত্ববর্জিত চিরাচরিত
झांकपी: খেপার_মতো বন্য বুনো
झिंबाबेयी: জিম্বাববেয়ন জিম্বাববিয়ান
झिपरे: কোঁকড়া কুঞ্চিত কোঁচকানো উসকোখুসকো জট-পাকানো
झिरझिरिल्ली: জর্জর জীর্ণ
झिरमिरीत: পাতলা সূক্ষ মিহি
झुजारी: রণবীর
झेंपें: মূর্খ আকাটমূর্খ মুখ্যু মূঢ় অজ্ঞ অশিক্ষিত অজ্ঞান আহাম্মক বোকা নির্বোধ অবুদ্ধি নির্বুদ্ধি বুদ্ধিহীন গবেট উজবুক
झेताचो: আকড়বাজ পেঠদার
झेमें: মূর্খ আকাটমূর্খ মুখ্যু মূঢ় অজ্ঞ অশিক্ষিত অজ্ঞান আহাম্মক বোকা নির্বোধ অবুদ্ধি নির্বুদ্ধি বুদ্ধিহীন গবেট উজবুক
झेलाचें: হিমযুক্ত বরফের
झोडिल्लें: হত নিহত অপহত খতম
टकलू: নেড়া চুলহীন
टकलो: ন্যাড়া টাক
टणक: শক্ত দৃঢ় সুদৃঢ় দ্রঢ়িষ্ঠ মজবুত টেঁকসই পোক্ত পাকাপোক্ত শক্তপোক্ত
टवटवीत: তাজা তাজা অম্লান তাজা তাজা লেটেস্ট আধুনিক অধুনাতন নতুন নব নব্য হালের
टाळपी: সংযমী সংযমকারী সংযমপরায়ণ
टाळूं_येना: অবশ্যসম্ভাবী অটল অটলনীয় অনিবার্য
टिकाकार: নিন্দক নিন্দুক নিন্দাকারী অপবাদক অপবাদকারী
टोगोली: টোগোলীয টোগোলীজ টোগোলীস
ट्युनिशियायी: টিউনিশিয়ান টিউনিশিয়াই
ट्युनीशी: টিউনিশিয়ান টিউনিশিয়াই
ठगो: লম্পট লোচ্চা বদ বদমাস বখা বখাটে পাজি নচ্ছার দুর্জন দুরাত্মা
डच: ডাচ ডাচ
डाळंबा_कोराचें: ডালিমী
डेनमार्की: ড্যানিশ ডেনমার্কী ড্যানিশ ডেনমার্কী
णव: নয়
णवपट: নয়গুণ
तंतूमय: রশযুক্ত
तंत्रांविशींचें: টেকনিক্যাল
तंत्रीक: টেকনিক্যাল
तकलेंतलें: কাল্পনিক কল্পিত কল্পনীয় মিথ্যা অপ্রকৃত অবাস্তবিক
तकलेचें: দেমাগী
तटवासी: তীরবর্তী তটবাসী তীরবাসী উপকূলবাসী
तटस्थ: নিরপেক্ষ উদাসীন পক্ষপাতরহিত অপক্ষপাতী অনপেক্ষ
तड्डकी: মিথ্যা অসত্যবাদী লবরা অনৃতভাষী অসত্যভাষী মিথ্যাভাষী অন্যবাদী অনেরা
तत्कालीक: তাত্ক্ষণিক
तत्काळीन: তত্কালীন তত্কালীন তদানীন্তন তাত্কালিক পূর্বকালীন সাবেকি
तत्पर: তত্পর কর্মতত্পর কর্মশীল উদ্যত তৈরি সক্রিয় প্রস্তুত
तत्पुरते: অস্থায়ী সাময়িক স্বল্পকালীন ক্ষণস্থায়ী স্বল্পমেয়াদি
तत्वज्ञानी: দার্শনিক বৈশেষিক
तपाची: অগ্নিজ
तपाचें: তপস্যাপ্রাপ্ত
तपाशिल्लें: অবলোকিত দৃষ্টিগত পরীক্ষিত নিরীক্ষিত সমীক্ষিত পর্যালোচিত পর্যবেক্ষিত বিচারিত
तपासणी: চিকিত্সা চিকিত্সা-সুল
तमीळ: তমিল তমিল তমিল
तयार: তৈরি তত্পর কর্মতত্পর কর্মশীল উদ্যত তৈরি সক্রিয় প্রস্তুত
तयार_करूंक_नाशिल्लें: অকৃত অনকীয়্‌অসম্পন্ন অসম্পাদিত
तयार_केल्लें: নির্মিত রচিত গঠিত প্রস্তুত সৃষ্ট সৃজিত কৃত সংরচিত
तरंगपी: ভাষা
तरणें: যুবক তরুণ
तरबेज: প্রশিক্ষিত
तर्क_नाशिल्लें: তর্কহীন তর্করহিত তর্কশূন্য যুক্তিহীন যুক্তিরহিত যুক্তিশূন্য
तर्कहीण: তর্কহীন তর্করহিত তর্কশূন্য যুক্তিহীন যুক্তিরহিত যুক্তিশূন্য তর্কাতীত অতর্ক্য তর্কাগম্য অপ্রতর্ক্য
तर्का_बगरचें: তর্কাতীত অতর্ক্য তর্কাগম্য অপ্রতর্ক্য
तर्काबगरचें: তর্কহীন তর্করহিত তর্কশূন্য যুক্তিহীন যুক্তিরহিত যুক্তিশূন্য
तर्र: মাতাল নেশাগ্রস্ত মদো মদমত্ত মদোন্মত্ত
तळा_बगरचें: অতল তলহীন তলবিহীন
तळाचें: তলীয় তলদেশীয়
तशाक_तशें: অবিকল যথাযথ সেইরকম
तांकीवंत: শক্তিশালি বলশালি বলবান শক্তিমান সবল বলিষ্ঠ
तांबशेल्लें: তেজস্বী তেজী
ताकतिकेन: দ্রুত ক্ষিপ্র ত্বরিত সবেগ দ্রুতগামী বেগবান
ताकतीक_करपी: ব্যস্তবাগিশ হড়বড়ে
ताचे_खेरीज: অতিরিক্ত
ताचे_बगर: অতিরিক্ত
ताचे_भायर: অতিরিক্ত
ताचे_शिवाय: অতিরিক্ত
ताजी: প্রোজ্জ্বল উজ্জ্বল সমুজ্জ্বল দীপ্তিযুক্ত
ताजें: তাজা টাটকা তাজা গরমাগরম তাজা তাজা তাজা টাটকা সতেজ সবুজ সজীব জীবন্ত লেটেস্ট আধুনিক অধুনাতন নতুন নব নব্য হালের
ताजें_टवटवीत: তরোতাজা
ताजो: তাজা তাজা অম্লান
तात्काळीचें: অবিলম্বিত ত্বরিত দ্রুত ক্ষিপ্র তাড়াতাড়ি
तापट: ক্রুদ্ধ ক্রোধিত ক্ষুব্ধ রাগী কুপিত ক্রোধী রাগী গরম_মেজাজ চণ্ডাল
तापिल्लें: গরম তপ্ত উত্তপ্ত আতপ্ত
ताब्यांत: অধীন আধীন
तामीळ: তমিল তমিল তমিল
तारीख_सोंपिल्लें: গতাবধিক
तिकतीकपी: আলোকিত উজ্জ্বলিত কান্তিমান চমকতা দমকতা দীপ্ত
तिक्कें: অত অতখানি অতটুকু
तिक्ष्ण: তীক্ষ্ণ প্রখর সুতীক্ষ্ণ ধারালো সূক্ষ তেজ খর তীব্র কুশাগ্র
तिखट: মুখরোচক মশলাদার ঝাল তীব্রস্বাদ ঝাঁঝালো কটুরস
तिख्याचें: ইস্পাতি ইস্পাতি ইস্পাতি
तितकें: অত অতখানি অতটুকু
तितलें: অত অতখানি অতটুকু
तिनचाकी: তে_চাকা তিন_চাকা
तिनशें: তিনশত
तिप्पट: তিনগুণ
तिबेटी: তিব্বতি তিব্বতি তিব্বতি
तिरकटी: কুভাষী খারাপ_কথা_বলে_যে
तिरसट: কর্কশ কটু কড়া কাঠখোট্টা কাটা_কাটা
तिरसुवादीक: কুভাষী খারাপ_কথা_বলে_যে
तिरायत: পর অপর অন্য ভিন্ন অনাত্মীয়
तिरायताचें: অন্য পরকীয়
तिव्र: তীক্ষ্ণ প্রখর সুতীক্ষ্ণ ধারালো সূক্ষ তেজ খর তীব্র কুশাগ্র তীব্র প্রখর প্রচণ্ড প্রবল উচ্চ জোরালো
तीख: মুখরোচক মশলাদার ঝাল তীব্রস্বাদ ঝাঁঝালো কটুরস কর্কশ কটু কড়া কাঠখোট্টা কাটা_কাটা মিহি মৃদু কোমল পাতলা সূক্ষ্ম
तीन: তিন ত্রয
तीन_कोनशांचे: মাননীয় মান্য মান্যগণ্য গণ্যমান্য সম্মাননীয় সমাদরণীয়
तीन_कोनांचे: মাননীয় মান্য মান্যগণ্য গণ্যমান্য সম্মাননীয় সমাদরণীয়
तीन_पडींचें: খজুরা খজুরী খরজুরি
तीनपडी: খজুরা খজুরী খরজুরি
तुंबिल्लें: গতিহীন স্থির গতিশূন্য গতিরহিত বেগহীন নির্বেগ অপ্রবাহিত
तुंबिल्लो: বন্ধ রুদ্ধ অবরুদ্ধ আটকা চাপা বাধাপ্রাপ্ত
तुमचें: আপনি
तुर्कस्थानी: তুর্কি তুরকি তুরস্ক-বাসী তুর্কিস্তান-বাসী
तुर्की: তুর্কি তুরকি তুর্কি তুরকি তুরস্ক-বাসী তুর্কিস্তান-বাসী তুর্কি তুরকি
तुलनात्मक: তুলনামূলক
तुळात्मक: তুলনামূলক
तुळे_भायरें: অতুল্য
तुस्ततोखणायेचें: প্রশংসিত অভিনন্দিত
तुस्तेचें: অভিন্দিত অভিনন্দিত বন্দিত
तृप्त: তৃপ্ত তুষ্ট সন্তুষ্ট খুশি তৃপ্ত আনন্দিত
तेंगशेचें: উঁচু উচ্চ উন্নত উর্ধ্ব
तेजपूर्ण: তেজোময় জাজ্বল্যমান দীপ্যমান দিব্য জ্যোতির্ময় কান্তিমান দেদীপ্যমান প্রকাশমান
तेजस्वी: তেজোময় জাজ্বল্যমান দীপ্যমান দিব্য জ্যোতির্ময় কান্তিমান দেদীপ্যমান প্রকাশমান তেজস্বী তেজী
तेजहीण: কাহিল নিস্তেজ নির্জীব নিষ্প্রান ম্রিয়মাণ নিষ্প্রভ অপ্রভ ফিকে কান্তিহীন
तेजाबी: অম্লযুক্ত
तेमकाचें: উঁচু উচ্চ উন্নত উর্ধ্ব
तेलकट: তৈলাক্ত তেলতেলে তেলা চিকন মসৃণ চকচকে তৈলাক্ত তেলতেলে তেলা তৈলাক্ত তেলতেলে তেলা চিকন মসৃণ চকচকে তেলচিটে
तेलगू: তেলুগু তেলুগু তেলেঙ্গি তেলুগু তেলেঙ্গা
तेलाचें: তৈলাক্ত তেলতেলে তেলা চিকন মসৃণ চকচকে তেলচিটে
तेलुगू: তেলুগু তেলুগু তেলেঙ্গি তেলুগু তেলেঙ্গা
तोंकाचें: উঁচু উচ্চ উন্নত উর্ধ্ব সূচালো ধারালো
तोंकाळ: সূচালো ধারালো
तोंडा_वयलें: আসন্ন সন্নিকট কাছাকাছি
तोंडाचें: মুখের_জন্য মুখ_সম্পর্কিত
तोखणायेचे: প্রশংসনীয় প্রশংস্য প্রশংসিত শ্লাঘনীয় শ্লাঘ্য অভিনন্দনীয় অভিনন্দনযোগ্য স্তুত প্রশস্ত
तोखणायेचें: অভিন্দিত অভিনন্দিত বন্দিত প্রশংসিত অভিনন্দিত
तोडीचो: তুল্য
तोतरें: তোতলা তোতলা
तोलाचें: গুরুত্ব ভারী গম্ভীর গভীরতা ওজন
त्या_काळा_वयलें: তত্কালীন তদানীন্তন তাত্কালিক পূর্বকালীন সাবেকি
त्या_काळाची: তত্কালীন
त्या_काळावयली: তত্কালীন
त्यागी: ত্যাগী অপাশ্রিত
त्याज्य: তাজ্য তাজনীয় পরিত্যাজ্য তজনীয় হেয়
त्रस्त: উত্পীড়িত পীড়িত অত্যাচারিত নিগৃহীত লাঞ্ছিত নির্যাতিত নিপীড়িত প্রতারিত গ্রাসিত গ্রস্থ
त्रासदिणी: দুঃখজনক দুঃখদায়ী দুঃখকর কষ্টদায়ক কষ্টদায়ী
त्रासाची: দুখময় দুঃখপূর্ণ দুখপূর্ণ দুখভরা
त्रासिल्लो: উত্পীড়িত পীড়িত অত্যাচারিত নিগৃহীত লাঞ্ছিত নির্যাতিত নিপীড়িত
त्रासीक: দুঃখী দুঃখিনী দুঃখার্ত দুঃখিত কাতর পীড়িত আর্ত বেদনার্ত বিষণ্ণ ব্যথিত
त्रिकोनी: মাননীয় মান্য মান্যগণ্য গণ্যমান্য সম্মাননীয় সমাদরণীয়
त्रिबुनालीन: ন্যায়_বিষয়ক ন্যায়যুক্ত
थंड: কোমল_স্বভাবী সোম সোম্য সভ্য শিষ্ট শালীন সুশীল সুব্যবহার গম্ভীর শান্ত সৌম্য ধীর স্থির অচঞ্চল অচপল অনুদ্যত বিরোধহীন ঠান্ডা ঠান্ডা শীতল সুশীতল অনুষ্ণ হিম ঠাণ্ডা শীতল হিম হিমশীতল হিমেল নিবারিত প্রশমিত শমিত ঠান্ডা শান্ত ঠান্ডা শান্ত নম্র বিনয়যুক্ত বিনীত শান্ত অচণ্ড ঠাণ্ডা অক্রুদ্ধ অক্রোধিত সন্ন সজ্ঞাশূন্য নিধেশঠ জড় অচেশষ্ট ঠান্ডা আবেগহীন আবেশবর্জিত ঠাণ্ডা শীতল স্নিগ্ধ শীতলকারক আরামদায়ক
थकपाचें: ক্লান্তিকর
थकिल्लें: ক্লান্ত পরিশ্রান্ত
थपथपिल्लें: মাখামাখি লেপটানো সিক্ত ভেজা ভিজে সিঞ্চিত নিষিক্ত
थपथपीतप: সিক্ত ভেজা ভিজে সিঞ্চিত নিষিক্ত
थरांचें: স্তরিভূত স্তরিত
थरावीक: সসীম পরিসীমিত সীমিত
थरिल्ली: নির্ণীত নির্ণিত ণির্নেয়
थळावें: দেশজ স্থানিক স্থানীয় লোকাল
थांबिल्ली: গতিহীন গতিহারা গতিরহিত স্থির অগতি
थांबिल्लें: স্থগিত থামা বন্ধ মুলতুবি স্থির গতিহীন রুদ্রনিঃশ্বাষে_অপেক্ষা_করা
थायां_पडपी: দৃশ্যমান দৃশ্য দৃষ্টিগোচর চাক্ষুষ
थायी: থাই থাই থাই থাইল্যাণ্ডি থাইল্যাণ্ড-বাসী
थारनासतना: অনবরত অবিরত সর্বদা নিত্য নিয়ত প্রায়ই নিরন্তর
थारायिल्लें: ঠিক নির্দিষ্ট নির্ধারিত নিশ্চিত নিয়ত নির্ধারিত স্থির স্থিরীকৃত নির্দিষ্ট নিশ্চিত
थारायिल्ल्या: পরিসীমিত সীমাবদ্ধ সসীম সীমাযুক্ত পরিমিত
थारावीक: নিশ্চিত
थीर: অবিচলিত অবিচল গম্ভীর শান্ত সৌম্য ধীর স্থির অচঞ্চল অচপল অনুদ্যত বিরোধহীন ঠান্ডা অটল অনঢ় অবিচল অপরিবর্তনশীল দৃঢ় স্থির স্থির অবিচলিত গতিহীন অচল শৈল স্থাবর
थीर_चित्ताचो: শান্ত ধীর স্থির প্রশান্ত অচঞ্চল স্থিরচিত্ত অবিচলিত
थेट: সোজা সহজ সিধা সিধে
थोटें: খোঁড়া ল্যাংড়া
थोडें: কম একটু ছোট অল্প অপ্রচুর অবহু সামান্য কিছু কয়েক অল্প সামান্য কিয়ত্
थोडोसो: নুন্যতম একটু সামন্য
दंगलखोर: হূল্লোরবাজ হল্লাবাজ
दंगेखोर: হূল্লোরবাজ হল্লাবাজ
दक्षिणायन: দক্ষিণায়ন দক্ষিণায়ণ
दक्षिणी: অতীন্দ্রিয় ইন্দ্রিয়াতীত অপ্রত্যক্ষ পরোক্ষ
दक्षीण_अस्तंती: দক্ষীণ-পশ্চীম দক্ষীণ-পশ্চীমী
दक्षीण_उदेंती: দক্ষীণ-পূর্ব দক্ষীণ-পূর্বী
दक्षीण_पश्चिमी: দক্ষীণ-পশ্চীম দক্ষীণ-পশ্চীমী
दक्षीण_पुर्वी: দক্ষীণ-পূর্ব দক্ষীণ-পূর্বী
दक्षीण_मध्यवर्ती: দক্ষীণ-মধ্য দক্ষীণ-মধ্যবর্তী
दक्षीणमार्गी: দক্ষিণমার্গী দক্ষিণপন্থী
दडपी: অস্তমিত
दडोवपी: অপহরনকারী
दणकट: সুগঠিত সুস্থ
दणकेबाज: জোরদার
दयाळू: দয়ালু দয়াল দয়াশীল সদয় দয়াময় দয়াবান দয়াবন্ত সহৃদয় কৃপালু কৃপাময় কারুণিক করুণাময় অকঠোর
दयेस्त: দয়ালু দয়াল দয়াশীল সদয় দয়াময় দয়াবান দয়াবন্ত সহৃদয় কৃপালু কৃপাময় কারুণিক করুণাময় অকঠোর সহানুভূতিশীল সমব্যথী সমমর্মী
दर्याचें: সমুদ্রীয় সামুদ্রিক
दर्यायी: সমুদ্রের সাগরের সামুদ্রিক সৈন্ধব
दर्शनीय: দর্শনীয় প্রেক্ষনীয় অবলেকনীয় অশোভন অদর্শনিয় অশ্লীল
दलीत: পদদলিত পদাক্রান্ত দলিত দলিত
दळडिरो: নির্ধন ধনহীন গরিব দরিদ্র দীন দীনহীন হতদরিদ্র নিঃস্ব সম্পদহীন দুস্থ সংগতিশূন্য মুফলিস বিত্তহীন কাঙাল অসম্পন্ন দলিত
दळिद्रो: নির্ধন ধনহীন গরিব দরিদ্র দীন দীনহীন হতদরিদ্র নিঃস্ব সম্পদহীন দুস্থ সংগতিশূন্য মুফলিস বিত্তহীন কাঙাল অসম্পন্ন
दांडगट: সুগঠিত সুস্থ
दांत_नाशिल्लो: দন্ত_হীন দন্ত_বিহীন বিনা_দাঁতের দাঁত_ফোকলা
दाग_आशिल्लें: দাগি
दागा_विरयत: দাগবিহীন দাগহীন
दागिल्लें: দাগি
दाट: সঘন ঘনা ঘরেরা গহন গুজান অবিকল অবিকল ঘন ঘিঞ্জি অতরল গাঢ় ঘন জমাট মোটা স্থূল অসূক্ষ্ম পৃথুল
दादलेपणाचें: পৌরুষ পুরুষত্ত্ব
दादलो: ছেলে পুরুষ
दानवीर: দানবীর
दानशूर: দাতা দানশীল দানী দানবীর উদার দানপতি দানবীর
दानी: দাতা দানশীল দানী দানবীর উদার দানপতি দানবীর
दार्शनीक: দার্শনিক
दिक्षीत: দীক্ষিত
दिखावटी: দেখানো বানানো উপরী আনুষ্ঠানিক কর্তৃত্বময় প্রবল সাড়াম্বর
दिखावू: বাঁকা তির্যক তেরছা টেড়া
दिनवाशी: কৃতজ্ঞ উপকৃত অনুগৃহীত
दिल्लें: প্রাপ্ত প্রাপ্য লব্ধ লভিত প্রাপিত উপলব্ধ সম্প্রাপ্ত সমলব্ধ অধিগত আবন্টিত অর্পিত
दिवंक_नाशिल्लें: অনাবৃত্তি
दिवंगत: মৃত মৃতক প্রয়াত স্বর্গগত স্বর্গীয় অপগত মরহুম গত তিরভৃত স্বর্গস্থ
दिवपाचें: আদেয় আদায়
दिवाणी: দেওয়ানি
दिवाळखोर: দেউলে দেউলিয়া ফতুর হৃতসর্বস্ব সর্বস্বান্ত সর্বস্বহারা
दिव्य: পারলৌকিক আমুষ্মিক অলৌকিক লোকোত্তর স্বর্গীয় স্বর্গ্য অমর্ত্য দিব্য অপার্থিব দিব্য
दिश्टी_पडपी: দৃশ্যমান দৃশ্য দৃষ্টিগোচর চাক্ষুষ
दिसपी: দৃশ্যমান দৃশ্য দৃষ্টিগোচর চাক্ষুষ
दुंदर_पानांचें: সুপর্ণ
दुकाळिल्लो: অশ্রুপূর্ণ অশ্রুযুক্ত অশ্রুপুরিত
दुखापती_बगरचे: অনাহত অক্ষত ক্ষতিহীন অনুপহত
दुखावल्लें: ঘায়েল আহত ক্ষত জখমী অপচারিত
दुख्खदिणी: দুঃখজনক দুঃখদায়ী দুঃখকর কষ্টদায়ক কষ্টদায়ী
दुख्खाची: দুঃখজনক দুঃখদায়ী দুঃখকর কষ্টদায়ক কষ্টদায়ী দুখময় দুঃখপূর্ণ দুখপূর্ণ দুখভরা
दुख्खी: শোকপূর্ণ শোকাকুল শোকগ্রস্ত উন্মনস্ক দুঃখী দুঃখিনী দুঃখার্ত দুঃখিত কাতর পীড়িত আর্ত বেদনার্ত বিষণ্ণ ব্যথিত কষ্টগ্রস্থ কাতর দুঃক্ষিত বিপন্ন
दुडवांकार: ধন্যায় ধণী আমীর দৌলতবান ধনবান মালদার ধনবত বৈবভশালী মালামাল সমুদ্রশালী ধনধ্যানপূর্ণ সম্পতিবান ধনী
दुतर्फी: দুপক্ষ দুতরফা দুনম্বরি
दुतोंडी: দুমুখো দুমুখো দুনম্বরি
दुदाळ: দুধসাদা দুধালো দুধের দুধের_মতো
दुपटें: দ্বিগুণ দুইগুন
दुबळें: পাতলা রোগা রুগণ ক্ষীণ কৃশকায় কৃশ শীর্ণ
दुबळो: ক্ষমতাহীন অক্ষম অশক্ত শক্তিহীন অসমর্থ
दुबावा_बगरचो: সন্দেহহীন সন্দেহাতীত
दुबावा_विरयत: সন্দেহহীন সন্দেহাতীত সন্দেহহীন সন্দেহাতীত সংশয়হীন নিঃসঙ্কোচ নিসঙ্কোচ সঙ্কোচহীন অসঙ্কোচী সন্দেহহীন সন্দেহাতীত সংশয়হীন সংকাহীন
दुबावी: সন্দেহ_প্রবন সম্ভ্রান্ত কুলীন
दुबावीत: আশঙ্কিত আশঙ্কাপূর্ণ দুবিধাজনক দুবিধাজনক অনিশ্চয়াত্মক ভ্রামক সংশয়াত্মক সন্দিগ্ধ সন্দেহাস্পদ সন্দিগ্ধ সন্দেহাস্পদ সন্দেহজনক সন্দেহপ্রবণ সন্দিগ্ধ
दुयेंती: রোগী অসুস্থ পীড়িত রোগগ্রস্ত রোগার্ত ব্যাধিগ্রস্ত রোগশীর্ণ আতুর রুগণ রোগকাতর
दुरंगी: দুই_রঙা
दुरीग_आशिल्लें: প্রাচীরযুক্ত প্রাচীরঅলা দেওয়ালঅলা প্রাচীরদার
दुरुस्त: যথার্থ ভালো ঠিক সঠিক যথাযথ ফিট ঠিক-ঠাক যথাযথ
दुर्गाचें: প্রাচীরযুক্ত প্রাচীরঅলা দেওয়ালঅলা প্রাচীরদার
दुर्गूण: খারাপ মন্দ বদগুণযুক্ত অপগুণযুক্ত
दुर्जन: দুর্জন দুষ্ট অধম হারামী পাজী শঠ খারাপ
दुर्बोध: দুর্বোধ্য অবোধ্য দুর্বোধ দুর্জ্ঞেয় দুর্গ্রহ জটিল দুর্গম
दुर्भागी: দুর্ভাগ্যশালী অভাগা ভাগ্যহীন মন্দভাগ্য অভাগী
दुर्मीळ: দুর্গম দুরগম্য দুরধিগম্য অগম্য অগম অগমনীয় দুস্তর অসুগম কঠিন দুর্লভ অলভ্য দুষ্প্রাপ্য অপ্রাপ্য
दुशीत: দুষিত দোষমুক্ত খারাপ অপুনিত
दुश्ट: দুর্জন দুষ্ট অধম হারামী পাজী শঠ খারাপ
दुसरें: দ্বিতীয় দোসরা পিছনের পরবর্তী অনুবর্তী
दुसर्‍यांच्या_कुडक्यांचेर_जगपी: নতুন নূতন নবীন নব্য হালের নয়া আধুনিক অপ্রাচীন অকালাতীত অপুরাতন অপুরান
दुसर्‍यांच्या_जिवार_जगपी: নতুন নূতন নবীন নব্য হালের নয়া আধুনিক অপ্রাচীন অকালাতীত অপুরাতন অপুরান
दुसर्‍याचें: অন্য পরকীয়
दुस्मानकेचो: শত্রুতাপূর্ণ বৈরপূর্ণ বৈরপূর্ণ
दुस्मानहीण: শত্রুহীন অজাতশত্রু শত্রুবিহীন অরিহীন
दुस्मानी: শত্রুপূর্ণ
दुस्वाशी: ঘৃণা_করে_যে দুর্জন দুষ্ট অধম হারামী পাজী শঠ খারাপ
दूर: দূর দূরবর্তী দূরস্থ সুদূর বিদূর৷
दृढ: অটল অনঢ় অবিচল অপরিবর্তনশীল দৃঢ় স্থির
देंवणेचें: অধোগামী
देंवतें: মন্দা কম অবনত অধোগামী ঢালু গড়ানে ক্রমনিম্ন
देंवयिल्लें: পদচ্যুত বরখাস্ত
देखघेणे: আদর্শ
देखणें: সুন্দর চারু সুচারু সুকান্ত সুকুমার অপরূপ সুদর্শন সৌম্যদর্শন রূপবান রূপবন্ত সৌম্য সুশ্রী
देगणाचें: ঢালু গড়ানে ক্রমনিম্ন
देगे_वयलें: উপতটীয় তটীয়
देगेचें: কাছের নিকটতম নিকটবর্তী নিকটস্থ সন্নিকট সমীপস্থ সমীপবর্তী
देड: ডেড়
देणें: আদেয় আদায়
देण्याचें: দেয় দেওয়ার_যোগ্য
देवा_बगरचें: অনীশ অনীশ্বর
देवाचें: দৈব দৈবী দৈবিক
देवादेणें: ঈশ্বর_প্রদত্ত ভগবান_দত্ত
देशी: দেশীয় দেশী দেশজ স্থানিক স্থানীয় লোকাল
देशी.: স্বদেশীয় দেশী স্বদেশী দেশীয় দেশজ
दैववादी: ভাগ্যবাদী প্রারব্ধবাদী দৈববাদী
दैवी: ঈশ্বরীয় ঐশ্বরিক দৈবী পরমেশ্বরী দৈবী দৈব দৈবিক ঐশী ঐশিক ঐশ্বরিক দৈব দৈবী দৈবিক দৈবী দৈবিক দৈব খুদাঈ দেবত্ত দেবদত্ত দেবদত্ত দেবত্র
दोंगराळ: পাহাড়ি পাহাড়িয়া পার্বত্য পার্বতীয় পর্বতীয় পর্বতবাসী গিরিবাসী পাহাড়ি পার্বত্য পার্বত পার্বতীয় পর্বতীয় পাহাড়ি পাহাড়িয়া পাহাড়ে পার্বতীয় পার্বত্য পর্বতজাত
दोंगरी: পাহাড়ি পার্বত্য পার্বত পার্বতীয় পর্বতীয়
दोट्टी: দোহারা দ্বিগুণ
दोट्टें: দ্বিগুণ দুইগুন
दोतर्फी: দুপক্ষ দুতরফা
दोन_कुडक्यांचें: দ্বিখন্ডিত দ্বিধাবিভক্ত দ্বিধাকৃত
दोन_तोंडांचें: দুমুখো দুমুখো
दोन_पटी: দ্বিগুণ দুইগুন
दोनभुजी: প্রতিষ্ঠিত প্রতিষ্ঠাবান বিখ্যাত খ্যাতিমান প্রসিদ্ধ সুপ্রসিদ্ধ অগ্রগণ্য গণ্যমান্য মান্য মাননীয় সম্মাননীয় সম্ভ্রান্ত নামী নামকরা স্বনামধন্য
दोनरंगी: দুই_রঙা
दोनांय_वटांतलें: দুদিক দুতরফ
दोळ्याचें: চোখের
दोशमुक्त: অপরাধ_মুক্ত নির্দোষ
दोशी: আসামী অপরাধী দোষী
द्रव: তরল
द्रवीत: দ্রবিভূত গলিত তরলিত তরলীভূত
द्राक्षा_भशेन: অঙ্গুরী
द्राक्षांचें: অঙ্গুরী অঁঙ্গুরী
द्राक्षाच्या_रंगाचें: অঙ্গুরী
द्राक्षाळ: অঙ্গুরী
द्विधाग्रस्थ: কিংকত্যর্ববিমুড়
धडधाकट: সুগঠিত সুস্থ তাগড়াই বলিষ্ঠ বলবান বলশালী লম্বা-চওড়া মোটাসোটা পুষ্ট হৃষ্টপুষ্ট নধর দশাসই বৃংহিত
धडपडो: উপদ্রবকারী উপদ্রবী অত্যাচারী বদমাস পীড়ক উত্পীড়ক নির্যাতক নিগ্রহকারী উত্ত্যক্তকারী হাঙ্গামাকারী
धडाकेबाज: জোরদার
धनवान: ধনী বড়মানুষ ওমরাও
धनी: ধনী বড়মানুষ ওমরাও ধন্যায় ধণী আমীর দৌলতবান ধনবান মালদার ধনবত বৈবভশালী মালামাল সমুদ্রশালী ধনধ্যানপূর্ণ সম্পতিবান ধনী
धन्य: কৃতার্থ কৃতার্থ ধন্য ধন্ন
धन्यवादी: কৃতজ্ঞ উপকৃত অনুগৃহীত
धरपी: ধারী
धरिल्लें: প্রজনিত
धर्मनिश्ट: ধার্মিক ধর্মশীল ধর্মী ধর্মনিষ্ঠ ধর্ম_পরায়ণ ধর্মাত্মা
धर्मार्थ: ধর্মার্থ
धर्मिक: ধার্মিক ধর্মশীল ধর্মী ধর্মনিষ্ঠ ধর্ম_পরায়ণ ধর্মাত্মা
धर्मीक: ধার্মিক
धवली: ধৌলা
धवें: শ্বেত শুভ্র সাদা উজ্জ্বল ধবল ধলা শ্বেতকায় শ্বেতাভ রজতশুভ্র
धांपिल्लो: আচ্ছাদিত ঢাকা আবৃত্ত আচ্ছন্ন
धांवडायिल्लें: পদচ্যুত বরখাস্ত বহিষ্কৃত ছেড়েদেওয় ছেড়েদেওয়া
धांवपी: অভিদ্রুত বিদ্রুত পলাতক বেপাত্তা নিরুদ্দিষ্ট নিখোঁজ
धाकटो: কনিশষ্ট
धाकलो: অনুজ ছোট অনুজন্মা অনুজাত কণিষ্ট
धाडशी: সহিষ্ণু ধৈর্যশীল ধৈর্যশালী ধৈর্যবান ধীর শান্ত ধীরস্থির অচপল সাহসী নির্ভীক অভয় ভয়শূন্য অভী৷
धाडसाचें: সাহসি সাহসপূর্ণ
धाडसी: সাহসি সাহসপূর্ণ
धाडिल्लें: রওনা রওয়ানা
धादोस: তৃপ্ত তুষ্ট সন্তুষ্ট খুশি তৃপ্ত আনন্দিত
धारण_करपी: ধারী
धारदार: তীক্ষ্ণ সুতীক্ষ্ণ চোখা ধারালো শানিত খরধার
धारी: ধারী
धारेचें: তীক্ষ্ণ সুতীক্ষ্ণ চোখা ধারালো শানিত খরধার
धार्मीक: ধার্মিক
धिमें: মন্থর অলস শিথিল মন্দ ঢিমা ধীর শ্লথ মৃদু
धिरिश्ट: সহিষ্ণু ধৈর্যশীল ধৈর্যশালী ধৈর্যবান ধীর শান্ত ধীরস্থির অচপল
धीट: সহিষ্ণু ধৈর্যশীল ধৈর্যশালী ধৈর্যবান ধীর শান্ত ধীরস্থির অচপল সাহসী নির্ভীক অভয় ভয়শূন্য অভী৷
धील: শিথিল থলথলে ঢিলা আলগা আলগা আলতো ঢিলা ঢিলে
धुगधुगीत: ঈষদুষ্ণ কবোষ্ণ নাতিশীতোষ্ণ
धुयलेलें: ধোয়া ধৌত ধোলাই
धुयिल्लें: ধোয়া ধৌত ধোলাই
धुल्लाचें: ধূলিময় ধূলিপূর্ণ ধূলিধূসর ধূলিধূসরিত ধুলাচ্ছন্ন ধূসরিত
धुल्लें: ধোয়া ধৌত ধোলাই
धुळकट: ধুলোমাখা ধুলোভর্তি ধূলিধূসর ধূলিধূসরিত ধূসরিত ধূলিমলিন ধূলিময় ধূলিপূর্ণ ধূলিধূসর ধূলিধূসরিত ধুলাচ্ছন্ন ধূসরিত
धुवंक_नाशिल्लें: অনাপ্লুত
धोंतर_न्हेशिल्लो: ধুতিওয়ালা
धोंतरकार: ধুতিওয়ালা
धोदेल: মোটা স্থূল্কায় বিরাটাকার ফোলা
धोनयो: পেটূক অত্যাহারী অতিভোজী
धोलपी: অসমর্থিত অননুমোদিত অস্বীকৃত অপলাপিত
ध्यानी: ধ্যানী ধ্যানমগ্ন ধ্যানযুক্ত
ध्वनीक: সুর ধ্বনি আওয়াজ শব্দ স্বনন ধ্বনিবিদ্যা স্বনন ধ্বনিত্ব
ध्वनीत: বাদিত ধ্বনিত শব্দিত
न_फेडी_सारकें: অদেয় দেওয়ার_অযোগ্য
नकल_करपी: অনুকারী অনুহারক অনুহারী অনুকরনকারী
नकली: নকল কৃত্তিম অপ্রকৃত বাঁকা তির্যক তেরছা টেড়া অনুকারী অনুহারক অনুহারী অনুকরনকারী সদৃশ অনুরূপ তূল্য মতন ডুপ্লিকেট
नकसूद: স্পর্শকাতর
नकारांती: সংরক্ষিত সুরক্ষিত
नकारात्मक: নেতিবাচক
नक्षिदार: নক্কাশীদার
नक्षीकाम_केल्लें: নকশাদার কারুকার্যখোচিত অলঙ্কৃত
नगरवासी: শহরী নগর_বাসী নগর_নিবাসী নগর-বাসী নগর-নিবাসী নগরনিবাসী নগরবাসী শহরাতী নাগর অগ্রাম্য পুরবাসী
नगरेंतले: শহরী নগর_বাসী নগর_নিবাসী নগর-বাসী নগর-নিবাসী নগরনিবাসী নগরবাসী শহরাতী নাগর অগ্রাম্য পুরবাসী
नग्न: নগ্ন আবরণহীন অনাবৃত নিরাবরণ উন্মুক্ত বিবস্ত্র বস্ত্রহীন
नटयिल्लें: সুসজ্জিত সজ্জিত সাজানো-গোছানো ছিমছাম ফিটফাট
नटिल्लो: সাজসজ্জা সজ্জিত
नटोवणी: সাজানো
नडणी: বুনো জঙ্গলি জংলি
नदरेक_पडपी: দৃশ্যমান দৃশ্য দৃষ্টিগোচর চাক্ষুষ
नमळायेचो: অপ্রমত্ত অনুন্মত্ত অক্ষিপ্ত প্রকৃতিস্থ অমত্ত
नमस्कार_करी_सारकें: প্রণম্য
नम्र: শান্ত অচণ্ড ঠাণ্ডা অক্রুদ্ধ অক্রোধিত
नर: ছেলে পুরুষ
नरभक्षक: মানুষখেকো নরখাদক রাক্ষস
नरम: কোমল_স্বভাবী সোম সোম্য নম্য নমনীয় বিনম্য সুনম্য
नवनिर्मीत: নবরচিত নবগঠিত নবনির্মিত নয়া নব্য নতুন নওল টাটকা
नवलकाणयेचें: ঔপন্যাসিক উপন্যাস_সম্বন্ধীয়
नवलकाणीक: ঔপ-ন্যাসিক
नवलिकेचें: ঔপন্যাসিক উপন্যাস_সম্বন্ধীয়
नवशिकें: কাঁচা নবপ্রশিক্ষিত নবশিক্ষিত অনভ্যস্ত অপটু অদক্ষ
नवशिक्षीत: কাঁচা নবপ্রশিক্ষিত নবশিক্ষিত অনভ্যস্ত অপটু অদক্ষ
नविनीकरणी: কর্কশ_মহিলা খারাপ_মহিলা
नवी: নবরচিত নবগঠিত নবনির্মিত নয়া নব্য নতুন নওল টাটকা
नवीन: নতুন নূতন নবীন নব নব্য হালের নয়া আধুনিক লেটেস্ট আধুনিক অধুনাতন নতুন নব নব্য হালের
नवे: নতুন নূতন নবীন নব নব্য হালের নয়া আধুনিক
नवेंच_शिकिल्लें: কাঁচা নবপ্রশিক্ষিত নবশিক্ষিত অনভ্যস্ত অপটু অদক্ষ
नवो: আধুনিক অর্বাচীন সাম্প্রতিক আজকের
नशिलें: পাগল মত্ত
नशीबवान: সৌভাগ্যশালী ভাগ্যবান ভাগ্যশালী
नशेचें: মাদক নেশাগ্রস্থ নেশাদার পাগল মত্ত
नश्ट: নষ্ট ধ্বংস বরবাদ বিনষ্ট সমাপ্ত প্রনষ্ট বিহত নাশপ্রাপ্ত ধসে_পড়া বিধ্বস্ত
नश्टो: ঘৃণা_করে_যে
नश्वर: নশ্বর অশাশ্বত ক্ষণজীবী ক্ষয়শীল নাশবান ভঙ্গুর বিনাশী অনিত্য
नसायहीण: ঈর্ষ্যাহীন দ্বেষহীন অদ্বেষী
नस्तार: নেতিবাচক
नांगरणे_विरयत: অজোত অপ্রহত
नांगरिल्लें: কর্ষিত কৃষ্ট
नांगरूंक_नाशिल्लें: অজোত অপ্রহত
नांमाबगरचें: বেনামী নামবিহীন
नांवाजतो: প্রসিদ্ধ নামী বিখ্যাত খ্যাতিমান অখ্যাত প্রখ্যাত
नांवादीक: প্রসিদ্ধ নামী বিখ্যাত খ্যাতিমান অখ্যাত প্রখ্যাত
नाका_जावपाचें: ক্লান্তিকর
नाकाजाल्लें: অনাবশ্যক অবাঞ্ছিত অবাঞ্ছ্নীয় নিষ্প্রয়োজন অপ্রয়োজনীয় অতিরিক্ত বাড়তি বাজে ফালতু
नाखूश: নারাজ রুষ্ট কৃতিম অপ্রসন্ন নাখুস খফা নাখুস অপ্রতীত
नागडो: নগ্ন আবরণহীন অনাবৃত নিরাবরণ উন্মুক্ত বিবস্ত্র বস্ত্রহীন
नागमोडें: সর্পিল
नागोवणेचें: অপহৃত হৃত চোরিত লুন্ঠিত অপহারিত বিহৃত
नागोवणो: লম্পট লোচ্চা বদ বদমাস বখা বখাটে পাজি নচ্ছার দুর্জন দুরাত্মা অপহারী অপহারক অপহরণকারী হারক
नाच_करपी: নৃত্যরত
नाचपी: নৃত্যরত
नाजूक: সুকুমার সুকান্ত কান্ত পেলব সুন্দর কোমল কোমলাঙ্গ নমনীয় স্নিগ্ধ কমজোরি পলকা অশক্ত ঠুনকো অমজবুত অদৃঢ্ পাতলা স্পর্শকাতর
नाटकी: নকল কৃত্তিম অপ্রকৃত আনুষ্ঠানিক নাটকীয় নাটকীয়
नात्या_बगरचें: সম্বন্ধহীন সম্বন্ধরহিত সম্বন্ধশূন্য সম্বন্ধবিহীন সম্পর্কহীন সম্পর্করহিত সম্পর্কশূন্য সম্পর্কবিহীন সংস্রবহীন সংস্রবরহিত সংস্রবশূন্য সংস্রববিহীন যোগাযোগহীন যোগাযোগরহিত যোগাযোগশূন্য যোগাযোগবিহীন
नापसंतीचें: অপ্রিয় অপ্রীতিকর অহৃদ্য অসন্তোষজনক
नापास: অনুত্তীর্ণ ফেল
नाबाद: অপ্রতিহত
नामंजुर: অস্বীকৃত অসমর্থিত অগ্রাহ্য নামঞ্জুর বাতিল
नामंजूर: অস্বীকৃত অসমর্থিত অননুমোদিত অসম্মত নামঞ্জুর অপলাপিত অস্বীকৃত অসমর্থিত বাতিল খারিজ নামঞ্জুর অগ্রাহ্য অসম্মত
नामनेचे: বিশ্ব_বিখ্যাত জগত্প্রসিদ্ধ লোক_প্রসিদ্ধ
नामनेचो: প্রসিদ্ধ নামী বিখ্যাত খ্যাতিমান অখ্যাত প্রখ্যাত
नामांकीत: মনোনিত
नारंगी: লাল
नालायक: অযোগ্য অনুপযুক্ত অপারগ অপ্রভু অকর্মণ্য অকর্মা বেকার নিষ্কর্মা অপদার্থ অকেজো অকম্মার_ঢেঁকি ঠুঁটো_জগন্নাথ অকর্মা নিষ্কর্মা অকর্মণ্য অকম্মা অপদার্থ অকেজো অযোগ্য
नावडटें: অপছন্দ অপছন্দের অমনোনীত অনির্বাচিত অমনঃপূত অপ্রিয়
नावडीचें: অপ্রিয় অপ্রীতিকর অহৃদ্য অসন্তোষজনক
नावाडगें: দুরন্ত দামাল দুষ্টু দস্যি ছটফটে অশান্ত বদমাস
नावाडगो: কুখ্যাত কুনামা কুপ্রসিদ্ধ নিন্দিত অখ্যাত দুর্নামগ্রস্ত বদনামের_ভাগী অপকৃত
नावेश: বিলুপ্ত লুপ্ত অদৃশ্য অদিষ্ট অন্তর্হিত অন্তর্হিত
नाशक: নাশক নাশী বিনাশী বিনাশক বিনায়ক বিধ্বংসী বিধ্বংসক মারক বিনষ্ট_কারক
नाशवंत: নশ্বর অশাশ্বত ক্ষণজীবী ক্ষয়শীল নাশবান ভঙ্গুর বিনাশী অনিত্য
नास्तीक: নাস্তিক অনীশ্বরবাদী নাস্তিকতাবাদী নিরীশ্বরবাদী
निंदक: নিন্দক নিন্দুক নিন্দাকারী অপবাদক অপবাদকারী
निंदा_करपी: নিন্দক নিন্দুক নিন্দাকারী অপবাদক অপবাদকারী
निंदात्मक: অপবাদমূলক নিন্দনীয় নিন্দার্হ নিন্দাজনক নিন্দাকর গর্হিত বিগর্হিত ন্যক্কারজনক কলঙ্কজনক
निखळपी: পৃথক আলাদা
निग्रही: সংযত নিয়ন্ত্রিত নিবৃত্ত প্রতিহত প্রশমিত বশীভূত পরিমিত স্পষ্ঠবক্তা স্পষ্ঠভাষী
नितळ: স্বচ্ছ মেঘহীন নিরভ্র মেঘরহীন অনাকাশ অপঘন স্পষ্ঠ সাফ পরিষ্কার পরিচ্ছন্ন পরিষ্কার পবিত্র প্রাঞ্জল সাফ সাফসুতরো শুচি শুদ্ধ অমল বিমল সুবিমল নির্মল বিশুদ্ধ অনাবিল বিশুদ্ধ শুদ্ধ পরিশোধিত
नितीक: বৈধ_কানুন বিধিমান্য বিধিক বিনীত বিনয়যুক্ত বিনয়ী বিনম্র সবিনয় সত
निनावी: বেনামী নামবিহীন
निपक्ष: নিরপেক্ষ উদাসীন পক্ষপাতরহিত অপক্ষপাতী অনপেক্ষ
निपुत्रीक: পুত্রহীন অপুত্রক নিঃসন্তান
निपूण: প্রবীণ নিপুণ সুনিপুণ দক্ষ পাকা কাবিল পটু অভিজ্ঞ পরিপক্ব সিদ্ধ পারদর্শী পারঙ্গম বিচক্ষণ যোগ্য সুযোগ্য কাবিল উপযুক্ত পারগ পারঙ্গম সক্ষম সমর্থ
निबर: ক্রূর নিষ্ঠুর নির্দয় নির্মম নিঠুর কঠোর কঠিন নৃশংস দয়াহীন করুণাহীন মমতাহীন অদয় পাষাণ নিডর অভয় নির্ভয় নির্ভীক বেডর ভয়হীন নির্ভীত নিঃশঙ্ক অপশঙ্ক কঠোর কঠিন কড়া শক্ত খর দৃঢ় অনমনীয় কঠোর কঠিন শক্ত কড়া অনমনীয় শক্ত দৃঢ় সুদৃঢ় দ্রঢ়িষ্ঠ মজবুত টেঁকসই পোক্ত পাকাপোক্ত শক্তপোক্ত কড়া কড়কড়ে শক্ত জমাট কঠোর নিষ্ঠুর নির্দয় নির্মম ন্Rরিশংস নিঠুর নিকরুণ হৃদয়হীন অকৃপ পাষাণ
निमाणें: চরম
निमाणो: কনিশষ্ট
निमाण्या: অন্তিম অন্তিম শেষ সমাস্তিক চরম অন্ত অন্ত্য
नियाळात्मक: সমালোচনামূলক
नियाळिल्लें: অবলোকিত দৃষ্টিগত
नियुक्तीत: নিযুক্ত নিয়োজিত
नियोजीत: নির্ধারিত স্থির স্থিরীকৃত নির্দিষ্ট নিশ্চিত
निरंकूश: নিরঙ্কুশ স্বেচ্ছাচারী বন্ধনহীন অসম্বাধ অপ্রতিহত অপ্রতিরোধ্য দুর্দম
निरंहकारी: নিরভিমানী অনভিমানী গর্বহীন দর্পহীন নিরহঙ্কারী অহংকারহীন দর্ভহীন
निरपराध: অদণ্ডনীয়
निरपराधी: নির্দোষ নিরপরাধ নিরপরাধী অপরাধহীন অনপরাধ অনপরাধী
निरपेक्ष: অনপেক্ষ নিরপেক্ষ বন্ধনহীন মুক্ত স্বাবলম্বী
निरभिमानी: নিরভিমানী অনভিমানী গর্বহীন দর্পহীন নিরহঙ্কারী অহংকারহীন দর্ভহীন
निरर्थक: অর্থহীন অনর্থক নিরর্থক অসংগত অহেতুক বাজে আজেবাজে খাপছাড়া নিরর্থক অনর্থক বৃথা অর্থহীন ব্যর্থ অর্থশূন্য নিষ্প্রয়োজন
निरशेल्लें: কুঠিত কুন্ঠিত
निरस: অরসিক খুষ্ক খুষ্ক
निराकार: নিরাকার অমূর্ত নিরঙ্কার অশরীরী অশারীরীক আত্মিক
निरादार: নিরাধার আধারহীন অবলম্বনহীন অনালম্ব নিরালম্ব নিরবলম্ব অনাধার অনাধাররহিত
निराधार: অসহায় নিঃসহায় সহায়হীন নিরাশ্রয় আশ্রয়হীন অনাশ্রিত সহায়সম্বলহীন অবলম্বনহীন অনাথ বেচারা তথ্যহীন অপ্রামাণিক আধারহীন নির্মূল অনাধার আধাররহিত যথার্থহীন অনবলম্ব অবলম্বনহীন সহায়হীন অসহায় নিরাশ্রয় আশ্রয়হীন নিরবলম্ব
निरावासीत: নির্বাসিত উজাড়
निराश्रीत: নিরাশ্রয় অনাশ্রয় আশ্রয়হীন অনাশ্রিত অপাশ্রয়
निराहार: অনাহারী উপবাসী উপবাসক উপোষিত উপোসি সোপবাস উপাসি অভুক্ত ক্ষুধার্ত
निरीश्वरवादी: নাস্তিক অনীশ্বরবাদী নাস্তিকতাবাদী নিরীশ্বরবাদী
निरुत्तर: নিরুত্তর জবানহীন বাকরুদ্ধ অনুত্তর
निरुपायी: অনুপায় উপায়হীন উপায়ান্তরহীন অনন্যগতি অনন্যোপায় নিরুপায় অনুপায় উপায়হীন উপায়ান্তরহীন অনন্যগতি অনন্যোপায় নিরুপায়
निरुपेगी: অনাবশ্যক অপ্রয়োজনীয় অদরকারি অনর্থক অনুপযোগী অবান্তর মূল্যহীন বেকার ফালতু
निरोगी: সুস্থ নীরোগ রোগহীন রোগশূন্য ভালো সবল
निर्गुणी: নির্গুণ গুণরহিত গুণহীন গুণশূন্য
निर्गूण: নির্গুণ
निर्जन: নির্জন জনহীন জনবিরল জনশুন্য শুনশান ফাঁকা নিভৃত বিজন নিরিবিলি নিরালা
निर्जल: নির্জলা নিরম্বু
निर्जाप: নিরুত্তর জবানহীন বাকরুদ্ধ অনুত্তর
निर्जीव: নির্জীব নিষ্প্রাণ বেজান অজীবিত জীবনহীন অজীব অপ্রাণ অপ্রাণী জড় নির্জীব অজৈব ভৌতিক অচেতন চেতনাহীন
निर्णय_जाल्ली: নির্ণীত নির্ণিত ণির্নেয়
निर्णीत: নির্ণীত নির্ণিত ণির্নেয়
निर्दयी: ক্রূর নিষ্ঠুর নির্দয় নির্মম নিঠুর কঠোর কঠিন নৃশংস দয়াহীন করুণাহীন মমতাহীন অদয় পাষাণ নিষ্ঠুর নির্দয় নির্মম ন্Rরিশংস নিঠুর নিকরুণ হৃদয়হীন অকৃপ পাষাণ
निर्देशीत: নির্দিষ্ট নির্দেশিত আজ্ঞাপিত আদিষ্ট উপদিষ্ট অনুজ্ঞাত
निर्दोश: নির্দোষ নিরপরাধ নিরপরাধী অপরাধহীন অনপরাধ অনপরাধী নির্দোষ দোষহীন দোষরহিত নিরপরাধ নির্দোষী অকলঙ্ক অকলঙ্কিত অকলঙ্কী নিষ্কলঙ্ক অকলুষ
निर्बंध: নিয়মনিষ্ঠ নিয়মানুবর্তী নিয়মী নিয়মপালক নৈয়মিক
निर्बळ: ক্ষমতাহীন অক্ষম অশক্ত শক্তিহীন অসমর্থ
निर्भय: নিডর অভয় নির্ভয় নির্ভীক বেডর ভয়হীন নির্ভীত নিঃশঙ্ক অপশঙ্ক
निर्भेळ: বিশুদ্ধ শুদ্ধ পরিষ্কার খাঁটি নির্ভেজাল নিখাদ ভেজালহীন অমিশ্রিত বাছাই পরিচ্ছন্ন পরিষ্কার পবিত্র প্রাঞ্জল সাফ সাফসুতরো শুচি শুদ্ধ অমল বিমল সুবিমল নির্মল বিশুদ্ধ অনাবিল
निर्मळ: পরিচ্ছন্ন পরিষ্কার পবিত্র প্রাঞ্জল সাফ সাফসুতরো শুচি শুদ্ধ অমল বিমল সুবিমল নির্মল বিশুদ্ধ অনাবিল
निर्माण_केल्लें: নির্মিত রচিত গঠিত প্রস্তুত সৃষ্ট সৃজিত কৃত সংরচিত
निर्माणकर्तो: সৃজনকর্তা সর্জক সৃজক রচনা_করে_যে স্রষ্টা
निर्मातो: সৃজনকর্তা সর্জক সৃজক রচনা_করে_যে স্রষ্টা
निर्मिल्लें: নির্মিত রচিত গঠিত প্রস্তুত সৃষ্ট সৃজিত কৃত সংরচিত
निर्मीत: নির্মিত রচিত গঠিত প্রস্তুত সৃষ্ট সৃজিত কৃত সংরচিত
निर्यात_करपी: নির্যাতক
निर्याती: নির্যাতক
निर्लज्ज: নির্লজ্জ লজ্জাহীন বেহায়া অলজ্জ লাজলজ্জহীন নিলাজ বেশরম লজ্জাশূন্য অকুণ্ঠিত কুণ্ঠাহীন অকুণ্ঠ অসংকুচিত নিঃসংকোচ সংকোচহীন দ্বিধাহীন
निर्वासीत: শরণার্থী নিষ্কোষিত কোষমুক্ত বিকোষ
निर्शेल्लें: উদাস উদাসীন অন্যমনা আনমনা অন্যমনস্ক বিমনা উন্মনা
निर्शेवप: হতাশা নিরাশা মায়ুস খিন্ন
निलंबीत: পদচ্যুত বরখাস্ত
निलांतीत: অতিবেগুনি_রশ্মি রঙ্গোত্তর আলট্রাভায়োলেট
निवडिल्ली: নিযুক্ত নিয়োজিত
निवलकाणयेचें: ঔপন্যাসিক উপন্যাস_সম্বন্ধীয়
निवळ: পরিচ্ছন্ন পরিষ্কার পবিত্র প্রাঞ্জল সাফ সাফসুতরো শুচি শুদ্ধ অমল বিমল সুবিমল নির্মল বিশুদ্ধ অনাবিল উজ্জ্বল উজল প্রোজ্জ্বল স্বচ্ছ সাফ পরিষ্কার স্পষ্ট বিশুদ্ধ শুদ্ধ পরিশোধিত
निवळावपी: নিবারক
निवारक: নিবারক নিবারক
निवृत्तीवेतना_विशींचें: সম্মত সম্বন্ধিত স্বীকৃত_৷
निवेदीत: নিবেদিত বর্ণিত
निव्वळ: স্পষ্ঠ সাফ পরিষ্কার
निशाणी__केल्ली: হস্তাক্ষরিত
निशाणे_बगर: হস্তাক্ষরিত দস্তখ়ত
निशाणे_विरयत: হস্তাক্ষরিত দস্তখ়ত
निशिद्ध: হারাম নিষিদ্ধ
निशुल्क: নিঃশুল্ক শুল্কমুক্ত
निश्कपट: পরিচ্ছন্ন পরিষ্কার পবিত্র প্রাঞ্জল সাফ সাফসুতরো শুচি শুদ্ধ অমল বিমল সুবিমল নির্মল বিশুদ্ধ অনাবিল
निश्कपटी: ইমানদার বিশ্বস্ত সত্ অকপটচিত্ত নিষ্কপট সজ্জন সাচ্চা
निश्कलंक: নির্দোষ দোষহীন দোষরহিত নিরপরাধ নির্দোষী অকলঙ্ক অকলঙ্কিত অকলঙ্কী নিষ্কলঙ্ক অকলুষ
निश्काम: নিষ্কাম অকাম
निश्चींत: নিশ্চিন্ত চিন্তারহিত চিন্তাহীন চিন্তামুক্ত অচিন্ত
निश्चीत: অবশ্যসম্ভাবী অটল অটলনীয় অনিবার্য ঠিক নির্দিষ্ট নির্ধারিত নিশ্চিত নিয়ত নিশ্চিত
निश्टूर: ক্রূর নিষ্ঠুর নির্দয় নির্মম নিঠুর কঠোর কঠিন নৃশংস দয়াহীন করুণাহীন মমতাহীন অদয় পাষাণ
निश्ठावान: নিষ্ঠাবান শ্রদ্ধাশীল অকলঙ্ক অকলঙ্কিত অকলঙ্কী গ্লানিহীন অকলুষ নিষ্কলঙ্ক নিষ্পাপ নির্দোষ নির্দোষী
निश्ठाहीण: নিষ্ঠাহীন
निश्पाप: পরিচ্ছন্ন পরিষ্কার পবিত্র প্রাঞ্জল সাফ সাফসুতরো শুচি শুদ্ধ অমল বিমল সুবিমল নির্মল বিশুদ্ধ অনাবিল পাপহীন নিষ্পাপ পাপরহিত নির্দোষ নিরপরাধ নিরপরাধী অপরাধহীন অনপরাধ অনপরাধী
निश्प्राण: নির্জীব নিষ্প্রাণ বেজান অজীবিত জীবনহীন অজীব অপ্রাণ অপ্রাণী
निश्फळ: নিষ্ফল বিফল ব্যর্থ অসফল অকৃতকার্য অসার্থক নিরর্থক অকৃতার্থ অফলদায়ী অফলদায়ক নিষ্কাম অকাম
निसंकोच: সন্দেহহীন সন্দেহাতীত সংশয়হীন সংকাহীন
निसंकोची: অকুণ্ঠিত কুণ্ঠাহীন অকুণ্ঠ অসংকুচিত নিঃসংকোচ সংকোচহীন দ্বিধাহীন
निसुवार्थ: নিস্বার্থ নিঃস্বার্থ
निस्तेज: মলিন_বা_ম্লান_রূপ বিশীর্ণ ক্ষীণ নিস্প্রভ ক্লান্ত পরিশ্রান্ত দুর্বল দুর্বল বল_বা_শক্তি_নেই_এমন ক্ষীণ মৃদু
नीच: ইতর অধম নিকৃষ্ঠ নীচ তুচ্ছ অসভ্য ক্ষুদ্র বাজে ওঁচা
नीच_कुळाचें: নিম্ন_কুলীন নিম্ন_বংশীয়
नुतनीकरणी: কর্কশ_মহিলা খারাপ_মহিলা
नेटाचें: প্রবল প্রচন্ড উগ্র তেজ কড়া তীব্র সুতীব্র অত্যন্ত
नेटाचो: আকড়বাজ পেঠদার
नेटान: দ্রুত ক্ষিপ্র ত্বরিত সবেগ দ্রুতগামী বেগবান
नेणटें: নাবালক অল্পবয়স্ক অপৌঢ় অপ্রাপ্তযৌবন
नेणार: অপটু অদক্ষ আনাড়ি অনিপুণ অশক্ত অপারদর্শী কাঁচা অপ্রবীণ অপরিণত অবিবকী অবিবেক বিবেকহীন নির্বিবেক অবোধ অবুঝ অবুধ বিবেকদংশনহীণ অজ্ঞাত অজানা অজানিত অপরিচিত
नेपाळी: নেপালি নেপালি নেপালবাসী নেপালি
नेम_पाळपी: নিয়মী নিয়ম_পালক আত্মানুশাসী
नेमणूक_केल्लें: অধিকারী সত্বাধিকারী
नेमा_प्रमाणें: বিহিত যথাবিহিত বিধিমতো উচিত ন্যায্য সংগত ন্যায়সংগত সঠিক সমীচীন যথার্থ
नेमिल्लें: অধিকারী সত্বাধিকারী পদস্থ পদমর্যাদাসম্পন্ন পদমর্যাদাপূর্ণ কর্তৃত্বপূর্ণ
नेमी: নিয়মী নিয়ম_পালক আত্মানুশাসী ধার্মিক ধর্মপ্রাণ_ব্যক্তি
नेमीत: বিহিত যথাবিহিত বিধিমতো উচিত ন্যায্য সংগত ন্যায়সংগত সঠিক সমীচীন যথার্থ
नैरुत्यी: দক্ষীণ-পশ্চীম দক্ষীণ-পশ্চীমী
नैसर्गीक: প্রাকৃতিক প্রাকৃত প্রকৃতিগত স্বাভাবিক নৈসর্গিক নিসর্গজ প্রকৃত অকৃত্রিম
नॉर्वेयी: নরওয়েজিয়ান নরওয়েজিয়ান
नोंदणी: পজ্ঞিকরণ পজ্ঞিভূত
नोंदिल्लें: সংরক্ষিত রক্ষিত সঞ্চিত সুরক্ষিত
नोंदीत: পজ্ঞিকরণ পজ্ঞিভূত সংরক্ষিত রক্ষিত সঞ্চিত সুরক্ষিত
न्यायालयीन: ন্যায়_বিষয়ক ন্যায়যুক্ত
न्हयकार: নেতিবাচক
न्हयकारपी: অনিচ্ছুক
न्हावंक_नाशिल्लें: অনাপ্লুত
न्हावपा_सारकें: সামুদ্রিক সামুদ্রক সাগরিক সমুদ্রজ
न्हावपाचें: সামুদ্রিক সামুদ্রক সাগরিক সমুদ্রজ
न्हिदखुरें: তন্দ্রালু তন্দ্রিত তন্দ্রিল তন্দ্রাবিষ্ট আলস্যযুক্ত
न्हिदसुरें: তন্দ্রালু তন্দ্রিত তন্দ্রিল তন্দ্রাবিষ্ট আলস্যযুক্ত
न्हेसपा_सारकें: পরিধেয় পরিধানযোগ্য ধেয়
न्हेसपाचें: পরিধেয় পরিধানযোগ্য ধেয়
पंचभुजांचें: শুষ্ক রুক্ষ জলহীন অনার্দ্র
पंचभुजी: শুষ্ক রুক্ষ জলহীন অনার্দ্র
पंचभुतांचें: ভূতসম্বন্ধীয় ভৌতিক_ঘটনা জড়জগত্সম্বন্ধীয় পঞ্চভূতসম্বন্ধীয় ভূতুড়ে ভৌতিক_কাণ্ড
पंचमासीक: পঞ্চমাসিক
पंचरंगी: পাঁচরঙা
पंजाबी: পঞ্জাবি পাঞ্জাবি পঞ্জাবি পাঞ্জাবি পঞ্জাবি পাঞ্জাবি পাঞ্জাব-বাসী পঞ্জাব-বাসী পঞ্জাবি পাঞ্জাবি
पंडीत: বুদ্ধিমান বুদ্ধিমন্ত বুদ্ধিধর ধীমান হুঁশিয়ার সমঝদার জ্ঞানী বিবেকবান বিবেচক ধীযুক্ত বিদ্বান জ্ঞানী জ্ঞানবান পন্ডিত বুদ্ধ বিজ্ঞ অভিজ্ঞ বিদ্যবান সম্বুদ্ধ প্রবুদ্ধ
पकदस्त: ভারী ভারি ওজনদার বোঝাই বাদশাহী রাজকীয় রাজোচিত
पक्कें: নিশ্চিত
पक्को: উগ্র চরমপন্থী আপসবিরোধী কট্টরপন্থী
पक्षपाती: সমর্থনকারী সমর্থক পক্ষাবলম্বী
पगारी: বৈতনিক বেতনভোগী বৃত্তিধারী বেতনধারী বৃত্তিভুক
पचकळ: খেপার_মতো বন্য বুনো
पचकें: জোলো পানসে আলুনি ফিকা
पचनाशिल्लें: দুষ্পাচ্য দুষ্পচ অপাচ্য গুরুপাক ভারী ভারি
पचपी: সুপাচ্য পাচ্য সুপচ লঘুপাক হাল্কা সহজপাচ্য
पचिल्लें: পাচিত পক্ব পরিপক্ব রন্ধিত
पच्छतापी: অনুতপ্ত অনুশোচিত পরিতপ্ত অনুশয়িত
पटेकार: বাচাল বেশি_কথা_বলা অতিকথন বকবক বাগড়াম্বরবাগবাহুল্য
पठारी: স্থলজ স্থলজাত
पडमूर: কৃতঘ্ন অকৃতজ্ঞ নিমকহারাম
पडिल्लें: উদাস উদাসীন অন্যমনা আনমনা অন্যমনস্ক বিমনা উন্মনা মন্দা কম অবনত
पणसाचें: পানস
पथी: সংযমী নিয়মী সংযমশীল
पदचारी: পথচারী পথিক পান্হ রাহি পাদবিক
पदव्युत्तरी: বিকশিত প্রস্ফুটিত প্রস্ফুট
पनवतीचो: অবনত অধোগত অধঃপতিত অপকৃষ্ট পতিত
पयलींचें: জর্জর জীর্ণ
पयलींचो: প্রথম প্রারম্ভিক প্রাথমিক পয়লা
पयलें: প্রথম অগ্র্য অনন্য একনম্বর পয়লা_নম্বর
पयशेकार: ধন্যায় ধণী আমীর দৌলতবান ধনবান মালদার ধনবত বৈবভশালী মালামাল সমুদ্রশালী ধনধ্যানপূর্ণ সম্পতিবান ধনী
पयश्यांची: আর্থিক আর্থ অর্থনৈতিক আর্থনীতিক বৈষয়িক বিত্তীয়
पयस: দূর দূরবর্তী দূরস্থ সুদূর বিদূর৷ বঞ্চিত প্রতারিত প্রবঞ্চিত ছলিত অব্যবহৃত অপ্রযুক্ত অনিযুক্ত নতুন অস্পৃষ্ট
परकें: পর অপর অন্য ভিন্ন অনাত্মীয়
परक्याचें: অন্য পরকীয়
परजळपी: আলোকিত উজ্জ্বলিত কান্তিমান চমকতা দমকতা দীপ্ত
परजिवी: অন্যাসক্ত অন্যগত আশ্রিত অবলম্বিত অধীন অন্যাধীন অন্যকৃত
परत-परत_येवपी: ঘন
परत_घेतिल्लो: বহাল পুনর্নিযুক্ত
परत_दिल्लो: বহাল পুনর্নিযুক্ত
परतायिल्लें: প্রত্যর্পিত ফেরতযোগ্য পরিশোধিত প্রতিদত্ত প্রদিষ্ট
परतिल्लें: প্রত্যর্পিত ফেরতযোগ্য পরিশোধিত প্রতিদত্ত প্রদিষ্ট বদলি পালটা
परतुपाचें: ফেরা
परतूंक_नाशिल्लें: অনাবৃত্তি
परतें: বিপরীত উল্টো বিপরীত প্রতিকুল অমান্য উল্টো বিরুদ্ধ আধো উল্টা আধোমুখ পট
परतेचें: ফেরা
परदेशी: বিদেশী বিদেশীয় ভিনদেশী পরদেশী পরবাসী দেশান্তরিত প্রবাসী বিদেশী ভিনদেশী অন্যরাষ্ট্রীয অন্যদেশীয়
परम: চরম
परमळीत: সুবাসিত অনুবাসিত
परमार्थी: তত্ত্বানুসন্ধায়ী তত্ত্বজিজ্ঞাসু
परलोकी: পারলৌকিক আমুষ্মিক অলৌকিক লোকোত্তর
परलोकीक: পারলৌকিক আমুষ্মিক অলৌকিক লোকোত্তর
परवानगे_भायरें: আজ্ঞাবিহীন অনুমতি_বিহীন
परसुवादीन: পরনির্ভর পরমুখাপেক্ষী মুখাপেক্ষী পরায়ত্ত পরনির্ভরশীল পরজীবী পরোপজীবী পরগাছা পরভৃত পরাশ্রিত পরাশ্রয়ী আশ্রিত অবলম্বিত অধীন
परस्त्रिगामी: পরদারগামী পরস্ত্রী_গামী পারদারিক
पराधीन: পরাধীন গুলাম পরতন্ত্র অন্যাধীন অপরবশ পরবশ অবশ অবস
परावर्तीत: পিছন_ঘুরে পশ্চাত্_মুখি
परावलंबी: আশ্রিত অবলম্বিত নির্ভর আধারিত অন্যাসক্ত অন্যগত আশ্রিত অবলম্বিত অধীন অন্যাধীন অন্যকৃত
परासक्त: অন্যাসক্ত অনুরাগী অনুরক্ত আসক্ত অনুষক্ত অনুরত প্রসক্ত
परिचीत: অবগত অধিগত জ্ঞাত অবহিত বিদিত সুবিদিত বিজ্ঞাত পরিজ্ঞাত
परिणामकारक: প্রভাবশালী কার্যকরী উপযোগী ফলদায়ক ফলদায়ক
परिणामी: পরিবাহক পরিবাহিত সঞ্চালিত
परित्यागी: তাজ্য তাজনীয় পরিত্যাজ্য তজনীয় হেয়
परिपक्व: অভিজ্ঞ অনুভবী পরিপক্ব পাকা পক্ব পরিপক্ব পূর্ণপক্ব সুপক্ব সিদ্ধ পুর্ণপক্ব প্রৌঢ় উর্বর পরিপক্ব
परिपूर्ण: পূর্ণ পরিপূর্ণ পরিপূরিত ভরতি ভরন্ত পূরন্ত ভরপুর ভরাভরতি
परिमाणीत: প্রমেয় পরিমেয় পরিমাপনসাধ্য
परिवर्तनशील: পরিবর্তনশীল পরিবর্তনীয পরিবর্তী
परिवर्तीत: পরিবর্ধিত বর্ধিত সম্প্রসারিত বৃদ্ধিপ্রাপ্ত বর্ধমান
परिवारांतलें: পারিবারিক ধরালু পরিবারিয়
परिसिमीत: পরিসীমিত সীমাবদ্ধ সসীম সীমাযুক্ত পরিমিত
परोपकारी: পরোপকারী পরহিতৈষী পরহিতব্রতী পরহিতাকাঙ্ক্ষী পরার্থপর
पर्यायी: বৈকল্পিক বিকল্পযুক্ত বিকল্পী ঐচ্ছিক সমানর্থক
पर्यावरणी: পারিপার্শ্বিক
पर्शियन: ইরানী পার্সিয়ান ইরানী ইরানিয়ান
पलायनवादाचें: পলায়নবাদী
पलायनवादी: পলায়নবাদী
पळयिल्लें: অবলোকিত দৃষ্টিগত অপহরণীয় অপহরণযোগ্য জ্ঞাত বিদিত অবগত পূর্বপরিচিত অভিজ্ঞাত
पळून_गेल्लो: অপসৃত
पळोवपा_सारकें: দর্শনীয় প্রেক্ষনীয় অবলেকনীয় অশোভন অদর্শনিয় অশ্লীল
पवित्र: পবিত্র পুণ্য শুদ্ধ নির্মল শুচি পাক নিরবদ্য
पसंतीचें: মনঃপূত মনের_মত পছন্দ_মত প্রিয় মনোনয়ন নির্বাচন
पसरायिल्लें: প্রসারিত বিস্তৃত প্রশস্ত প্রতত বিসারিত অত্যায়ত পরিব্যাপ্ত
पसरिल्लें: বিস্থাপিত স্থানচ্যুত ছড়ানো এলোমেলো বিকীর্ণ
पसून: জনিত জন্য
पांखां_बगरचें: ডানাহীন পক্ষহীন পাখহীন পাখনাহীন পাখাহীন কুন্তহীন পতত্রহীন পালকরহিত
पांच_पटीचें: পাঁচগুন
पांचपट: পাঁচগুন
पांचमाही: পঞ্চমাসিক
पांचरंगी: পাঁচরঙা
पांचवें: পঞ্চম পাঁচ_নম্বর
पांय_ओडपी: অপকৃষ্ট নিকৃষ্ট অশ্রেষ্ট অপ্রকৃষ্ট
पांयां_पड_सारकें: প্রণম্য
पाकिस्तानी: পাকিস্তানী
पाखाट्यांविरयत: ডানাহীন পক্ষহীন পাখহীন পাখনাহীন পাখাহীন কুন্তহীন পতত্রহীন পালকরহিত
पाचक: সুপাচ্য পাচ্য সুপচ লঘুপাক হাল্কা সহজপাচ্য
पाचवें: সবুজ সবজে তাজা টাটকা সতেজ সবুজ সজীব জীবন্ত
पाचवेंचार: সবুজ শ্যামল হরিত্ গুলজার টাটকা তাজা সতেজ সবুজ
पाचारिल्लें: সংবোধিত বিবোধিত সম্বোধ্য
पाझरप: বিগলিত গদগদ দ্রবিভূত
पाठ्य: পঠনীয় সুপাঠ্য পাঠ্য পঠ্য অধ্যয়নীয় অধ্যেয়
पाड: অপরিচ্ছন্ন অপরিষ্কৃত অপরিষ্কার মলিন কলুষিত ময়লা নোংরা অস্বচ্ছ অপবিত্র অশুদ্ধ শক্তসমর্থ পেশীবহুল জঘন্য
पाड_जाल्लें: পচা
पाडिल्लें: নিক্ষিপ্ত নিক্ষেপিত
पाडें: অপরিচ্ছন্ন অপরিষ্কৃত অপরিষ্কার মলিন কলুষিত ময়লা নোংরা অস্বচ্ছ অপবিত্র অশুদ্ধ
पाडो: ঘৃণা_করে_যে
पाण: জলীয় জলজ
पाणाविल्लो: অশ্রুপূর্ণ অশ্রুযুক্ত অশ্রুপুরিত
पातकी: অপুণ্য পাপ
पातयेवणें: আস্থাভাজন নির্ভরযোগ্য বিশ্বাসী
पातळ: অগভীর যার_মধ্যে_জলের_মাত্রা_অনেক_বেশি তরল পাতলা তরল হালকা পাতলা তরল পাতলা সূক্ষ মিহি
पातळिल्लें: ছড়ানো এলোমেলো বিকীর্ণ ব্যাপী
पात्र: যোগ্য সুযোগ্য উপযুক্ত উপযোগী যথাযোগ্য
पानगळी: পর্ণমোচী পতঝড়ী
पानझडी: পর্ণমোচী পতঝড়ী
पानाळ: পর্ণী পল্লবিত
पापहीण: পাপহীন নিষ্পাপ পাপরহিত
पापी: পাপী পাপিষ্ঠ পাপাত্মা অধম অনাচারী পতিত পাতকী নীচ অধার্মিক ম্লেচ্ছ্ পামর মহাপাপী মহাপাতক ঘোরপাপী
पारपांरीक: পারম্পরিক পরম্পরাগত পারম্পরিক
पार्थीव: পার্থিব
पालविल्लें: নিবারিত প্রশমিত শমিত ঠান্ডা শান্ত
पालेल्लें: পল্লবিত
पाळिल्लें: পালতু ঘরেলু
पाव: পোয়া সিকি চতুর্থ চার_সংখ্যক চার_সংখ্যার_পূরক
पावणे_दोनशें: একশপচাত্তর ১৭৫
पावन: কৃতার্থ ধন্য ধন্ন
पावयिल्लें: মেটানো চোকানো
पावली_घालपी: চলন্ত চলমান সচল
पावली_मारपी: চলন্ত চলমান সচল
पावसा_विणें: না-ঝরা না-পড়া
पावसा_विरयत: না-ঝরা না-পড়া
पाशाणी: শুখা শুখো করকরে শুকনো
पाश्चात्य: পাশ্চাত্য পশ্চিমি পচ্ছিমী
पाश्च्यात्य: পশ্চিমী পচ্ছিমী
पास: উত্তীর্ণ পাস পারিত পাস
पिंजिल्लें: জীর্ণ-শীর্ণ ফটা-পুরানা ঘিসা_পিটা ঘিসা-পিটা
पिकसावं: চিন্তিত চিন্তাযুক্ত চিংতাগ্রস্ত
पिकाळ: উর্বর উর্বরা আবাদি চষা কর্ষিত উর্বর
पिकिल्लें: পাকা পক্ব পরিপক্ব পূর্ণপক্ব সুপক্ব সিদ্ধ
पिकें: পাকা পক্ব পরিপক্ব পূর্ণপক্ব সুপক্ব সিদ্ধ
पिचो: পাগল উন্মত্ত উন্মাদ মত্ত খ্যাপা বাউরা বাওরা
पिडिल्लें: প্রতারিত
पिडिल्लो: উত্পীড়িত পীড়িত অত্যাচারিত নিগৃহীত লাঞ্ছিত নির্যাতিত নিপীড়িত
पिडीत: ব্যথিত পীড়িত দুঃখিত আর্ত শোকার্ত গৌরবময়
पिडेस्त: রোগী অসুস্থ পীড়িত রোগগ্রস্ত রোগার্ত ব্যাধিগ্রস্ত রোগশীর্ণ আতুর রুগণ রোগকাতর দুঃখী দুঃখিনী দুঃখার্ত দুঃখিত কাতর পীড়িত আর্ত বেদনার্ত বিষণ্ণ ব্যথিত গ্রাসিত গ্রস্থ
पित्ताचें: পৈত্তিক পৈত্ত
पियेनासपाचें: অপেয়
पिशें: পাগল পাগলা উন্মত্ত উন্মাদ মত্ত খ্যাপা বাউরা বাওরা বাতুল অপ্রকৃতিস্থ বিকৃতমস্তিষ্ক ছিটিয়াল মানসিক_ভারসাম্যহীন দেওয়ানা
पिसांट: মূর্খ আকাটমূর্খ মুখ্যু মূঢ় অজ্ঞ অশিক্ষিত অজ্ঞান আহাম্মক বোকা নির্বোধ অবুদ্ধি নির্বুদ্ধি বুদ্ধিহীন গবেট উজবুক
पिसाट: পাগল উন্মত্ত উন্মাদ মত্ত খ্যাপা বাউরা বাওরা
पिसावल्लें: পাগল উন্মাদ অস্হির_মস্তিষ্ক
पुजनीय: পূজনীয় উপাসনীয় উপাস্য অর্চনীয পূজ্য বন্দনীয় বন্দ্য বন্দনীয় আরাধ্য আরাধনীয় স্তুত্য অভিবন্দনীয় অভিবন্দ্য
पुजपा_सारकी: পূজনীয় উপাসনীয় উপাস্য অর্চনীয পূজ্য বন্দনীয় বন্দ্য বন্দনীয় আরাধ্য আরাধনীয় স্তুত্য অভিবন্দনীয় অভিবন্দ্য
पुजा_केल्लें: পুজিত পূজ্য আরাধিত উপাসিত অর্চিত পূজনীয়
पुजिल्लें: পুজিত পূজ্য আরাধিত উপাসিত অর্চিত পূজনীয়
पुज्य: পূজনীয় উপাসনীয় উপাস্য অর্চনীয পূজ্য বন্দনীয় বন্দ্য বন্দনীয় আরাধ্য আরাধনীয় স্তুত্য অভিবন্দনীয় অভিবন্দ্য দেমাগী অহঙ্কারপূর্ণ পূজনীয়া পূজ্যা বন্দনীয়া পূজনীয় পূজ্য বন্দনীয়
पुण्य: শুভজনক হিতকর মাঙ্গল্য মাঙ্গলিক শুভদ ক্ষেমকর
पुण्यवान: পুণ্যাত্মা পুণ্য_কর্তা পুণ্যকর্মা পুণ্যকর্মী পুণ্যবান পুণ্যবান্ ধর্মাত্মা
पुण्यहीण: অপুণ্য পাপ
पुण्यात्मो: পুণ্যাত্মা পুণ্য_কর্তা পুণ্যকর্মা পুণ্যকর্মী পুণ্যবান পুণ্যবান্ ধর্মাত্মা
पुत्र_वत्सल: বৎসল
पुनरावृत्तीचें: সম্মত সম্বন্ধিত স্বীকৃত_৷
पुनरुक्त: পুনরুক্ত পুনরাবৃত্ত
पुनर्नियुक्ती: বহাল পুনর্নিযুক্ত
पुनर्स्थापीत: প্রতিস্থাপিত
पुरक: পূরক সম্পুরক
पुराणीक: পৌরাণিক পৌরাণ পুরাণীয
पुरातात्वीक: পুরাতাত্ত্বিক পৌরাণিক পুরাতাত্ত্বিক
पुराय: আনন্দী সদানন্দ পুরো সম্পূর্ণ আদ্যপান্ত সমগ্র সব সমুদায় সমুদয় সমস্ত পুরো সম্পূর্ণ সমগ্র সব সমুদয় সমস্ত গোটা আস্ত অখণ্ড অখণ্ডিত পুরো সম্পূর্ণ সমগ্র সব সমুদয় সমস্ত সকল সমুচয় তামাম সর্ব অখিল সম্পূর্ণ পুরো ভরপুর সার্বিক সামগ্রিক পূর্ণ পরিপূর্ণ ভর্তি
पुरुशी: পৌরুষ পুরুষত্ত্ব
पुरूश: ছেলে পুরুষ
पुरो_जाल्लें: ক্লান্ত পরিশ্রান্ত
पुरो_जावपाचें: ক্লান্তিকর
पुर्तगाली: পর্তুগালী পর্তুগীস
पुर्तुगेझ: পর্তুগালী পর্তুগীস
पुर्वापार: পৈতৃক পৈত্রিক পৈত্র পুরুষানুক্রমিক পারিবারিক মৌরুসি
पुर्विल्लें: প্রাচীন প্রত্ন পুরোনো পুরাতন পুরাকালীন পূর্বকালীন সাবেকি আদিম প্রাচীন পুরোনো পুরাতন পুরাকালীন পূর্বকালীন আদিম প্রাগৈতিহাসিক
पुर्विल्लो: প্রথম প্রারম্ভিক প্রাথমিক পয়লা
पुश्ट: পুষ্টিকর পুষ্টিদায়ক বলবর্ধক বলদায়ক বলকারক শক্তিবর্ধক স্বাস্থ্যকর
पुश्टीक: পৌষ্টিক পুষ্টিদায়ক
पुसट: অস্পষ্ট অপ্রতীত
पुस्तकाकार: চৌকোনা চারকোনা চৌকো ক্ষেত্রাকৃতি
पुस्तकी: বই_সম্বন্ধীয় পুস্তকীয় পূস্তক_সম্বন্ধীয়
पूर्ण: পুরো সম্পূর্ণ আদ্যপান্ত সমগ্র সব সমুদায় সমুদয় সমস্ত পুরো সম্পূর্ণ সমগ্র সব সমুদয় সমস্ত গোটা আস্ত অখণ্ড অখণ্ডিত পুরো সম্পূর্ণ সমগ্র সব সমুদয় সমস্ত সকল সমুচয় তামাম সর্ব অখিল পূর্ণ পরিপূর্ণ ভর্তি
पूर्णप्रभावीत: অভিভূত আপ্লুত
पृश्ठ: পিছনের পশ্চাদবর্তী পিছনস্ত অনুবর্তী পরবর্তী
पृश्ठांकीत: পৃষ্ঠাঙ্কিত
पेंवपी: সাঁতারু
पेज: খেপার_মতো বন্য বুনো
पेज_पडिल्लें: ভারগ্রস্ত ভারাক্রান্ত বোঝাক্রান্ত
पेझाद: শক্তিশালি বলশালি বলবান শক্তিমান সবল বলিষ্ঠ
पेटयिल्लें: প্রজ্বলিত জ্বলন্ত প্রদীপ্ত জ্বলত্
पेटिल्लें: হত নিহত অপহত খতম
पेय: পেয় পানীয় পানযোগ্য
पेयहीण: অপেয়
पॉझिट्रॉन: সংরক্ষিত সুরক্ষিত রক্ষিত
पॉलिशा_बगरचें: অগঠিত অকর্তিত নাকাটা অখন্ড অখন্ডিত
पोंदलें: নিম্ন
पोकळ: ফাঁপা ফাঁকা
पोको: ফাঁপা ফাঁকা
पोजडें: অশ্লীল কামুকতাপূর্ণ গন্দা
पोटभर: ভরপেট
पोटयो: পেটূক অত্যাহারী অতিভোজী
पोर: দোগলা দোগলা সংকর হরামি হরামজাদা হরামজাদা
पोरणें: জর্জর জীর্ণ প্রাচীন প্রত্ন পুরোনো পুরাতন পুরাকালীন পূর্বকালীন সাবেকি আদিম প্রাচীন পুরোনো পুরাতন পুরাকালীন পূর্বকালীন আদিম প্রাগৈতিহাসিক অতীত বিগত গত পুরোনো অতিক্রান্ত বীত অপগত সমতীত
पोल: ফাঁপা ফাঁকা
पोलिशी: পোল্যান্ডীয় পোলেস পোলিশ
पोलो: ফাঁপা ফাঁকা
पोशिल्लें: পালতু ঘরেলু
पोशेगवाली: বাস্ত্র বস্ত্রাবৃত বাসিত বসনাবৃত
प्रकाशी: দ্যোতক পরিচায়ক প্রকাশক প্রদর্শক
प्रकाशीत: প্রকাশিত প্রকাশিত প্রকটিত স্ফুট পরিষ্ফুট স্ফুটিত বিকশিত
प्रक्षेपक: নিক্ষেপক ক্ষেপক
प्रखर: তীক্ষ্ণ প্রখর সুতীক্ষ্ণ ধারালো সূক্ষ তেজ খর তীব্র কুশাগ্র
प्रगट: অভিব্যক্ত প্রকাশিত প্রকটিত জাহির বিকশিত প্রদর্শিত প্রকট ব্যক্ত প্রকাশিত প্রকটিত প্রকট আবির্ভূত স্ফুট পরিস্ফুট
प्रगतिशील: উন্নত বিকশিত সুবিকশিত
प्रगतीकर्तो: প্রগতিশীল উন্নতিশীল প্রগতিবাদী প্রগতিপন্থী অগ্রগামী
प्रचलीत: চালিত পরিচালিত প্রচালিত প্রচলিত চালু চলিত বহুপ্রচলিত চলতি প্রবর্তিত
प्रचारक: প্রচারক
प्रचारीत: প্রচারিত
प्रजातंत्री: প্রজাতন্ত্রীয় গনতান্ত্রিক লোকতান্ত্রিক
प्रजातंत्रीक: প্রজাতাণত্রিক প্রজাতণত্রীয় প্রজাতণত্রী
प्रजोत्पादक: প্রজনক
प्रतिद्वंद्वी: প্রতিদ্বংদী প্রতিদ্বন্দ্বী প্রতিস্পর্ধী প্রতিযোগী স্পর্ধী স্পর্দ্ধী
प्रतिध्वनीत: প্রতিধ্বনিত অনুনাদিত
प्रतिपादीत: বাচ্য অভিধেয়
प्रतिभावान: প্রতিভাশীল প্রতিভাবান প্রতিভাসম্পন্ন জহীন
प्रतिभाशाली: প্রতিভাশীল প্রতিভাবান প্রতিভাসম্পন্ন জহীন
प्रतिरुपी: প্রতিরূপী অনুরূপী সমরূপী
प्रतिश्ठीत: গন্য গন্যমান বিশিষ্ট বিশেষ সুপ্রতিষ্ঠ সুপ্রতিষ্ঠিত
प्रतिस्थापीत: প্রতিস্থাপিত
प्रतिस्पर्धक: প্রতিদ্বংদী প্রতিদ্বন্দ্বী প্রতিস্পর্ধী প্রতিযোগী স্পর্ধী স্পর্দ্ধী
प्रतीसर्तक: প্রতিদ্বংদী প্রতিদ্বন্দ্বী প্রতিস্পর্ধী প্রতিযোগী স্পর্ধী স্পর্দ্ধী
प्रत्यक्ष: প্রত্যক্ষ সাক্ষাত্ নয়নগোচর দৃশ্যমান প্রতীয়মান৷
प्रथम: প্রথম অগ্র্য অনন্য একনম্বর পয়লা_নম্বর
प्रदर्शीत: প্রদর্শিত প্রদর্শিত
प्रदुशीत: দুষিত প্রদুষিত দুষিত দোষমুক্ত খারাপ অপুনিত
प्रभावकारी: ফলদায়ক
प्रभावशाली: প্রভাবশালী প্রভাবযুক্ত প্রতিপত্তিশীল প্রতাপী
प्रभावहीण: প্রভাবহীন
प्रभावी: প্রভাবশালী প্রভাবযুক্ত প্রতিপত্তিশীল প্রতাপী প্রভাবশালী কার্যকরী উপযোগী ফলদায়ক ফলদায়ক
प्रभावीत: প্রভাবিত
प्रमाणीत: প্রমাণিত প্রত্যয়িত সত্যপ্রতিপাদিত প্রমাণিত প্রমাণীকৃত প্রতিপন্ন প্রমাণভূত প্রতিপাদিত প্রমাণিত প্রমাণসিদ্ধ প্রমাণীকৃত প্রতিপাদিত
प्रमाणें: সমান তুল্য বরাবর স্পষ্ট সদৃশ
प्रमेयी: প্রমেয় প্রমাণসিদ্ধ প্রমাণনির্ভর প্রতিপাদনীয় প্রমেয় প্রামাণ্য প্রমাণসিদ্ধ
प्रयत्नशील: প্রযাসশীল প্রযত্নশীল প্রযাসী প্রযত্নী প্রযত্নবান উদ্যমী উদ্যমশীল উদ্যোগী
प्रवासी: প্রবাসী প্রবসিত বিদেশবাসী দেশান্তরিত প্রবাসী প্রবসিত বিদেশবাসী দেশান্তরিত
प्रवेशीत: প্রবিষ্ট আগত প্রবেশিত
प्रशंसक: প্রশংসক প্রশংসী
प्रशस्त: সুন্দর অনবদ্য অতুলনীয় রাজসিক রাজোচিত নান্দনিক প্রশস্ত
प्रशासनीक: প্রশাসনিক
प्रशिक्षीत: প্রশিক্ষিত
प्रसन्न: প্রসন্ন সুপ্রসন্ন আনন্দিত প্রফুল্ল উল্লসিত উত্ফুল্ল আহ্লাদিত পুলকিত হর্ষিত হৃষ্ট প্রমোদিত
प्रसन्नचित्त: প্রসন্নচিত্ত প্রসন্ন আনন্দিত প্রফুল্ল উল্লসিত
प्रसारीत: সম্প্রচার সম্প্রচারিত
प्रसिद्ध: প্রসিদ্ধ নামী বিখ্যাত খ্যাতিমান অখ্যাত প্রখ্যাত বিশ্ব_বিখ্যাত জগত্প্রসিদ্ধ লোক_প্রসিদ্ধ
प्रस्तावीत: প্রস্তাবিত আলোচিত আলোচ্য
प्राकृतीक: প্রাকৃতিক প্রাকৃত প্রকৃতিগত স্বাভাবিক নৈসর্গিক নিসর্গজ প্রকৃত অকৃত্রিম
प्राचीन: প্রাচীন প্রত্ন পুরোনো পুরাতন পুরাকালীন পূর্বকালীন সাবেকি আদিম
प्राणघातक: প্রাণহারী প্রাণহারক প্রাণঘাতী জীবনান্তক
प्राथमीक: আরম্ভিক প্রারম্ভিক প্রারম্ভকালীন প্রাথমিক উপক্রমিক গোড়াকার
प्राप्त: উপার্জিত অর্জিত লব্ধ প্রাপ্ত হস্তগত প্রাপিত আপ্ত অধিগত করায়ত্ত
प्राप्त_केल्लें: প্রাপ্ত প্রাপ্য লব্ধ লভিত প্রাপিত উপলব্ধ সম্প্রাপ্ত সমলব্ধ অধিগত
प्रामाणीक: আস্থাভাজন নির্ভরযোগ্য বিশ্বাসী ইমানদার বিশ্বস্ত সত্ অকপটচিত্ত নিষ্কপট সজ্জন সাচ্চা
प्रायोगीक: প্রয়োগাত্মক প্রায়োগিক
प्रायोजीत: প্রাযোজিত
प्रारब्दवादी: ভাগ্যবাদী প্রারব্ধবাদী দৈববাদী
प्रासंगीक: প্রাসঙ্গিক প্রসঙ্গ-সম্বন্ধী
प्रेमपूर्ण: বেহিসাব অপরিমিত
प्रेममय: বেহিসাব অপরিমিত
प्रेमासक्त: প্রেমাসক্ত প্রণয়াসক্ত অনুরাগী অনুরক্ত অনুরাগযুক্ত আসক্ত অনুরত
प्रेरक: প্রেরক প্রেষক প্রেরয়িতা
प्रेरीत: অনুপ্রাণিত প্রণোদিত প্রাণিত
प्रोत्साहीत: অনুপ্রাণিত প্রণোদিত প্রাণিত
प्रौढ: পুর্ণপক্ব প্রৌঢ় উর্বর পরিপক্ব
फकत: কেবল স্রেফ শুধু শুধুমাত্র অদ্বিতীয়
फकिरी: ফকিরি ফকীরী ফকীরের_মতন
फटकिरें: মিথ্যা অসত্যবাদী লবরা অনৃতভাষী অসত্যভাষী মিথ্যাভাষী অন্যবাদী অনেরা মিথ্যা অসত্য মিছা ঝুট ঝুটা ভুয়া ভুয়ো অনৃত অতথ্য অপ্রকৃত
फटकीरपणाचें: মিথ্যা অসত্য মিছা ঝুট ঝুটা ভুয়া ভুয়ো অনৃত অতথ্য অপ্রকৃত
फटाश्यो_मारपी: বাচাল বেশি_কথা_বলা অতিকথন বকবক বাগড়াম্বরবাগবাহুল্য
फटींग: মিথ্যা অসত্যবাদী লবরা অনৃতভাষী অসত্যভাষী মিথ্যাভাষী অন্যবাদী অনেরা তথ্যহীন অপ্রামাণিক আধারহীন নির্মূল অনাধার আধাররহিত যথার্থহীন অসভ্য অভদ্র অশিষ্ঠ অভব্য বেয়াদব আচারহীন লম্পট লোচ্চা বদ বদমাস বখা বখাটে পাজি নচ্ছার দুর্জন দুরাত্মা বেইমান ধোঁকাবাজ ধূর্ত চালবাজ চালু চতুর চালাক হুঁশিয়ার শঠ ধড়িবাজ মন্দমতি ধাঁপ্পাবাজ ছলনাকারী
फटीचें: মিথ্যা অসত্য মিছা ঝুট ঝুটা ভুয়া ভুয়ো অনৃত অতথ্য অপ্রকৃত কল্পিত মনগড়া আকাশকুসুম মিথ্যা অসত্য মিছা ভুয়া ভুয়ো ঝুটা
फटोवणेचें: অপহৃত হৃত চোরিত লুন্ঠিত অপহারিত বিহৃত
फडफडीत: তাজা তাজা অম্লান তাজা তাজা লেটেস্ট আধুনিক অধুনাতন নতুন নব নব্য হালের
फरारी: ফেরার পলায়িত পলাতক
फळदिणें: ফলদ ফলদায়ক ফলদায়ী ফলপ্রদ ফলপ্রসূ
फळां_दिवपी: ফলদায়ী ফলদায়ক
फळां_नाशिल्ले: অফল অফলিত ফলহীন ফলবিহীন ফলরহিত
फळां_लागपी: ফলদায়ী ফলদায়ক
फळां_लागिल्लें: ফলদার ফলবান
फळांचें: ফলদার ফলবান
फळादीक: সফল সফলকাম সার্থক সিদ্ধ কৃতকার্য
फांकिल्लें: ছড়ানো এলোমেলো বিকীর্ণ
फांफार्रांव: ধৃষ্ট উচ্ছৃঙ্খল অভদ্রচিত অশালীন অশোভন বেয়াড়া উদ্ধত
फाकिवंत: প্রসিদ্ধ নামী বিখ্যাত খ্যাতিমান অখ্যাত প্রখ্যাত
फाटलें: পিছনের পশ্চাদবর্তী পিছনস্ত অনুবর্তী পরবর্তী পরবর্তী
फाटलो: প্রথম প্রারম্ভিক প্রাথমিক পয়লা
फाटल्या: অতীত বিগত গত পুরোনো অতিক্রান্ত বীত অপগত সমতীত
फाटल्यान: অপ্রত্যক্ষ পরোক্ষ ইন্দ্রিয়াতীত
फाटल्यानचें: অকথিত অনূক্ত অবিবৃত অবর্ণিত অব্যক্ত অধ্বনিত
फाटीं_सरनासपी: অপরাজিত অজিত অপরাভূত অপরাহত অদমিত অপরাস্ত৷ অপরাজিত অজিত অপরাভূত অপরাহত অদমিত অপরাস্ত৷
फाटीचें: ত্রুটিপূর্ণ জাল অচল নকল দুনম্বরি কৃত্রিম
फातराळ: ছিদ্রান্বেষী দোষগ্রাহী দোষদর্শী ছিদ্রদর্শী ছলগ্রাহী দোষোরোপকারী বিদূষক
फाफडिल्लें: প্রসারিত বিস্তৃত প্রশস্ত প্রতত বিসারিত অত্যায়ত পরিব্যাপ্ত
फाफशिल्लें: ছড়ানো এলোমেলো বিকীর্ণ
फामाद: প্রসিদ্ধ নামী বিখ্যাত খ্যাতিমান অখ্যাত প্রখ্যাত সুপ্রসিদ্ধ সুবিখ্যাত সুখ্যাত অভিবিশ্রুত বিশ্ব_বিখ্যাত জগত্প্রসিদ্ধ লোক_প্রসিদ্ধ
फायद्याचें: লাভদাযক লাভপ্রদ লাভকর লাভকারী লাভজনক গুণকারী উপযোগী হিতকারী
फारायल्लें: অপহৃত হৃত চোরিত লুন্ঠিত অপহারিত বিহৃত
फारायिल्लें: অপহরণীয় অপহরণযোগ্য
फारावपी: চোর পকেটমার অপহারী অপহারক অপহরণকারী হারক
फाराविल्लो: আটকানো বদ্ধ বাঁধা
फारीक_करिनासपा_सारकें: অদেয় দেওয়ার_অযোগ্য
फारीक_करूंक_नाशिल्लें: বাকি বকেয়া পাওনা
फारीक_करून_घेतिल्लें: ভুক্ত
फारीक_केल्लें: মেটানো চোকানো
फारीक_ना_करी_सारकें: অদেয় দেওয়ার_অযোগ্য
फालतू: অর্থহীন অনর্থক নিরর্থক অসংগত অহেতুক বাজে আজেবাজে খাপছাড়া অনাবশ্যক অপ্রয়োজনীয় অদরকারি অনর্থক অনুপযোগী অবান্তর মূল্যহীন বেকার ফালতু ইতর অধম নিকৃষ্ঠ নীচ তুচ্ছ অসভ্য ক্ষুদ্র বাজে ওঁচা অনাবশ্যক অবাঞ্ছিত অবাঞ্ছ্নীয় নিষ্প্রয়োজন অপ্রয়োজনীয় অতিরিক্ত বাড়তি বাজে ফালতু নিরর্থক অনর্থক বৃথা অর্থহীন ব্যর্থ অর্থশূন্য নিষ্প্রয়োজন
फाल्गुनी: ফাগুন ফাল্গুন ফাগ
फावोशें: উচিত ন্যায্য সংগত ঠিক সঠিক যোগ্য যথোচিত সমুচিত যথার্থ উপযুক্ত যোগ্য সুযোগ্য উপযুক্ত উপযোগী যথাযোগ্য অনুকূলিত
फिकें: রংহীন বর্ণহীন বর্ণশূন্য হাল্কা ফিকে অনুজ্জ্বল ফ্যাকাসে
फिटफिटें: কমজোরি পলকা অশক্ত ঠুনকো অমজবুত অদৃঢ্ পাতলা
फिन: বুদ্ধিমান বুদ্ধিমন্ত বুদ্ধিধর ধীমান হুঁশিয়ার সমঝদার জ্ঞানী বিবেকবান বিবেচক ধীযুক্ত
फिनलॅण्डी: ফিনল্যান্ডী ফিনিশ ফিনলান্ডী
फिरकेचें: প্যাঁচানো পাকানো
फिलिपियन: ফিলিপিনি ফিলিপিনো
फिलिपीनी: ফিলিপিনো ফিলিপাইনস
फिल्मी: ফিল্মী নাটুকে
फिशाल: যোগ্য সুযোগ্য কাবিল উপযুক্ত পারগ পারঙ্গম সক্ষম সমর্থ বুদ্ধিমান বুদ্ধিমন্ত বুদ্ধিধর ধীমান হুঁশিয়ার সমঝদার জ্ঞানী বিবেকবান বিবেচক ধীযুক্ত
फिशाळ: জানকার জ্ঞাতা বিজাতা ভিজ্য
फीट: ছোট চাপা হ্রস্ব অল্পক অল্পস্বল্প ক্ষুদ্র সংক্ষিপ্ত মাপমতো মাপসই ফিট ফিট ঠিক-ঠাক যথাযথ
फुकट: নিঃশুল্ক শুল্কমুক্ত
फुक्याचें: অনর্থক অফল অফলদায়ক নিষ্ফল ব্যর্থ ফালতু
फुटें: হাল্কা ফিকা পানসে জোলো
फुडलें: পিছনের পরবর্তী অনুবর্তী
फुडलो: সামনের সন্মুখের সন্মুখবর্তী সন্মুখস্থ অগ্রবর্তী অগ্রিম পূর্ব পুরোগামী পুরোবর্তী অগ্রগামী অগ্রগত অগ্রবর্তী
फुडल्या: ভাবী আগামী হবু অনাগত ভবিষ্য উত্তরকালীন
फुडाराचें: ভবিষ্যতের আগামীকালের ভাবী আগামী অনাগত ভবিতব্য
फुलां_बगरचें: পুষ্পহীন অপুষ্পিত পুষ্প_রহিত কুসুমরহিত
फुलांचें: পুষ্পিত পুষ্পময় কুসুমিত ফুলন্ত ফুলদার ফুল-কাটা ফুলদার ফুল-তোলা
फुलांनी_भरिल्लें: পুষ্পিত কুসুমিত পুষ্পযুক্ত
फुलिल्लें: পুষ্পিত কুসুমিত ফুলন্ত ফুল্ল প্রস্ফুটিত প্রফুল্লিত প্রস্ফুটিত স্ফুটিত প্রস্ফুট পুষ্পিত পুষ্পময় কুসুমিত ফুলন্ত ফুলেল হুলদার
फुलूंक_नाशिल्लें: অপুষ্পিত অনখিলা অবিকশিত মুকুলিত অফুল্ল
फुश्यारी_मारपी: বাচাল বেশি_কথা_বলা অতিকথন বকবক বাগড়াম্বরবাগবাহুল্য
फॅल: অনুত্তীর্ণ ফেল
फेडिनासपा_सारकें: অদেয় দেওয়ার_অযোগ্য
फेसाळ: ফেনিল
फॉरेन: বিদেশী ভিনদেশী অন্যরাষ্ট্রীয অন্যদেশীয়
फोडपी: খণ্ডক ছেদক কর্তক কর্তনকারী কৃন্তক ছেত্তা
फोर्त: শক্ত দৃঢ় সুদৃঢ় দ্রঢ়িষ্ঠ মজবুত টেঁকসই পোক্ত পাকাপোক্ত শক্তপোক্ত ভালো খুব_ভালো চমত্কার বেশ বেশ_ভালো ঠিকঠাক
फोलगी: অপব্যয়ী অতিব্যয়ী
फोल्गी: অপব্যযী ব্যয়শীল অতিব্যয়ী অতি-ব্যয়ী ব্যয়ী বিলাসী আয়েসি বিলাসপরায়ণ বিলাসপ্রিয় ভোগবিলাসী আরামপ্রিয় সুখী শৌখিন রঙ্গিলা স্ফূর্তিবাজ
फौजी: ফৌজী
फ्रान्सी: ফ্রেন্চ ফরাসী
फ्रेंच: ফরাসী ফ্রেন্চ ফ্রান্সের_ভাষা ফ্রেন্চ ফরাসী
फ्रेन्च: ফরাসী ফ্রেন্চ ফ্রান্সের_ভাষা ফ্রেন্চ ফরাসী
बंगाली: বঙ্গীয় বঙ্গদেশীয় বাঙালি বাংলা বাঙালি বঙ্গবাসী বঙ্গদেশবাসী বাংলাদেশবাসী বাংলা বাঙলা বাঙ্গলা বঙ্গীয়
बंजारा: পরিব্রাজক পরিক্রমণকারী প্রব্রাজক পরিযায়ী বাঞ্জারা
बंडखोर: বিদ্রোহি বাগী বলবাই গহার
बंद: বন্ধ রুদ্ধ অবরুদ্ধ আটকা চাপা বাধাপ্রাপ্ত বন্ধ রুদ্ধ আবদ্ধ আটকা অর্গলিত
बंद_केल्लें: স্থগিত থামা বন্ধ মুলতুবি স্থির গতিহীন
बंदखणीचे: কারাগারের জেলখানার
बकासूर: পেটূক অত্যাহারী অতিভোজী
बकें: রোগা কৃশ শীর্ণ ক্ষীণ ছিপছিপে রোগা-পাতলা
बचत_केल्लें: সংগৃহীত সঞ্চিত পূঞ্জিত সংহৃত রক্ষিত
बडबडे: বাচাল অতিভাষী মুখর বাক_চপল
बडबडेचें: অর্থহীন অনর্থক নিরর্থক অসংগত অহেতুক বাজে আজেবাজে খাপছাড়া
बडबडो: খেপার_মতো বন্য বুনো
बडयिल्लें: হত নিহত অপহত খতম
बडाय_मारपी: বাচাল বেশি_কথা_বলা অতিকথন বকবক বাগড়াম্বরবাগবাহুল্য
बडीची: পৈতৃক পৈত্রিক পৈত্র পুরুষানুক্রমিক পারিবারিক মৌরুসি
बडीचें: বংশগত বংশানুক্রমিক বংশপরম্পরায় বংশপরম্পরাগত পৈতৃক পারিবারিক
बदनामिकारक: অপবাদমূলক নিন্দনীয় নিন্দার্হ নিন্দাজনক নিন্দাকর গর্হিত বিগর্হিত ন্যক্কারজনক কলঙ্কজনক
बदलनासपी: অপরিবর্তনীয় অপরিবর্তনশীল
बदलपी: পরিবর্তনশীল পরিবর্তনীয পরিবর্তী
बदिस्त: আবদ্ধ নিবদ্ধ বদ্ধ অনুবদ্ধ
बनावट: দেখানো বানানো উপরী নকল কৃত্তিম অপ্রকৃত কল্পিত মনগড়া আকাশকুসুম
बरयल्लें: কাগজী কাগজী
बरयल्लो: লিখিত লিপিবদ্ধ অঙ্কিত লেখা
बरयिल्लें: নথিকৃত
बरी: উত্কৃষ্ট অত্যুত্কৃষ্ট উত্তম শ্রেষ্ঠ সেরা প্রকৃষ্ট প্রশস্ত বিশাল বড় ভারী বিরাট
बरें: ভালো বেশ_ভালো ভদ্র শিষ্ট শালীন শ্লীল মার্জিত রুচিসম্পন্ন চিকিৎসা সাধ্য স্বাদযুক্ত স্বাদিষ্ঠ মুখরোচক উপাদেয় উপভোগ্য সুস্বাদু সরস রসাল খাসা দিব্য ভালো সু
बरें_जायना__अशें: অচিকিৎস্য চিকিৎসাতীত দুস্সাধ্য অসাধ্য
बरो: সজ্জন সুজন ভদ্র সভ্য সুভদ্র শিষ্ট ভব্য সভ্যভব্য সুশীল সুশীলা নম্র বিনয়ী উত্তমতর সর্বশ্রেষ্ঠ সর্বত্তোম উত্কৃষ্ট ভালো খুব_ভালো চমত্কার বেশ বেশ_ভালো ঠিকঠাক
बरोबर: ঠিক সঠিক যথার্থ অভ্রান্ত নির্ভুল শুদ্ধ ত্রুটিহীন
बरोवन_दवरपा_सारकें: উল্লেখনীয় উল্লেখ্য উল্লেখযোগ্য
बर्फाळ: হিমযুক্ত বরফের
बर्मी: বর্মী বর্মা-বাসী বর্মী বর্মীয় বর্মী বর্মীয়
बर्‍या_कुळाचें: কুলীন খানদানী আর্য
बर्‍या_घराण्यांतलें: কুলীন খানদানী আর্য
बलदंड: সুবাহু বলিষ্ঠ দীর্ঘবাহু
बल्ल: মোটা স্থূল্কায় বিরাটাকার ফোলা
बळकट: সুগঠিত সুস্থ
बळवर्धक: পুষ্টিকর পুষ্টিদায়ক বলবর্ধক বলদায়ক বলকারক শক্তিবর্ধক স্বাস্থ্যকর
बळादीक: শক্তিশালি বলশালি বলবান শক্তিমান সবল বলিষ্ঠ
बळिश्ट: শক্তিশালি বলশালি বলবান শক্তিমান সবল বলিষ্ঠ শক্ত দৃঢ় সুদৃঢ় দ্রঢ়িষ্ঠ মজবুত টেঁকসই পোক্ত পাকাপোক্ত শক্তপোক্ত সুগঠিত সুস্থ
बशिल्लें: সওয়ার আরূঢ়
बहिश्कृत: বহিষ্কৃত ছেড়েদেওয় ছেড়েদেওয়া বহিষ্কৃত ছেড়েদেওয় ছেড়েদেওয়া
बांदिल्लें: নির্মিত রচিত গঠিত প্রস্তুত সৃষ্ট সৃজিত কৃত সংরচিত
बाकी: দেয় বকেয়া দাতব্য দায়
बाकीचें: বকেয়া বাকী শেষ
बागवल्लें: অবনত নত
बाजारांतलें: বাজারূ বাজারী
बाजाराचें: বাজারূ বাজারী
बाजारी: বাজারূ বাজারী
बाद: অকর্মণ্য অকর্মা বেকার নিষ্কর্মা অপদার্থ অকেজো অকম্মার_ঢেঁকি ঠুঁটো_জগন্নাথ শক্তসমর্থ পেশীবহুল
बाद_जावंक_नाशिल्लें: অপ্রতিহত
बापायचें: পৈতৃক পৈত্রিক পৈত্র পিত্র্য
बापोल: খুড়তুতো
बायजणपणाचें: এটা এইটা ইনি যিনি যে
बायलांचें: মেয়েলী
बायलाडें: এটা এইটা ইনি যিনি যে
बायलेचे: সে সেটা ওটা তিনি ঐ
बारामाही: চিরহরিৎ বারোমাসে_পাওয়া_যায়_এমন সবসময়_সবুজ বারোমাসে_পাওয়া_যায়_এমন
बारीक: রোগা কৃশ শীর্ণ ক্ষীণ ছিপছিপে রোগা-পাতলা সূক্ষ অণু ক্ষুদ্র আণুবীক্ষণিক সূক্ষাতিসূক্ষ সূক্ষ নিপুণ নিখুঁত পাতলা রোগা রুগণ ক্ষীণ কৃশকায় কৃশ শীর্ণ ছোট ছোট্ট
बारीक-सारीक: ছোটো_খাটো অল্প_বিস্তর হালকা_ফুলকা
बाळंटेर: একমাত্র
बाविल्लें: কাহিল নিস্তেজ নির্জীব নিষ্প্রান ম্রিয়মাণ নিষ্প্রভ অপ্রভ ফিকে কান্তিহীন মলিন_বা_ম্লান_রূপ বিশীর্ণ ক্ষীণ নিস্প্রভ ক্লান্ত পরিশ্রান্ত দুর্বল উদাস উদাসীন অন্যমনা আনমনা অন্যমনস্ক বিমনা উন্মনা মলিন_বা_ম্লান_রূপ বিশীর্ণ ক্ষীণ নিস্প্রভ ক্লান্ত পরিশ্রান্ত দুর্বল নিস্প্রভ মলিন_বা_ম্লান_রূপ বিশীর্ণ ক্ষীণ ক্লান্ত পরিশ্রান্ত দুর্বল
बावीस: বাইশ
बाश्पीत: বিশুদ্ধপরিশ্রুত
बाह्य: বাহ্য বাহ্যিক বহিঃস্থ বহিস্থ বাইরের বহিরঙ্গ
बिंधास्त: পাগল উন্মাদ খ্যাপ্‌মত্ত প্রমত্ত
बिकट: বিপরীত প্রতিকুল অমান্য উল্টো কঠিন সুকঠিন দুরূহ গভীর মুশকিল জটিল বিকট প্রচণ্ড গূঢ়
बिनकांटयारें: কন্টকহীন অকন্টক শূলহীন
बिनपावशी: না-ঝরা না-পড়া
बी: আদি
बीन: আদি
बीनविरोध: অবিরোধী অবিরুদ্ধ নির্বিরোধ
बुडा_विरयत: অতল তলহীন তলবিহীন
बुडिल्लें: জলমগ্ন প্লাবিত
बुडिल्लो: অস্তগত অস্ত অস্তমিত
बुड्डिवपी: নোচু খিমচিবুড়ো
बुदवंत: বুদ্ধিজীবী বুদ্ধিমান বুদ্ধিমন্ত বুদ্ধিধর ধীমান হুঁশিয়ার সমঝদার জ্ঞানী বিবেকবান বিবেচক ধীযুক্ত বিদ্বান জ্ঞানী জ্ঞানবান পন্ডিত বুদ্ধ বিজ্ঞ অভিজ্ঞ বিদ্যবান সম্বুদ্ধ প্রবুদ্ধ
बुद्दिजिवी: বুদ্ধিজীবী
बुद्दीक: বুদ্ধিক মানসিক
बुद्दीहीण: বুদ্ধিহীন মতিহীন নির্বুদ্ধি আহন্মক আকাট অগা গবেট নিরেট অপ্রতিভ
बुन्यादीक: মৌলিক স্বকৃত মুল অননুকৃত বুনিয়াদী বংশীয়
बुरशें: অপরিচ্ছন্ন অপরিষ্কৃত অপরিষ্কার মলিন কলুষিত ময়লা নোংরা অস্বচ্ছ অপবিত্র অশুদ্ধ অশ্লীল কামুকতাপূর্ণ গন্দা
बुराकाची: ছিদ্রযুক্ত রন্ধ্রযুক্ত
बेकार: অকর্মণ্য অকর্মা বেকার নিষ্কর্মা অপদার্থ অকেজো অকম্মার_ঢেঁকি ঠুঁটো_জগন্নাথ খালি কর্মহীন কর্মশূন্য
बेकारलवडी: অকর্মণ্য অকর্মা বেকার নিষ্কর্মা অপদার্থ অকেজো অকম্মার_ঢেঁকি ঠুঁটো_জগন্নাথ
बेगडी: দেখানো বানানো উপরী নকল কৃত্তিম অপ্রকৃত বাঁকা তির্যক তেরছা টেড়া আনুষ্ঠানিক কর্তৃত্বময় প্রবল সাড়াম্বর
बेगीन: দ্রুত ক্ষিপ্র ত্বরিত সবেগ দ্রুতগামী বেগবান
बेघर: আবাসহীন আশ্রয়হীন গৃহহীন
बेचव: জোলো পানসে আলুনি ফিকা
बेचैन: উদ্বিগ্ন উদগ্রীব উদ্বেল উত্কন্ঠিত উতলা ব্যাকুল আকুল
बेजार: নারাজ রুষ্ট কৃতিম অপ্রসন্ন নাখুস খফা নাখুস অপ্রতীত হতাশা নিরাশা মায়ুস খিন্ন
बेजारदिणें: উদাসীন্ উন্মনা উদাস্ নির্লিপ্ত আপনভোলা বেখেয়াল৷
बेजारिल्लें: ক্লান্ত
बेजोड: বেজোড় জোড়হীন বিজোড়
बेताल: বেসুরো তালবিহীন বেতাল
बेदाग: দাগবিহীন দাগহীন
बेधडक: অকুণ্ঠিত কুণ্ঠাহীন অকুণ্ঠ অসংকুচিত নিঃসংকোচ সংকোচহীন দ্বিধাহীন
बेनुल्ल: নতুন নূতন নবীন নব্য হালের নয়া আধুনিক অপ্রাচীন অকালাতীত অপুরাতন অপুরান
बेपरवाय: বেপরোয়া বিন্দাস অচিন্ত
बेपर्वाय: উপেক্ষাকারী উদাসীন অমনোযোগী অকৃতজ্ঞ
बेपर्वाहीत: অনাদৃত উপেক্ষিত অবহেলিত পরাকৃত
बेफिकीर: পাগল উন্মাদ খ্যাপ্‌মত্ত প্রমত্ত
बेबदड: মদ্যপ মদখোর মাতাল মদ্যপায়ী মাদকসেবী পানাসক্ত মাতাল নেশাগ্রস্ত মদো মদমত্ত মদোন্মত্ত
बेबदो: মদ্যপ মদখোর মাতাল মদ্যপায়ী মাদকসেবী পানাসক্ত মদ্যপ মদখোর মাতাল মদ্যপায়ী মাদকসেবী পানাসক্ত মাতাল নেশাগ্রস্ত মদো মদমত্ত মদোন্মত্ত
बेमुदत: অবধিহীন অশেষ
बेयमान: কৃতঘ্ন অকৃতজ্ঞ নিমকহারাম বেইমান
बेलगाम: লাগামছাড়া বল্গাহীন উদ্দাম বন্ধনহীন অসংযত অনিয়ন্ত্রিত
बेलरसी: বেলারুশী বেলারুশিয়ান বেলারুশীয় বেলারুশিয়ান
बेल्जियन: বেলজিয়াম
बेल्जियमी: বেলজিয়াম বেলজিয়ান_ফ্রেন্চ
बेवारशी: অনাথ এতিম বেওয়ারিশ মাতাপিতাহীন মাতৃপিতৃহীন বেওয়ারিশ মালিকহীন ছন্নছাড়া ভবঘুরে বেওয়ারিশ মালিকহীন
बेशुद्ध: বেহুঁশ্ মূর্ছিত অচৈতন্য চেতনাহীন অচেতন অজ্ঞান জ্ঞানশূন্য সংজ্ঞাহীন খেয়ালহীন সন্ন সজ্ঞাশূন্য নিধেশঠ জড় অচেশষ্ট
बेसावध: অসবধান অসতর্ক গাফিলতি
बेसूर: বেসুরো তালবিহীন বেতাল
बोंडें: মূর্খ আকাটমূর্খ মুখ্যু মূঢ় অজ্ঞ অশিক্ষিত অজ্ঞান আহাম্মক বোকা নির্বোধ অবুদ্ধি নির্বুদ্ধি বুদ্ধিহীন গবেট উজবুক
बोडको: পত্রহীন নিষ্পত্র ন্যাড়া অদল
बोधक: দ্যোতক সূচক বোধক বাচক বাচ্য অভিধেয় ব্যকরণ
बोध्य: বোধ্য বোধগম্য আসান সরল সুগম
बोलकें: মুখর বাঙ্ময়
बोसनियन: বসনীয় বসনীয়
बौद्ध: বৌদ্ধ
बौद्ध_धर्मावलंबी: বৌদ্ধ_ধর্মাবলম্বী বৌদ্ধ
बौद्धीक: বুদ্ধিক মানসিক
ब्रह्मज्ञानी: অধ্যাত্মতত্ত্ববিদ ব্রহ্মজ্ঞানী সিদ্ধ অধ্যাত্মজ্ঞ
ब्रिटीश: বৃটিশ বৃটেনমূলক ব্রিটিশ
भंगीत: ভগ্ন ভাঙ্গা বিচ্ছিন্ন বিখন্ডি
भंगुर: ভঙ্গুর
भंयकर: ভয়ংকর ভয়ানক প্রচণ্ড উগ্র বিকট ভীষণ ভয়াল ভয়াবহ রুদ্র করাল ভীতিপ্রদ ভীতিকর ভয়ার্ত ভয়দ উচ্চণ্ড ভীষণ ভয়ানক অত্যধিক অত্যন্ত প্রচণ্ড প্রবল ঘোরতর
भंयभीत: ভয়ুকে কাতর আতঙ্কিত ভয়গ্রস্থ ভয়াম্বিত ভীত ডরা অপগ্রস্থ দহসাতজদা দহসাতজদা
भक्तीहीण: অভক্ত ভক্তিশূন্য
भक्ष्य: খাদ্য ভোজ্য আহার্য গ্রাহ্য
भटकें: উড়োন্চণ্ডী ভবঘুরে ভ্রম ফিরাফিরি
भटा_बगरचें: অব্রহ্মণ্য
भडक: উত্তেজক উত্তেজনাপ্রদ ভডকদার জমকালো জাঁকজমকপূর্ণ
भड्डें: মোটা স্থূল্কায় বিরাটাকার ফোলা
भड्डो: দুরদুরা
भयंकर: দারুণ
भयांकृत: ক্রূর নিষ্ঠুর নির্দয় নির্মম নিঠুর কঠোর কঠিন নৃশংস দয়াহীন করুণাহীন মমতাহীন অদয় পাষাণ ভয়ংকর ভয়ানক প্রচণ্ড উগ্র বিকট ভীষণ ভয়াল ভয়াবহ রুদ্র করাল ভীতিপ্রদ ভীতিকর ভয়ার্ত ভয়দ উচ্চণ্ড
भयानक: আক্রামক আক্রামকতাপূর্ণ ভয়ংকর ভয়ানক প্রচণ্ড উগ্র বিকট ভীষণ ভয়াল ভয়াবহ রুদ্র করাল ভীতিপ্রদ ভীতিকর ভয়ার্ত ভয়দ উচ্চণ্ড
भरड: দুরদুরা
भरदस्त: ভারী ভারি ওজনদার বোঝাই
भरपूर: অত্যাধিক প্রচুর অধিক অনেক অটুট বিপুল বহুত অধিক অতিশয় অগাধ অনেক অতি প্রচুর সম্পূর্ণ পুরো ভরপুর সার্বিক সামগ্রিক ভরপুর ভরতি পূর্ণ পরিপূর্ণ
भरवण: বিলীন অদৃশ্য অদৃষ্টিগোচর অদৃষ্টয়মান নাদেখা অন্তরহিত
भरिल्लें: পূর্ণ পরিপূর্ণ পরিপূরিত ভরতি ভরন্ত পূরন্ত ভরপুর ভরাভরতি মেটানো চোকানো ভরা ভর্তি মাখামাখি লেপটানো ভরতি পূর্ণ পুরা পরিপূর্ণ
भलायकी_वाडोवपी: স্বাস্থ্যকর স্বাস্থ্যদায়ক
भलायकेक_बरें: স্বাস্থ্যপ্রদ আরোগ্যপ্রদ নীরোগকর
भलायकेवंत: সুস্থ নীরোগ রোগহীন রোগশূন্য ভালো সবল
भलें: ভালো বেশ_ভালো
भव्य: অতিকায় বৃহদাকার ভীমাকৃতি স্থূলকায়৷ বিশাল বৃহৎ বৃহদ বিরাট বড় বিশাল প্রকাণ্ড বৃহত্ বৃহদাকার প্রকাণ্ড এমনি সুন্দর অনবদ্য অতুলনীয় রাজসিক রাজোচিত নান্দনিক প্রশস্ত বড় বৃহত্ বিশাল
भशेन: সমান তুল্য বরাবর স্পষ্ট সদৃশ তদনুরূপ তদাকার
भस्म: ভস্ম ভস্মীভূত ভস্মিত
भांगरा_पसून_तयार_केल्ली: স্বর্ণ সোনা অমূল্য অপরিহার্য ধন্সম্পদ স্বর্ণ_নির্মিত সোনালি দামি গুরুত্বপুর্ণ
भांगराची: স্বর্ণ সোনা অমূল্য অপরিহার্য ধন্সম্পদ স্বর্ণ_নির্মিত সোনালি দামি গুরুত্বপুর্ণ
भांगराळें: সোনালী স্বর্নালী হেমবর্ণ কনকবরণ সুবর্ণ সুবর্ণময় স্বর্ণময় সোনালি
भागपी: বিভাজক খণ্ডক বিভাজনকারী
भाग्यशाली: সৌভাগ্যশালী ভাগ্যবান ভাগ্যশালী
भाजिल्लें: ভাজা দগ্ধ পোড়া
भाट: প্রশংসক প্রশংসী
भाटकारवादी: সামন্তবাদী সামন্ততন্ত্রিক ফিউডাল সামন্তবাদী ফিউডাল
भाटकारशायी: সামন্তবাদী সামন্ততন্ত্রিক ফিউডাল
भाटकारी: সামান্ততান্ত্রিক
भाड्याच्यो: করযুক্ত
भानगडींचें: ঝঞ্ঝাটপূর্ণ ঝামেলাদায়ক গোলমেলে ঝকমারি
भायराविल्लें: বহিষ্কৃত ছেড়েদেওয় ছেড়েদেওয়া
भायरें: বহিষ্কৃত ছেড়েদেওয় ছেড়েদেওয়া
भायलें: বাহ্য বাহ্যিক বহিঃস্থ বহিস্থ বাইরের বহিরঙ্গ বিদেশী ভিনদেশী অন্যরাষ্ট্রীয অন্যদেশীয় পর অপর অন্য ভিন্ন অনাত্মীয় ওপরের উপরের বাইরের বাহিরের বহিরঙ্গ
भायलो: বিদেশী বিদেশীয় ভিনদেশী পরদেশী পরবাসী দেশান্তরিত প্রবাসী
भायल्याचें: অন্য পরকীয়
भारी: গুরুত্ব ভারী গম্ভীর গভীরতা ওজন
भाळावपी: মোহিনী মোহময়ী বিমোহিনী
भावपूर्ण: ভাবপুর্ণ মার্মিক ভাবানাত্মক ভাবনাপুর্ণ হৃদয়স্পর্শি
भाविल्लें: মনঃপূত মনের_মত পছন্দ_মত প্রিয় মনোনয়ন নির্বাচন
भावी: ভাবী আগামী হবু অনাগত ভবিষ্য উত্তরকালীন
भावूक: ভাবুক ভাবপ্রবণ ভাবালু ভাববিলাসী ভাবগ্রাহী রোমান্টিক
भाशीक: ভাষীয ভাষিক
भाशेचें: ভাষীয ভাষিক
भिकुणा_कोराचें: ছারপোকারঙা বাদামী
भिकुणांचें: ছারপোকাযুক্ত মত্কুণযুক্ত শয্যাকীটযুক্ত
भिकुणाच्या_कोराचें: ছারপোকারঙা বাদামী
भिजिल्लें: ভেজা ভিজে আর্দ্র সিঞ্চিত সিক্ত নিষিক্ত অভিষিক্ত জলসিক্ত
भिडेस्त: লাজুক লজ্জাশীল মুখচোরা লজ্জাবতী লাজবন্তী লজ্জাশীলা লজ্জিত লজ্জালু লজ্জামান অপ্রতিভ সংকুচিত কুণ্ঠিত কুণ্ঠাযুক্ত দ্বিধাগ্রস্ত বিহ্বল লজ্জিত
भितरले: আন্তরিক অন্তর্বর্তী অন্তরঙ্গ আন্তরীণ অন্তরিত অন্তর্নিহিত
भितरें: সংকুচিত কুণ্ঠিত দ্বিধাগ্রস্ত
भिन्नरुपी: ভিন্নরূপী বিষমরূপী
भियेल्लो: আতঙ্কিত ত্রস্ত ভয়াক্রান্ত সন্ত্রস্ত ভয়াতুর ভয়াকুল
भिरांकूळ: আক্রামক আক্রামকতাপূর্ণ ভয়ংকর ভয়ানক প্রচণ্ড উগ্র বিকট ভীষণ ভয়াল ভয়াবহ রুদ্র করাল ভীতিপ্রদ ভীতিকর ভয়ার্ত ভয়দ উচ্চণ্ড
भिल्ली: ভীলী
भिसाचें: কোঁকড়া কুঞ্চিত কোঁচকানো উসকোখুসকো জট-পাকানো
भुंयगत: আত্মগোপনকারী ফেরার
भुंयेंतलें: ভূ-মধ্যস্থ ভূ-গর্ভস্থ
भुकेल्लो: ক্ষুধার্ত ক্ষুধিত ক্ষুধাতুর
भुकेस्त: ক্ষুধার্ত ক্ষুধিত ক্ষুধাতুর পেটুক ঔদরিক ভোজনবিলাসী
भुतकाळ: অতীত বিগত গত পুরোনো অতিক্রান্ত বীত অপগত সমতীত
भुतकाळीन: ভূতকালের অতীত_কালের পূর্ব_কালের
भुताचें: ভূত_বিষয়ক
भुताटकेचें: ভূত_বিষয়ক
भुतानी: ভুটানী ভুটানী ভটানের_বাসিন্দা ভুটিয়া ভুটানী_ভাষা
भुमितीक: হিংসক হিংসাপরায়ণ ঈর্ষাপরায়ণ পরশ্রীকাতর হিংস্র ঘাতক বর্বর নৃশংস
भुमीगत: আত্মগোপনকারী ফেরার
भुरगें: নাবালক অল্পবয়স্ক অপৌঢ় অপ্রাপ্তযৌবন
भुरगेंपणाचें: বালকোচিত বালকসুলভ
भुरग्यांचें: শিশুসুলভ ছেলেমানুষি
भुरळ_घालपी: মোহিনী মোহময়ী বিমোহিনী
भुलयणें: আকর্ষণীয় রমণীয় আকর্ষক চিত্তাকর্ষক মনোরম মঞ্জু মঞ্জুল সুন্দর মনোহর মনোহারী চিত্তহারী মনোলোভা
भुलोवपी: আকর্ষণীয় রমণীয় আকর্ষক চিত্তাকর্ষক মনোরম মঞ্জু মঞ্জুল সুন্দর মনোহর মনোহারী চিত্তহারী মনোলোভা মোহিনী মোহময়ী বিমোহিনী
भुसभुशीत: ভুরভুরা
भूक_वाडोवपी: রুচিকর রুচিকারক
भेदक: ভেদকারক ভেদকারী ভেদক ছেদক
भेदनीय: বেধ্য ভেদ্য বেধনীয় ভেদনীয়
भेदपी: ভেদকারক ভেদকারী ভেদক ছেদক
भेदभाव_करपी: ভেদক ভেদী ভেদকারক ভেদকারী
भेदिल्ले: ভেদিত ভগ্নিত ভগ্ন বিদীর্ণ বিদারিত খন্ডিত
भेदीत: ভেদিত ভগ্নিত ভগ্ন বিদীর্ণ বিদারিত খন্ডিত
भेद्य: বেধ্য ভেদ্য বেধনীয় ভেদনীয়
भेसळीचें: অশুদ্ধ মিশ্রিত ভেজালযুক্ত অশোধিত অপরিশুদ্ধ অবিশুদ্ধ অখাঁটি অপমিশ্রিত
भोंवपी: উড়োন্চণ্ডী ভবঘুরে ভ্রম ফিরাফিরি
भोक्ता: গ্রাহক উপভোক্তা
भोगी: কামুক কামী লম্পট বিলাসী বিষয়ী ভোগী কামচারী কামকূট লম্পট
भोगूंक_नाशिल्लें: অভুক্ত অভোগা
भोळो: কোমল_স্বভাবী সোম সোম্য সহজ আসান সরল সুগম নিষ্কোপোট সাদাসিধে ভোলাভালা
भोवगुणी: যোগ্য সুযোগ্য কাবিল উপযুক্ত পারগ পারঙ্গম সক্ষম সমর্থ
भोवमानीत: সৎকার সৎকৃত
भोवमानेस्त: মান্য মাননীয় মান্যগণ্য গণ্যমান্য অভিজাত আদরনীয় সম্মাননীয়
भोवसंख्या: বহুসংখ্যক বহুত প্রচুর অনেক
भौतीक: পৃথিবীসম্বন্ধীয় ভৈতিক ঐহ্যিক_বা_পার্থিব_সুখ
भ्रमिश्ट: পাগল পাগলা উন্মত্ত উন্মাদ মত্ত খ্যাপা বাউরা বাওরা বাতুল অপ্রকৃতিস্থ বিকৃতমস্তিষ্ক ছিটিয়াল মানসিক_ভারসাম্যহীন দেওয়ানা ভুলভাল পাগল উন্মাদ
भ्रमीत: ভুলভাল পাগল উন্মাদ
भ्रश्ट: ভ্রষ্ট পথভ্রষ্ট স্খলিত চ্যুত বিচ্যুত পতিত অবরূঢ় অধঃপতিত
भ्रश्टाचारी: ভ্রষ্টাচারী
मंगल: শুভজনক হিতকর মাঙ্গল্য মাঙ্গলিক শুভদ ক্ষেমকর
मंगोलियन: মোঙ্গল মঙ্গোলিয়ান মঙ্গোলিয়াই
मंगोलियायी: মঙ্গোলিয়ান মঙ্গোলিয়াই
मंगोली: মোঙ্গল
मंजूर: স্বীকৃত প্রতীষ্ঠ অনুমোদিত অনুমোদনপ্রাপ্ত অনুমতিপ্রাপ্ত অনুজ্ঞাত
मंत्र_मारिल्लें.: মন্ত্রপুতঃ
मंत्रीत: মন্ত্রপুতঃ
मंद: মন্দ মন্থর ধীর শ্লথ বিলম্বিত ঢিমা মৃদু চাপা অনুচ্চ মৃদু কোমল মিহি ক্ষীণ মন্থর অলস শিথিল মন্দ ঢিমা ধীর শ্লথ মৃদু ঠান্ডা আবেগহীন আবেশবর্জিত
मंदबुद्दी: মন্দ_বুদ্ধি মন্দ_মতি
मंदमती: মন্দ_বুদ্ধি মন্দ_মতি
मंदावपी: অপয়া অলক্ষনা অলক্ষুনে
मकदुनियायी: ম্যাসিডোনিয়া_সংক্রান্ত ম্যাসিডোনিয়া_দেশীয় ম্যাসীডোনীয়
मखमली: মখমলের_তৈরি মখমলী মখমলী রেশমী
मचमचीत: স্বাদযুক্ত স্বাদিষ্ঠ মুখরোচক উপাদেয় উপভোগ্য সুস্বাদু সরস রসাল খাসা চটকদার মসলাযুক্ত সুগন্ধ ঝাঁঝালো
मजबूत: শক্ত দৃঢ় সুদৃঢ় দ্রঢ়িষ্ঠ মজবুত টেঁকসই পোক্ত পাকাপোক্ত শক্তপোক্ত
मजेशीर: মুখরোচক রুচিকর মজাদার রঙিন উপভোগ্য মজাদার
मडगास्करी: ম্যাডাগাস্করী ম্যাডাগাস্কারী মাডাগাস্করী মাডাগাস্কারী মাদাগাস্কারী মাদাগাস্করী
मडील्लें: গড়া আকার_প্রদত্ত আরূপিত
मढोवंक_नाशिल्लें: আকারহীন নিরাকৃতি নিরূপ অরূপ
मणिपुरी: মনিপুরি মনিপুরি মনিপুরের_ভাষা
मणिपूरी: মনিপুরি
मतींतलें: কাল্পনিক কল্পিত কল্পনীয় মিথ্যা অপ্রকৃত অবাস্তবিক
मदल्याकाळांतलें: মধ্যযুগীয় মধ্যযুগী
मदांद: পাগল উন্মাদ খ্যাপা মত্ত প্রমত্ত পাগল উন্মাদ অস্হির_মস্তিষ্ক
मदेवर्ती: মাঝ মাঝখান
मद्यम_पिरायेचें: মধ্যবয়স্ক প্রৌঢ়
मधलें: মধ্যম
मध्यकाळांतलें: মধ্যযুগীয় মধ্যযুগী
मध्यकाळीन: মধ্যযুগীয় মধ্যযুগী
मध्यम: মধ্যম
मध्ययुगीन: মধ্যযুগীয় মধ্যযুগী
मध्यवर्ती: মাঝ মাঝখান
मनभुलयणी: রমণীয় রম্য
मनभुलयणें: মনোরম সুন্দর ভালো মনোলোভা মনোমোহিনী মনোহারিনী
मनमानी: মনঃপূত মনের_মত পছন্দ_মত প্রিয় মনোনয়ন
मनरिजवणेचें: মনোরঞ্জক মনোরঞ্জনপূর্ণ আনন্দপ্রদ আমোদ-প্রমোদপূর্ণ
मनशाउंचायेचें: পূর্ণাবয়ব
मनसीक: বুদ্ধিক মানসিক
मनायेचें: মানা নিষিদ্ধ বর্জিত প্রতিবন্ধিত
मनीस_निर्मीत: মানব_কৃত মানব_রচিত মানবকৃত মানব-কৃত মানবনির্মিত মানব-নির্মিত মানব_নির্মিত কৃতিম
मनीसपण: ভালো বেশ_ভালো
मनीसपणाचें: মানবীয় মানুষিক মানবী
मनोगत: মনোগত স্বগত
मरगळिल्लें: দুর্বল বল_বা_শক্তি_নেই_এমন ক্ষীণ মৃদু
मरचें_न्हय_असें: অবধ্য
मरणाभिलाशी: অধিকারী
मरणासन्न: দরকচা দরকাঁচা দড়কচা দড়কাঁচা আধকাঁচা
मरणेत्शी: অধিকারী
मराठी: মারাঠি মারাঠা মহারাষ্ট্রিয় মহারাষ্ট্রিয়ান মারাঠি মহারাষ্ট্রিয় মারাঠি মহারাষ্ট্রিয় মারাঠি
मरूंक_पाविल्लें: দুর্বল বল_বা_শক্তি_নেই_এমন ক্ষীণ মৃদু
मर्दानी: পৌরুষ পুরুষত্ত্ব
मर्मज्ञ: হৃদয়-বিদারক মর্মভেদী মার্মিক
मर्यादीत: মিতব্যয়ী স্বল্পব্যায়ী সসীম পরিসীমিত সীমিত পরিসীমিত সীমাবদ্ধ সসীম সীমাযুক্ত পরিমিত সংযত নিয়ন্ত্রিত নিবৃত্ত প্রতিহত প্রশমিত বশীভূত পরিমিত
मलेशियायी: মালয়েশিয়ান মালয়েশিয়াই মালয়েশিয়ান মালয়েশিয়াই
मल्ल्याळम: মালায়ালী মালায়ালম মালয়ালী মালয়ালী
मल्ल्याळी: মালায়ালী মালায়ালম মালয়ালী মালয়ালী
मळकें: অপরিচ্ছন্ন অপরিষ্কৃত অপরিষ্কার মলিন কলুষিত ময়লা নোংরা অস্বচ্ছ অপবিত্র অশুদ্ধ
मळबभेदी: গগনভেদী গগনবিদারী
मळबस्पर्शी: গগনচুম্বী গগনভেদী আকাশভেদী গগনস্পর্শী
मळबा_कोराचें: আসমানী আকাশী
मळबांतलें: আকাশীয় আকাশী আসমানী গগনীয়
मळबाक_तेंकपी: গগনচুম্বী গগনভেদী আকাশভেদী গগনস্পর্শী
मळाचें: স্থলজ স্থলজাত
मशागत: প্রতিপালিত প্রতিপাল্য পালিত পুষ্ট বর্ধিত
मसाल्याचें: চটকদার মসলাযুক্ত সুগন্ধ ঝাঁঝালো
मस्तिल्लें: পদদলিত
मस्तें: দুরন্ত দামাল দুষ্টু দস্যি ছটফটে অশান্ত বদমাস
महत्वाकांक्षी: মহত্বাকাঙ্ক্ষী উচ্চাকাঙ্ক্ষী
महान: মহান সুমহান মহত্ মহীয়ান মহাত্মা বড় উদার শ্রেষ্ট
महाराष्ट्री: মারাঠি মারাঠা মহারাষ্ট্রিয় মহারাষ্ট্রিয়ান
महाराष्ट्रीयन: মারাঠি মারাঠা মহারাষ্ট্রিয় মহারাষ্ট্রিয়ান
मांडिल्लें: বাচ্য অভিধেয়
माखिल्लें: মাখামাখি লেপটানো
मागलें: পিছনের পশ্চাদবর্তী পিছনস্ত অনুবর্তী পরবর্তী
मागलो: প্রথম প্রারম্ভিক প্রাথমিক পয়লা
मागीरचें: পরবর্তী
माजी: ভূতপূর্ব পূর্বতন প্রাক্তন আগেকার বিগত অতীতের
माड्डिल्लें: পদদলিত
माणकुलें: কচিকাঁচা শিশু কাচ্চাবাচ্চা ছানাপোনা বাচ্চা ছোট ছোট্ট
मातयेभरवण: নষ্ট ধ্বংস বরবাদ বিনষ্ট সমাপ্ত প্রনষ্ট বিহত নাশপ্রাপ্ত ধসে_পড়া বিধ্বস্ত
मातसो: অত্যল্প
मादक: মাদক নেশাগ্রস্থ নেশাদার পাগল মত্ত
मानपी: অনুগামী অনুগ অনুবর্তী অনুগমনকারী অনুসারক অনুযাত
मानवल्लें: মনঃপূত মনের_মত পছন্দ_মত প্রিয় মনোনয়ন নির্বাচন
मानवी: মানবীয় মানুষিক মানবী
मानसीक: মানসিক
मानादीक: মান্য মাননীয় মান্যগণ্য গণ্যমান্য অভিজাত আদরনীয় সম্মাননীয় অভিনন্দনীয় অভিনন্দনযোগ্য অভিবাদনযোগ্য
मानिल्लें: অনিষিদ্ধ নিষেধহীন অবাধ অপ্রতিবন্ধিত
मानेस्त: অভিনন্দনীয় অভিনন্দনযোগ্য অভিবাদনযোগ্য
मान्य: অনিষিদ্ধ নিষেধহীন অবাধ অপ্রতিবন্ধিত স্বীকৃত মঞ্জুর অনুমোদিত অনুমোদনপ্রাপ্ত পারিত পাস সম্মত রাজী
मान्य_केल्ली: স্বীকৃত মঞ্জুর সম্মত সম্মতি অনুমোদিত সমর্থিত
मापूंक_नाशिल्लें: অপরিমিত অকুতো অপরিমাপিত
मामे: মামাতো মামাতুতো মামাতুতো
माया_नाशिल्लो: নিষ্ঠুর নির্দয় নির্মম ন্Rরিশংস নিঠুর নিকরুণ হৃদয়হীন অকৃপ পাষাণ
मायेस्त: স্নেহময় স্নেহমইয়ী
मार_खाल्लेलें: হত নিহত অপহত খতম
मारक: মারক বিনষ্ট_কারক মারক বিনষ্ট_কারক মারক বিনষ্ট_কারক
मारपी: মারক বিনষ্ট_কারক
मारवाडी: মারোয়ারী মারোয়ারী মারোয়ারী
मारिल्लें: হত নিহত অপহত খতম
मारूंक_जायना_अशें: অবধ্য
मार्गदर्शक: দ্যোতক সূচক পরিচায়ক নির্দেশক প্রদর্শক
मार्मीक: হৃদয়-বিদারক মর্মভেদী মার্মিক
मालकीचें: অধিকৃত অধিগত আয়ত্ত অধিকারগত
मालक्रियाद: দুরন্ত দামাল দুষ্টু দস্যি ছটফটে অশান্ত বদমাস
मालदिवी: মালদ্বীপিয়ান মালদ্বীপি মালদ্বীপিয়ান মালদ্বীপি
मावळिल्लो: অস্তগত অস্ত অস্তমিত
मावशे: মাসতুতো মাসশাশুড়ী মাসশুশুর মাস্তুতো
मावस: মাসতুতো মাসশাশুড়ী মাসশুশুর মাস্তুতো
मासहीण: পাতলা রোগা রুগণ ক্ষীণ কৃশকায় কৃশ শীর্ণ
मासाळ: মাঁসল রসালো
मासाहारी: আমিষ
मिजो: সংকটমোচনকারী পরিত্রাণকারী বিপত্তারণ
मिजोरमाचें: সংকটমোচনকারী পরিত্রাণকারী বিপত্তারণ
मिटना__अशें: অবিনশ্বর অবিনাশী
मिथ्या: মিথ্যা অসত্য মিছা ভুয়া ভুয়ো ঝুটা
मिरीमिरी: টিপটিপ রিমঝিম
मिश्र: মিশ্র মিশ্রিত সম্মিশ্রিত
मिस्तुराद: অশুদ্ধ মিশ্রিত ভেজালযুক্ত অশোধিত অপরিশুদ্ধ অবিশুদ্ধ অখাঁটি অপমিশ্রিত মিশ্র মিশ্রিত সম্মিশ্রিত
मिस्री: মিশরীয় ইজিপ্শিয়ন
मुंजी: সংস্কৃত
मुंबयकार: মুম্বাইস্থিত মুম্বাইওয়ালা মুম্বাইওয়ালি বম্বেস্থিত বম্বাইওয়ালা বম্বাইওয়ালী
मुंबयचें: মুম্বাইয়া বম্বাইয়া
मुक्कामाचें: গন্তব্য
मुक्त: স্বতন্ত্র স্বাধীন আজ়াদ অনধীন অনায়ত্ত অনির্বন্ধ উন্মুক্ত খোলা বাঁধনমুক্ত মুক্ত বাঁধনছাড়া স্বচ্ছন্দ স্বতন্ত্র অবাধ স্বাধীন
मुखार_धाडिल्लें: অগ্রসর অগ্রসার আগুয়ান আগুসার অগ্রবর্তী
मुखार_येवपी: ভাবী আগামী হবু অনাগত ভবিষ্য উত্তরকালীন
मुखारचो: সামনের সন্মুখের সন্মুখবর্তী সন্মুখস্থ অগ্রবর্তী অগ্রিম পূর্ব
मुखावयलो: সামনের সন্মুখের সন্মুখবর্তী সন্মুখস্থ অগ্রবর্তী অগ্রিম পূর্ব পুরোগামী পুরোবর্তী অগ্রগামী অগ্রগত অগ্রবর্তী
मुखेल: ‌মুখ্য প্রধান অগ্রগন্য মূল প্রমুখ অগ্রনী সর্বাপেক্ষা_গুরুত্বপূর্ণ অমাত্য পরমেশ্বর মুখ্য প্রধান প্রাথমিক
मुखेली: প্রধান অগ্রগন্য মুখ্য প্রমুখ অগ্রনী সর্বাপেক্ষা_গুরুত্বপূর্ণ অমাত্য পরমেশ্বর
मुख्यः2: ‌মুখ্য প্রধান অগ্রগন্য মূল প্রমুখ অগ্রনী সর্বাপেক্ষা_গুরুত্বপূর্ণ অমাত্য পরমেশ্বর
मुदयाळे: কোঁকড়ানো কুঞ্চিত কুঁকড়ানো কোঁচকানো
मुदलांतलें: স্থানিক স্থানীয় লোকাল
मुमुर्खें: নীরব নিশ্চুপ নির্বাক অবোলা অবোল
मुल्यवान: বহুমূল্য দামী মূল্যবান অমূল্য অনমোল
मुळावें: আরম্ভিক প্রারম্ভিক প্রারম্ভকালীন প্রাথমিক উপক্রমিক গোড়াকার
मुळाव्यो: মৌলিক স্বকৃত মুল অননুকৃত বুনিয়াদী বংশীয়
मुसलमानी: মুসলমান মুসলিম
मुस्तिल्लें: পদদলিত
मूर्ख: মূর্খ আকাটমূর্খ মুখ্যু মূঢ় অজ্ঞ অশিক্ষিত অজ্ঞান আহাম্মক বোকা নির্বোধ অবুদ্ধি নির্বুদ্ধি বুদ্ধিহীন গবেট উজবুক
मूर्त: সাকার আকারযুক্ত আকারবান মূর্তিমান সাক্ষাৎ সাক্ষাত
मूळ: স্থানিক স্থানীয় লোকাল
मृत: মৃত মৃতক প্রয়াত স্বর্গগত স্বর্গীয় অপগত মরহুম গত তিরভৃত স্বর্গস্থ
मृदुभाशी: মধুরভাষী মিষ্টভাষী সুভাষী
मृद्गंध: সোদা
मेंगें: মন্থর অলস শিথিল মন্দ ঢিমা ধীর শ্লথ মৃদু
मेकळी: স্বচ্ছন্দ স্বতন্ত্র অবাধ স্বাধীন
मेकळें: স্বতন্ত্র স্বাধীন আজ়াদ অনধীন অনায়ত্ত অনির্বন্ধ রিক্ত খালি শূন্য ফাঁকা শূন্যগর্ভ ফাঁপা খালি কর্মহীন কর্মশূন্য হালকা হাল্কা সহজ ভারহীন
मेकळो: উন্মুক্ত খোলা বাঁধনমুক্ত মুক্ত বাঁধনছাড়া
मेकळ्या_हाताचें: মুক্তহস্ত মুক্তকর
मेघहीण: স্বচ্ছ মেঘহীন নিরভ্র মেঘরহীন অনাকাশ অপঘন
मेजकेंच: সংযত নিয়ন্ত্রিত নিবৃত্ত প্রতিহত প্রশমিত বশীভূত পরিমিত
मेजिनाशिल्लें: অতুল্য
मेजूंक_नाशिल्लें: অসংখ্য অগণণীয় অগনিত অগণ্য অনন্ত অনেক
मेणा_सारकें: মোমের_মতো
मेणाचें: মোমের_তৈরি
मेणाभशेनचें: মোমের_মতো
मेल्लें: মৃত খরা
मेल्लो: মৃত মৃতক প্রয়াত স্বর্গগত স্বর্গীয় অপগত মরহুম গত তিরভৃত স্বর্গস্থ
मेळनाशिल्लें: অলব্ধ অপ্রাপ্ত দুর্লভ অলভ্য অপ্রাপ্য দুষ্প্রাপ্য দুর্গ্রহ দুর্লভ
मेळयिल्लें: অর্জিত ভুক্ত
मेळविरयत: অমিল মিলহীন অসম বেমানান
मेळिल्लें: উপার্জিত অর্জিত লব্ধ প্রাপ্ত হস্তগত প্রাপিত আপ্ত অধিগত করায়ত্ত
मेळोवन_दिल्लें: প্রাপ্ত প্রাপ্য লব্ধ লভিত প্রাপিত উপলব্ধ সম্প্রাপ্ত সমলব্ধ অধিগত
मेळोवप: বিলীন অদৃশ্য অদৃষ্টিগোচর অদৃষ্টয়মান নাদেখা অন্তরহিত
मैत्री: বন্ধুত্বপূর্ণ বন্ধুত্বমূলক মৈত্রীমূলক মিত্রবত মিত্রচিত
मैथिली: মৈথিল মৈথিল
मैदानी: স্থলজ স্থলজাত
मोखप: ভেদ্য ভেদনীয়
मोगभरीत: বেহিসাব অপরিমিত
मोगाळ: স্নেহময় স্নেহমইয়ী
मोगासक्त: প্রেমাসক্ত প্রণয়াসক্ত অনুরাগী অনুরক্ত অনুরাগযুক্ত আসক্ত অনুরত
मोटे: বড় বৃহত্ বিশাল
मोटें: অগ্রজ অগ্রজাত অগ্রজন্মা বড় বয়োজ্যেষ্ঠ জ্যেষ্ট বয়োজ্যেষ্ঠ বড় অগ্রজ দোহারা
मोटो: মোটা স্থূল্কায় বিরাটাকার ফোলা
मोडकें: জীর্ণ জর্জর
मोडको: ঠিগনা ছোট বেনা নাটা ঠিগনা বামন
मोडण: টেঠা টেঠা-মেটা টেঠা মেটা বক্র কুঙচিত বঙ্কিম
मोडणाचें: ঘুর্য্ণীয়া ঘুরুণে ঘুরুণিয়া ঘুরনযুক্ত
मोडवो: ঠিগনা ছোট বেনা নাটা ঠিগনা বামন
मोडिल्लें: ভগ্ন ভাঙ্গা বিচ্ছিন্ন বিখন্ডি জীর্ণ জর্জর উলঙ্ঘিত অবঞ্জাত
मोनें: অপুষ্পিত অনখিলা অবিকশিত মুকুলিত অফুল্ল নিঃশব্দ শান্ত নিঃশ্চুপ
मोनो: নিঃশব্দ স্বরহীন মৌনী মূক নির্বাক অবাক বোবা নিঃস্বর মূক বোবা নির্বাক মৌনী বাকশক্তিহীন গুঁঙা অবোলা অবোল
मोफत: নিঃশুল্ক শুল্কমুক্ত
मोलादीक: বহুমূল্য দামী মূল্যবান অমূল্য অনমোল অনমোল অমূল্য অমোল দামী
मोल्डोवायी: মলদ্বীপ_সম্বন্ধীয় মলদ্বীপীয় মলদ্বীপ_সংক্রান্ত মলদ্বীপীয়
मोव: কোমল_স্বভাবী সোম সোম্য নম্য নমনীয় বিনম্য সুনম্য কমজোরি পলকা অশক্ত ঠুনকো অমজবুত অদৃঢ্ পাতলা
मोसमी: মৌসুমী
मोहक: মনোরম সুন্দর ভালো মনোলোভা মনোমোহিনী মনোহারিনী সুদর্শণ মনহোর মনরোম সুন্দর
मोहीत: অনুরাগী অনুরক্ত আসক্ত সংসক্ত অনুষক্ত মুগ্ধ বিমুগ্ধ মোহিত বিমোহিত মুগ্ধ বিমুগ্ধ মোহিত বিমোহিত সন্মোহিত বিহ্বল অভিভূত আত্মহারা মোহময় মোহন মোহিনী
मौनव्रती: মৌনী মৌন_ব্রতী মৌনাবলম্বী
म्यानमारी: বর্মী বর্মীয় বর্মী বর্মীয়
म्हत्वपूर्ण: গুরুত্বপূর্ণ অর্থপূর্ণ তাত্পর্যপূর্ণ মূল্যবান জরুরি দরকারী
म्हत्वाचें: গুরুত্বপূর্ণ অর্থপূর্ণ তাত্পর্যপূর্ণ মূল্যবান জরুরি দরকারী
म्हयनाळें: মাসিক
म्हयमावान: মহিমময় মহাপুরূষ
म्हाकाय: বিশাল প্রকাণ্ড বৃহত্ বৃহদাকার প্রকাণ্ড
म्हातारें: বৃদ্ধ বূড়া বয়স্ক
म्हान: মহান সুমহান মহত্ মহীয়ান মহাত্মা বড় উদার শ্রেষ্ট
म्हानगरीय: মহানগরী
म्हापापी: মহাপাপী পাপাধম মহানীচ পাপিষ্ঠ
म्हाप्राण: অঘোষ অস্ফুট অনুচ্চ চাপা মৃদু অব্যক্ত
म्हारग: বহুমূল্য দামী মূল্যবান অমূল্য অনমোল দামী মূল্যবান দামি মূল্যবান মহামূল্য ব্যয়সাধ্য অনর্ঘ
म्हालम्हातारें: বৃদ্ধ বূড়া বয়স্ক
म्हावराक: আমিষ
म्हेळें: অপরিণত কাঁচা আপাকা অপরিচ্ছন্ন অপরিষ্কৃত অপরিষ্কার মলিন কলুষিত ময়লা নোংরা অস্বচ্ছ অপবিত্র অশুদ্ধ
म्होंवाळ: শ্রুতি_মধুর সুন্দর মিস্টি_আওয়াজ মধুর_আওয়াজ মিস্টি মধু মিস্টি মধু
म्होवल्याचें: চিরঞ্জী
यंत्रचलीत: যন্ত্রচালিত যান্ত্রিক স্বচালিত যন্ত্র-সঞচালিত
यजुर्वेदी: যজুর্বেদী
यजुर्वेदीक: যজুর্বেদী
यत्नशील: প্রযাসশীল প্রযত্নশীল প্রযাসী প্রযত্নী প্রযত্নবান উদ্যমী উদ্যমশীল উদ্যোগী
यशस्वी: বিজেতা বিজয়ী অপধ্বংসী অভিজিত
यहुदी: ইহূদী হিব্রূ হিব্রু
यहुदी_भास: হিব্রু
याचक: প্রার্থী অভ্যর্থী নিবেদক প্রার্থনা_কর্তা ফরিযাদী যাচী
याद__नाशिल्लें: অসম্পূর্ণ অপূর্ণ_রচিত
याद_उरपा_सारकी: স্মরণীয
याद_दिवपी: স্মরণীয় স্মরণযোগ্য স্মার্ত স্মরণার্থ
याददिण्यो: স্মরণীয় স্মরণযোগ্য স্মার্ত স্মরণার্থ
यादेस्त: স্মরণীয় স্মরণযোগ্য স্মার্ত স্মরণার্থ
युक्रेनी: ইউক্রেনী ইউক্রেনিয়ান ইউক্রেনী ইউক্রেনিয়ান
युगांडी: ইউগন্ডান ইউগান্ডাই
युनानी: য়ুনানী গ্রীক ইউনানি গ্রীক
युरेशियायी: যূরেশিয়া_সম্বন্ধিত
येतें_वतें: দুদিক দুতরফ
येवंक_नाशिल्लें: অপ্রাপ্ত অলব্ধ
येवंक_नाशिल्लो: অনাগত অনুপস্থিত গরহাজির অবিদ্যমান
येवंनजशा: অগম্য দূর্গম অগন্তব্য
येवजिल्लें: ঐচ্ছিক
येवपी: ভবিষ্যতের আগামীকালের ভাবী আগামী অনাগত ভবিতব্য
येवरोपी: যূরোপীয় যূরোপী যূরোপিয়ন
येशस्वी: সফল সফলকাম সার্থক সিদ্ধ কৃতকার্য
योगीक: যৌগিক
योग्य: যোগ্য সুযোগ্য কাবিল উপযুক্ত পারগ পারঙ্গম সক্ষম সমর্থ ঠিক নির্দিষ্ট নির্ধারিত নিশ্চিত নিয়ত উচিত ন্যায্য সংগত ঠিক সঠিক যোগ্য যথোচিত সমুচিত যথার্থ উপযুক্ত বৈধ_কানুন বিধিমান্য বিধিক ঠিক সঠিক যথার্থ অভ্রান্ত নির্ভুল শুদ্ধ ত্রুটিহীন সঠিক উচিত ন্যায্য সংগত উপযুক্ত যথাযথ যথার্থ যোগ্য যথোপযুক্ত অনুকূলিত
योग्य_वेळार: সাময়িক ক্ষণস্থায়ী সময়বিশেষে_ঘটে_এমন সময়োচিত বর্তমান_ঘটনাবলি_সংক্রান্ত_বা_নির্দিষ্ট_সময়ান্তরে_প্রকাশ্য
योजक: আলবানিয়ান
योजिल्लें: আয়োজিত
योजीत: আয়োজিত
योद्धो: রণবীর
यौगीक: যৌগিক
रंग-परिवर्तनशील: পরিবর্তনীয়
रंगयिल्लें: চিত্রিত রঞ্জিত
रंगहीण: রংহীন বর্ণহীন বর্ণশূন্য
रंगांचो: রঙিন রংচঙে রংদার বর্ণময় রং-বেরং
रंगी: বর্ণীয় বর্ণা রঙা
रंगीत: রঙ্গবিরঙ্গ বিবিধ তর-তর নানাপ্রকার রঙিন রংচঙে রংদার রাঙা বর্ণময়
रक्तपिपासू: খুখার খুখার
रक्तवर्णी: লোহিত রক্তিম
रक्ताचें: খূনী হত্যাকারী
रगत_पियेवपी: খুখার খুখার
रचणार: সৃজনকর্তা সর্জক সৃজক রচনা_করে_যে স্রষ্টা
रचिल्लें: কাল্পনিক কল্পিত কল্পনীয় মিথ্যা অপ্রকৃত অবাস্তবিক নির্মিত রচিত গঠিত প্রস্তুত সৃষ্ট সৃজিত কৃত সংরচিত
रचूंक_नाशिल्लें: অকৃত অনকীয়্‌অসম্পন্ন অসম্পাদিত
रणवीर: রণবীর
रणशूर: রণবীর
रमणीय: রমণীয় রম্য
रम्य: রমণীয় রম্য সুন্দর চারু সুচারু সুকান্ত সুকুমার অপরূপ সুদর্শন সৌম্যদর্শন রূপবান রূপবন্ত সৌম্য সুশ্রী
रवथाचें: রোমন্থক রোমন্থিক রোমন্থনকারী
रवांडायी: খান্ডাই
रवांडी: খান্ডাই
रवो: দুরদুরা
रशियन: রূসী রাশিয়ান
रशीयन: রূসী রাশিয়ান
रसहीण: নীরস রসহীন অরস শুষ্ক বেরসিক
रसात्मक: কবিত্বপূর্ণ রসাত্মক
रसाळ: রসদার রসপূর্ণ রসীলা সরস রসবান রসাল
रसीक: রসিক রসপ্রিয় আমুদে আমোদী রঙ্গিলা রঙ্গপ্রিয় রঙ্গকারী
रस्ताद: বেওয়ারিশ মালিকহীন ছন্নছাড়া ভবঘুরে
रस्त्याचें: পথের রাস্তার পথে
रहस्य: রহশ্যপূর্ণ রহশ্যময় রহশ্যাত্মক গুড়
रांड: বিধবা স্বামীহীনা পতিহীনা যতী রাঁড়ী রাঁড় বেওয়া
राकेसी: আসুরিক আসুর অসুরসম্বন্ধীয় দানবিক দানবীয় পৈশাচিক অমানুষিক রাক্ষুসে ভয়ঙ্কর
राक्षसी: আসুরিক আসুর অসুরসম্বন্ধীয় দানবিক দানবীয় পৈশাচিক অমানুষিক রাক্ষুসে ভয়ঙ্কর
राखीव: আরক্ষিত ব্যাসসিদ্ধ দামী মূল্যবান মহার্ঘ অমূল্য অনর্ঘ
रागिश्ट: ক্রুদ্ধ ক্রোধিত ক্ষুব্ধ রাগী কুপিত ক্রোধী রাগী গরম_মেজাজ চণ্ডাল
राजकारणाचे: রাজনৈতিক রাজনীতিবিষযক
राजकारणी: রাজনৈতিক রাজনীতিবিষযক
राजकी: রাজ্য-সম্পর্কীয় রজকীয রাজ্যমূলক রাজকীয় রাজসিক বাদশাহি শাহি
राजनितीक: রাজনৈতিক রাজনীতিবিষযক
राजपत्रीत: গেজেটেড_অফিসার উচ্চপদস্থ_কর্মচারী পদাধিকারী_ব্যক্তি
राजसी: রাজসিক
राजस्थानी: রাজস্থানী
राजाहीण: অরাজক রাজহীন
राज्य: শাসিত প্রশাসিত অভিশাসিত
राज्या_विशींचें: রাজ্য-সম্পর্কীয় রজকীয রাজ্যমূলক
राणटी: বন্য জংলি জঙ্গুলে বুনো জংলা বনজ বনজাত অরণ্যজাত
रानटी: বন্য জঙ্গলী বুনো বনজাত বনচর বনবাসী আরণ্য জঙ্গলি জংলি বুনো বন্য অসভ্য জংলি অরণ্যময় অরণ্যসংকুল বনাবৃত জঙ্গলাবৃত বনময় জঙ্গুলে
रानवटी: বন্য জঙ্গলী বুনো বনজাত বনচর বনবাসী আরণ্য জঙ্গলি জংলি বুনো বন্য অসভ্য জংলি অরণ্যময় অরণ্যসংকুল বনাবৃত জঙ্গলাবৃত বনময় জঙ্গুলে বন্য জংলি জঙ্গুলে বুনো জংলা বনজ বনজাত অরণ্যজাত
राबित्याचें: অধ্যুষিত অধ্যাসিত আবাদি বসতিপূর্ণ অধিকৃত অধিবসিত
राबित्याच्यो: ঘরালু আবাসিয় গৃহীয় গৃহ
रावपी: অধ্যুষিত অধ্যাসিত আবাদি বসতিপূর্ণ অধিকৃত অধিবসিত
राष्ट्रताये_संबंदी: বন্ধ মুলতুবি রহিত স্থগিত
रासायनीक: রাসাযনিক রসায়নিক
रिकामी: রিক্ত খালি শূন্য ফাঁকা শূন্যগর্ভ ফাঁপা খালি ফাঁকা
रिकामें: খালি কর্মহীন কর্মশূন্য সাদা অলিখিত আলেখা অলেখনীয়
रिटायर्ड: অবসরপ্রাপ্ত অবকাশপ্রাপ্ত রিটায়ার্ড অব-সৃত
रिणमुक्त: ঋণমুক্ত দেনামুক্ত ধারমুক্ত
रितसर: সুব্যবস্থিত সুবিন্যস্ত সুসমঞ্জস
रीण_दिवपी: ঋণপ্রদাতা ঋণদাতা ঋণ-প্রদাতা ঋণ-দাতা
रीतसर: বিন্যস্ত সুবিন্যস্ত সুসজ্জিত পরিপাটি অবস্থিত
रुचीचें: রুচিকর রুচিকারক মনমতন
रुढिवादी: গোড়া প্রাচীনপন্থী
रुपेरी: রুপালি
रुप्याचें: রুপালি
रुमानियन: রুমানীয় রুমানিয়ান
रुमानी: রুমানীয় রুমানিয়ান রুমানীয় রুমানিয়ান
रुसी: রূসী রাশিয়ান রূসী রাশিয়ান
रूक्ष: শুষ্ক রুক্ষ জলহীন অনার্দ্র ঊষর রুক্ষ নিষ্ঠুর নির্দয় নিঠুর কঠোর কাঠখোট্টা স্নেহহীন
रूच_नाशिल्लें: বিস্বাদ স্বাদহীন অস্বাদু রসাভাব নীরস অনাস্বাদ
रूचीक: স্বাদযুক্ত স্বাদিষ্ঠ মুখরোচক উপাদেয় উপভোগ্য সুস্বাদু সরস রসাল খাসা
रूप_नाशिल्लें: কুরূপ কুশ্রী অসুন্দর কদাকার কুতনু কুদর্শন শ্রীহীন কুতসিত
रूपगर्विता: রূপ_অভিমানিনী রূপগর্বিতা
रूपाभिमानी: রূপ_অভিমানিনী রূপগর্বিতা
रेंवटाळ: মরুস্থলীয়
रेशमी: রেশমী
रोगी: রোগী অসুস্থ পীড়িত রোগগ্রস্ত রোগার্ত ব্যাধিগ্রস্ত রোগশীর্ণ আতুর রুগণ রোগকাতর
रोमांचक: রোমাঞ্চকারী রোমাঙ্চক
रोमांचकारी: রোমাঞ্চকারী রোমাঙ্চক
रोमांचीत: রোমাঞ্চিত রোমাঞ্চিত রোমাঞ্চযুক্ত পুলকিত
रोसाळ: রসপূর্ণ রসালো রসদার রসীলা
लंगडें: খোঁড়া ল্যাংড়া
लंबवत: লম্ব
लकलकीत: উজ্জ্বল উজল প্রোজ্জ্বল স্বচ্ছ সাফ পরিষ্কার স্পষ্ট
लक्षवेदी: লক্ষ্যবেধী লক্ষ্যানুগামী
लक्समबर्गाचें: লক্সমবার্গ_সংক্রান্ত লক্সমবার্গ_সম্বন্ধীয়
लक्समबर्गी: লক্সমবার্গ_সংক্রান্ত লক্সমবার্গ_সম্বন্ধীয় লক্সেমবর্গী
लग्न_जाल्लें: বিবাহিত পরিণীত
लज_नाशिल्लो: নির্লজ্জ লজ্জাহীন বেহায়া অলজ্জ লাজলজ্জহীন নিলাজ বেশরম লজ্জাশূন্য
लजेस्त: লাজুক লজ্জাশীল মুখচোরা লজ্জাবতী লাজবন্তী লজ্জাশীলা লজ্জিত লজ্জালু লজ্জামান অপ্রতিভ সংকুচিত কুণ্ঠিত কুণ্ঠাযুক্ত দ্বিধাগ্রস্ত বিহ্বল লজ্জিত
लटकें: মিথ্যা অসত্য মিছা ঝুট ঝুটা ভুয়া ভুয়ো অনৃত অতথ্য অপ্রকৃত তথ্যহীন অপ্রামাণিক আধারহীন নির্মূল অনাধার আধাররহিত যথার্থহীন দেখানো বানানো উপরী মিথ্যা অসত্য মিছা ভুয়া ভুয়ো ঝুটা
लटको: লম্পট লোচ্চা বদ বদমাস বখা বখাটে পাজি নচ্ছার দুর্জন দুরাত্মা
लठ्ठ: দোহারা
लडकें: ত্রুটিপূর্ণ জাল অচল নকল দুনম্বরি কৃত্রিম
लढाऊ: রণবীর
लफड्याचें: ঝঞ্ঝাটপূর্ণ ঝামেলাদায়ক গোলমেলে ঝকমারি
लवचीक: নম্য নমনীয় বিনম্য সুনম্য
लांडें: পরম্পরাগত ডানাহীন পক্ষহীন পাখহীন পাখনাহীন পাখাহীন কুন্তহীন পতত্রহীন পালকরহিত
लांब: লম্বা দীর্ঘ সুদীর্ঘ দীর্ঘকায় লম্বকায়
लाओ: লাও লাও লাওসিয়ান
लाओशियन: লাও লাওসিয়ান
लागचें: কাছের নিকটতম নিকটবর্তী নিকটস্থ সন্নিকট সমীপস্থ সমীপবর্তী
लागपी: মিহি মৃদু কোমল পাতলা সূক্ষ্ম
लागवडीचें: কৃষিজ
लागशिल्लें: অন্তরিত অন্তর্হিত গৃহবন্দি
लागीं_वचपी: অভিগামী অগ্রগামী সম্মুখগামী পুরোগামী
लागींचे: আসন্ন সন্নিকট কাছাকাছি
लागींचें: কাছের নিকটতম নিকটবর্তী নিকটস্থ সন্নিকট সমীপস্থ সমীপবর্তী
लागू: কার্যকারী
लाचार: বাধ্য অসহায়
लाजरें: লাজুক লজ্জাশীল মুখচোরা লজ্জাবতী লাজবন্তী লজ্জাশীলা লজ্জিত লজ্জালু লজ্জামান অপ্রতিভ
लाजवर्दी: লাজুলিযুক্ত
लाठिमार: লেঠেল
लातवियायी: লাতভীয় লাতভীয়
लाबदिणें: লাভদাযক লাভপ্রদ লাভকর লাভকারী লাভজনক গুণকারী উপযোগী হিতকারী ফলদ ফলদায়ক ফলদায়ী ফলপ্রদ ফলপ্রসূ
लाभार्थी: লাভান্বিত লাভ_প্রাপ্তকর্তা
लायक: যোগ্য সুযোগ্য উপযুক্ত উপযোগী যথাযোগ্য
लायिल्लें: কার্যকারী
लाशिल्लें: দগ্ধ পোড়া
लाशें_आशिल्लें: দাগি
लाशेल्लें: দাগি
लिंगीक: লিঙ্গীয় যৌন
लिकलिकपी: চমকদার চাকচিক্য স্ফুরিত চকচকে ঝিকিমিকি
लिकलिकीत: চমকদার চমকতা
लिकलीकपी: আলোকিত উজ্জ্বলিত কান্তিমান চমকতা দমকতা দীপ্ত
लिखीत: লিখিত লিপিবদ্ধ অঙ্কিত লেখা নথিকৃত কাগজী কাগজী
लिथुनियायी: লিথুনীয় লিথুনীয়
लिपोवपी: অপহরনকারী
लिप्पी: অস্তমিত
लिबियायी: লীবিয়ান লীবিআন
लिबेरियायी: লাইবেরিয়ান লীবেরিয়ান লিবেরিয়ান
लुकसाणग्रस्त: অপকৃত অনুপকৃত ক্ষতিগ্রস্ত
लुकसाणदिणें: হানিকারক ক্ষতিকারক হানিকর ক্ষতিকর অনর্থকারী
लुकसाणीचें: হানিকারক ক্ষতিকারক হানিকর ক্ষতিকর অনর্থকারী
लुटिल्लें: অপহৃত হৃত লুন্ঠিত লুঠিত অপহারিত বিহৃত অপহৃত হৃত চোরিত লুন্ঠিত অপহারিত বিহৃত
लुडबें: তোতলা তোতলা
लुप्त: বিলুপ্ত লুপ্ত অদৃশ্য অদিষ্ট অন্তর্হিত অন্তর্হিত
लुळो: হাতকাটা ঠুঁটো নুলো ছিন্নহস্ত হস্তহীন
लुळोपांगळो: বিকলাঙ্গ পঙ্গু
लेथोसी: লেসোথী লেসোথো-সম্বন্ধী
लेव: হাল্কা ফিকে অনুজ্জ্বল ফ্যাকাসে
लेव_हळडुवें: বাসন্তী হলুদ হলদে হলুদে লেমন_ইয়্লো
लैंगीक: লিঙ্গীয় যৌন
लोक: লোক জন জনতা
लोकतंत्रीक: প্রজাতাণত্রিক প্রজাতণত্রীয় প্রজাতণত্রী
लोकशायी: প্রজাতাণত্রিক প্রজাতণত্রীয় প্রজাতণত্রী
लोकशायेचें: প্রজাতন্ত্রীয় গনতান্ত্রিক লোকতান্ত্রিক
लोकांचें: লোক জন জনতা
लोकाचें: অন্য পরকীয়
लोखंडाचें: লৌহ
लोखंडी: লৌহ
लोटांगण_घालपी: অনুশয়িত প্রণত বিনীত অনুতপ্ত
लोणयाचें: মাখন
लोळकें: অপরিচ্ছন্ন অপরিষ্কৃত অপরিষ্কার মলিন কলুষিত ময়লা নোংরা অস্বচ্ছ অপবিত্র অশুদ্ধ
लोळिल्लें: অপরিচ্ছন্ন অপরিষ্কৃত অপরিষ্কার মলিন কলুষিত ময়লা নোংরা অস্বচ্ছ অপবিত্র অশুদ্ধ
ल्हव: পলকা হালকা পাতলা
ल्हव_ल्हव: মন্দ মন্থর ধীর শ্লথ বিলম্বিত ঢিমা মৃদু
ल्हवपीक: চাপা অনুচ্চ মৃদু কোমল মিহি ক্ষীণ
ल्हान: কনিশষ্ট অবর অনুজ ছোট অনুজন্মা অনুজাত কণিষ্ট কনিশষ্ট ছোট ছোট্ট
ल्हान-सान: ছোটো_খাটো অল্প_বিস্তর হালকা_ফুলকা
ल्हेंवेल्लें: ভক্ষিত খাওয়া_হয়েছে_এমন ভক্ষ্য
वंचीत: বঞ্চিত প্রতারিত প্রবঞ্চিত ছলিত
वंशावळीचें: বংশগত বংশানুক্রমিক বংশপরম্পরায় বংশপরম্পরাগত পৈতৃক পারিবারিক
वक्र: বেঢপ বেডৌল বেখাপ্পা ধ্যাবড়া অসমাঙ্গ অসংগঠিত অসম্বদ্ধ
वगत: দেরি বিলন্বিত লেট
वजनदार: ভারী ভারি ওজনদার বোঝাই
वजनी: গুরুত্ব ভারী গম্ভীর গভীরতা ওজন
वट्ट: পুরো সম্পূর্ণ সমগ্র সব সমুদয় সমস্ত গোটা আস্ত অখণ্ড অখণ্ডিত পুরো সম্পূর্ণ সমগ্র সব সমুদয় সমস্ত সকল সমুচয় তামাম সর্ব অখিল
वत्सल: বৎসল
वयर_आयिल्लो: উদিত উদ্ভূত উন্মেষিত বিকশিত প্রস্ফুটিত
वयर_दिल्लो: উপরোক্ত উপর্যুক্ত উল্লিখিত উপরিলিখিত পূর্বোক্ত
वयरचो: উপর
वयरसकयल: অসমতল উঁচুনিচু এবড়ো-খেবড়ো চড়াই-উত্ রাই৷
वयले: উচু উচচ
वयलें: উঁচু উচ্চ উন্নত উর্ধ্ব ওপরের উপরের বাইরের বাহিরের বহিরঙ্গ
वयलो: উপরোক্ত উপর্যুক্ত উল্লিখিত উপরিলিখিত পূর্বোক্ত উপর
वयलो_सूर: উদাত্ত মন্দ্র দরাজ ভরাট গম্ভীর গমগমে
वयल्या_कुळांतलो: অভিজাত সম্ভ্রান্ত কুলীন উচ্চবংশীয় খানদানি বনেদি
वयल्याचाराचें: রুক্ষ নিষ্ঠুর নির্দয় নিঠুর কঠোর কাঠখোট্টা স্নেহহীন
वयल्यावयलें: দেখানো বানানো উপরী
वयस्क: বয়স্ক
वयार_आयिल्लें: অঙ্কুরিত উন্মেষিত উন্মোচিত উন্মীলিত প্রকাশিত বিকশিত মুকুলিত
वरिश्ठ: বৃদ্ধ বূড়া বয়স্ক বরিষ্ঠ প্রবর
वर्ग: সমকক্ষ সমতুল্য এক_সমান একই_রকম তুল্য সদৃশ্য
वर्गाकार: বর্গাকার বর্গাকৃতি
वर्गी: শ্রেণীয়
वर्जीत: মানা নিষিদ্ধ বর্জিত প্রতিবন্ধিত
वर्ज्य: মানা নিষিদ্ধ বর্জিত প্রতিবন্ধিত
वर्णनीय: বর্ণনীয় কথনীয় অভিধেয়
वर्णी: বর্ণীয় বর্ণা রঙা
वर्तमान: বর্তমান
वर्तमान_काळ: বর্তমান_কালের সাময়িক আধুনিক বর্তমান
वर्सभराच्यो: চিরহরিৎ বারোমাসে_পাওয়া_যায়_এমন সবসময়_সবুজ
वर्साचें: বয়ঃপ্রাপ্ত প্রপ্তবয়স্ক বর্ষীয়
वर्सुकें: বার্ষিক বাৎসরিক
वळखीचें: অবগত অধিগত জ্ঞাত অবহিত বিদিত সুবিদিত বিজ্ঞাত পরিজ্ঞাত জ্ঞাত বিদিত অবগত পূর্বপরিচিত অভিজ্ঞাত
वळखीचो: পরিচিত আলাপী আলাপিত
वळणाचें: ঘুর্য্ণীয়া ঘুরুণে ঘুরুণিয়া ঘুরনযুক্ত
वळेरीत: সূচীবদ্ধ
वळेरेंत: ক্রমিক অনুক্রমিক ক্রমবদ্ধ বিন্যস্ত ক্রমানুসার ক্রমানুকুল শৃঙ্খলাবদ্ধ অনুপূর্ব
वशिल्लें: অধ্যুষিত অধ্যাসিত আবাদি বসতিপূর্ণ অধিকৃত অধিবসিত
वसंत_काळाचें: বসন্ত_কালীন বসন্তকাল বাসন্তী
वसंतकाळीन: বসন্ত_কালীন বসন্তকাল বাসন্তী
वसणुकेचें: আবাসিক আবাসী
वसाड: নির্বাসিত উজাড়
वांकडें: টেঠা তিরক্ষা তির্যক আড়া কর্কশ কটু কড়া কাঠখোট্টা কাটা_কাটা অবনত নত
वांकडो: টেঠা টেঠা-মেটা টেঠা মেটা বক্র কুঙচিত বঙ্কিম
वांकडो-तिकडो: টেঠা টেঠা-মেটা টেঠা মেটা বক্র কুঙচিত বঙ্কিম
वांकिल्लें: অবনত নত
वांगडें: বেঢপ বেডৌল বেখাপ্পা ধ্যাবড়া অসমাঙ্গ অসংগঠিত অসম্বদ্ধ
वांझ: বাঁজা বন্ধ্যা অপ্রসুত অফলা আঁটকুড়া আঁড়া
वांटील्लें: আবন্টিত
वांटेकार: অন্তর্গত অন্তর্ভুক্ত মধ্যস্থ
वाकड्या_नाकाचें: নাকব্যাঁকা
वाचक: দ্যোতক সূচক বোধক বাচক
वाचपा_योग्य: পঠনীয় পাঠ্য পঠিতব্য অনুধেয় অধিগম্য অনুধাবনযোগ্য
वाचपा_सारकें: পঠনীয় পাঠ্য পঠিতব্য অনুধেয় অধিগম্য অনুধাবনযোগ্য
वाचपायोग्य: পঠনীয় সুপাঠ্য পাঠ্য পঠ্য অধ্যয়নীয় অধ্যেয়
वाचयिल्लें: সংগৃহীত সঞ্চিত পূঞ্জিত সংহৃত রক্ষিত
वाचाळ: বাচাল অতিভাষী মুখর বাক_চপল
वाचिल्लो: পড়া পঠিত
वाचीक: পঠনীয় সুপাঠ্য পাঠ্য পঠ্য অধ্যয়নীয় অধ্যেয়
वाच्य: বাচ্য অভিধেয় ব্যকরণ
वाच्यनीय: পঠনীয় পাঠ্য পঠিতব্য অনুধেয় অধিগম্য অনুধাবনযোগ্য
वाजयिल्लें: বাদিত ধ্বনিত শব্দিত
वाटकुळें: গোল গোলাকার গোলাকৃতি বৃত্তাকার বর্তুলাকার মন্ডলাকার গোলালো বর্তুলিক অখন্ডমন্ডলাকার বলয়াকার সুগোল চক্রাকার গোল গোলাকার গোলাকৃতি বৃত্তাকার বর্তুলাকার মন্ডলাকার গোলালো বলয়াকার সুগোল
वाटायिल्लें: সংগৃহীত সঞ্চিত পূঞ্জিত সংহৃত রক্ষিত
वाठारी: আঞ্চলিক স্থানিয় লোকাল অঞ্চলীয় স্থলীয়
वाडयिल्ली: পরিবর্ধিত বর্ধিত সম্প্রসারিত বৃদ্ধিপ্রাপ্ত বিবর্ধিত
वाडयिल्लें: বিস্তারিত অভিবৃদ্ধ
वाडिल्लें: অঙ্কুরিত উন্মেষিত উন্মোচিত উন্মীলিত প্রকাশিত বিকশিত মুকুলিত বৃদ্ধিপ্রাপ্ত বর্ধিত বিবর্ধিত পরিবর্ধিত
वाडोवपी: বর্ধক বর্ধয়িতা বৃদ্ধিকর বৃদ্ধিকারী পোষক
वातड: কড়া কড়কড়ে শক্ত জমাট কঠোর শুখা শুখো করকরে শুকনো
वातानुकुलीत: বাতানুকূলিত
वादग्रस्त: বিতর্কিত মতৈনক্
वादळ: তীব্র প্রচন্ড
वादाचें: বিতর্কিত মতৈনক্
वादास्पद: বিতর্কিত মতৈনক্
वादीत: বাদিত ধ্বনিত শব্দিত
वानरी: সমাপ্ত সম্পূর্ণ নিষ্পন্ন রচিত সম্পাদিত পূর্ণ সাঙ্গ সমাপিত
वान्शे_विरयत: অনপেক্ষ নিরপেক্ষ বন্ধনহীন মুক্ত স্বাবলম্বী
वापराचें: উপযোগী উপাদেয় ব্যবহারযোগ্য ব্যবহার্য ব্যবহর্তব্য
वापरिल्लें: প্রযুক্ত ব্যবহৃত উপভুক্ত ব্যবহারোপযুক্ত
वाफेचें: বিশুদ্ধপরিশ্রুত
वायट: দুরাশয় কুবিচারী কপট অন্তর্দুষ্ঠ কপটচারী অসত্ অসাধু অসজ্জন অপরিচ্ছন্ন অপরিষ্কৃত অপরিষ্কার মলিন কলুষিত ময়লা নোংরা অস্বচ্ছ অপবিত্র অশুদ্ধ ইতর অধম নিকৃষ্ঠ নীচ তুচ্ছ অসভ্য ক্ষুদ্র বাজে ওঁচা বিপরীত প্রতিকুল অমান্য উল্টো খারাপ মন্দ বাজে বদ জঘন্য কদর্য ভ্রষ্ট যাচ্ছেতাই নিকৃষ্ঠ্ অপকৃষ্ঠ অধম অসত্ ধোঁকাবাজ ধূর্ত চালবাজ চালু চতুর চালাক হুঁশিয়ার শঠ ধড়িবাজ মন্দমতি ধাঁপ্পাবাজ ছলনাকারী জঘন্য গন্দা
वायट_करपी: দুষ্কর্মী অকৃতকারী অপকর্মী খল অকর্মী
वायट_गूण: খারাপ মন্দ বদগুণযুক্ত অপগুণযুক্ত
वायट_मार्गान_मेळयिल्लें: হজম হজম হজম হজম
वायटकार: রোগী অসুস্থ পীড়িত রোগগ্রস্ত রোগার্ত ব্যাধিগ্রস্ত রোগশীর্ণ আতুর রুগণ রোগকাতর
वायव्यी: উত্তর-পশ্চীম উত্তর_পশ্চিমী
वायेचें: চানা_মটর_দিয়ে_এক_ধরনের_খাবার হাপের_রোগি বায়বীয় বায়ব্য
वार्‍याचें: বায়বীয় বায়ব্য
वावटळ: তীব্র প্রচন্ড
वासनाहीण: কামহীন বাসনাহীন নিষ্কাম নির্মম
वास्तवीक: বাস্তব বাস্তবিক প্রকৃত যথার্থ সত্য নিশ্চিত অকাল্পনিক অকল্পিত
वास्तुशिल्पीय: প্রমাণিত প্রতিপাদিত সিদ্ধ
विंगडविंगड: আলাদা_আলাদা আলাদা বিভিন্ন
विकल्पी: বৈকল্পিক বিকল্পযুক্ত বিকল্পী ঐচ্ছিক
विकसीत: উন্নত বিকশিত সুবিকশিত
विकासकर्तो: প্রগতিশীল উন্নতিশীল প্রগতিবাদী প্রগতিপন্থী অগ্রগামী
विकासशील: প্রগতিশীল উন্নতশীল বিকাশশীল উন্নতিশীল উত্থানশীল
विकृत: খারাপ বিকল অস্বাভাবিক অপ্রকৃতিস্থ বিকারগ্রস্থ বিকৃত
विक्रमी: বিক্রমী পরাক্রমশালী পরাক্রান্ত বীর বিক্রান্ত বিক্রমী
विक्राळ: ভয়ংকর ভয়ানক প্রচণ্ড উগ্র বিকট ভীষণ ভয়াল ভয়াবহ রুদ্র করাল ভীতিপ্রদ ভীতিকর ভয়ার্ত ভয়দ উচ্চণ্ড
विखाचें: বিষাক্ত জহরীলা বিশেলা বিষযুক্ত জহরীলা জহরী
विखारी: বিষাক্ত জহরীলা বিশেলা বিষযুক্ত জহরীলা জহরী বিষধর জহরী জহরী জহরীলা জহরীলা জহরীলা জহরীলা জহরী জহরী বিষাক্ত বিশেলা
विखाळ: বিষাক্ত জহরীলা বিশেলা বিষযুক্ত জহরীলা জহরী বিষধর জহরী জহরী জহরীলা জহরীলা জহরীলা জহরীলা জহরী জহরী বিষাক্ত বিশেলা
विख्यात: বিশ্ব_বিখ্যাত জগত্প্রসিদ্ধ লোক_প্রসিদ্ধ
विचलीत: অশান্ত চঞচল অস্থিরচিত্ত উৎকন্ঠিত বিচলিত অস্থির
विचार_करपाचें: বিচারণীয় বিচার্য চিংতনীয় চিন্ত্য অনুশীলনীয়
विचारशुन्य: অবিবেচক বিচারমূঢ় বুদ্ধিহীন হালকা বিচারহীন বিবেচনাহীন
विचारहीण: অবিবেচক বিচারমূঢ় বুদ্ধিহীন হালকা বিচারহীন বিবেচনাহীন অভাবনীয় অচিন্তনীয় চিন্তাতীত অকল্পনীয়
विचारी: বিচারণীয় বিচার্য চিংতনীয় চিন্ত্য অনুশীলনীয়
विचारीक: বিচারপূর্ণ যুক্তিপূর্ণ
विचित्र: অস্বাভাবিক অপ্রাকৃতিক অনৈসর্গিক অপ্রকৃত বিস্মযকর বিস্ময়জনক আশ্চর্য আশ্চর্যজনক চমকপ্রদ চমকদার আজব অদ্ভুত উদ্ভট বিচিত্র
विजयी: সফল সফলকাম সার্থক সিদ্ধ কৃতকার্য
विज्ञानीक: বৈজ্ঞানিক
विटिल्लें: ক্লান্ত
वितरायिल्लें: সম্প্রচার সম্প্রচারিত
वितळिल्लें: অভিতপ্ত তপ্ত উত্তপ্ত প্রতপ্ত
विदेशी: বিদেশী বিদেশীয় ভিনদেশী পরদেশী পরবাসী দেশান্তরিত প্রবাসী বিদেশী ভিনদেশী অন্যরাষ্ট্রীয অন্যদেশীয়
विद्यालयीन: বিদ্যালয়ের স্কুলের পাঠশালার
विद्रूप: কুরূপ কুশ্রী অসুন্দর কদাকার কুতনু কুদর্শন শ্রীহীন কুতসিত খারাপ বিকল অস্বাভাবিক অপ্রকৃতিস্থ বিকারগ্রস্থ বিকৃত
विद्वत्तापूर्ण: পান্ডিত্যপূর্ণ
विद्वान: বিদ্বান জ্ঞানী জ্ঞানবান পন্ডিত বুদ্ধ বিজ্ঞ অভিজ্ঞ বিদ্যবান সম্বুদ্ধ প্রবুদ্ধ
विधवा: বিধবা স্বামীহীনা পতিহীনা যতী রাঁড়ী রাঁড় বেওয়া
विधानीक: বিধানীয়
विधिचें: বৈধ_কানুন বিধিমান্য বিধিক
विधीलिखीत: প্রারব্ধাধীন নিয়তি_অধীন পূর্ব_নিশ্চিত বিধিবশ
विधेयात्मक: বিধেয়াত্মক
विनम्र: সবিনয় বিনয়ী বিনীত নম্র ভদ্র শিষ্ঠ শালীন
विनयशील: বিনীত বিনয়যুক্ত বিনয়ী বিনম্র সবিনয়
विनयी: ইমানদার বিশ্বস্ত সত্ অকপটচিত্ত নিষ্কপট সজ্জন সাচ্চা
विनाशक: নাশক নাশী বিনাশী বিনাশক বিনায়ক বিধ্বংসী বিধ্বংসক
विनाशी: নাশক নাশী বিনাশী বিনাশক বিনায়ক বিধ্বংসী বিধ্বংসক
विभागणी: বিভাজিত আলাদা বিভক্ত ভেদিত
विभागी: আঞ্চলিক স্থানিয় লোকাল অঞ্চলীয় স্থলীয়
विभाजक: বিভাজক খণ্ডক বিভাজনকারী
विभुशीत: অলঙ্কৃত উপাধিত বিভূষিত অলংকৃত ভুষিত আভুষিত সজ্জিত
वियेतनामी: ভিয়েতনামী ভিয়েতনামীজ ভিয়েতনামী ভিয়েতনামীজ
विरक्त: বিরক্ত বিমুখ বৈরাগী বিরাগী সন্ন্যাসী অপাশ্রিত
विरळ: অগভীর বিরলা বিরলা কোঈ-কোঈ ইক্কা-দুক্কা
विरहिणी: বিরহিণী বিরহপীড়িতা
विरुद्ध: বিপরীত উল্টো বিপরীত প্রতিকুল অমান্য উল্টো বিরুদ্ধ
विरोधा_बगरचें: অবিরোধী অবিরুদ্ধ নির্বিরোধ
विरोधी: বিরোধিত বিসংবাদিত বিরোধযুক্ত বিরোধপূর্ণ
विरोधी_पक्ष: শত্রুপক্ষ বিপক্ষ প্রতিপক্ষ বিরোধী বিরুদ্ধাচারী বিদ্বেষী
विरोधीत: অপকৃত ক্ষতিকারক হানিকর বিরোধিত
विलक्षण: বিস্মযকর বিস্ময়জনক আশ্চর্য আশ্চর্যজনক চমকপ্রদ চমকদার আজব অদ্ভুত উদ্ভট বিচিত্র
विलासी: কামুক কামী লম্পট বিলাসী বিষয়ী ভোগী কামচারী কামকূট লম্পট বিলাসী আয়েসি বিলাসপরায়ণ বিলাসপ্রিয় ভোগবিলাসী আরামপ্রিয় সুখী শৌখিন রঙ্গিলা স্ফূর্তিবাজ
विलीन: বিলীন অদৃশ্য অদৃষ্টিগোচর অদৃষ্টয়মান নাদেখা অন্তরহিত
विवश: বাধ্য অসহায়
विवादास्पद: বিতর্কিত মতৈনক্
विवाहीत: বিবাহিত পরিণীত
विवीध: অনেক কই বিবিধ নানা একাধিক কতিপয় অনেকানেক তমাম অনোগ
विवेकी: বিবেকবান বিবেকশীল
विशम: বিজোড় বেজোড় অযুগ্ম জোড়হীন বিষম
विशाचें: বিষাক্ত জহরীলা বিশেলা বিষযুক্ত জহরীলা জহরী
विशारी: বিষাক্ত জহরীলা বিশেলা বিষযুক্ত জহরীলা জহরী বিষধর জহরী জহরী জহরীলা জহরীলা জহরীলা জহরীলা জহরী জহরী বিষাক্ত বিশেলা
विशाळ: বিশাল বৃহৎ বৃহদ বিরাট বড় এমনি সুন্দর অনবদ্য অতুলনীয় রাজসিক রাজোচিত নান্দনিক প্রশস্ত বড় বৃহত্ বিশাল
विशाळकाय: অতিকায় বৃহদাকার ভীমাকৃতি স্থূলকায়৷ বিশাল প্রকাণ্ড বৃহত্ বৃহদাকার প্রকাণ্ড
विशीचें: বৈশেষিক
विशुववृत्ती: বিষুবীয়
विशेश: বিশিষ্ট অসামান্য অসাধারন বিশেষ
विश्वव्यापी: বিশ্বব্যাপী বিশ্বব্যাপ্ত
विश्वासघातकी: বিশ্বাসঘাতী দাঙ্গাবাজ দগাবাজ হারমী গহার বেবাফা অপঘাতক অপঘাতী
विश्वासी: বিশ্বাসী বিশ্বাসযোগ্য বিশ্বাসশীল
विश्वीक: সার্বভৌমিক সার্বভৌম
विसंगत: অনুচিত অন্যায় অন্যায্য অসংগত অসমীচীন ন্যায়বিরুদ্ধ
विसरिल्लें: অসম্পূর্ণ অপূর্ণ_রচিত
विसवदिणी: আরামদেহ আরমদায়ক
विसवहीण: যন্ত্রণাদায়ক পীড়াদায়ক কষ্টকর কষ্টদায়ক বেদনাদয়ক
विस्कळ: অগভীর
विस्कळीत: অব্যবস্থিত ব্যবস্থাহীন অনবস্হা বিস্থাপিত স্থানচ্যুত
विस्तारीत: বিস্তৃত বিশদ লম্বা-চওড়া বিস্তারিত অভিবৃদ্ধ
विस्तृत: বিশদ সবিশেষ সবিস্তার পুঙ্খ সবিস্তার
विस्थापीत: বিস্থাপিত স্থানচ্যুত
विस्वासघातकी: ধোঁকাবাজ ধূর্ত চালবাজ চালু চতুর চালাক হুঁশিয়ার শঠ ধড়িবাজ মন্দমতি ধাঁপ্পাবাজ ছলনাকারী
विस्वासू: আস্থাভাজন নির্ভরযোগ্য বিশ্বাসী
विहीत: বিহিত বিধিসম্মত বৈধ বিধিগত যথাবিহিত বিধানসম্মত
वीर: বীর বাহাদুর শুর বলবান বলশালী
वीस: এককুড়ি কুড়ি বিশ
वेंचणूक: নির্বাচনী
वेंचिल्ली: নিযুক্ত নিয়োজিত
वेंचिल्लें: মনোনীত নির্বাচিত
वेंचून_काडिल्लें: মনোনীত নির্বাচিত
वेगळायिल्लें: অপসৃত
वेगळी: অস্বাভাবিক অপ্রাকৃতিক অনৈসর্গিক অপ্রকৃত অব্যবহৃত অপ্রযুক্ত অনিযুক্ত নতুন অস্পৃষ্ট
वेगळे: আলাদা পৃথক ভিন্ন অসম বিভিন্ন অসমান বিসম
वेगळें: বিপরীত উল্টো অসংশ্লিষ্ট অসংলগ্ন অসম্বদ্ধ আলাদা পৃথক বিচ্ছিন্ন অসংযুক্ত অযুক্ত ভিন্ন
वेगळें_केल्लें: অপসৃত
वेगळेंवेगळें: আলাদা_আলাদা আলাদা বিভিন্ন
वेगवान: দ্রুত দ্রুতগামী দ্রুতগতিসম্পন্ন ফাস্ট
वेगहीण: গতিহীন গতিহারা গতিরহিত স্থির অগতি
वेगाचे: প্রবল প্রচন্ড উগ্র তেজ কড়া তীব্র সুতীব্র অত্যন্ত
वेगाचें: গতিশীল সচল চলমান অস্থির অবিরাম গতিময় জঙ্গম ত্বরিতগতি দ্রুতগামী দ্রুতগতি শীঘ্রগামী ক্ষিপ্রগতি বেগবান ত্বরিত ক্ষিপ্র দ্রুত শীঘ্র অচির
वेगान: দ্রুত ক্ষিপ্র ত্বরিত সবেগ দ্রুতগামী বেগবান
वेदीचें: মনোরম_নৈশর্গিক_দৃশ্য_সম্বলিত নৈশর্গিক_শোভামন্ডিত
वेधप: ভেদ্য ভেদনীয়
वेर्थ: নিষ্ফল বিফল ব্যর্থ অসফল অকৃতকার্য অসার্থক নিরর্থক অকৃতার্থ অফলদায়ী অফলদায়ক
वेलापवर्ती: সামুদ্রিক সামুদ্রক সমুদ্রিয় সাগরিক
वेळ: দেরি বিলন্বিত লেট
वेळार: সাময়িক ক্ষণস্থায়ী সময়বিশেষে_ঘটে_এমন সময়োচিত বর্তমান_ঘটনাবলি_সংক্রান্ত_বা_নির্দিষ্ট_সময়ান্তরে_প্রকাশ্য
वेवस्थीत: বিন্যস্ত সুবিন্যস্ত সুসজ্জিত পরিপাটি অবস্থিত সুব্যবস্থিত সুবিন্যস্ত সুসমঞ্জস সঠিক উচিত ন্যায্য সংগত উপযুক্ত যথাযথ যথার্থ যোগ্য যথোপযুক্ত নিরাপদ নিরুপদ্রব নির্বিঘ্ন সুরক্ষিত
वेव्हारी: কঠোর কঠিন শক্ত কড়া অনমনীয় ব্যবহারযোগ্য ব্যবহার্য ব্যবহর্তব্য
वेश्टिल्लो: আচ্ছাদিত ঢাকা আবৃত্ত আচ্ছন্ন
वेश्यागामी: বেশ্যাগামী রন্ডীবাজ রন্ডীবাজ এয়াশী এয়াশী বেশিক
वैचारीक: বিচারপূর্ণ যুক্তিপূর্ণ
वैतनीक: বৈতনিক বেতনভোগী বৃত্তিধারী বেতনধারী বৃত্তিভুক
वैभवशाली: ধন্যায় ধণী আমীর দৌলতবান ধনবান মালদার ধনবত বৈবভশালী মালামাল সমুদ্রশালী ধনধ্যানপূর্ণ সম্পতিবান ধনী
वैयक्तीक: নিজস্ব নিজের ব্যক্তিগত
वैरपणाचो: শত্রুতাপূর্ণ বৈরপূর্ণ বৈরপূর্ণ
वैरी: শত্রুপূর্ণ
वैश्वीक: সার্বভৌমিক সার্বভৌম
वोल्ताचें: ঘুর্য্ণীয়া ঘুরুণে ঘুরুণিয়া ঘুরনযুক্ত
व्यक्त: অভিব্যক্ত প্রকাশিত প্রকটিত জাহির বিকশিত প্রদর্শিত প্রকট ব্যক্ত প্রকাশিত প্রকটিত প্রকট আবির্ভূত স্ফুট পরিস্ফুট
व्यक्तीगत: নিজস্ব নিজের ব্যক্তিগত
व्यभिचारी: ব্যভিচারী কামুক দুঃচরিএ বদচলন কামী এয়াশা অন্যগামী ব্যভিচারিণী কুলটা চরিত্রহীনা ছিনাল ভ্রষ্টা
व्यर्थ: নিষ্ফল বিফল ব্যর্থ অসফল অকৃতকার্য অসার্থক নিরর্থক অকৃতার্থ অফলদায়ী অফলদায়ক অনর্থক অফল অফলদায়ক নিষ্ফল ব্যর্থ ফালতু
व्यस्त: ব্যস্ত কর্মব্যস্ত
व्याकूळ: অধীর ব্যাকুল আকুল ব্যগ্র কাতর উদ্বিগ্ন উদ্বেল উত্কন্ঠিত অস্থির অধৈর্য
व्याप्त: ব্যাপী
व्युत्पन्न: উড়িয়া
व्हगडायिल्लें: বরবাদ
व्हड: মহান সুমহান মহত্ মহীয়ান মহাত্মা বড় উদার শ্রেষ্ট বিশাল বৃহৎ বৃহদ বিরাট বড় দারুণ অগ্রজ অগ্রজাত অগ্রজন্মা বড় বয়োজ্যেষ্ঠ জ্যেষ্ট বয়োজ্যেষ্ঠ বড় অগ্রজ সুন্দর অনবদ্য অতুলনীয় রাজসিক রাজোচিত নান্দনিক প্রশস্ত বড় বৃহত্ বিশাল
व्हड-मनाचो: উদার বিশালহৃদয় উদারচরিত দরিয়াদিল উদরচিত্র উদারমনা অকৃপণ
व्हड_आंकडो: বহুসংখ্যক বহুত প্রচুর অনেক
व्हड_काळजाचो: উদার বিশালহৃদয় উদারচরিত দরিয়াদিল উদরচিত্র উদারমনা অকৃপণ
व्हडली: বিশাল বড় ভারী বিরাট
व्हडलें: অগ্রজ অগ্রজাত অগ্রজন্মা বড় বয়োজ্যেষ্ঠ জ্যেষ্ট বয়োজ্যেষ্ঠ বড় অগ্রজ বড় বৃহত্ বিশাল
व्हांवतें: প্রবাহিত বহতা বহতা প্রবাহশীল প্রবাহময় গতিশীল গতিমান প্রবাহী
व्हांवपी: প্রবাহিত বহতা বহতা প্রবাহশীল প্রবাহময় গতিশীল গতিমান প্রবাহী
शंखाचो: শাঙ্খিক
शंखाच्यो: শঙ্খনির্মিত শঙ্খরচিত
शंख्वाकार: শঙ্কুকার
शंबर: শ শত একশ
शक्तीवर्धक: পুষ্টিকর পুষ্টিদায়ক বলবর্ধক বলদায়ক বলকারক শক্তিবর্ধক স্বাস্থ্যকর
शक्य: সম্ভব সম্ভাবনীয় সম্ভাবিত সম্ভাব্য
शत्रुहीण: শত্রুহীন অজাতশত্রু শত্রুবিহীন অরিহীন
शब्दाचें: আগামী ভবিষ্যতের আগামীকালের ভাবী অনাগত আসন্ন
शब्दाडंबराचें: একেলা নির্জন_স্থান জনহীন জনশূন্য
शरण_आयिल्लो: শরণাগত
शरणागत: শরণাগত
शरणार्थी: শরণার্থী
शांत: কোমল_স্বভাবী সোম সোম্য সভ্য শিষ্ট শালীন সুশীল সুব্যবহার গম্ভীর শান্ত সৌম্য ধীর স্থির অচঞ্চল অচপল অনুদ্যত বিরোধহীন ঠান্ডা প্রশান্ত শান্ত নিরুদ্বিগ্ন উদ্বেগহীন স্থির সুস্থিত শান্ত ধীর স্থির প্রশান্ত অচঞ্চল স্থিরচিত্ত অবিচলিত শান্ত অচণ্ড ঠাণ্ডা অক্রুদ্ধ অক্রোধিত অপ্রমত্ত অনুন্মত্ত অক্ষিপ্ত প্রকৃতিস্থ অমত্ত নিঃশব্দ শান্ত নিঃশ্চুপ
शांती_दिवपी: শন্তিপ্রদ শান্তিদাযী শন্তিদাযক শান্তিপ্রদাযক
शांतीदिणें: শন্তিপ্রদ শান্তিদাযী শন্তিদাযক শান্তিপ্রদাযক
शांयशीं: ছিয়াশি
शाक्त: অসাময়িক অকালিক অবসর_প্রতিকূল
शाण्णव: ছিয়ানব্বুই ছিয়ানব্বই
शात्तर: ছিয়াত্তর
शापीत: শাপিত শাপগ্রস্ত অভিশপ্ত অভিশাপিত
शापोती: ধৃষ্ট উচ্ছৃঙ্খল অভদ্রচিত অশালীন অশোভন বেয়াড়া উদ্ধত
शाब्दीक: আগামী ভবিষ্যতের আগামীকালের ভাবী অনাগত আসন্ন
शारांतले: শহরী নগর_বাসী নগর_নিবাসী নগর-বাসী নগর-নিবাসী নগরনিবাসী নগরবাসী শহরাতী নাগর অগ্রাম্য পুরবাসী
शारिकरणाचें: শহরীকরণ নাগরীকরণ
शारी: শহরী নগর_বাসী নগর_নিবাসী নগর-বাসী নগর-নিবাসী নগরনিবাসী নগরবাসী শহরাতী নাগর অগ্রাম্য পুরবাসী মহানগরী
शारीकरणी: শহরীকরণ নাগরীকরণ
शाळचें: বিদ্যালয়ের স্কুলের পাঠশালার
शाश्वत: অমর অক্ষয় অনশ্বর শাশ্বত অক্ষুন্ন অক্ষর অনষ্ট অবিনাশী অভঙ্গ অনাশ অনাশ্য অনাশবান অভঙ্গুর চির চিরকালীন চিরন্তন চিরস্থায়ী সনাতন শাশ্বত নিত্য অনন্ত অবিচ্ছিন্ন অবিনাশী অবিনশ্বর
शासकी: প্রশাসক প্রশাস্তা প্রশাসিতা৷ প্রশাসনিক
शासन: শাসিত প্রশাসিত অভিশাসিত
शास्त्रीय: শাস্ত্রীয় শাস্ত্রীয় শাস্ত্রোক্ত
शास्वत: অবিনশ্বর অবিনাশী
शाही: শাহী
शिंपडिल्लें: ছড়ানো এলোমেলো বিকীর্ণ প্রসারিত বিস্তৃত প্রশস্ত প্রতত বিসারিত অত্যায়ত পরিব্যাপ্ত
शिंपिल्लें: ভেজা ভিজে আর্দ্র সিঞ্চিত সিক্ত নিষিক্ত অভিষিক্ত জলসিক্ত
शिंयाळें: ঠান্ডা শীতকালীন শীতের হিমেল শীতপ্রধান
शिंविल्लें: সেলাই
शिकपी: অধ্যয়নরত অধ্যয়ননিরত পাঠরত
शिकारी: শিকারী শিকারী
शिकिल्लें: শিক্ষিত সাক্ষর
शिक्षणीक: শিক্ষাগত শৈক্ষিক
शिक्षीत: শিক্ষিত সাক্ষর
शिटूक: প্রফুল্ল উত্ফুল্ল প্রসন্ন আনন্দিত আনন্দবিহ্বল সহর্ষ উচ্ছ্বসিত উল্লসিত জহীন জহীন
शिटूक.: চালাক চতুর হুঁশিয়ার সেয়ানা পটু চালাকচতুর প্রখরবুদ্ধি
शिडशिडीत: রোগা কৃশ শীর্ণ ক্ষীণ ছিপছিপে রোগা-পাতলা
शितळ: ঠান্ডা শীতল সুশীতল অনুষ্ণ হিম ঠাণ্ডা শীতল হিম হিমশীতল হিমেল শান্ত অচণ্ড ঠাণ্ডা অক্রুদ্ধ অক্রোধিত ঠাণ্ডা শীতল স্নিগ্ধ শীতলকারক আরামদায়ক
शिफारशीत: অনুশংসিত
शिमा_रक्षक: সীমা_রক্ষক সীমাপাল
शिमीत: সসীম পরিসীমিত সীমিত সসীম পরিসীমিত সীমিত সংযত নিয়ন্ত্রিত নিবৃত্ত প্রতিহত প্রশমিত বশীভূত পরিমিত
शिरंगार: সাজানো
शिरापीत: শাপিত শাপগ্রস্ত অভিশপ্ত অভিশাপিত
शिल्लक: দেয় বকেয়া দাতব্য দায় বকেয়া বাকী শেষ
शिश्ट: সভ্য শিষ্ট শালীন সুশীল সুব্যবহার
शींगां_आशिल्लें: শৃংগযুক্ত শৃংগী
शीत: ঠান্ডা শান্ত নম্র বিনয়যুক্ত বিনীত ঠাণ্ডা শীতল স্নিগ্ধ শীতলকারক আরামদায়ক
शीम_रक्षक: সীমা_রক্ষক সীমাপাল
शुद्ध: বিশুদ্ধ শুদ্ধ পরিষ্কার খাঁটি নির্ভেজাল নিখাদ ভেজালহীন অমিশ্রিত বাছাই পরিচ্ছন্ন পরিষ্কার পবিত্র প্রাঞ্জল সাফ সাফসুতরো শুচি শুদ্ধ অমল বিমল সুবিমল নির্মল বিশুদ্ধ অনাবিল বিশুদ্ধ খাঁটি আসল প্রকৃত যথার্থ শুদ্ধ বিশুদ্ধ শুদ্ধ পরিশোধিত
शुल्लक: ছোটো_খাটো অল্প_বিস্তর হালকা_ফুলকা
शूभ: শুভজনক হিতকর মাঙ্গল্য মাঙ্গলিক শুভদ ক্ষেমকর
शूर: বীর বাহাদুর শুর বলবান বলশালী
शेंकड्यांनी: একশকোটি
शेचाळीस: ছেচল্লিশ
शेजारचें: অন্তরিত অন্তর্হিত গৃহবন্দি
शेण_मेळयिल्लें: গোবরে
शेणलेलो: পথভোলা হারানো মার্গচ্যুত
शेणाचें: গোবরে গোবরময় গোময় গোমিষ্টাময় গোমলময় গোকৃতময় গোবিটময় সারময় গোপুরীষময় সারকুড়ময়
शेणिल्लो: পথভোলা হারানো মার্গচ্যুত
शेतकी: কৃষিজ
शेपडायिल्लें: হত নিহত অপহত খতম
शेपडी_आशिल्लें: লেজযুক্ত
शेपडेचें: লেজবিশিষ্ট লাঙুলি লেজযুক্ত
शेष: দেয় বকেয়া দাতব্য দায়
शोकी: বিলাস শৌখিন রং-তামাশা সুখভোগ
शोकीन: বিলাস শৌখিন রং-তামাশা সুখভোগ
शोधक: সন্ধানরত অনুসন্ধানরত খোঁজরত নিরীক্ষমাণ অন্বেষক অন্বেষণকারক অন্বেষণকারী অনুসন্ধানবান
शोधीत: শোধিত অন্বেষিত অনুসন্ধানিত গবেষিত
शोशीत: গৌরবময়
शौकीन: বিলাসী আয়েসি বিলাসপরায়ণ বিলাসপ্রিয় ভোগবিলাসী আরামপ্রিয় সুখী শৌখিন রঙ্গিলা স্ফূর্তিবাজ
श्रद्धाळू: শ্রদ্ধালু
श्रवणीय: শ্রবনীয় শ্রব্য শ্রবনীয় শ্রব্য
श्रीमंत: ধন্যায় ধণী আমীর দৌলতবান ধনবান মালদার ধনবত বৈবভশালী মালামাল সমুদ্রশালী ধনধ্যানপূর্ণ সম্পতিবান ধনী
श्रेणीय: শ্রেণীয়
श्रेष्ठ: মহান সুমহান মহত্ মহীয়ান মহাত্মা বড় উদার শ্রেষ্ট
स: ছয়
स_पटींनी: ছয়গুণ
संकुचीत: সংকীর্ণ সংকীর্ণমনা সংকুচিত অনুদার হীনচেতা
संकोची: সংকুচিত কুণ্ঠিত কুণ্ঠাযুক্ত দ্বিধাগ্রস্ত বিহ্বল লজ্জিত
संगणकाचें: প্রতিবন্ধিত
संगणकी: প্রতিবন্ধিত
संगणकीकरणी: কম্পিউটারীকৃত কম্পিউটারীকৃত
संगमरवरी: শুখা শুখো করকরে শুকনো
संघटनेचें: সংঘীয়
संघर्शीत: সংঘর্ষরত
संघीय: সংঘীয়
संचालीत: সঞ্চালিত চালিত আন্দোলিত
संत: অবিস্মরণীয়
संतुळीत: উপযুক্ত
संदीसादू: সুবিধাবাদী সুযোগসন্ধানী
संन्याशी: সন্যাসী পরিব্রাজক সাধু
संपादनीय: প্রত্যক্ষ ইন্দ্রিয়গোচর অপরোক্ষ
संपादीत: সম্পাদিত
संबंदहीण: সম্বন্ধহীন সম্বন্ধরহিত সম্বন্ধশূন্য সম্বন্ধবিহীন সম্পর্কহীন সম্পর্করহিত সম্পর্কশূন্য সম্পর্কবিহীন সংস্রবহীন সংস্রবরহিত সংস্রবশূন্য সংস্রববিহীন যোগাযোগহীন যোগাযোগরহিত যোগাযোগশূন্য যোগাযোগবিহীন
संबंदा_बगरचें: সম্বন্ধহীন সম্বন্ধরহিত সম্বন্ধশূন্য সম্বন্ধবিহীন সম্পর্কহীন সম্পর্করহিত সম্পর্কশূন্য সম্পর্কবিহীন সংস্রবহীন সংস্রবরহিত সংস্রবশূন্য সংস্রববিহীন যোগাযোগহীন যোগাযোগরহিত যোগাযোগশূন্য যোগাযোগবিহীন
संबंदीत: সম্বন্ধিত
संबोधक: সংবোধক
संभव: সম্ভব সম্ভাবনীয় সম্ভাবিত সম্ভাব্য
संभोग_घेवपी: সম্ভোগী ভোগী উপসেবী
संभोगी: সম্ভোগী ভোগী উপসেবী
संयमी: সংযমী নিয়মী সংযমশীল সংযত নিয়ন্ত্রিত নিবৃত্ত প্রতিহত প্রশমিত বশীভূত পরিমিত সংযত নিয়ন্ত্রিত নিবৃত্ত প্রতিহত প্রশমিত বশীভূত পরিমিত
संयमीत: সংযমী সংযমপরায়ণ সংযমিত সংযমী
संयुक्त: যুক্ত সংযুক্ত সন্নিহিত লিপ্ত সংলিপ্ত শ্লিষ্ঠ সম্পৃক্ত সংশ্লিষ্ঠ জোড়া জোড়িত বিজোড়িত একত্র
संयोगी: আলবানিয়ান
संयोजक: আলবানিয়ান
संवसारीक: ইহলৌকিক সাংসারিক লৌকিক দুনিয়াদারী বিশ্বব্যাপী বিশ্বব্যাপ্ত
संविधानीक: সংবিধানীক সংবিধানীয় বিধানিক
संवेदनशीळ: সংবেদনশীল সংবেদী অনুভুতিময় সচেতন
संशयी: সন্দিগ্ধ সন্দেহাস্পদ সন্দিগ্ধ সন্দেহাস্পদ সন্দেহ_প্রবন সম্ভ্রান্ত কুলীন
संशोदक: শোধক অনুসন্ধানী অন্বেষক অনুসন্ধানী শোধকর্ত্তা শোধকর্তা
संशोधक: আবিষ্কারক আবিষ্কর্তা
संसर्गजन्य: সংক্রামক
संसर्गीक: সংক্রামক
संस्कृत: সংস্কৃত
सकयलें: নীচ নিম্ন পতিত অন্ত্য অন্ত্যবর্ণ অন্ত্যজ ব্রাত্য নিম্ন
सकयलो: নিচু নিম্ন অনুচ্চ অবনত অনুন্নত অতুঙ্গ্
सकयल्ल्या__कुळाचें: নিম্ন_কুলীন নিম্ন_বংশীয়
सकलें: নগন্য ছোট মামুলি তুচ্ছ যে-সে অগন্য নাচীজ যে-সে নিচু নিম্নস্থ অনুচ্চ অতুঙ্গ
सक्तीचें: অনিবার্য
सक्षम: সক্ষম ক্ষমতাবান সামর্থ্যবান ক্ষমতাশালী সামর্থী
सगली: পুরো সম্পূর্ণ সমগ্র সব সমুদয় সমস্ত সকল সমুচয় তামাম সর্ব অখিল
सगलें: পুরো সম্পূর্ণ আদ্যপান্ত সমগ্র সব সমুদায় সমুদয় সমস্ত
सगल्या_गुणांनी_भरिल्लो: সর্বগুণ_সম্পন্ন সর্বগুণ_যুক্ত
सगल्यांक_खबर_आशिल्लें: সর্ব_সংজ্ঞাত সর্বজ্ঞাত
सगूण: সগুণ গুণপূর্ণ সর্বগুণসম্পন্ন গুণময়
सजयिल्लें: সুসজ্জিত সজ্জিত সাজানো-গোছানো ছিমছাম ফিটফাট আলংকারিক
सजावट: সাজানো
सजिल्लो: সাজসজ্জা সজ্জিত
सजीव: জীবন্ত সজীব
सज्जन: সজ্জন সুজন ভদ্র সভ্য সুভদ্র শিষ্ট ভব্য সভ্যভব্য সুশীল সুশীলা নম্র বিনয়ী
सटीक: সঠিক উচিত ন্যায্য সংগত উপযুক্ত যথাযথ যথার্থ যোগ্য যথোপযুক্ত
सडसडीत: সুস্থ নীরোগ রোগহীন রোগশূন্য ভালো সবল
सडीक: সঠিক উচিত ন্যায্য সংগত উপযুক্ত যথাযথ যথার্থ যোগ্য যথোপযুক্ত
सडेतोड: স্পষ্টভাষী মুখফোঁড় কট্টার অপ্রিয়ভাষী অপ্রিয়বাদী দুর্বাক
सणसणीत: কড়া
सत: সত্য প্রকৃত ঠিক হক যথার্থ
सत_उलोवपी: সত্যবাদী সত্যভাষী সত্যবাক্ যথার্থবাদী সাচ্চা
सतत: অনবরত অবিরত সর্বদা নিত্য নিয়ত প্রায়ই নিরন্তর
सतर्क: প্রফুল্ল উত্ফুল্ল প্রসন্ন আনন্দিত আনন্দবিহ্বল সহর্ষ উচ্ছ্বসিত উল্লসিত
सतर्क.???????????: সচেতন সাবধান চৌকস সতর্ক সজাগ খবরদার হুঁশিয়ার
सतायिल्लें: প্রতারিত
सत्तर: সত্তর
सत्ता: শাসিত প্রশাসিত অভিশাসিত
सत्ते_खाला: অধীন আধীন
सत्ते_तळा: অধীন আধীন
सत्य: সত
सत्यनिश्ठ: সত্যবতী
सत्यभाशी: সত্যবাদী সত্যভাষী সত্যবাক্ যথার্থবাদী সাচ্চা
सत्यवादी: সত্যবাদী সত্যভাষী সত্যবাক্ যথার্থবাদী সাচ্চা সত্যবতী
सदळ: শিথিল থলথলে ঢিলা আলগা ঢিলে ঢলঢলে ঢিলেঢালা ঢোলা শিথিল ঢিলা আলগা আলগা আলতো ঢিলা ঢিলে
सदळ_हाताचें: মুক্তহস্ত মুক্তকর
सदां__खातीरचें: অবিনশ্বর অবিনাশী
सदापर्णपाती: চিরহরিত্
सदापर्णी: চিরহরিত্
सदाहरीत: চিরহরিত্
सद्गूण: সগুণ গুণপূর্ণ সর্বগুণসম্পন্ন গুণময়
सनसनाटी: চটকদার
सनातन: চির চিরকালীন চিরন্তন চিরস্থায়ী সনাতন শাশ্বত নিত্য অনন্ত অবিচ্ছিন্ন অবিনাশী অবিনশ্বর চলতি নিয়ত আবহমান
सनाथ: সনাথ
सपाट: সাপটা সাধারণ নির্বিকার নির্লিপ্ত ভাবলেশহীন
सप्तकाचें: সাপ্তাহিক
सभावीक: স্বাভাবিক স্বাভাবগত
सभ्य: সভ্য শিষ্ট শালীন সুশীল সুব্যবহার
सम: সমান তুল্য বরাবর স্পষ্ট সদৃশ
समकालीन: সাময়িক ক্ষণস্থায়ী
समजिकायचें: সামজ্ঞস্যপূর্ণ মিল
समजूंक_नाशिल्लें: অবোধ্য দুর্বোধ্য দুর্বোধ জটিল খটমট
समजूतदार: বিবেকবান বিবেকশীল
समजूतदारपणाचें: সামজ্ঞস্যপূর্ণ মিল
समन्वयीत: সন্নিহিত সমাহিত
समरुपी: প্রতিরূপী অনুরূপী সমরূপী
समर्पीत: সমর্পিত
समाजीक: সামাজিক সাম্প্রদায়িক সম্প্রদায়বদ্ধ সমাজভুক্ত
समाधान: গদগদ গদ্দদ
समाधानी: সমাধানিত মীমাংসিত সমাধান_যোগ্য সমাধান্য সমাধেয় গদগদ গদ্দদ
समाधिस्त: সমাধিস্থ সমাধিত
समान: তদনুরূপ তদাকার সদৃশ অনুরূপ তূল্য মতন ডুপ্লিকেট
समानार्थी: সমানর্থক
समाप्त: সমাপ্ত পরিসমাপ্ত সাঙ্গ সম্পন্ন সমাপিত নিষ্পাদিত শেষ খতম পূর্ণ সম্পূর্ণ পরিপূর্ণ পুরো
समिक्षणात्मक: সমালোচনামূলক
समुद्री: সমুদ্রের সাগরের সামুদ্রিক সৈন্ধব সৈন্ধব সামুদ্রিক সমুদ্রজাত সমুদ্রীয় সামুদ্রিক
समृद्धिदिणें: সমৃদ্ধিপ্রদ সমৃদ্ধিপ্রদায়ক সমৃদ্ধিদায়ক সমৃদ্ধি_দানকারী ঐশ্বর্যপ্রদ ঐশ্বর্যপ্রদায়ক ঐশ্বর্যদায়ক ঐশ্বর্যদানকারী
समेटाचें: অনুবদ্ধ
समेस्त: পুরো সম্পূর্ণ সমগ্র সব সমুদয় সমস্ত সকল সমুচয় তামাম সর্ব অখিল
सम्मानीत: সম্মানিত অভিপূজিত আদৃত অপচিত
सय__केल्ली: হস্তাক্ষরিত
सयल: আলগা আলতো ঢিলা ঢিলে
सरकारी: প্রশাসক প্রশাস্তা প্রশাসিতা৷ প্রশাসনিক
सरबरायेचें: অতিথীপরায়ন আতিথেয়তা
सरळ: ঝামেলাহীন ঝামেলাবিহীন ঝামেলারহিত সহজ আসান সরল সুগম প্রাকৃতিক প্রাকৃত স্বাভাবিক নৈসর্গিক প্রকৃতিজাত অকৃত্রিম সহজ প্রকৃত বোধ্য বোধগম্য আসান সরল সুগম সহজ আসান সরল সুগম নিষ্কোপোট সাদাসিধে ভোলাভালা সুবিধাজনক সুবিধাপূর্ণ সহজ শোনানো সোজা বাঁকহীন মোড়হীন সুগম্য সুগম স্পষ্ট সুস্পষ্ট স্বচ্ছ প্রকট পরিস্ফুট সোজা সহজ সিধা সিধে অভিজাত মর্জিতভাব পোশাকের_চমৎকারিত্ব
सरसादारण: সর্বজনীন সর্বসাধারণ আপামর
सरसामान्य: সর্বসামান্য সর্বসাধারণ সর্ববিচরণশীল সর্বজনীন সর্বসাধারণ আপামর
सरींचें: কাছের নিকটতম নিকটবর্তী নিকটস্থ সন্নিকট সমীপস্থ সমীপবর্তী
सर्गींचें: স্বর্গীয় স্বর্গ্য অমর্ত্য দিব্য অপার্থিব
सर्गेस्त: মৃত মৃতক প্রয়াত স্বর্গগত স্বর্গীয় অপগত মরহুম গত তিরভৃত স্বর্গস্থ
सर्पील: সর্পিল
सर्वगुणी: সর্বগুণ_সম্পন্ন সর্বগুণ_যুক্ত
सर्वगूणसंपन्न: সর্বগুণ_সম্পন্ন সর্বগুণ_যুক্ত
सर्वव्यापी: সর্বব্যাপী সর্বব্যাপ্ত সর্ববিরাজমান
सर्वश्रेश्ट: উত্কৃষ্ট অত্যুত্কৃষ্ট উত্তম শ্রেষ্ঠ সেরা প্রকৃষ্ট প্রশস্ত
सर्वसादारण: সর্বজনীন সর্বসাধারণ আপামর
सर्वसामान्य: সর্বসামান্য সর্বসাধারণ সর্ববিচরণশীল সর্বজনীন সর্বসাধারণ আপামর
सर्वोच्च: চরম সর্বোচ্চ সব_চেয়ে_বেশি চূড়ান্ত
सर्वोत्कृश्ठ: সর্বোত্তম সর্বোশ্রেষ্ঠ সর্বোৎকৃষ্ট অনুত্তম অনুত্তর পুষ্কল
सर्वोत्तम: সর্বোত্তম সর্বোশ্রেষ্ঠ সর্বোৎকৃষ্ট অনুত্তম অনুত্তর পুষ্কল
सर्वोपरी: সর্বোচ্চ সব_চেয়ে_বেশি চূড়ান্ত
सळसळीत: গরমাগরম গরম_গরম
सवकाश: মন্দ মন্থর ধীর শ্লথ বিলম্বিত ঢিমা মৃদু
सवकास: মন্দ মন্থর ধীর শ্লথ বিলম্বিত ঢিমা মৃদু
सवाय: সস্তা অল্পমূল্য কম_দামী সোয়া সবাযা সবাগুনা সস্তা অল্পমূল্য কম_দামী
सवार: সওয়ার আরূঢ়
सवें: ষষ্টম
सव्वा: সোয়া
सव्वीस: ছাব্বিশ
सहकारी: সহযোগী
सहज: সহজ আসান সরল সুগম প্রাকৃতিক প্রাকৃত স্বাভাবিক নৈসর্গিক প্রকৃতিজাত অকৃত্রিম সহজ প্রকৃত সুবিধাজনক সুবিধাপূর্ণ সহজ শোনানো অভিজাত মর্জিতভাব পোশাকের_চমৎকারিত্ব
सहन_करपी: সহিষ্ণু সহনশীল সর্বংসহা সহ্যকারী
सहमत: সম্মত রাজী
सांगपा_सारकी: কথনীয় কথা বাচ্য
सांगि_सारकी: কথনীয় কথা বাচ্য
सांगिल्लें: নিবেদিত বর্ণিত উল্লিখিত কথিত অপদিষ্ট বাচ্য অভিধেয়
सांगिल्ल्या: যা_বলা_হয়েছে
सांगिल्ल्यो: প্রচারিত
सांगूंक_नाशिल्लें: অকথিত অনূক্ত অবিবৃত অবোলা অবর্ণিত অব্যক্ত অনভিব্যক্ত
सांचिल्लें: গতিহীন স্থির গতিশূন্য গতিরহিত বেগহীন নির্বেগ অপ্রবাহিত
सांच्यांत_घातिल्लें: ছাঁচে_তৈরি ছাঁচের
सांठयिल्लें: সংগৃহীত সঞ্চিত পূঞ্জিত সংহৃত রক্ষিত
सांठिल्लें: গতিহীন স্থির গতিশূন্য গতিরহিত বেগহীন নির্বেগ অপ্রবাহিত
सांठ्याचें: ধরায়ু
सांद्र: সংপৃক্ত সান্দ্র
सांमंतकाळीन: অকাল_প্রসূত সময়_পূর্ব_জাত
साक्षर: শিক্ষিত সাক্ষর
साक्षात: সাকার আকারযুক্ত আকারবান মূর্তিমান সাক্ষাৎ সাক্ষাত প্রত্যক্ষ সাক্ষাত্ নয়নগোচর দৃশ্যমান প্রতীয়মান৷
साक्षिदार: প্রত্যক্ষদর্শী
सागरी: সমুদ্রের সাগরের সামুদ্রিক সৈন্ধব
साठ: ষাট
साठयिल्लें: ধরায়ু
साडे: সাড়ে
सातवें: সপ্তম
सातोळें: সপ্তমাসিক সপ্তম_মাস
सातोळ्याचें: সাপ্তাহিক
सादारण: নগন্য ছোট মামুলি তুচ্ছ যে-সে অগন্য নাচীজ যে-সে সামান্য সাধারন অবশেষ অবশিষ্ট সর্বসামান্য সর্বসাধারণ সর্ববিচরণশীল সাদা সাধারণ সাদামাটা সাদাসিধা সাদাসাপটা অনাড়ম্বর ছোটো_খাটো অল্প_বিস্তর হালকা_ফুলকা
सादूर: সচেতন সাবধান চৌকস সতর্ক সজাগ খবরদার হুঁশিয়ার
सादें: নগন্য ছোট মামুলি তুচ্ছ যে-সে অগন্য নাচীজ যে-সে সুবিধাজনক সুবিধাপূর্ণ সহজ সাদা অলিখিত আলেখা অলেখনীয় সাদা সাধারণ সাদামাটা সাদাসিধা সাদাসাপটা অনাড়ম্বর সাদা শুভ্র শ্বেত
सादें.: সোজা বাঁকহীন মোড়হীন
सादो: সহজ আসান সরল সুগম নিষ্কোপোট সাদাসিধে ভোলাভালা
साध्य: চিকিৎসা সাধ্য সাধ্য সাধনীয়
सान: ছোট ছোট্ট
सानुलें: কচিকাঁচা শিশু কাচ্চাবাচ্চা ছানাপোনা বাচ্চা ছোট ছোট্ট
साफ: স্পষ্ঠ সাফ পরিষ্কার বিশুদ্ধ শুদ্ধ পরিশোধিত
सामकें_गरजेचें: অত্যাবশ্যক অতি_আবশ্যক অপরিহার্য
सामको: আনন্দী সদানন্দ
सामको_उणो: অত্যল্প
सामवेदी: অল্পআয়ু অল্প_জীবী স্বল্পায়ু
सामान्य: সামান্য সাধারন অবশেষ অবশিষ্ট সামান্য সাধারন সর্বজনীন তুচ্ছ গতানুগতিক বৈশিষ্ট্যবিহীন সর্ববিষয়ক সাদা সাধারণ সাদামাটা সাদাসিধা সাদাসাপটা অনাড়ম্বর
सामुहीक: সামান্য সাধারন সর্বজনীন তুচ্ছ গতানুগতিক বৈশিষ্ট্যবিহীন সর্ববিষয়ক
साम्यवादी: সাম্যবাদী সমানতাবাদী কমিউনিস্ট সাম্যবাদী সোসালিস্ট কমিউনিস্ট্
सायबेरियायी: সাইবেরীয় সাইবেরিয়ান
सारकें: সমান তুল্য বরাবর স্পষ্ট সদৃশ সদৃশ্য একইরকম সমান অনুরুপ সমরুপ সুব্যবস্থিত সুবিন্যস্ত সুসমঞ্জস ঠিক সঠিক যথার্থ অভ্রান্ত নির্ভুল শুদ্ধ ত্রুটিহীন
सारको: আনন্দী সদানন্দ ভালো খুব_ভালো চমত্কার বেশ বেশ_ভালো ঠিকঠাক
सारहीण: অসার সারহীন অন্তঃসারশূন্য শূন্যগর্ভ
सार्थ: ঠিক সঠিক যথার্থ অভ্রান্ত নির্ভুল যথাযথ শুদ্ধ নিষ্প্রমাদ ত্রুটিহীন ত্রুটিশূন্য অবিভ্রান্ত প্রমাদহীন প্রমাদশূন্য ভুলহীন অন্বর্থ
सार्थक: চরিতার্থ সার্থক
सार्वभौमीक: সার্বভৌমিক সার্বভৌম সার্বদেশিক সর্বদেশীয়
साव: সভ্য শিষ্ট শালীন সুশীল সুব্যবহার ইমানদার বিশ্বস্ত সত্ অকপটচিত্ত নিষ্কপট সজ্জন সাচ্চা
सावध: সচেতন সাবধান চৌকস সতর্ক সজাগ খবরদার হুঁশিয়ার
सावळें: শ্যাম শ্যামল শ্যামলা
सावळो: অসিত কালো কৃষ্ণ কৃষ্ণবর্ণ শ্যাম
सासणा_खातीरचें: অবিনশ্বর অবিনাশী
सास्टांग_नमस्कार_करपी: অনুশয়িত প্রণত বিনীত অনুতপ্ত
साहसी: সাহসি সাহসপূর্ণ
साहित्यीक: সাহিত্যিক
सिंदुरी: সিঁদুরে সিন্দূরে সিন্দূরিয়া
सिंधी: সিন্ধি সিন্ধি সিন্ধি সিন্ধবাসী সৈন্ধব সিন্ধী সিন্ধি
सिंहली: সিঙ্ঘলী শ্রীলঙ্কা শ্রীলঙ্কাবাসী সিঙ্ঘল সিঙ্ঘলী শ্রীলঙ্কা শ্রীলঙ্কাবাসী সিঙ্ঘল সিঙ্ঘলী শ্রীলঙ্কা শ্রীলঙ্কাবাসী সিঙ্ঘল
सिद्ध: প্রমাণিত প্রমাণসিদ্ধ প্রমাণীকৃত প্রতিপাদিত সিদ্ধ সিদ্ধ যোগসিদ্ধ সিদ্ধ
सिद्धांतीक: সৈদ্ধাংতিক সিদ্ধাংতীয
सिने: ফিল্মী নাটুকে
सुंदर: সুন্দর চারু সুচারু সুকান্ত সুকুমার অপরূপ সুদর্শন সৌম্যদর্শন রূপবান রূপবন্ত সৌম্য সুশ্রী মনোরম সুন্দর ভালো মনোলোভা মনোমোহিনী মনোহারিনী সুদর্শণ মনহোর মনরোম সুন্দর
सुंदर_दंडांचें: সুবাহু
सुंदर_पांखांचें: সুপর্ণ
सुकडें: রোগা কৃশ শীর্ণ ক্ষীণ ছিপছিপে রোগা-পাতলা
सुकण्या_विशीचें: পাখীর_মত
सुकप: বিহীন রোহিত শূন্য
सुकिल्लें: খরা মলিন_বা_ম্লান_রূপ বিশীর্ণ ক্ষীণ নিস্প্রভ ক্লান্ত পরিশ্রান্ত দুর্বল
सुकुमार: সুকুমার সুকান্ত কান্ত পেলব সুন্দর কোমল কোমলাঙ্গ নমনীয় স্নিগ্ধ
सुकें: রোগা কৃশ শীর্ণ ক্ষীণ ছিপছিপে রোগা-পাতলা শুষ্ক রুক্ষ জলহীন অনার্দ্র ঊষর খরা শুখা শুখো করকরে শুকনো রুক্ষ নিষ্ঠুর নির্দয় নিঠুর কঠোর কাঠখোট্টা স্নেহহীন
सुक्षीम: সূক্ষ্মতম সূক্ষ্মাতিসূক্ষ্ম সূক্ষ অণু ক্ষুদ্র আণুবীক্ষণিক সূক্ষাতিসূক্ষ সূক্ষ নিপুণ নিখুঁত
सुक्ष्म: সূক্ষ্মতম সূক্ষ্মাতিসূক্ষ্ম
सुख: সুখী খুশহাল খুশাল
सुखदिणी: সুখদ সুখদায়ক সুখকারী সুখদায়ী সুখপ্রদ
सुखभरीत: গুলজার শোভাময় জাঁকজমকপূর্ণ সরগরম জমজমাট ভরন্ত
सुखाची: সুখদ সুখদায়ক সুখকারী সুখদায়ী সুখপ্রদ
सुखाळ: সুখদ সুখদায়ক সুখকারী সুখদায়ী সুখপ্রদ
सुखी: সুখী খুশহাল খুশাল
सुग्राही: সুগ্রাহী গ্রহণকারী
सुग्र्याह: গ্রাহ্য সুগ্রাহ্য গ্রহণীয় সুগ্রাহী
सुचक: দ্যোতক সূচক বোধক বাচক
सुचीत: সূচিত জ্ঞাত উল্লিখিত উল্লেখিত উপর্যুক্ত
सुटनासपी: অবুঝ অবুজ
सुटसुटीत: সুডৌল সুগঠিত নিডৌল
सुटिल्लें: দোহারা
सुटिल्लो: রওনা রওয়ানা
सुतलावपी: চোর পকেটমার অপহারী অপহারক অপহরণকারী হারক
सुदारीत: পরিস্কৃত পরিমার্জিত সংকৃত
सुन्न: সন্ন সজ্ঞাশূন্য নিধেশঠ জড় অচেশষ্ট স্তম্ভিত হতচকিত
सुपाच्य: সুপাচ্য পাচ্য সুপচ লঘুপাক হাল্কা সহজপাচ্য
सुपीक: উর্বর উর্বরা আবাদি চষা কর্ষিত
सुपुल्लें: ছোট ছোট্ট
सुप्रसिद्ध: সুপ্রসিদ্ধ সুবিখ্যাত সুখ্যাত অভিবিশ্রুত
सुफी: সূফী সুফী
सुबेज: ডীঠ গৃস্তাখ সরচড়া ধৃষ্ট গ্রৃস্তাখ ধৃষ্ট উচ্ছৃঙ্খল অভদ্রচিত অশালীন অশোভন বেয়াড়া উদ্ধত
सुये_आकाराचें: সূচ্যাকার সূচালো
सुयेच्या_आकाराचें: সূচ্যাকার সূচালো
सुरक्षीत: রক্ষিত সংরক্ষিত সুরক্ষিত পরিরক্ষিত সুরক্ষিত সুরক্ষিত নিরাপদ নিরাপদ নিরুপদ্রব নির্বিঘ্ন নিরাপদ নিরুপদ্রব নির্বিঘ্ন সুরক্ষিত
सुरयीकारी: সুরাহীদার
सुरवातीचें: আরম্ভিক প্রারম্ভিক প্রারম্ভকালীন প্রাথমিক উপক্রমিক গোড়াকার
सुरांटो: মদ্যপ মদখোর মাতাল মদ্যপায়ী মাদকসেবী পানাসক্ত
सुरांडो: মদ্যপ মদখোর মাতাল মদ্যপায়ী মাদকসেবী পানাসক্ত মদ্যপ মদখোর মাতাল মদ্যপায়ী মাদকসেবী পানাসক্ত মদ্যপ মদখোর মাতাল মদ্যপায়ী মাদকসেবী পানাসক্ত
सुरू_आशिल्लें: চালিত পরিচালিত প্রচালিত
सुलभ: গম্য গমনীয় সহজ আসান সরল সুগম সুলভ সুসাধ্য সহজ সহজপ্রাপ্ত
सुवर्णी: সুবর্ণ
सुवादीक: স্বাদযুক্ত স্বাদিষ্ঠ মুখরোচক উপাদেয় উপভোগ্য সুস্বাদু সরস রসাল খাসা
सुवादीन: সমর্পিত
सुवार्था_बगर: নিস্বার্থ নিঃস্বার্থ
सुवासीत: সুবাসিত অনুবাসিত
सुशिक्षीत: শিক্ষিত সাক্ষর
सुशील: সচচরিত্র চরিত্রবান শিষ্টাচারী সুশীল
सुशेगाद: অলস আলস্যপরায়ণ আলসে শ্লথ ঢিলে ঢিলেডালা কাহিল
सुसंस्कृत: উদার উদারতাবাদী উদারমনস্ক
सुसेगदिणी: আরামদেহ আরমদায়ক
सुसेगाद: প্রশান্ত শান্ত নিরুদ্বিগ্ন উদ্বেগহীন স্থির সুস্থিত মন্থর অলস শিথিল মন্দ ঢিমা ধীর শ্লথ মৃদু
सुस्त: অলস আলস্যপরায়ণ আলসে শ্লথ ঢিলে ঢিলেডালা কাহিল মন্থর অলস শিথিল মন্দ ঢিমা ধীর শ্লথ মৃদু
सूखदिणें: আনন্দপ্রদ আনন্দ-দায়ক আহ্লাদক সুখপ্রদ আনন্দদায়ক আনন্দ
सृजक: সৃজনকর্তা সর্জক সৃজক রচনা_করে_যে স্রষ্টা
सृजनकर्तो: সৃজনকর্তা সর্জক সৃজক রচনা_করে_যে স্রষ্টা
सॅटिनाचें: সাটিন-জাতীয় সাটিনের_মতো
सेंद्रीय: জান্তব জন্তুজাত
सेगीत: অনবরত অবিরত সর্বদা নিত্য নিয়ত প্রায়ই নিরন্তর
सेवनाचें: সেবনীয
सेवा_करपी: সেবিকা পরিচারিকা
सेवानिवृत्त: অবসরপ্রাপ্ত অবকাশপ্রাপ্ত রিটায়ার্ড অব-সৃত
सेवीत: সেবিত সেব্য
सेशिल्जी: সেশিল্জী
सैनिकी: ফৌজী
सैन्या_बगरचें: সৈন্যবিহীন
सैन्या_विरयत: সৈন্যবিহীন
सैमीक: প্রাকৃতিক প্রাকৃত প্রকৃতিগত স্বাভাবিক নৈসর্গিক নিসর্গজ প্রকৃত অকৃত্রিম প্রাকৃতিক প্রাকৃত স্বাভাবিক নৈসর্গিক প্রকৃতিজাত অকৃত্রিম সহজ প্রকৃত
सैल: শিথিল থলথলে ঢিলা আলগা ঢিলে ঢলঢলে ঢিলেঢালা ঢোলা শিথিল ঢিলা আলগা
सोंपते_तारखेचें: মেয়াদুত্তীর্ণ
सोंपूंक_नाशिल्लें: অধুরা অর্ধেক বাকী শেষ অসমাপ্ত অনিষ্পাদিত অসম্পাদিত অপূর্ণ অসম্পন্ন অসিদ্ধ
सोंपे: সুলভ সুসাধ্য সহজ সহজপ্রাপ্ত
सोंपें: গম্য গমনীয় বোধ্য বোধগম্য আসান সরল সুগম সুবিধাজনক সুবিধাপূর্ণ সহজ শোনানো
सोंपेपणाचें: সুবিধাজনক সুবিধাপূর্ণ সহজ
सोंपो: সহজ আসান সরল সুগম
सोंशीक: সহিষ্ণু সহনশীল সর্বংসহা সহ্যকারী
सोडिल्ले: অপসৃত
सोडिल्लें: রওনা রওয়ানা
सोडून_गेल्लें: অপসৃত
सोडोवंक_जायना_अशें: অবুঝ অবুজ
सोदक: শোধক অনুসন্ধানী অন্বেষক অনুসন্ধানী শোধকর্ত্তা শোধকর্তা
सोदपी: সন্ধানরত অনুসন্ধানরত খোঁজরত নিরীক্ষমাণ অন্বেষক অন্বেষণকারক অন্বেষণকারী অনুসন্ধানবান
सोदिल्लें: শোধিত অন্বেষিত অনুসন্ধানিত গবেষিত
सोबीत: সুন্দর চারু সুচারু সুকান্ত সুকুমার অপরূপ সুদর্শন সৌম্যদর্শন রূপবান রূপবন্ত সৌম্য সুশ্রী সুশোভিত শোভান্বিত শোভাযমান শোভিত অভিমংডিত সুসজ্জিত সুদর্শণ মনহোর মনরোম সুন্দর দিব্য
सोरपा_आकाराचें: সর্পিল
सोरेकार: মদ্যপ মদখোর মাতাল মদ্যপায়ী মাদকসেবী পানাসক্ত
सोर्‍याकार: মদ্যপ মদখোর মাতাল মদ্যপায়ী মাদকসেবী পানাসক্ত
सोलिल्लीं: কবচহীন আবরণহীন
सोळा: ষোল ষোড়শ
सोळावें: ষোলো ১৬
सोसूंक_जायना_अशें: অসহ্য অসহ অসহনীয় দুঃসহ দুর্বিষহ দুর্বহ
सौम्य: কোমল_স্বভাবী সোম সোম্য
सौर: সৌর
स्टोनियायी: এস্টোনিয়া এস্টোনীয়
स्तुतीपाठक: প্রশংসক প্রশংসী
स्थापणूक_करी_सारकें: অবসরানুকূল অবসরোচিত কালোচিত সময়োচিত
स्थापी_सारकें: অবসরানুকূল অবসরোচিত কালোচিত সময়োচিত
स्थापीत: সংস্থাপিত অধিষ্ঠিত অধিষ্ঠাপিত স্থাপিত
स्थायी: স্থায়ী চিরস্থায়ী স্থিতিশীল চিরন্তন স্থায়ী পাকা পোক্ত পাকাপোক্ত
स्थायीक: অধ্যুষিত অধ্যাসিত আবাদি বসতিপূর্ণ অধিকৃত অধিবসিত
स्थावर: অচল নিশ্চল স্থাণু স্থায়ী স্থাবর গতিহীন অগতিক স্থির অবিচলিত গতিহীন অচল শৈল স্থাবর
स्थीर: গতিহীন গতিহারা গতিরহিত স্থির অগতি অচল নিশ্চল স্থাণু স্থায়ী স্থাবর গতিহীন অগতিক অচল অবিচল নিশ্চল স্থির দৃঢ় অনঢ় অটল স্থাণু স্থির অবিচলিত গতিহীন অচল শৈল স্থাবর অবিস্মরণীয়
स्थूल: মোটা স্থূল্কায় বিরাটাকার ফোলা
स्नेही: স্নেহময় স্নেহমইয়ী
स्पटिकी: স্পটিকবত্
स्पर्श_करूंक_नाशिल्लें: অস্পর্শিত
स्पश्ट: স্পষ্ঠ সাফ পরিষ্কার স্পষ্ট সুস্পষ্ট স্বচ্ছ প্রকট পরিস্ফুট
स्पश्टवादी: স্পষ্টবাদী
स्पॅनीश: স্পেনীয় স্প্যানিশ স্পেন_দেশীয় স্পেনীয় স্পেনদেশীয়
स्फटिका_भशेन: স্পটিকবত্
स्फटिकाचें: ফটিক স্ফটিকবত্ পরিষ্কার টলটলে স্পটিকবত্
स्फूर्तहीण: উদ্যমহীন উত্সাহহীন নিরুত্সাহ নিরুদ্যম অনুদ্যত স্ফূর্তিহীন অনুত্সাহী অনাগ্রহী
स्फूर्तीदायक: স্ফূর্তিপ্রদ
स्मरणीय: স্মরণীয
स्लोवाकी: স্লোভাকী স্লোভাকী
स्लोवेनियाचें: স্লোভেনীয়ান
स्लोवेनियायी: স্লোভেনীয়ান স্লোভেনীয়
स्वगत: মনোগত স্বগত
स्वच्छ: বিশুদ্ধ শুদ্ধ পরিশোধিত
स्वजातीय: সজাতীয় সমবর্গীয় সজাতি স্বজাতীয় স্বজাতি
स्वतंत्र: স্বতন্ত্র স্বাধীন আজ়াদ অনধীন অনায়ত্ত অনির্বন্ধ স্বচ্ছন্দ স্বতন্ত্র অবাধ স্বাধীন
स्वताचें: নিজস্ব নিজের ব্যক্তিগত স্বকীয় আত্ম
स्वताचो: স্বগত আত্মগত নিজস্ব
स्वदेशी: স্বদেশীয় দেশী স্বদেশী দেশীয় দেশজ
स्वनिर्भर: স্বনির্ভর আত্মনির্ভর
स्वपक्षी: সপক্ষীয় নিজস্ব ব্যক্তিগত
स्वभावीक: স্বাভাবিক স্বাভাবগত
स्वराचें: স্বরিত
स्वराळ: স্বরিত
स्वर्णीम: সুবর্ণ সুবর্ণময় স্বর্ণময় সোনালি
स्वाभावीक: প্রাকৃতিক প্রাকৃত স্বাভাবিক নৈসর্গিক প্রকৃতিজাত অকৃত্রিম সহজ প্রকৃত
स्वाभिमानहीण: স্বভিমানহীন স্বাভিমানী
स्वायत्त: স্বায়ত্ত আত্মাধীন আত্মবশ স্ববশ
स्वावलंबी: স্বাবলম্বী আত্মাবলম্বী স্বাবলম্বী আত্মাবলম্বী স্বনির্ভর আত্মনির্ভর
स्वास_आडावपी: শ্বাসপ্রশ্বাসহীন শ্বাসরোধকারী
स्वाहिली: সোয়াহিলি স্বাহিলী কিস্বাহিলী
स्विकार_करी_सारकें: স্বীকার্য স্বীকৃত গ্রহণীয় অঙ্গীকার্য স্বীকরণীয়
स्विकारपा_सारकें: স্বীকার্য স্বীকৃত গ্রহণীয় অঙ্গীকার্য স্বীকরণীয়
स्विकारिल्ली: স্বীকৃত মঞ্জুর সম্মত সম্মতি অনুমোদিত সমর্থিত স্বীকৃত মঞ্জুর অনুমোদিত অনুমোদনপ্রাপ্ত
स्विकारिल्लें: অঙ্গীকৃত অঙ্গীকারবদ্ধ প্রতিজ্ঞাবদ্ধ সত্যবদ্ধ গৃহীত স্বীকৃত পরিগ্রহীত
स्विकारूंक_नाशिल्लें: অস্বীকৃত অসমর্থিত অননুমোদিত অসম্মত নামঞ্জুর অপলাপিত
स्विकृत: স্বীকৃত সম্মত প্রতীষ্ঠ অনুমোদিত সমর্থিত অনুমোদনপ্রাপ্ত স্বীকৃত মঞ্জুর অনুমোদিত অনুমোদনপ্রাপ্ত
स्विडीश: সুইডিশ সুইডিশ
हक्क_आशिल्लो: অধিকারী অধিকার_প্রাপ্ত অধিকারযুক্ত অধিকারিক হকদার অধিকারক
हजर: উপস্থিত আগত সমাগত হাজির বিদ্যমান স্থিত অবস্থিত বিরাজমান
हजार: হাজার সহস্র সহস্ত্র
हजारांनी: হজারো
हट्टी: জেদী একগুঁয়ে গোঁয়ার
हडपिल्लें: হজম হজম হজম হজম
हरवें: কাঁচা অপক্ক অপরিপক্ক আপাকা অপরিণত অপুষ্ট কাঁচা কাঁচা আধকাঁচা আধপাকা অপরিপক্ক অসিদ্ধ অর্ধসিদ্ধ আধসিদ্ধ তাজা টাটকা সতেজ সবুজ সজীব জীবন্ত
हरामी: হরামজাদা হরামজাদা হরামি
हलकें: চাপা অনুচ্চ মৃদু কোমল মিহি ক্ষীণ হাল্কা ফিকে অনুজ্জ্বল ফ্যাকাসে হালকা হাল্কা
हलको: পলকা হালকা পাতলা
हळू: চাপা অনুচ্চ মৃদু কোমল মিহি ক্ষীণ
हळू_हळू: মন্দ মন্থর ধীর শ্লথ বিলম্বিত ঢিমা মৃদু
हवाई: বায়বীয় উড়ো বায়ব বায়ব্য
हस्तलिखीत: হস্তলিখিত হস্তাঙ্কিত হাতে_লেখা
हस्तांतरीत: হস্তান্তরিত
हांडेकार: ধন্যায় ধণী আমীর দৌলতবান ধনবান মালদার ধনবত বৈবভশালী মালামাল সমুদ্রশালী ধনধ্যানপূর্ণ সম্পতিবান ধনী
हांशाक_म्हारग: হাস্য
हांशाचें: হাস্য
हांसमूख: হাসিখুশি সদাহাস্য
हांसरें: হাসিখুশি সদাহাস্য
हाचे_सारको: অবিকল অবিকৃত হুবহু অনুরুপ সদৃশ
हाडकुळें: অস্থিময় হাড়গিলে রোগা কৃশ শীর্ণ ক্ষীণ ছিপছিপে রোগা-পাতলা
हाडांचें: অস্থিময় অস্থিনির্মিত অস্থি_নির্মিত
हात_मारपी: চোর পকেটমার
हातबरपाचें: হস্তলিখিত হস্তাঙ্কিত হাতে_লেখা
हाता_खालचें: অধিনস্থ অধীন অধিশ্রিত
हातांत_जाता_अशें: স্ববশ স্বাধীন
हातांत_जाय_सारकें: স্ববশ স্বাধীন
हारिल्लो: পরাজিত পরাস্ত অপধ্বস্ত অবঞ্জাত হেরো
हालपी: অসমর্থিত অননুমোদিত অস্বীকৃত অপলাপিত
हालयिल्लें: অপহত
हावी: প্রবল প্রধান কর্তৃত্বময় প্রভাবশালী প্রতাপশালী
हावेसाचें: ইচ্ছিত অভিলষিত
हासयाळें: হাসিখুশি সদাহাস্য
हास्य: হাস্য
हिंदी: হিন্দী
हिंसक: হিংসক হিংসাপরায়ণ হিংস্রক হিংস্র ঘাতক বর্বর নৃশংস জালিম হিংসুটে হিংসাত্মক ঘাতক বর্বর নৃশংস
हिब्रू: হিব্রু
हिब्रू_भास: হিব্রু
हिमालयी: হিমলয়ান
हिवाळी: ঠান্ডা শীতকালীন শীতের হিমেল শীতপ্রধান
हुंपूंक_जायनाशिल्लो: দুস্তর দুরতিক্রম দুরত্যয় অনতিক্রম্য অগম অগম্য অগমনীয়
हुंवारग्रस्त: বন্যাপীড়িত বন্যাকবলিত বানগ্রস্ত
हुनहुनीत: গরমাগরম গরম_গরম গরম তপ্ত উত্তপ্ত আতপ্ত
हुप_सारकें: সেই
हुबेहुब: অবিকল যথাযথ সেইরকম
हुमटपी: উত্পাটিত উত্খাত উচ্ছিন্ন
हुलपल्लें: দগ্ধ পোড়া
हुल्लडबाज: হূল্লোরবাজ হল্লাবাজ
हुशार: যোগ্য সুযোগ্য কাবিল উপযুক্ত পারগ পারঙ্গম সক্ষম সমর্থ বুদ্ধিমান বুদ্ধিমন্ত বুদ্ধিধর ধীমান হুঁশিয়ার সমঝদার জ্ঞানী বিবেকবান বিবেচক ধীযুক্ত উত্তমতর সর্বশ্রেষ্ঠ সর্বত্তোম উত্কৃষ্ট প্রফুল্ল উত্ফুল্ল প্রসন্ন আনন্দিত আনন্দবিহ্বল সহর্ষ উচ্ছ্বসিত উল্লসিত চালাক চতুর হুঁশিয়ার সেয়ানা পটু চালাকচতুর প্রখরবুদ্ধি
हुसक्यामेकळें: নিঃশঙ্ক অশঙ্কিত আশঙ্কাহীন সংশয়হীন
हुसक्यामेकळो: নিশ্চিন্ত চিন্তারহিত চিন্তাহীন চিন্তামুক্ত অচিন্ত
हुस्को: চিন্তিত চিন্তাযুক্ত চিংতাগ্রস্ত
हुस्क्याचें: চিন্তাজনক চিন্তাকর চিন্তনীয় চিন্ত্য ভাবনীয় চিন্তনযোগ্য অনুধাবনীয় শোচনীয় অনুশোচনীয় গম্ভীর
हून: গরম তপ্ত উষ্ণ উত্তপ্ত গরম গরম তপ্ত উত্তপ্ত আতপ্ত
हे_तरेचें: বৈসা
हे_तरेचो: অবিকল অবিকৃত হুবহু অনুরুপ সদৃশ
हे_भशेचें: বৈসা
हे_सारकें: বৈসা
हे_सारको: অবিকল অবিকৃত হুবহু অনুরুপ সদৃশ
हेडगें: উড়োন্চণ্ডী ভবঘুরে ভ্রম ফিরাফিরি পরিব্রাজক পরিক্রমণকারী প্রব্রাজক পরিযায়ী বাঞ্জারা
हेर: অন্য অপর অন্য অপর ভিন্ন দোসরা দুসরা পর অপর অন্য ভিন্ন অনাত্মীয়
हैदराबादी: হায়দ্রাবাদী
