53: അന്പത്തി_മൂന്ന്
79: എഴുപത്തി_ഒന്പത്
अंकीत: എഴുതിയ..
अंगरक्षक: രക്ഷിക്കുന്നവന്‍ സംരക്ഷകന്‍ രക്ഷകന്‍ ഉദ്ധാരകന്‍ പരിപാലകന്‍.
अंडज: മുട്ടയിടുന്ന.
अंतर्मुखी: അന്തര്മുഖനായ മനസ്സിലേക്കു_നോക്കുന്ന.
अंधविश्वासी: അന്ധവിശ്വാസി
अंधश्रद्धाळू: മത_കാര്യങളില്_വിട്ടുവീഴ്ചയില്ലാത്ത.
अंधूक: മങ്ങലുള്ള വ്യ്ക്‌തമല്ലാത്ത അസ്പഷ്ടമായ അവ്യക്‌തമായ
अंयशांवें: എണ്പത്തി_ഒന്നാമത്തെ
अकथनीय: പറയുവാന്_കൊള്ളാത്ത.
अकर्मी: ജോലി_ചെയ്യാത്ത.
अकलात्मक: പ്രവ്ര്ത്തിയിലെ_കൌശലമില്ലായ്മ.
अकल्पीत: സങ്കല്പ്പിക്കാവുന്നതിനപ്പുറം.
अकल्याणकारी: അമംഗളകരമായ. അമംഗളകരം_ഇഷ്ട്ടപ്പെടുന്നവന് അശുഭ_ചിന്തകന്ന്.
अकस्मात: പെട്ടെന്നുള്ള.
अकारण: അകാരണമായ
अकाळीक: അകാലത്തില്_ജനിച്ച. നിശ്ചിതസമയത്തല്ലാത്ത.
अकुळीन: താഴ്ന്ന.
अकूशळ: സാമറ്ത്ഥ്യമില്ലാത്ത മിടുക്കില്ലാത്ത നൈപുണ്യമില്ലാത്ത കുശലതയില്ലാത്ത കാര്യക്ഷമയില്ലാതാത്ത വൈദ്ഗദ്ധ്യമില്ലാത്ത പ്രാഗ്ലഭ്യമില്ലാത്ത പ്രവീണ്യമില്ലാത്ത ചാതുര്യമില്ലാത്ത മികവില്ലാത്ത പാടവമില്ലാത്ത വിരിതില്ലാത്ത.
अकृत: ചെയ്യാത്തത്. നിര്മ്മിക്കാത്ത.
अकृतज्ञ: നന്ദികെട്ട ഉപകാരസ്മരണയില്ലാത്ത.
अक्षम्य: ക്ഷമിക്കാന്_പറ്റാത്തത്.
अखंड: ഭേദിക്കാന്‍_പറ്റാത്തത് തുളക്കുവാന്‍_പറ്റാത്തത് അവിഭാജ്യം. അഭേദ്യമായ തകര്ക്കാനാവാത്ത. ഭങ്കം_വരാത്ത.
अखंडीत: അഭേദ്യമായ. മുഴുവനായുള്ള. വിഭജിക്കപ്പെടാത്ത അഖ്ണ്ഡമായ കൂടിചേര്ന്ന. തുളയ്ക്കപ്പെടാത്ത.
अखेरचें: അവസാനത്തേതല്ലാത്ത
अखेरच्या: അവസാനം.
अग्नीशामक: വേദന_ഇല്ലാതാക്കുന്ന ശമിപ്പിക്കുന്ന.
अग्रगामी: മുന്നേറുന്ന പുരോഗമനോന്മുഖമായ.
अग्रणी: മുന്പേ_നടക്കുന്ന മുന്പനായ ശ്രേഷ്ഠനായ.
अघटीत: സംഭവിക്കാത്ത അസാധ്യമായ. സംഭവിക്കുവാനല്ലാത്തത്.
अचंचळ: മാറാത്ത ഇളക്കപ്പെടാത്ത സ്ഥിരമായ അചഞ്ഞലമായ.
अचंबीत: പ്രത്യേകതയുള്ള അപൂര്വമായ.വ്യത്യാസമായ. വിസ്മയിച്ച പരിഭ്രമിച്ച അമ്പരന്ന.
अचकीत: പെട്ടെന്നുള്ള.
अचल: സ്ഥാവരങള്. സ്ഥിരമായ.
अचूक: മുഖത്തടിച്ച_പോലെ.
अचेतन: ജഡം.
अजय: അജയ്യ്ന് തോല്പ്പിക്കാന_്വയ്യാത്ത.
अजरंवर: അമരന്‍ മൃത്യുഞ്ഞയന്‍ ചിരഞ്ഞീവി അമര്‍ത്യന്‍ ചിരഞ്ജീവി.
अजरबॅजानी: അസറ്ബൈജാനിയന്‍
अजाण: ജയിക്കാന്_പറ്റാത്ത. അവിവേകി. അറിവില്ലാത്ത് അറിഞ്ഞുകൂടാത്ത.
अजातशत्रू: ശത്രുഹീനന്.
अजाप: സൂര്യന്റെ.
अजापाचें: അഭൂതപൂര്വ്വമായ പണ്ണ്ടുണ്ടാവാത്ത.
अजापीत: ആഗ്രഹിക്കാത്ത അപേക്ഷിക്കാത്ത മറ്റൊന്നിനെ_ആശ്രയിക്കാത്ത. വിസ്മയിച്ച പരിഭ്രമിച്ച അമ്പരന്ന.
अजीर्ण: ദഹനമില്ലായ്മ.
अजैत: ജയിക്കപ്പെടാത്ത. അജയ്യ്ന് തോല്പ്പിക്കാന_്വയ്യാത്ത.
अज्ञात: ബോധ്യമില്ലാത്ത അറിവില്ലാത്ത. അപരിചിതമായ.
अज्ञानी: ജയിക്കാന്_പറ്റാത്ത.
अज्ञेय: ജയിക്കാന്_പറ്റാത്ത.
अटूट: അടുത്ത. അഭേദ്യമായ. അഭേദ്യമായ തകര്ക്കാനാവാത്ത.
अठरा: പതിനെട്ടാം പതിനെട്ടാമത്തെ
अठ्ठ्यांयश्यांवें: എണ്പത്തി_എട്ടാമത്തെ.
अठ्ठ्याण्णवावें: തൊണ്ണൂറ്റി_എട്ടാമത്തെ
अठ्ठ्यात्तरावें: എഴുപത്തി_എട്ടാമത്തെ
अडचणीन_भरिल्लें: നിരോധനമുള്ള അവരോധമുള്ള.
अडाणी: സാമറ്ത്ഥ്യമില്ലാത്ത മിടുക്കില്ലാത്ത നൈപുണ്യമില്ലാത്ത കുശലതയില്ലാത്ത കാര്യക്ഷമയില്ലാതാത്ത വൈദ്ഗദ്ധ്യമില്ലാത്ത പ്രാഗ്ലഭ്യമില്ലാത്ത പ്രവീണ്യമില്ലാത്ത ചാതുര്യമില്ലാത്ത മികവില്ലാത്ത പാടവമില്ലാത്ത വിരിതില്ലാത്ത. വിദ്യാഭാസമില്ലാത്ത പഠിപ്പില്ലാത്ത മണ്ടന്മാരായ
अडेचें: പ്രകടനപരമായ കപടമായ ക്ര്‌ത്രിമമായ.
अडेज: രണ്ടര
अणकार_करपा_सारकें: തര്‍ജ്ജിമചെയ്യാവുന്ന.
अणकार_करपी: വിവവ്ര്ത്തകന്‍.
अणकारक: വിവവ്ര്ത്തകന്‍.
अणकारपी: വിവവ്ര്ത്തകന്‍.
अणकारीत: ഭാഷാന്തരം_ചെയ്യപ്പെട്ട തര്‍ജ്ജിമ_ചെയ്യപ്പെട്ട വിവര്‍ത്തനം_ചെയ്യപ്പെട്ട ഭാഷാന്തരം_ചെയ്യപ്പെട്ട.
अणभवशुन्य: പ്രായോഗികജ്ഞാനമില്ലാത്ത അഭ്യാസജ്ഞാനമില്ലാത്ത പ്രാവറ്ത്തികജ്ഞാനമില്ലാത്ത ക്രിയാത്മകജ്ഞാനമില്ലാത്ത അനുഭവസിദ്ധന്മല്ലാത്ത പക്വതയില്ലാത്ത.
अणभवहीण: പ്രായോഗികജ്ഞാനമില്ലാത്ത അഭ്യാസജ്ഞാനമില്ലാത്ത പ്രാവറ്ത്തികജ്ഞാനമില്ലാത്ത ക്രിയാത്മകജ്ഞാനമില്ലാത്ത അനുഭവസിദ്ധന്മല്ലാത്ത പക്വതയില്ലാത്ത.
अणभवी: പ്രായോഗികന്ജ്ഞാനമുള്ള അനുഭവന്ജ്ഞാനം_ഉള്ള പരിചയസമ്പന്നത_ഉള്ള ഇടപഴക്കമുള്ള പ്രായോഗികജ്ഞാനം_ഉള്ള അഭ്യസിക്കപ്പെട്ട് പരിശീലിപ്പിക്കപ്പെട്ട.
अणभावी: ദ്രിഢ്വിശ്വാസമുള്ള
अतंत्रीक: സാങ്കേതികമല്ലാത്ത.
अतिंद्रीय: ഇന്ദ്രിയാതീതമായ.
अतिक्रमी: മറ്റുള്ളവരുടെ_അധികാര_സീമയില്_കടക്കുന്ന.
अतिक्रमीत: ലംഘനം_ചെയ്യപ്പെട്ട. സ്വായത്തമാക്കിയ. ആക്ക്രമിക്കപ്പെട്ട
अतिलाल: അപരക്ത ഇന്‍ഫ്രാറെഡ്.
अतीरागिश्ट: വളരേ_ഭയങ്കരമായ കഠിനമായ. അത്യധികം_ക്രോധ്ധമുള്ള.
अतुलनीय: തുല്യപ്പെടുത്താനില്ലാത്തത്.
अतुल्य: തുല്യപ്പെടുത്താനില്ലാത്തത്.
अतूट: ഭേദിക്കാന്‍_പറ്റാത്തത് തുളക്കുവാന്‍_പറ്റാത്തത് അവിഭാജ്യം. ഒന്നായത്.
अतृप्त: അത്രുപ്തം.
अत्याचारी: ന്യായമില്ലായ്മ അനീതി ന്യായവിരിദ്ധമായ_പെരുമാറ്റം അക്രമം അന്യായം_ചെയ്യുന്ന ദുരാചാരിയായ. സദാചാരമില്ലാത്ത മറ്റുള്ളവരേ_ഉപദ്രവിക്ക്ല്.
अत्याधुनीक: അത്യാധുനികമായ അതി_നൂതനമായ അതി_നവീനമായ.
अथक: ക്ഷീണിക്കാത്ത മടുക്കാത്ത.
अथांग: വളരേ_ആഴമുള്ള അഗാധമായ. ആഴമുള്ള താഴ്ചയുള്ള
अदमासीत: അനുമാനിക്കാന്_യോഗ്യമായ
अदृश्य: കണ്ണുകൊണ്ടു_കാണാന്_പറ്റാത്തത്.
अधर्मी: ധര്‍മ്മബോധമില്ലാത്ത ധര്‍മ്മവിരുദ്ധിയായ
अधाशिल्ले: ആകര്‍ഷിക്കപ്പെട്ട കൊതിയുള്ള അത്യാഗ്രഹമുള്ള.
अधाशी: അത്യാഗ്രഹമുള്ള അത്യാറ്‍ത്തിയുള്ള ലോഭമുള്ള ദുരാഗ്രഹമുള്ള അതിതൃഷ്ണയുള്ള അതിമോഹമുള്ള
अधिकार_नाशिल्लें: അധികാര_ഹീനനായ ആധിപത്യം_ഇല്ലാത്ത നായകത്വം_ഇല്ലാത്ത.
अधिकारहीण: അധികാര_ഹീനനായ ആധിപത്യം_ഇല്ലാത്ത നായകത്വം_ഇല്ലാത്ത. അനധിക്രിതമായി
अधिकारा_भायरें: അനധിക്രിതമായ അനധിക്രിതമായി
अधिकाराची: അധികാരപൂര്‍ണ്ണമായ അധികാരം_ഉള്ള്.
अधिकारी: അവകാസപ്പെട്ട് അധികാരപ്പെട്ട.
अधीन: കീഴ്പെട്ട അധീനതയുള്ള.
अधीनहीण: ഒഴിവാക്കാന്_ആവാത്ത വശത്താക്ക്പ്പെടാനാവാത്ത.
अधोगतीक: അധോഗതിശീലമുള്ള നശിച്ച്_ശീലമുള്ള.
अध्यक्ष: ഭരണകര്‍ത്താവ് ആജ്ഞാപിക്കുന്നവന്‍.
अध्यक्षा_विरयत: അദ്ധ്യക്ഷവിഹീനമായ
अध्यक्षीय: അധ്യക്ഷീയ.
अनंत: നിസ്സീമമായ അതിരറ്റ.
अनंताचो: അവസാനമില്ലാത്ത അന്തമില്ലാത്ത.
अनधिकृत: അനധിക്രിതമായ
अनपेक्षीत: ആഗ്രഹിക്കാത്ത അപേക്ഷിക്കാത്ത മറ്റൊന്നിനെ_ആശ്രയിക്കാത്ത. അപ്രതീക്ഷിതമായി.
अनभिप्रेत: അനിഷ്ട്ടമായ
अनमननासपी: പിന്മാ‍റാത്ത
अनर्जीत: ആര്ജ്ജിക്കാത്ത
अनर्थकारी: ദോഷം_ചെയ്യുന്ന.
अनळंकृत: അലംഗരിക്കാത്ത.
अनवळखी: ബോധ്യമില്ലാത്ത അറിവില്ലാത്ത. അപരിചിതമായ. അപരിചിതമായ പരിചിതമല്ലാത്ത അന്യമായ അവിദിതമായ പുതുമയുള്ള അജ്ഞാതമായ മുന്നറിവു_കിട്ടാത്ത.
अनवाणी: നഗ്നപാദം
अनाज्ञाकारी: ആജ്ഞ്ഞ_അനുസരിക്കാത്ത
अनात्म: ആത്മാവില്ലാത്ത
अनात्मदर्शी: ബാഹ്യ_വിഷയങളില്‍_കുടുങിയ.
अनाथ: അനാഥ രക്ഷിതാവില്ലാത്ത രക്ഷയില്ലാത്ത ആശ്രയമില്ലാത്ത അഗതിയായ അഭയമില്ലാത്ത ഉടമയില്ലാത്ത. അനാഥന്
अनादरी: ആദരണീയനല്ലാത്ത
अनादरीत: അപമാനിതനായ ആദരിക്കപ്പെടാത്ത തിരസ്ക്രിതനായ
अनासक्त: ആസക്തനല്ലാത്ത.
अनिंदनी: നിന്ദിക്കാന്_പാടില്ലാത്ത
अनितीक: ഉചിതമല്ലാത്ത അനീതിപൂര്‍ണ്ണമായ തെറ്റായ നീതിക്കു_വിരുദ്ധമായി.
अनित्सूक: ഉത്സാഹമില്ലാത്ത. ആഗ്രഹമില്ലാത്തവന്.
अनिमंत्रीत: ക്ഷണിക്കപ്പെടാത്ത
अनियंत्रीत: പരിമിതമല്ലാത്ത മിതമല്ലാത്ത.
अनियमीत: അനിശ്ചിതമായ നിശ്ചയമില്ലാത്ത. ക്രമമില്ലാത്ത
अनिर्धारीत: ഉറപ്പു_വരുത്താത്ത നിശ്ചിതമല്ലാത്ത നിശ്ചയിക്കപ്പെടാത്ത. തീരുമാനമെടുക്കാനാവാത്ത വിമര്ശിക്കാനാവാത്ത
अनिर्मीत: നിര്മ്മിക്കാത്ത.
अनिर्वाह्य: നിലനിര്ത്താത്ത ജീവിച്ചു_പോകാത്ത
अनिवासी: പുറമ്പോക്ക്_സ്ഥലം
अनिश्चित: തീരുമാനമെടുക്കാനാവാത്ത വിമര്ശിക്കാനാവാത്ത
अनिश्चीत: ആഗ്രഹിക്കാത്ത. അനിശ്ചിതമായ നിശ്ചയമില്ലാത്ത.
अनुकरण_करपी: അനുകരിക്കുന്ന
अनुकरणावपी: അനുകരിക്കുന്ന
अनुकरणीय: അനുകരണീയം.
अनुकृतीत: അനുകരണം വേറെ_ഒന്നിനെ_മാത്രികയാക്കല്‍ അനുവ്ര്‌ത്തി അനുകരിക്കല്‍ അനുകര്‍മ്മം അനുഗതി അനുപ്രവേശം അനുഹരണം അന്യര്‍ചെയ്യുന്നതു_പോലെ_ചെയ്യല്‍.
अनुक्रमान: ക്രമത്തിലുള്ള.
अनुक्रमीत: തുടറ്ച്ചായായുള്ള സ്ഥിരമായ ഇടവിടാതെയുള്ള ആവറ്ത്തിച്ചുള്ള.
अनुचीत: അനുചിതമായ അയുക്‌തമായ ശരിയല്ലാത്ത ഔചിത്യമില്ല്ലാത്ത അരുതാത്ത
अनुत्तीर्ण: തോറ്റുപോയ തോറ്റ പരാജയപ്പെട്ട വിഫലമായ അപജയപ്പെട്ട.
अनुत्पादीत: ഉത്പാദനമില്ലാത്ത
अनुपकारादीक: ദോഷം_ചെയ്യുന്ന അഹിതം_ചെയ്യുന്ന ഹാനികരമായ നിന്ദിക്കുന്ന അനാദരവു_കാണിക്കുന്ന ദ്വേഷം_ഉണ്‍ടാക്കുന്ന.
अनुपलब्ध: ലഭിച്ചിട്ടില്ലാത്ത്.
अनुपस्थीत: അസന്നിഹിതനായ ഇല്ലാത്ത ഹാജരില്ലാത്ത വരത്ത
अनुपेक्षीत: തിരസ്ക്കരിക്കാതെയുള്ള ഉപേക്ഷിക്കാതെയുള്ള അവഗണിക്കപ്പെടാതെയുള്ള.
अनुपेगी: ഉപയോഗശൂന്യ്മായ.
अनुमतीत: സ്വീകരിച്ച സ്വീകരിക്കപ്പെട്ട അനുമതി_കിട്ടിയ അനുമതി_പ്രദാനം_ചെയ്ത.
अनुमतीप्राप्त: സ്വീകരിച്ച സ്വീകരിക്കപ്പെട്ട അനുമതി_കിട്ടിയ അനുമതി_പ്രദാനം_ചെയ്ത.
अनुवंशीक: പിന്തുടര്‍ച്ചയായി_ലഭിച്ച.
अनुवादक: വിവവ്ര്ത്തകന്‍.
अनुवादपी: വിവവ്ര്ത്തകന്‍.
अनुवादीत: ഭാഷാന്തരം_ചെയ്യപ്പെട്ട തര്‍ജ്ജിമ_ചെയ്യപ്പെട്ട വിവര്‍ത്തനം_ചെയ്യപ്പെട്ട ഭാഷാന്തരം_ചെയ്യപ്പെട്ട.
अनुशासक: ഭരണകര്‍ത്താവ് ആജ്ഞാപിക്കുന്നവന്‍.
अनुशीक: ചെറിയ.
अनुसरण_करपी: പിന്തുടരുന്ന
अनुसरपी: പിന്തുടരുന്ന
अनुसरून: യോജിക്കുന്ന അനുകൂലമായ ചേര്‍ച്ചയുള്ള പൊരുത്തമുള്ള ഐക്യമുള്ള കൂടികലരുന്ന സംയോജിക്കുന്ന.
अनेक: അനേകം ഒന്നിലധികമായ പല വളരെയേറേ അസംഖ്യം.
अनेकार्थी: അനേകാര്‍ഥമുള്ള
अनैतीक: ഉചിതമല്ലാത്ത അനീതിപൂര്‍ണ്ണമായ തെറ്റായ നീതിക്കു_വിരുദ്ധമായി.
अनैत्शीक: ഇച്ഛാനുസരണമല്ലാത്ത ആഗ്രഹപൂര്‍ണ്ണമല്ലാത്ത.
अन्न_खावपी: ഭുജിക്കുന്നവന്‍
अन्न_मागपी: ഭക്ഷണാര്‍ഥിയായ
अन्नहारी: ഭുജിക്കുന്നവന്‍
अन्नाचें: കൊഴുപ്പ് കാര്‍ബൊഹൈഡ്രേറ്റ്
अन्य.: മറ്റൊന്ന് രണ്ടാമത് അതല്ലാത്തത്.
अन्याय_संबंदी: ന്യായ_വിരുദ്ധമായ നീതി_വിരുധ്ധ്ഹമായ.
अन्यायपुर्ण: അന്യായപൂര്‍ണ്ണമായ.
अन्यायी: ന്യായമില്ലായ്മ അനീതി ന്യായവിരിദ്ധമായ_പെരുമാറ്റം അക്രമം അന്യായം_ചെയ്യുന്ന ദുരാചാരിയായ.
अपंग: അംഗവിഹീന വികലാംഗ അംഗഭംഗ അംഗവൈകല്യമുള്ള കോട്ടം_വന്ന ശരീരക്ഷ്തം_വന്ന. വികലാംഗനായ
अपंगूळ: അംഗവിഹീന വികലാംഗ അംഗഭംഗ അംഗവൈകല്യമുള്ള കോട്ടം_വന്ന ശരീരക്ഷ്തം_വന്ന. മുടന്തനായ. അംഗവൈകല്ല്യമുള്ള.
अपठनीय: വായനായോഗ്യമല്ലാത്ത
अपथ्य: ആരോഗ്യത്തിനു_ഹാനികരമായ ആരോഗ്യത്തിനു_ഹാനികരമായ
अपभ्रंश: മോശമായ ചീത്തയായ.
अपभ्रंशीत: ദുഷ്പദം
अपमान: നിന്ദിക്കപ്പെട്ട അധിക്ഷേപിക്കപ്പെട്ട.
अपमान_करपी: അനാദരവ്_കാണിക്കുന്ന അപമാനിക്കുന്ന
अपमानकर्तो: അനാദരവ്_കാണിക്കുന്ന
अपमानकारक: തിരസ്ക്കരണീയ അപമാന്യമായ അപമാനജനകമായ
अपमानकारी: പുച്ചിക്കുന്ന തിരസ്ക്കരണീയ അപമാന്യമായ അപമാനജനകമായ
अपमानाचें: പുച്ചിക്കുന്ന
अपरंपार: പരിമിതമല്ലാത്ത മിതമല്ലാത്ത.
अपराजीत: ജയിക്കപ്പെടാത്ത.
अपराधी: അപരാധിയായ നിയമലംഘകനായ കുറ്റവാളിയായ പാപിയായ തെറ്റുകാരനായ തെറ്റ്_ചെയ്യുന്ന കുറ്റം_ചെയ്യുന്ന പാപം_ചെയ്യുന്ന അക്രമം_ചെയ്യുന്ന കുറ്റക്ര്‌ത്യം_ചെയ്യുന്ന ദ്രോഹം_ചെയ്യുന്ന.
अपरिपक्व: പ്ക്വതയില്ലാത്ത പാകം_വരാത്ത പൂറ്ണ്ണ_വികാസം_പ്രാപിക്കാത്ത
अपरिवर्तनशील: മാറില്ലാത്ത മാറ്റംവരാത്ത.
अपरिवारीक: കുടുമ്ബപരമല്ലാത്ത.
अपरूप: ഉപമയില്ലാത്ത അതുല്യമായ.
अपवादीत: ആക്ഷേപകരമായ. പരാതി.
अपवित्र: ശുദ്ധീകരിക്കാത്ത പരിശോധിക്കാത്ത സംശുദ്ധിയാക്കാത്ത വിരേചനം_ചെയ്യാത്ത ശുചീകരിക്കാത്ത സംസ്കരിക്കാത്ത പരിപൂതമാക്കാത്ത. അപവിത്രമായ അശുദ്ധമായ.
अपहरण_केल्लें: അപഹരിക്കപ്പെട്ട.
अपात्र: അയോഗ്യനായ ഉപയോഗമില്ലാത്ത പറ്റാത്ത കൊള്ളാത്ത തെറ്റായ അശക്തമായ കഴിവില്ലാത്ത പ്രാപ്തിയില്ലാത്ത അനുയോജ്യമില്ലാത്ത അനുരൂപമല്ലാത്ത സന്മുചിതമല്ലാത്ത അനറ്ഘമായ യുക്തമല്ലാത്ത. തെരഞ്ഞെടുക്കാന്_പറ്റാത്ത
अपीलेचें: അപേക്ഷ_സമര്‍പ്പിക്കുന്ന.
अपुरें: പൂര്‍ണ്ണമല്ലാത്തത് അപൂര്‍ണ്ണം. അപര്യാപ്തമായത് അപൂറ്ണ്ണമായത്.
अपूर्ण: പൂര്‍ണ്ണമല്ലാത്തത് അപൂര്‍ണ്ണം. മുഴുവനാകാത്ത.
अपेक्षा_नासतना: ആഗ്രഹിക്കാത്ത അപേക്ഷിക്കാത്ത മറ്റൊന്നിനെ_ആശ്രയിക്കാത്ത.
अपेक्षाहीण: ആഗ്രഹമില്ലാത്ത
अपेक्षीत: ഇച്ഛിച്ച് ആഗ്രഹിച്ച താല്പര്യപ്പെട്ട.
अपेक्षे_भायलें: അപ്രതീക്ഷിതമായി.
अपेक्षेचें: പ്രതീക്ഷയുള്ള ആശയുള്ള. ത്ര്പ്തിയുള്ള മനസ്സാലെയുള്ള.‌
अपैठ: പ്രവേശനമില്ലാത്ത.
अपैतृक: അച്ഛനോടു_ബന്ധമില്ലാത്ത പിത്രു_സമ്പന്ധമല്ലാത്ത.
अप्रकाशीत: പ്രസിദ്ധീകരിക്കാത്ത. പ്രസിദ്ധീകരിക്കാത്ത.
अप्रचलीत: പ്രചാരത്തിലില്ലാത്ത നടപ്പില്ലാത്ത പ്രസിദ്ധന്മില്ലാത്ത പരസ്യമല്ലാത്ത യുക്തമല്ലാത്ത പ്രാബല്യത്തിലില്ലാത്ത ആയുസ്സില്ലാത്ത.
अप्रतिकार: തിരിച്ചുകൊടുക്കാന്‍_പറ്റാത്തത്. തിരിച്ചുകൊടുക്കാന്‍_പറ്റാത്ത.
अप्रतिकारी: പ്രതികാരം_ചെയ്യാത്ത. പ്രതികാരം_ചെയ്യാത്ത.
अप्रतिघात: തിരിചചടിക്കാത്ത.
अप्रतिदेय: മടക്കിക്കൊടുക്കാതത.
अप्रतिभा: കഴിവില്ലായ്മ ബുദ്ധിയില്ലായ്മ.
अप्रतियोगी: മത്സരിക്കത്തവന്‍.
अप्रतिवीर्य: അതിശക്തനായ.
अप्रतिश्ठीत: അപമാനിക്കപ്പെട്ട അനാദരിക്കപ്പെട്ട.
अप्रतीबंद: ബാധ്യതയില്ലാത്ത.
अप्रतीम: വളരെ_നല്ല്
अप्रत्यक्ष: അറിയാത്ത.
अप्रभावी: നിഷ്ഫലമായ ഫലശ്യൂന്യമായ നിഷ്പ്രയോജനമായ വ്യ്ര്ത്ഥ്മായ.
अप्रमत्त: മത്ത്_പിടിച്ചിട്ടില്ലാത്ത ബോധമുള്ള ഉന്മത്തനല്ലാത്ത മദ്യപിക്കാത്ത.
अप्रमाणीक: ചതിയനായ വഞ്ചകനായ. തെളിയിക്കപ്പെടത്ത.
अप्रमाणीत: നേരാണെന്ന്_തെളിയിക്കാവുന്ന. തെളിയിക്കപ്പെടാത്ത.
अप्रमादी: ശ്രദ്ധയുള്ള.
अप्रयत्नशील: പ്രയത്നശീലമില്ലാത്ത പ്രയത്നിക്കാത്ത സംയമനമില്ലാത്ത അലസനായ മടിയനായ.
अप्रयोजक: സാന്ദര്ഭികമല്ലാത്ത അപ്രസക്തമായ. പ്രയോഗിക്കാത്ത.
अप्रवर्तक: നിരുത്സാഹകന്‍ പ്രവര്‍ത്തിക്കാത്തവന്‍.
अप्रवृत्त: ജോലിയില്‍_ശരിയായി_ഏര്‍പ്പെടാത്ത.
अप्रवृद्ध: ഏറ്റവും_കുറവില്‍ അധികം_വലുതാകാത്ത.
अप्रवेश्य: പ്രവേശിക്കാന്_പറ്റാത്ത.
अप्रशंसनीय: പ്രശംസിക്കാന്‍_യോഗ്യമല്ലാത്ത.
अप्रशिक्षीत: ശിക്ഷണം_ചെയ്യപ്പെടാത്ത പരിശീലിപ്പിക്കാത്ത ശീലിപ്പിക്കാത്ത.
अप्रसन्न: വിഷമിച്ച.
अप्रसिद्ध: പ്രസിദ്ധമല്ലാത്ത.
अप्राकृतीक: ക്ര്‌ത്രിമമായ പ്രക്ര്‌തിവിരുദ്ധമായ.
अप्राप्त: ലഭിക്കാത്ത് കിട്ടാത്ത. പ്രാപ്യമല്ലാത്തത്.
अप्रामाणीक: അപരിഷ്കൃതമായ മാന്യമല്ലാത്ത സംസ്കാരമില്ലാത്ത_പ്രാകൃതപ്പെരുമാറ്റമുള്ള
अप्रासंगीक: സാന്ദര്ഭികമല്ലാത്ത അപ്രസക്തമായ. സാന്ദര്‍ഭികമല്ലാത്ത അനഭീഷ്ട്ടമായ അരുചികരമായ നന്നായിട്ട്_തോന്നാത്ത
अप्रीय: ഇഷ്ട്ടപ്പെടാത്ത വെറുപ്പുണ്ടാക്കുന്ന. വിരിദ്ധമായ അസന്തുഷ്ടമായ.
अफगाणी: അഫ്ഘാനിന്റെ.
अफवा: കേട്ടു_കേള്‍വി.
अफेण: നുരയും_പതയും_ഇല്ലാത്ത.
अबंधक: അടക്കാത്ത.
अबध्य: വധത്തിനര്‍ഹനല്ലാത്ത. വധത്തിനര്‍ഹനല്ലാത്ത.
अबादीत: നസിക്കാതെ.
अबाध्य: ബാധ്യതയില്ലാത്ത.
अबुद्ध: അവിവേകി.
अबोध्य: ബോധ്യ_മാവാത്തത്ത്.
अबोल: അധികം_സംസാരിക്കാത്ത
अभंग: ഭങ്കം_വരാത്ത.
अभक्ष: ഉപയോഗശ്യൂന്യമായ നിരുപയോഗമായ ഫലശ്യൂന്യമായ അയോഗ്യമായ നിഷ്ഫലമായ ഗുണമില്ലാത്ത വ്യ്ര്ത്ഥമായ പാഴായ.
अभक्ष्य: ആഹാരമല്ലാത്തത്.
अभागी: ദുര്ഭാഗ്യശാലി.
अभिगोप्ता: ശരിയായി_രക്ഷിക്കുന്ന.
अभितृप्त: പൂര്‍ണ്ണമായും_ത്രിപ്തമായ.
अभिनंदीत: അഭിനന്ദിക്കപ്പെട്ട.
अभिनयीत: അഭിനയിച്ച.
अभिप्राया_आड: അനിഷ്ട്ടമായ
अभिव्यक्त: വ്യക്തമാക്കപ്പെട്ട സ്പഷ്ട്ടമായ.
अभेद्य: ഭേദിക്കാന്‍_പറ്റാത്തത് തുളക്കുവാന്‍_പറ്റാത്തത് അവിഭാജ്യം.
अभोज्य: ആഹാരമല്ലാത്തത്.
अभ्यासमोगी: പഠിപ്പില്_ശ്രദ്ധിക്കുന്ന
अभ्यासहीण: അഭ്യസിക്കാത്ത.
अभ्यासू: അഭ്യസിക്കപ്പെട്ട് പരിശീലിപ്പിക്കപ്പെട്ട. പഠിപ്പില്_ശ്രദ്ധിക്കുന്ന അദ്ധ്യാപനം
अभ्यासोपयोगी: പരിശീലിച്ചു_പഠിച്ച
अभ्रमीत: സന്ദേഹത്തിലകപ്പെടാത്ത ഭ്രമത്തില്‍_പെടാത്ത.
अमतिक्रमीत: അതിക്രമിച്ചു_കയറാത്ത.
अमर: അമരന്‍ മൃത്യുഞ്ഞയന്‍ ചിരഞ്ഞീവി അമര്‍ത്യന്‍ ചിരഞ്ജീവി.
अमानवी: അമാനുഷികമായ ലൌകികമല്ലാത്ത പരലോകസംബന്ധമായ.
अमान्य: നിഷേധിക്കപ്പെട്ടത് നിരോധിക്കപ്പെട്ട തടയപ്പെട്ട.
अमिश्रीत: കൂടി_ചേരാത്ത.
अमीट: നശിക്കാത്ത മായാത്ത സ്ഥായിയായ.
अमुक्त: മോക്ഷം_ലഭിക്കാത്ത മുക്തി_ലഭിക്കാത്ത പാപമോചനം_ലഭിക്കാത്ത മേള്ഗതി_ലഭിക്കാത്ത രക്ഷ_ലഭിക്കാത്ത വരഗതി_ലഭിക്കാത്ത പരമഗതി_ലഭിക്കാത്ത നിറ്വ്വാണം_ലഭിക്കാത്ത.
अमुरपिकें: പകുതി_പഴുത്ത.
अमुर्त: ക്ലിപ്തരൂപമില്ലാത്ത.
अमुल्य: വിലയേറിയ വിലമതിക്കാനാവാത്ത വിലപിടിച്ച വിലയേറിയത്.
अमूर्त: ഇന്ദ്രിയാതീതമായ. അശരീരി.
अयशस्वी: അസഫലമായ.
अयोग्य: അയോഗ്യനായ ഉപയോഗമില്ലാത്ത പറ്റാത്ത കൊള്ളാത്ത തെറ്റായ അശക്തമായ കഴിവില്ലാത്ത പ്രാപ്തിയില്ലാത്ത അനുയോജ്യമില്ലാത്ത അനുരൂപമല്ലാത്ത സന്മുചിതമല്ലാത്ത അനറ്ഘമായ യുക്തമല്ലാത്ത. അനുചിതമായ അയുക്‌തമായ ശരിയല്ലാത്ത ഔചിത്യമില്ല്ലാത്ത അരുതാത്ത വിപരീതമായ പ്രതികൂലമായ.
अरचीत: നിര്മ്മിക്കാത്ത.
अरमेनियायी: അറ്മേനിയന്‍
अरिश्टनिवारक: സംകട_മോചകന്.
अरिश्टमय: സംകടപ്രദമായ.
अरिश्टाचें: സംകടപ്രദമായ.
अरुचीक: അരുചികരമായ ഇഷ്ട്ടപ്പെടാത്ത. രുചിയില്ലാത്ത സ്വാദില്ലാത്ത രോചകമല്ലാത്ത ചുവയില്ലാത്ത രോചനയില്ലാത്ത രുചിതമല്ലാത്ത രുച്യമല്ലാത്ത അരുചിയുള്ള.
अरुणाचलाचें: അരുണാചലത്തിലെ.
अरुणाचली: അരുണാചലത്തിലെ.
अरूंद: ഇടുങ്ങിയ വീതി_കുറഞ്ഞ കുടുസ്സായ
अरेखीत: അതിര്‍ത്തി_തിരിക്കാത്ത.
अर्ज_करपी: അപേക്ഷകന്.
अर्ज_केल्लें: അപേക്ഷകന്.
अर्जदार: അപേക്ഷകന്. അപേക്ഷകന്.
अर्जेन्टिनी: അര്‍ജന്റീനയുടെ.
अर्थशास्त्राचें: ധനത്തെ_സംബന്ധിക്കുന്ന_ശാസ്ത്രം.
अर्थशास्त्रीय: ധനത്തെ_സംബന്ധിക്കുന്ന_ശാസ്ത്രം.
अर्थीक: സാമ്പത്തിക_സ്ഥിതി.
अर्द: പകുതി.
अर्दउकतें: പകുതി_അടഞ്ഞ.
अर्दकुटें: പൂര്‍ണ്ണമല്ലാത്തത് അപൂര്‍ണ്ണം. മുഴുവനാകാത്ത.
अर्दपिकें: പകുതി_പഴുത്ത.
अर्दमेलो: പകുതി_മരിച്ച.
अर्दवट: പൂര്‍ണ്ണമല്ലാത്തത് അപൂര്‍ണ്ണം.
अर्दवर्सुकी: അരകൊല്ലത്തെ.
अर्दशिक्षीत: അല്പം_വിദ്യയുള്ള.
अर्दुकुटें: പൂര്‍ണ്ണമല്ലാത്തത് അപൂര്‍ണ്ണം.
अर्पीत: അറ്പ്പിച്ച സമറ്പ്പിച്ച തറ്പ്പിച്ച
अर्भक: ഇപ്പോള്‍_ജനിച്ച.
अलंकृत: അലംകരിക്കപ്പെട്ട ഒരുക്കപ്പെട്ട.
अलबानियन: അല്‍ബാനിയയുടെ. അല്‍ബാനിയയുടെ.
अलभ्य: ലഭിക്കാത്ത് കിട്ടാത്ത.
अलिखीत: പ്രബന്ധമില്ലാത്ത.
अलौकीक: അമാനുഷികമായ ലൌകികമല്ലാത്ത പരലോകസംബന്ധമായ.
अल्प_काळीन: ക്ഷണികമായ നൈമിഷികമായ.
अल्पआहारी: അല്പമായും_ക്രമീക്ര്‌തമായും_ആഹാരം_കഴിക്കുന്ന മിതമായി_ഭക്ഷിക്കുന്ന സ്വല്പം_ഭക്ഷിക്കുന്ന.
अल्पशिक्षीत: അല്പം_വിദ്യയുള്ള.
अल्पसंख्यांक: ന്യൂന_പക്ഷം.
अल्पायुशी: അല്പായുസ്സുള്ള ആയുസ്സ്_കുറഞ്ഞ.
अळंकारहीण: അലംഗരിക്കാത്ത.
अळंकारा_बगरचें: അലംഗരിക്കാത്ത.
अळंकारीत: അലങ്കരിച്ച ആഭരണമണിഞ്ഞ അലങ്ക്ര്തമായ.
अवयस्क: വയസ്സില്ലാത്ത.
अवर्णनी: വര്ണ്ണിക്കാത്ത്
अवर्णनीय: പറയുവാന്_പറ്റാത്തത്.
अवश: ഒഴിവാക്കാന്_ആവാത്ത വശത്താക്ക്പ്പെടാനാവാത്ത.
अवाचनीय: വായിക്കുവാന്‍_പറ്റാത്ത.
अविकृत: വിക്രുതമല്ലാത്ത.
अविचारीक: വിചാരിക്കാത്തത്. വിചാരിക്കാതെ അവിചാരിതമായി.
अविज्ञानीक: അശാസ്ത്രീയം. വിജ്ഞാനത്തെ_സംബന്ധിക്കാത്തത്.
अविभाज्य: തുളയ്ക്കപ്പെടാത്ത. വിഭജിക്കാന്‍_പറ്റാത്ത.
अविवाहीत: അവിവാഹിത.
अविश्वासी: വിശ്വാസമില്ലാത്ത.
अविश्वासू: വിശ്വസിക്കാന്_പറ്റാത്ത.
अवेवस्थीत: ക്രമപ്പെടുത്തപ്പെടാത്ത വ്യവസ്ഥയില്ലാത്ത മര്യാദയില്ലാത്ത. സൌകര്യപ്രദമല്ലാത്ത.
अवेव्हारी: വ്യവഹാരസംബന്ധമല്ലാത്ത തൊഴില്_സംബന്ധമല്ലാത്ത.
अवेव्हारीक: ഉപയോഗിക്കാത്തത്.
अव्यक्त: പറയാത്ത
अशक्त: ലോലമായ സുകുമാരമായ കോമളമായ
अशक्य: അസംഭാവ്യമായ. അസാധ്യമായത്.
अशांत: ശാന്തമല്ലാത്ത.
अशिक्षीत: വിദ്യാഭാസമില്ലാത്ത പഠിപ്പില്ലാത്ത
अशिमांकीत: അതിര്‍ത്തി_തിരിക്കാത്ത.
अशीम: നിസ്സീമമായ അതിരറ്റ.
अशीर: ഇടുങ്ങിയ വീതി_കുറഞ്ഞ കുടുസ്സായ
अशुद्ध: ശുദ്ധീകരിക്കാത്ത പരിശോധിക്കാത്ത സംശുദ്ധിയാക്കാത്ത വിരേചനം_ചെയ്യാത്ത ശുചീകരിക്കാത്ത സംസ്കരിക്കാത്ത പരിപൂതമാക്കാത്ത. അശുദ്ധം കലര്‍പ്പുള്ള മായം_ചേര്‍ത്ത. മുഷിഞ്ഞ ശുചിയല്ലാത്ത അഴുക്കായ മലിനപ്പെട്ട വൃത്തിഹീനമായ മുഷിഞ്ഞ
अशूभ: അമംഗളകരമായ.
अशे_तरेचो: ഇതതരത്തിലുള്ള.
अशें-तशें: പ്രാധാന്യമില്ലാത്ത.
अश्राव्य: കേള്ക്കുവാന്_പറ്റാത്തത്.
अश्लील: അശ്ലീലം.
असंख्य: അസംഖ്യം.
असंतुश्ट: അത്രുപ്തം.
असंबंदीत: സംബന്ധിക്കാത്ത ബന്ധമില്ലാത്ത.
असंबंद्द: സാന്ദര്‍ഭികമല്ലാത്ത അനഭീഷ്ട്ടമായ അരുചികരമായ നന്നായിട്ട്_തോന്നാത്ത
असंयमी: ആത്മ_നിയന്ത്രണമില്ലാത്ത മിതത്വമില്ലാത്ത മിത_ഭോജി_അല്ലാത്ത സമചിത്തതയില്ലാത്ത.
असंस्कृत: അശ്ലീലം.
असत्य: നുണ കള്ളം അസത്യം
असत्यपणाचें: നുണ കള്ളം അസത്യം
असत्यापीत: നേരാണെന്ന്_തെളിയിക്കാവുന്ന.
असफळ: അസഫലമായ.
असभावीक: അസ്വാഭാവികമായ.
असभ्य: അപരിഷ്കൃതമായ മാന്യമല്ലാത്ത സംസ്കാരമില്ലാത്ത_പ്രാകൃതപ്പെരുമാറ്റമുള്ള
असमंजस: മണ്ടന്മാരായ
असमक्ष: അറിയാത്ത.
असमजिकाय: യോജിപ്പില്ലാത്ത_അവസ്ഥ.
असमजुतदार: അവിവേകി.
असमतल: പരുപരുപ്പുള്ള ഉയര്‍ന്നതും_താണതുമായ തുല്യമല്ലാത്ത പൊങിറ്യതും_താണതുമായ കുണ്ടും_കുഴിയുമായ യോജിക്കാത്ത ചേര്‍ച്ചയില്ലാത്ത.
असमाधानी: പ്രശ്നപരിഹാരമില്ലാത്ത പ്രശ്നം_പരിഹരിക്കാത്ത.
असमृद्धिदिणें: അഭിവ്ര്ദ്ധിയില്ലാത്ത് ഐശ്വര്യമില്ലാത്ത്.
असलो: ഇതതരത്തിലുള്ള.
असहनशील: സഹിക്കാത്ത.
असहमत: അഭിപ്രായൈക്യമില്ലാത്ത സ്വീകാര്യമല്ലാത്ത
असहाय्य: അസഹ്യമായ.
असादारण: അസാമാന്യമായ സാധാരണമല്ലാത്ത.
असाध्य: അസാധ്യമായത്. അസാദ്ധ്യമായത്.
असामान्य: അസാമാന്യമായ സാധാരണമല്ലാത്ത.
असुसंस्कृत: അപരിഷ്കൃതമായ മാന്യമല്ലാത്ത സംസ്കാരമില്ലാത്ത_പ്രാകൃതപ്പെരുമാറ്റമുള്ള
असैमीक: ക്ര്‌ത്രിമമായ പ്രക്ര്‌തിവിരുദ്ധമായ.
असोच: ഇതതരത്തിലുള്ള.
अस्कळीत: ക്രമപ്പെടുത്തപ്പെടാത്ത വ്യവസ്ഥയില്ലാത്ത മര്യാദയില്ലാത്ത.
अस्ताचें: ഒളിക്കപ്പെടുന്ന
अस्ताव्यस्त: ക്രമപ്പെടുത്തപ്പെടാത്ത വ്യവസ്ഥയില്ലാത്ത മര്യാദയില്ലാത്ത.
अस्तित्वांत_आशिल्लें: സമകാലീന വറ്ത്തമാനകാല ഇപ്പോഴുള്ള നിലവിലുള്ള.
अस्तूंक_नाशिल्लें: അസ്തമിക്കാത്ത
अस्थायी: സ്ഥിരം_അല്ലാത്ത
अस्थिहीण: അസ്ഥി_ഇല്ലാത്ത_.
अस्थीमय: അസ്ഥികളെ_കൊണ്ട്_നിര്‍മ്മിച്ചത്.
अस्थीर: ചലനാത്മകമായ പുരോഗമനപരമായ ക്രിയാത്മകമായ. ചഞ്ചലചിത്തനായ അസ്ഥിരനായ ദ്രിഢാഭിപ്രായമില്ലാത്ത. ചഞ്ഞ്ചലിതമായ.
अस्पश्ट: അസ്പഷ്ട്ടമായ. മങ്ങലുള്ള വ്യ്ക്‌തമല്ലാത്ത അസ്പഷ്ടമായ അവ്യക്‌തമായ
अस्पृश्य: തൊട്ടുകൂടാത്ത.
अस्वच्छ: മുഷിഞ്ഞ
अस्वस्थ: അസ്വസ്ഥമായ.
अस्विकृत: നിരാകരിച്ച സമ്മതിക്കാത്ത് സമ്മതമില്ലാത്ത സമ്മതം_ലഭിക്കാത്ത സമ്മതംകിട്ടാത്ത.
अस्सल: ശുദ്ധമായ ഒന്നാംതരമായ ശുദ്ധമായതു.
अहंकारी: അഹങ്കാരിയായ അഹന്തയുള്ള അഹമ്മതിയുള്ള പൊങ്ങച്ചക്കാരിയായ
अहिंसक: ഹിംസ_ചെയ്യാത്ത.
अहीतकारी: പതനത്തിന്‍_കാരണമായവന്‍. അമംഗളകരം_ഇഷ്ട്ടപ്പെടുന്നവന് അശുഭ_ചിന്തകന്ന്.
आंकवार: അവിവാഹിത്ന്. അവിവാഹിത. കുമാരി.
आंगाचे: ശാസ്ത്രത്തിനനുസ്രിതമായ_.
आंगीक: ശാസ്ത്രത്തിനനുസ്രിതമായ_.
आंतकड्यांचें: കുട്ല്_സംബന്ധമായ.
आंतरदेशी: അന്തര്‍ദേശീയം.
आंतरराज्य: ആഭ്യന്തരം.
आंतरीक: ആന്തരികമായ.
आंतर्राष्ट्रीय: അന്താരാഷ്ട്രീയമായ.
आंधळो: അന്ധനായ കാഴ്ചയില്ലാത്ത കണ്ണില്ലാത്ത
आंबट: പുളിയുള്ള അംളരസമുള്ള
आंवुळिल्ल्या: ചുരുങ്ങുക.
आकर्शक: ആകര്‍ഷിക്കുന്ന ആകര്‍ഷകമായ ആകര്‍ഷണീയമായ വശ്യ മാസ്മരശക്‌തിയുള്ള മാദകമായ ചേതോഹാരിയായ ആനന്ദിപ്പിക്കുന്ന വശീകൃതമായ ആക്ഷേപിക്കുന്ന
आकलनीय: എണ്ണപ്പെടാവുന്ന കണക്കാക്കത്തക്ക അംഗീകരിക്കപ്പെടേണ്ട്.
आकस्मीक: പെട്ടെന്നുള്ള.
आकाराचें: നിര്‍മ്മാണം രൂപം ആക്രിതി_കൊടുക്കല്‍.
आकारीक: വിസ്താരമുള്ള.
आकारीत: പാദമില്ലാത്ത.
आकालीक: കാലത്തിനല്ലാത്ത
आकाशी: ആകാശനീല.
आक्रमक: ആക്രമിക്കുന്ന.
आक्रमणकारी: ആക്രമ_സ്വഭാവമുള്ള.
आक्रमणा_बगरचें: ആക്രമിക്കാത്ത.
आक्रमणा_विरयत: ആക്രമിക്കാത്ത.
आक्रांत: തോല്‌പ്പിക്കപ്പെട്ട
आगंतूक: ഇന്നതായ
आगळें: വ്യത്യസ്ഥമായ ഭിന്നമായ
आगळो: ഉപമയില്ലാത്ത അതുല്യമായ.
आगामी: വരാന്‍_പോകുന്ന ഭാവികാലത്തെ_സംബന്ധിച്ച.
आग्रही: നിര്‍ബന്ധബുദ്ധിയുള്ള
आघात_वर्धनी: അടിച്ചു_പരത്താവുന്ന.
आचारवान: ഉത്തമനായ സര്‍വ്വശ്റേഷ്ടനായ അതിവിശിഷ്ടനായ ഉല്‍കൃഷ്ടനായ അതുല്യനായ അദ്വിതീനായ മികവുള്ളവനായ
आजापीत: പ്രത്യേകതയുള്ള അപൂര്വമായ.വ്യത്യാസമായ.
आज्ञा_करपी: ആജ്ഞ്ഞാപിക്കുന്ന.
आज्ञाकारी: ആജ്ഞ്ഞാപിക്കുന്ന.
आज्ञातीत: ആജ്ഞാപിക്കപ്പെട്ട നിറ്‌ദ്ദേശിക്കപ്പെട്ട കല്പിക്കപെട്ട ഏല്‍പ്പിക്കപ്പെട്ട.
आज्ञाभंगी: ആജ്ഞ്ഞ_അനുസരിക്കാത്ത
आज्ञेचें: ആജ്ഞാപിക്കപ്പെട്ട നിറ്‌ദ്ദേശിക്കപ്പെട്ട കല്പിക്കപെട്ട ഏല്‍പ്പിക്കപ്പെട്ട.
आटक: തടവിലാക്കിയ ബന്ധനത്തിലാക്കിയ കാരഗ്രഹത്തിലായ തടങ്കലിലായ.
आठ: എട്ട് 8
आठपट: എട്ടുമടങ്ങ്
आठवड्याचें: ആഴ്ചയിലുള്ള.
आठवें: എട്ടാം എട്ടാമത്തെ
आडखळ_हाडपी: ഇന്സുലേറ്റര് തടയ്ല്.
आडखळहीण: വിഘ്നം_ഇല്ലാത്ത്.
आडखळिल्लें: കുരുക്കുള്ള് കുഴപ്പത്തില്_പെട്ട.
आडखळिल्लो: ഒടക്കിയ. അടഞ്ഞുപ്പോയ
आडखळीन_भरिल्लें: നിരോധനമുള്ള അവരോധമുള്ള.
आडखळीबगरचें: വിഘ്നം_ഇല്ലാത്ത്.
आडनदर: ഉപേക്ഷിക്കപ്പെട്ട. ഉപേക്ഷിക്കത്തക്ക അവഹേളിക്കത്തക്ക.
आडमेळी_हाडपी: ഇന്സുലേറ്റര് തടയ്ല്.
आडवो: കുറുകെയുള്ള വിലങ്ങനെയുള്ള ചെരിഞ്ഞ വളഞ്ഞ.
आडावपा_भायरें: തടയാന്_പറ്റാത്ത.
आतांचें: വറ്ത്തമാനകാലത്തുള്ള വറ്ത്തമാനസമയത്തുള്ള ഇപ്പൊഴുള്ള ഇന്നത്തെ വറ്ത്തമാനമായ.
आतिरिक्त: കൂടാതെ അല്ലാതെ
आतूर: ഇളകിമറിഞ്ഞ തകിടം_മറിഞ്ഞ.
आत्मपरक: സ്വാര്ഥതയുള്ള
आत्मप्रशंसी: പ്രതീക്ഷിച്ച കാത്തിരിന്ന.
आत्माभिमानी: ആത്മാഭിമാനമുള്ള.
आदखळीचे: ബുദ്ധിമുട്ടുള്ള_.
आदर्श: ആദര്ശവാനായ
आदर्शवादी: പ്രദര്‍ശിപ്പിക്കുന്ന കാണിക്കുന്ന.
आदलें: ജീര്‍ണ്ണിച്ച. പുരാതനം പണ്ടേയുള്ള പൂര്‍വ്വ_കാലത്തെ
आदारप्राप्त: സഹായം_ലഭിച്ചിട്ടുള്ള ധനസഹായം_ലഭിച്ചിട്ടുള്ള.
आदारवान: സാധകമാക്കുന്ന സഹായക ഉപകരിക്കുന്ന ഗുണപ്രദമായ അനുകൂലമായ പ്രയോജനകരമായ ചായ്‌വുള്ള പോഷകമായ ഉതകുന്ന ഉന്നതി_വരുത്തുന്ന അഭിവ്ര്‌ദ്ധിപ്പെടുത്തുന്ന.
आदारीत: ആശ്രയിക്കപ്പെട്ട.
आदिवासी: ഗിരിവര്‍ഗ്ഗ_സംബന്ധിയായ.
आदेशीत: ആജ്ഞാപിക്കപ്പെട്ട നിറ്‌ദ്ദേശിക്കപ്പെട്ട കല്പിക്കപെട്ട ഏല്‍പ്പിക്കപ്പെട്ട.
आधुनीक: ആധുനികം.
आनंददायी: ആനന്ദപ്രദം ആനന്ദ_ദായകം സുഖപ്രദം പ്രസന്നതാദായകം ആനന്ദദായി ആനന്ദകാരി ആഹ്ലാദി.
आनंदी: വിനോദപ്രിയനായ ആനന്ദം_പൂണ്ടവന്‍ ഉത്സാഹമുള്ള_.
आनंदीत: ആനന്ദപൂര്‍ണ്ണം ആനന്ദമയം ഉല്ലാസപൂര്‍ണ്ണം സാനന്ദം. ആനന്ദം_നിറഞ്ഞ സന്തോഷം_പ്രകടിപ്പിക്കുന്ന. സന്തോഷമുള്ള്വരാകുക.
आनिकूय: വേറെയും മറ്റു
आनिवार्य: ദുര്നിവാര്യമായ.
आनीक: വേറെയും മറ്റു
आनीक_कोणूय: വേറെയും മറ്റു
आपखोसयेचें: സ്വന്തം_ഇഷ്ട്ടാനുസരണം.
आपणायिल्ली: അങ്കീകരിച്ച സ്വീകരിച്ച.
आपणायिल्लें: സ്വന്തമായി_തിരഞ്ഞെടുത്ത.
आपरोसहीण: നിസ്സാരമായ കഴ്മ്പില്ലാത്ത. നിസ്സാരമായ കാര്യമില്ലാത്ത.
आपले_सुवातेर_बरयिल्लें: കുറിച്ചു_വച്ച.
आपलें: അവനവന്റെ സ്വന്തമായ തന്റെ തന്റേതായ.
आपलेपणाचे_भामनेन: സ്വജന_സങ്കല്പത്തോടു_കൂടി.
आपल्या_पक्षाचो: എന്റെ_പക്ഷത്തുള്ള സ്വ്ന്തം_ഭാഗത്തുള്ള തന്റെ തന്റെ_പക്ഷത്തുള്ള സ്വപക്ഷത്തുള്ള.
आपसुवार्थी: സ്വാര്‍ത്ഥ_താത്പര്യമുള്ള തങ്കാര്യത്തിലുള്ള_ശ്രദ്ധയുള്ള സ്വാര്‍ത്ഥ_ബുദ്ധിയുള്ള സ്വതാത്പര്യ്മുള്ള ആത്മാരാധന അഹങ്കാരോന്മാദിയായ പൊങച്ചം_കാണിക്കുന്ന സ്വജന_പക്ഷപാതമുള്ള ഭൌതിക_താത്പര്യങളുള്ളൈടുങിയ_മനസ്ത്ഥിതിയുള്ള_.
आपार: പരിമിതമല്ലാത്ത മിതമല്ലാത്ത.
आपोवंक_नाशिल्ले: ക്ഷണിക്കപ്പെടാത്ത
आफडूंक_नाशिल्लें: തൊടാത്ത
आफताबी: സൂര്യനെ_സംബന്ധിച്ച.
आबुझाद: മാറിയ ഇളക്കപ്പെട്ട അസ്ഥിരമായ ചഞ്ചലമായ പരിഭ്രമിച്ച.
आबूझ: മാറിയ ഇളക്കപ്പെട്ട അസ്ഥിരമായ ചഞ്ചലമായ പരിഭ്രമിച്ച.
आभारी: നന്ദിയുള്ള ഉപകാര_സ്മരണയുള്ള.
आभुशीत: അലങ്കരിച്ച ആഭരണമണിഞ്ഞ അലങ്ക്ര്തമായ.
आम: സാധാരണ.
आमल: അമ്ലതയുള്ള
आमिझाद: മിത്രത മിത്രോചിതമായ_.
आमीग_आशिल्लो: കൂട്ടുകാരോടു_കൂടിയ.
आम्लीक: അമ്ലസംബന്ധി
आयकपा_सारको: കേള്ക്കത്തക്ക.
आयकल्यो: കേട്ടിട്ടുള്ള.
आयकुपा_सारकें: കേള്ക്കുവാന്_സാധിക്കുന്നത്.
आयकूंक_नाशिल्ली: ഇതുവരെയും_കേള്ക്കാത്ത്ത്.
आयचो_काळ: നിലവിലുള്ള്_കാലത്തെ
आयच्या_काळांतलें: ആധുനികം.
आयदनाचें: മൂശാരിയുടെ.
आयरलॅंडी: അയര്‍ലാന്റിലെ
आयरिश: ഐറിഷ്
आयसलॅण्डाचें: അയിസ്ലാണ്ഡിന്റെ.
आयसलॅण्डी: അയിസ്ലാണ്ഡിന്റെ.
आयामी: വിസ്താരമുള്ള.
आयिल्लें: ആക്രമിക്കപ്പെട്ട ഉപദ്രവിക്കപ്പെട്ട.
आयिल्लो: വന്ന തിരിച്ചു_വന്ന വന്നുചേര്‍ന്ന എത്തിയ ആഗമിച്ച ആഗതനായ പ്രാപിച്ച എത്തിച്ചെര്‍ന്ന എത്തിക്കഴിഞ സമീപിക്കുന്ന കയറിക്കൂടിയ വസിക്കുന്ന ചെന്നെത്തിയ.
आयोजीत: തയ്യാറാക്കിയ
आरक्षीत: കരുതല്.
आरामदिणी: വിശ്രമദായകമായ വിശ്രമം_നല്കുന്ന ക്ഷീണമകറ്റുന്ന ആശ്വാസം_നല്കുന്ന.
आरोग्याक_बरें: ആരോഗ്യപ്രദമായ.
आरोप_करपी: ആരോപിക്കുന്ന്യാള്‍.
आरोपी: കുറ്റം_ആരോപിക്കപ്പെട്ട ആരോപിക്കപ്പെട്ടയാള്‍.
आरोही: ആരോഹണ കയറുന്ന ആരോഹണം_ചെയ്യുന്ന.
आर्काचें: കമാനയുക്തമായ
आर्काट्याचें: കമാനയുക്തമായ
आर्थीक: സാമ്പത്തിക_സ്ഥിതി.
आर्य_जातीचें: ആര്യജാതിയില്പെട്ട.
आलतडचें: അഗാധതയെ_മറി_കടക്കാത്ത.
आलमपेड्ड्यार: പണിയെടുക്കാത്ത.
आलायतें: കൂടാതെ അല്ലാതെ
आल्मिखुशाल: ആകുലതയില്ലാത്ത.
आल्मीखुशाल: ആശങ്കയില്ലാത്ത ഭയമില്ലാത്ത ശങ്കയില്ലാത്ത ചിന്തയില്ലാത്ത കൂസലില്ലാത്ത.
आळशी: അലസനായ മടിയനായ ആലസ്യമുള്ള
आवटें: അവിവേകിയായ ജളനായ ഭോഷനായ മൂഢനായ മന്ദതയുള്ള ജളത്വമുള്ള വീതി
आवडनाशिल्लें: ഇഷ്ട്ടപ്പെടാത്ത വെറുപ്പുണ്ടാക്കുന്ന. അരുചികരമായ ഇഷ്ട്ടപ്പെടാത്ത.
आवडीचें: ഇച്ഛിച്ച് ആഗ്രഹിച്ച താല്പര്യപ്പെട്ട. മനസ്സിനിണങ്ങിയ പ്രിയപെട്ട ഇഷ്ടപെട്ട
आवय_नाशिल्लो: അമ്മയില്ലാത്ത മാത്ര്ഹീനന്‍.‌
आवरणहीण: തുറന്ന മൂടി_നീക്കിയ അടപ്പു_മാറ്റിയ
आवेगपूर्ण: ബാധിച്ച തീവ്രമായ_വികാരം_നിറഞ്ഞ തീവ്രമായ_വികാരം_നിറഞ്ഞ
आशादायी: ആശാജനകമായ.
आशावादी: പ്രതീക്ഷയുള്ള ആശയുള്ള. ശുഭാപ്തിവിശ്വാസത്തിന്റെ.
आशियायी: ഏഷ്യന്‍.
आशेखोर: അത്യാഗ്രഹമുള്ള അത്യാറ്‍ത്തിയുള്ള ലോഭമുള്ള ദുരാഗ്രഹമുള്ള അതിതൃഷ്ണയുള്ള അതിമോഹമുള്ള
आशेचें: ത്ര്പ്തിയുള്ള മനസ്സാലെയുള്ള.‌
आशेभगत: അത്യാഗ്രഹമുള്ള അത്യാറ്‍ത്തിയുള്ള ലോഭമുള്ള ദുരാഗ്രഹമുള്ള അതിതൃഷ്ണയുള്ള അതിമോഹമുള്ള
आशेल्ले: ആകര്‍ഷിക്കപ്പെട്ട കൊതിയുള്ള അത്യാഗ്രഹമുള്ള.
आशेल्लो: പ്രബലമായ_ആഗ്രഹം.
आश्चर्य: സൂര്യന്റെ.
आश्चर्याचें: അഭൂതപൂര്വ്വമായ പണ്ണ്ടുണ്ടാവാത്ത.
आसक्त: ആസക്തനായ താല്പര്യമുള്ള വിശ്വാസമുള്ള അനുരാഗമുള്ള താത്പര്യമുള്ള ശുഷ്കാന്തിയുള്ള മോഹമുള്ള അനുരക്തനായ.
आसपावीत: ചേര്ച്ചയുള്ള
आसा: ക്രിത്യമായി_സ്ഥാന_നിര്ണ്യം_നടത്തിയ.
आसामी: ആസാമിന്റേതായ. ആസാമിലെ ആസാമിലെ
आस्ट्रियायी: ആസ്ട്രിയയുടെ.
आस्पाविल्ले: ഗ്രസിക്കപ്പെട്ട.
आहाराचें: ഭക്ഷണയോഗ്യമായ ഭക്ഷണ_പദാര്‍ഥം.
इंग्रजी: ഇംഗലീഷ് ഇംഗ്ലീഷുകാര്‍
इंग्लीश: ഇംഗ്ലീഷുകാര്‍
इंग्लेज: ഇംഗലീഷ് ഇംഗ്ലീഷുകാര്‍
इंद्रीयगम्य: ഇന്ദ്രിയങള്‍ക്ക്_വിഷയമാകത്തക്ക.
इंद्रीयगोचर: ഇന്ദ്രിയങള്‍ക്ക്_വിഷയമാകത്തക്ക.
इकरावें: പതിനൊന്നാം പതിനൊന്നാമത്തെ
इजिप्ती: ഈജിപ്ഷ്യന്‍.
इटाली: ഇറ്റലിയുടെ.
इटालीयन: ഇറ്റാലിയന്‍. ഇറ്റലിയുടെ.
इण्डोनेशियन: ഇന്ദോനേഷ്യയുടെ
इतलें: തുല്യമായ സമമായ സമാനമായ
इतिहासीक: ചരിത്ര_സംബന്ധമായ.
इत्शीक: ഇച്ഛയനുസരിച്ചുള്ള തിരഞെടുക്കാനുള്ള ആഗ്രഹന്മനുസരിച്ചുള്ള തിതമനുസരിച്ചുള്ള അഭിലാഷം_അനുസരിച്ചുള്ള ഇച്ഛിത ഉദ്ദിഷ്ടമായ താ‍ത്പര്യമുള്ള തിതകരമായ.
इत्शीत: ഇച്ഛയനുസരിച്ചുള്ള് ഇഷ്ടത്തിനനുസ്രിതമായ ഉദ്ദേശ്യത്തോടെയുള്ള.
इत्सा_नासतना: ഇച്ഛാനുസരണമല്ലാത്ത ആഗ്രഹപൂര്‍ണ്ണമല്ലാത്ത.
इत्साहीण: ആഗ്രഹമില്ലാത്തവന്. ആഗ്രഹമില്ലാത്തവന്.
इत्सीत: ഇച്ഛിച്ച് ആഗ്രഹിച്ച താല്പര്യപ്പെട്ട.
इत्सुक: ആഗ്രഹമുള്ള.
इत्सूक: ത്ര്പ്തിയുള്ള മനസ്സാലെയുള്ള.‌
इत्से_बगर: ഇച്ഛാനുസരണമല്ലാത്ത ആഗ്രഹപൂര്‍ണ്ണമല്ലാത്ത.
इथियोपियायी: എത്യോപ്യന് എത്യോപ്യ.
इनामी: സമ്മാന സമ്മാനത്തിന്റെ സമ്മാനത്തിന്റേതായ.
इबाडिल्लें: ചീഞ്ഞഅഴുകിയ അളിഞ്ഞ ജീര്‍ണ്ണിച്ച
इबाडिल्लो: മോശമായ ചീത്തയായ.
इमारतीचें: കെട്ടിട_സംബന്ധിച്ച കെട്ടിട_സംബന്ധമായ.
इराकी: ഇറാക്കിലെ ഇറാക്ക്_രാജ്യത്തെ.
इराणी: ഇറാനി പേര്‍ശ്യന്‍ ഇറാനിന്റെ
इर्शेन_भरिल्लें: അസൂയ_നിറഞ്ഞ.
इल्लें: കുറച്ചു.
इल्लेशें: ലേശം_മാത്രം.
इश्कोलाचें: വിദ്യാലയത്തിലെ
इश्ट_आशिल्लो: കൂട്ടുകാരോടു_കൂടിയ.
इश्टागत: സ്നേഹബുദ്ധിയായ ഇടപഴകുന്ന ആത്മാര്‍ത്ഥതയുള്ള. മിത്രത മിത്രോചിതമായ_.
इश्टाबगरचो: കൂട്ടുകാരില്ലാത്ത.
इश्टाविरयतचो: കൂട്ടുകാരില്ലാത്ത.
इश्वरी: ഈശ്വരനെ_സംബന്ധിക്കുന്ന ദേവിയെ_സംബന്ധിക്കുന്ന പരമേശ്വരിയെ_സംബന്ധിക്കുന്ന.
इस्रायली: ഇസ്രേയേലിയന്‍.
इहलोकीक: ഈ_ലോകത്തുള്ള ലൌഗികമായ.
उंचलो: മുകളിലുള്ള.
उंचल्या_कुळातलो: ഉന്നതകുലജാതനായ.
उंचवटो: ഉയര്ന്ന പൊങ്ങിയ ഉയര്ന്നു_നില്ക്കുന്ന.
उंचेलें: ഉയര്‍ന്ന പൊക്കമുള്ള
उकडिल्लें: പുഴുങ്ങിയ.
उकतायिल्लें: വ്യക്തമാക്കപ്പെട്ട സ്പഷ്ട്ടമായ.
उकती: ഒളിവില്ലാത്ത.
उकतें: തുറന്ന മൂടി_നീക്കിയ അടപ്പു_മാറ്റിയ രഹസ്യസ്വഭാവമല്ലാത്ത രഹസ്യമല്ലാത്ത. തുറന്ന തുറന്ന പരസ്യമാക്കിയ ആരംഭിച്ച വെളിപ്പെടുത്തിയ.
उकतेपणीचें: ആവര്ത്തിക്കാത്ത
उकतो: നഗ്നനായ വിവസ്ത്രനായ ദിഗംബരനായ അനംബരനായ
उकत्या_पांयाचें: നഗ്നപാദം
उक्तें: പരസ്യമായ.
उगडास_नाशिल्लें: മറന്നു_പോയ.
उगडें: തുറന്ന മൂടി_നീക്കിയ അടപ്പു_മാറ്റിയ
उग्रवादी: ഉഗ്രവാദി തീവ്രവാദി.
उचांबळ: അസ്വസ്ഥമായ. ഇളകിമറിഞ്ഞ തകിടം_മറിഞ്ഞ.
उचांबळीत: ചഞ്ചലചിത്തനായ അസ്ഥിരനായ
उचीत: സാന്മാര്‍ഗ്ഗികത സാന്മാര്‍ഗ്ഗികാചരണം. യുക്തമായ ഉചിതമായ ഒത്ത തക്ക ഉചിതമായ.
उच्च: ഏറ്റവും_പ്രായം_കൂടിയത്.
उजबेकिस्तानी: ഉസ്ബെക്കിസ്താനിന്റെ.
उजळ: വെളുത്തത്. സ്വര്‍ണ്ണം_കൊണ്ടലങ്ങ്കരിച്ച കാന്തിപൂര്‍ണ്ണമായ ഉജ്ജ്വലമായ.
उजळणी: ആവര്‍ത്തിച്ച.
उजू: സത്യസന്ധനായ നെറിയുള്ള വിശ്വസ്തനായ
उजो_पालोवपी: വേദന_ഇല്ലാതാക്കുന്ന ശമിപ്പിക്കുന്ന.
उडयिल्लें: ഉപേക്ഷിച്ച
उडिया: ഒറിയ
उणे_पिरायेचें: അല്പായുസ്സുള്ള ആയുസ്സ്_കുറഞ്ഞ.
उणें: അപര്യാപ്തമായത് അപൂറ്ണ്ണമായത്. കുറച്ചു.
उणें_उलोवपी: അല്പം_സംസാരിക്കുന്നത്.
उणें_केल्लें: ജോലിയില്‍_നിന്നു_മാറ്റി_നിര്‍ത്തിയ.
उणें_जाल्लें: കുറയുക.
उण्या_आयुश्याचें: അല്പായുസ്സുള്ള ആയുസ്സ്_കുറഞ്ഞ.
उण्यांतउणें: ഏറ്റവും_കുറഞ്ഞ.
उतरांचें: വാക്കുകളെ_സംബന്ധിക്കുന്ന.
उताणें: മലര്‍ന്നു_കിടക്കുക.
उतावळें: സൂക്ഷ്മതയില്ലാത്ത വേണ്ടപോലെ_ആലോചിക്കാത്ത ദ്രുതഗതിയിലുള്ള.
उतावळो: ചഞ്ചലചിത്തനായ അസ്ഥിരനായ
उत्तम: ഉത്തമമായ.
उत्तर_अमेरीकी: വടക്കേ_അമേരിക്കയിലെ.
उत्तर_कोरियायी: ഉത്തര_കൊറിയന്‍.
उत्तरकाळीन: ഉത്തരകാലീനമായ.
उत्तरदायी: ഉത്തരവാദിത്വമുള്ള ഉത്തരവാദപ്പെട്ട
उत्तरी: വടക്കിനെ_സംബന്ധിക്കുന്ന.
उत्तीर्ण: വിജയിച്ച ജയിച്ച്ച സഫലമായ.
उत्तेजक: ഉത്തേജിപ്പിക്കുന്ന പ്രേരിപ്പിക്കുന്ന ജ്വലിപ്പിക്കുന്ന.
उत्तेजीत: ഉതേജിപ്പിക്കുക ജ്വലിപ്പിക്കുക. ഉത്പ്രേരിതമായ
उत्पन्न: ഉത്പാദിപ്പിക്കുന്ന ഉത്ഭവിക്കുന്ന ഔല്പാദികമായ ഉല്പാദിക്കപ്പെട്ട് ഉല്പാദിത ഉല്പാദിപ്പിക്കപ്പെട്ട ഉല്പാദ്യ് സ്ര്‌ഷ്ടിപരമായ നിറ്മ്മാണാത്മകമായ രചനാത്മകമായ.
उत्पादीत: ഉത്പാദിപ്പിക്കപ്പെട്ട.
उत्पादीत_जाल्लें: ഉത്പാദിപ്പിക്കുന്ന ഉത്ഭവിക്കുന്ന ഔല്പാദികമായ ഉല്പാദിക്കപ്പെട്ട് ഉല്പാദിത ഉല്പാദിപ്പിക്കപ്പെട്ട ഉല്പാദ്യ് സ്ര്‌ഷ്ടിപരമായ നിറ്മ്മാണാത്മകമായ രചനാത്മകമായ.
उत्साहहीण: ഉത്സാഹമില്ലാത്ത.
उत्साही: ഉത്സാഹമുള്ള_.
उत्सुक: അറിയാനാഗ്രഹമുള്ള ജിജ്ഞാസു.
उथळ: ആഴമില്ലാത്ത ആഴം_കുറഞ്ഞ താഴ്ച_കുറഞ്ഞ
उदकाळ: വെള്ളമയം
उदय_जाल्लो: ഉദിച്ച ഉയര്ന്ന.
उदार: ഉദാരമായ ദാനശീലമുള്ള. ഉദാരമതിയായ വിശാലഹ്രിദയനായ .
उदारें: മലര്‍ന്നു_കിടക്കുക.
उदेल्लो: ഉദിച്ച ഉയര്ന്ന.
उद्घोशक: വിളംബരം_ചെയ്യുന്ന ഉദ്ഘോഷിക്കുന്ന ഘോഷിക്കുന്ന പ്രസ്താവിക്കുന്ന പ്രഖ്യാപിക്കുന്ന.
उद्धार_केल्लें: ഉദ്ധരിക്കപ്പെട്ട
उद्युक्त: ആര്ജ്ജിക്കാത്ത
उद्येगीक: ഔദ്യോഗികമായ.
उध्वस्त: മരിച്ച നശിച്ച നശിപ്പിക്കപ്പെട്ട.
उनी: കമ്പിളി.
उन्नत: വികസിതമായ.
उन्नतीकारक: കയറ്റം_കിട്ടുന്നത് ഉയര്‍ച്ചകിട്ടുന്നത് വ്ര്ദ്ധി_ഉണ്ാകുന്നത് അഭിവ്ര്ദ്ധി_ഉണ്ടാകുന്നത് പുരോഗ്തി_ഉണ്ടാകുന്നത്.
उपकारादीक: ഉപകാരം_ചെയ്യുന്ന സഹായിക്കുന്ന നന്മ_ചെയ്യുന്ന
उपकारी: നന്ദിയുള്ള ഉപകാര_സ്മരണയുള്ള. ക്ര്താര്ഥന്.
उपचार_केल्लें: ചികിത്സിക്കപ്പെട്ട ശുശ്രൂഷിക്കപ്പെട്ട.
उपचारा_बगरचें: ശുശ്രൂഷിക്കപ്പെട്ട ചികിത്സിക്കപ്പെട്ട ചികിത്സ_നല്‍കപെട്ട.
उपदेश_करपी: ഉപദേശകന്.
उपदेशक: ഉപദേശകന്.
उपदेशी: ഉപദേശകന്.
उपद्रवग्रस्त: അശാന്തിപൂര്ണ്ണമായ.
उपभोगी: ഉപയോഗ്യമായ.
उपयुक्त: യുക്തമായ ഉചിതമായ ഒത്ത തക്ക
उपयोगी: ഉപയോഗമുള്ള പ്രയോജനമുള്ള
उपरो: ഉയര്ന്ന പൊങ്ങിയ ഉയര്ന്നു_നില്ക്കുന്ന.
उपस्थीत: ഹാജരുള്ള സന്നിഹിതമായ വന്ന ഉള്ള
उपहासात्मक: പരിഹാസത്തിനു_അര്‍ഹനായ നിന്ദായോഗ്യമായ.
उपाट: വളരേയധികം. വളരേ. അടക്കാന്_പടാത്ത പ്രബലമായ ജയിക്കാന്_പറ്റാത്ത. പൂര്‍ണ്ണമായ നിറഞ്ഞു_കവിഞ്ഞ
उपाधीत: അലംകരിക്കപ്പെട്ട ഒരുക്കപ്പെട്ട.
उपाशी: ഉപവാസം നിരാഹാരം
उपासमारो: പട്ടിണിയായ.
उपेक्षा: ഉപേക്ഷിക്കത്തക്ക അവഹേളിക്കത്തക്ക.
उपेक्षित: ഉപേക്ഷിക്കപ്പെട്ട തിരസ്ക്കരിക്കപ്പെട്ട
उपेक्षीत: ഉപേക്ഷിക്കപ്പെട്ട.
उपेगाचें: ലാഭദായകം ഗുണകരം ഉപയോഗപ്രദം.
उपेगी: യോഗ്യനായ കാര്യശേഷിയുള്ള നിപുണനായ സമര്ത്ഥനായ ശക്തനായ വിദഗ്ദ്ധനായ ചുണയുള്ള ചെയ്തുതഴക്കമുള്ള ചതുരനായ ചുറുചുറുക്കുള്ള ജ്ഞാനമുള്ള കെല്‍പ്പുള്ള പാടവമുള്ള കൌശലമുള്ള കഴിവുള്ള ഉപയോഗമുള്ള പ്രയോജനമുള്ള ഉപയോഗമുള്ള ഗുണമുള്ള പ്രയോജനകരമായ പ്രയോജനപ്രദമായ ഉപയോഗയോഗ്യമായ യൌഗികമായ പ്രയുക്തമായ കൊള്ളാവുന്ന പറ്റിയ.
उप्तादीत: ഉത്പാദിപ്പിക്കുന്ന ഉത്ഭവിക്കുന്ന ഔല്പാദികമായ ഉല്പാദിക്കപ്പെട്ട് ഉല്പാദിത ഉല്പാദിപ്പിക്കപ്പെട്ട ഉല്പാദ്യ് സ്ര്‌ഷ്ടിപരമായ നിറ്മ്മാണാത്മകമായ രചനാത്മകമായ.
उप्राशिल्लें: വന്നു_ചേര്‍ന്ന.
उबगणें: മനസ്സ്_മുഷിഞ്ഞ മനസ്സ്_മടുത്ത.
उबगल्लें: മടുപ്പ് മുഷിച്ചില്.
उबें: മുകളില്‍ ഉയരത്തില്‍.
उबें_केल्लें: രചിക്കപ്പെട്ട എഴുതപ്പെട്ട.
उबेवपी: പൊങ്ങികിടക്കുന്ന പൊന്തി_കിടക്കുന്ന.
उभयचर: ഉഭയചര വെള്ളത്തിലും_കരയിലും_ജീവിക്കുന്ന.
उमेदी: ആനന്ദം_നിറഞ്ഞ സന്തോഷം_പ്രകടിപ്പിക്കുന്ന. വിനോദപ്രിയനായ ആനന്ദം_പൂണ്ടവന്‍ സന്തോഷമുള്ള്വരാകുക. ഉത്സാഹമുള്ള_.
उमेदी_बगरचें: ഉത്സാഹമില്ലാത്ത.
उरफाटे: വിപരീതം.
उरफाटें: വിപരീതമ്മയ്.
उरफाटो_चलपी: പിന്തിരിപ്പന്‍.
उरफाट्या_अर्थाचें: വിപരീതമായ
उरफाट्या_काळजाचो: കഠിനഹ്രിദയനായ കഠോരഹ്രിദയനായ ദയ_ഇല്ലാത്ത. വികാരമില്ലാത്ത.
उरमट: അചഞ്ചലമായ മാറാത്ത നിശ്ചലമായ.
उरिल्लें: കഴിഞ്ഞിട്ടില്ലാത്ത.
उरिल्लें_रीण: മിച്ചം_വന്ന മിച്ചം_നില്‍ക്കുന്ന.
उरुग्वेयी: ഉറ്ഗുവേയന്.
उलटें: വിപരീതം.
उलटें_सुलटें: അസംബന്ധം.
उलोवपी: സംസാരിക്കുന്ന. വ്യക്തമാക്കുന്ന.
उल्लेखीत: നിര്‍ദേശിച്ച.
उशीर_जाल्लें: താമസിച്ച.
उश्टें: ഉച്ഛിഷ്ടമായ എച്ചിലായ ഫേലമായ ചണ്ടിയായ ശേഷിച്ച
उश्ट्याचें: ഉച്ഛിഷ്ടമായ എച്ചിലായ ഫേലമായ ചണ്ടിയായ ശേഷിച്ച
उश्ण: ചൂടു ഉഷ്ണം ചൂടേകുന്ന ചൂട്പകരുന്ന.
उश्णकटिबंधी: ഉഷ്ണമേഖലയെ_സംബന്ധിക്കുന്ന.
ऊंच: ഉയര്‍ന്ന പൊക്കമുള്ള ഉയര്ന്ന്.
एक: ഒരു ഒന്ന് 1.
एक_करोड: ഒരു_കോടി 10000000
एकठांय: ഒന്നിച്ചു_ചേര്‍ന്ന ശേഖരിച്ച കൂട്ടിചേര്‍ത്ത.
एकतर्फी: ഏകപക്ഷീയമായ.
एकतायपूर्ण: ഒരുമയോടെ അഖണ്ഡമായ അനന്യമായ ഏകീക്ര്‌തമായ ഒന്നായ സംഗതമായ പൊരുത്തപ്പെട്ട ഏക സംഘടിതമായ ഏകീഭവിച്ച ഏകചിത്തമായ യോജിച്ച ഏകകണ്ഡമായ.
एकत्र: ഒന്നിച്ചു_ചേര്‍ന്ന ശേഖരിച്ച കൂട്ടിചേര്‍ത്ത.
एकत्रीत: ഒരുമയോടെ അഖണ്ഡമായ അനന്യമായ ഏകീക്ര്‌തമായ ഒന്നായ സംഗതമായ പൊരുത്തപ്പെട്ട ഏക സംഘടിതമായ ഏകീഭവിച്ച ഏകചിത്തമായ യോജിച്ച ഏകകണ്ഡമായ. ഒന്നിച്ചു_ചേര്‍ന്ന ശേഖരിച്ച കൂട്ടിചേര്‍ത്ത.
एकदम: ദ്ര്ഢമായ പാകമായ.
एकपिकी: ഒരു_പൂ_ക്രിഷി_ചെയ്യുന്ന__സ്ഥലം.
एकभशेनचें: പര്യായം
एकमताचें: സ്വീകാര്യമായ
एकमती: സ്വീകാര്യമായ
एकमुळी: ഏകാന്തമായ തനിയേ_ഉള്ള ഒറ്റയായ അനാഥമായ
एकमुळें: ആരോടും_ഇടപഴകാത്ത.
एकमुळो: വേറിട്ട.
एकरुपी: ത്ത്സ്വരൂപമായ പ്ര്തിരൂപമായ പകറ്പ്പായ സാദ്ര്ശ്മായ പ്തിച്ഛായയുള്ള്.‌
एकलें: ഒരു ഒന്ന് 1.
एकलें-दुकलें: ഒന്നോ_രണ്ടോ.
एकलेंच: ഒരേയൊരു.
एकवटिल्लें: ഒന്നിച്ചു_ചേര്‍ന്ന ശേഖരിച്ച കൂട്ടിചേര്‍ത്ത.
एकशिंगी: ഒറ്റക്കൊമ്പുള്ള.
एकशें_एक: നൂറ്റി_ഒന്ന്
एकसठ: അറുപത്തി_ഒന്ന്
एकसठावें: അറുപത്തി_രണ്ട്
एकसारकें: പര്യായം
एकसुरी: ഏകാന്തമായ തനിയേ_ഉള്ള ഒറ്റയായ അനാഥമായ
एकसुरें: ആരോടും_ഇടപഴകാത്ത.
एकसुरो: വേറിട്ട.
एका_दांड्याचो: ഒറ്റക്കാല്‍_നാട്ടിയ_കൂടാരം.
एका_वर्साचें: ഒരു_വര്‍ഷം_നീണ്ടു_നില്‍ക്കുന്ന_ചെടി.
एकांत: നിര്ജ്ജനം ഏകാന്തം.
एकांतवासी: ഏകാന്തവാസി.
एकांतहीण: വിജനമല്ലാത്ത ഒറ്റ്യ്ക്കല്ലാത്ത തനിയെ_അല്ലാത്ത
एकाक्षरी: ഏകാക്ഷര.
एकाच_काळांतलें: സ്മയോചിതമായ സന്ദര്‍ഭത്തിനു_ചേര്‍ന്ന സമകലീനമായ.
एकाद्रें: ഒന്നോ_രണ്ടോ
एकावन: അന്പത്തി_ഒന്ന്
एकावनावें: അന്പത്തി_ഒന്നാം
एकासारकें: ഒരു_പോലെയുള്ള സമാനരൂപിയായ
एकुणअंयशीं: എഴുപത്തി_ഒന്പത്
एकुणअंयश्यांवें: എഴുപത്തി_ഒന്പതാമത്തെ
एकुणसत्तरावें: അറുപത്തി_ഒന്പതാം
एकुणसाठावें: അന്പത്തി_ഒന്പതാമത്തെ
एकुणीस: പത്തൊന്‍പതാം പത്തൊന്‍പതാമത്തെ
एकुलगें: ആരോടും_ഇടപഴകാത്ത.
एकुलतें: ആരോടും_ഇടപഴകാത്ത.
एकुलयो: വേറിട്ട.
एकूच: ഒരേയൊരു.
एकूलगी: ഏകാന്തമായ തനിയേ_ഉള്ള ഒറ്റയായ അനാഥമായ
एकूलयी: ഏകാന്തമായ തനിയേ_ഉള്ള ഒറ്റയായ അനാഥമായ
एक्यांयशीं: എണ്പത്തി_ഒന്ന്
एक्यांयश्यांवें: ഇരുപത്തി_ഒന്നാമത്തെ
एक्याण्णव: തൊണ്ണൂറ്റി_ഒന്ന്
एक्याण्णवावें: തൊണ്ണൂറ്റി_ഒന്നാമത്തെ.
एक्यात्तर: എഴുപത്തി_ഒന്ന്
एक्यात्तरावें: എഴുപത്തി_ഒന്നാം
एतिहासीक: ഐതിഹാസികമായി.
एरिट्रियायी: എറിട്രിയന്
ऑफिसरा_भशेन: ആഫീസര്‍_എന്ന_പദവിക്ക്_തുല്യം.
ऑफिसाचें: ഓഫീസ്_സംബന്ധമായ.
ऑस्ट्रियन: ആസ്ട്രിയയുടെ_.
ऑस्ट्रेलियायी: ആസ്ട്രേലിയന്‍ ആസ്ട്രേലിയയുടെ.
ओंपिल्लें: അറ്പ്പിച്ച സമറ്പ്പിച്ച തറ്പ്പിച്ച
ओगोत_जाल्लें: താമസിച്ച.
ओजस्वी: കാന്തിമത്തായ.
ओडलायणें: ആകര്‍ഷിക്കുന്ന ആകര്‍ഷകമായ ആകര്‍ഷണീയമായ വശ്യ മാസ്മരശക്‌തിയുള്ള മാദകമായ ചേതോഹാരിയായ ആനന്ദിപ്പിക്കുന്ന വശീകൃതമായ ആക്ഷേപിക്കുന്ന
ओपेरासांव_केल्ले: മാറ്റി_വച്ച പറിച്ചു_നടപ്പെട്ട ഇടം_മാറ്റിയ.
ओपेरासावीं: ശസ്ത്രക്രിയാ_സംബന്ധമായ.
ओबड_धोबड: പരുപരുത്ത
ओबडधोबड: പരുപരുപ്പുള്ള ഉയര്‍ന്നതും_താണതുമായ തുല്യമല്ലാത്ത പൊങിറ്യതും_താണതുമായ കുണ്ടും_കുഴിയുമായ യോജിക്കാത്ത ചേര്‍ച്ചയില്ലാത്ത.
ओमानी: ഒമാനി.
ओरिया: ഒറിയ
ओलें: നനവുള്ള ഈറനായ ആറ്‍ദ്രമായ കുതിറ്‍ന്ന ഈറ്‍പ്പമുള്ള
ओल्ताचें: വളവും_തിരിവും_ഉള്ള_.
औपचारीक: ഔപചാരികമായി ഉപചാരപൂര്വ്വമുള്ള ആചാരപരമായ ഔദ്യോഗപരമായ.
कंगाल: ഇല്ലായ്മ_പിടിപ്പെട്ട.
कंजूस: പിശുക്കനായ ക്ര്പണനായ.‌ പിശുക്കന്‍ ലുബ്ധന്‍ ലോഭന്‍ കൃപണന്‍
कंपुचियन: കമ്പോടിയയുടെ കമ്പൂചിയയുടെ
कंबोडियन: കമ്പോടിയയുടെ കമ്പൂചിയയുടെ
कंवळें: ലോലമായ
कचेरीक: ഓഫീസിനെ_സംബന്ധിക്കുന്ന.
कच्चें: പച്ചയായ പാകമല്ലാത്ത പച്ചയായ. ശരിയായ_രൂപമില്ലാത്ത രൂപപെടുത്ത ആക്ര്‌തിയില്ലാത്ത വടിവില്ലാത്ത.
कजाकी: കസാക്കിസ്ഥാനിയന്‍ കസാക്കിയന്‍.
कट्टर: യാഥാസ്തികനായ നിയന്മത്തില്‍_നിന്നും_അണുപോലും_വ്യതിചലിക്കാതത് നിര്‍ബ്ന്ധ_ബുദ്ധിയായ.
कट्टरवादी: മത_കാര്യങളില്_വിട്ടുവീഴ്ചയില്ലാത്ത.
कठीण: ബുദ്ധിമുട്ടുള്ള_. പ്രയാസമുള്ള ഗൂഢമായ ദുരൂഹതയുള്ള. അറിവില്ലാത്ത ഇരിപ്പിടമില്ലാത്ത. കഠിനമായ.
कठोर: ദ്രോഹിയായ കരുണയില്ലാത്ത ഉപദ്രവിക്കുന്ന കര്ക്കശ_സ്വഭാവമുള്ള.
कडक: സൂക്ഷ്മ_ഗ്രാഹിത്വം. ദാരുണമായ. കര്‍ക്കശമായ ദൃഢചിത്തനായ കഠോരം ദ്രിഢം ക്ലേശകരമായ.
कडकडीत: നല്ല_ചൂടുള്ള.
कडयिल्लें: ഉരുക്കിയ
कडेनचें: അടുത്തുള്ള.
कड्डणाचें: ധാന്യം_കൊണ്ടുള്ള.
कणखर: സ്വാധീനശ്ക്തിയുള്ള.
कणिल्ली: കുഴിച്ച കുഴികുത്തിയ.
कथनीय: പറയത്തക്ക പറയാന്‍_കൊള്ളാവുന്ന.
कदें: തടിച്ച സ്ഥുലശരീരിയായ
कनवाळू: ദയാലുവായ ക്രിപാലുവായ കാരുണികനായ മഹാമനസ്കനായ
कनिश्ट: ഇളയ പ്രായം_കുറഞ്ഞ.
कन्नड: ക്ന്നഡ കന്നഡ കന്നടത്തിലെ
कपटहीण: കാപഠ്യമില്ലാത്ത.
कपटी: ചതി_നിറഞ്ഞ. ചീത്ത_ആശയം ചീത്ത_ലക്ഷ്യം ദ്രോഹബുദ്ധി. കുടിലമായ കള്ളത്തരത്തിലുള്ള.
कफल्लक: പാവപെട്ട ദരിദ്രനായ നിര്‍ദ്ധനനായ പാപപരായ അഗതിയായ
कबलातीचें: ബന്ധിക്കപ്പെടാത്ത സ്വാധീനമായ മുക്തമായ.
कमयिल्लें: നേടിയത്
कमी: അപര്യാപ്തമായത് അപൂറ്ണ്ണമായത്. കുറച്ചു.
कमी_उलोवपी: അല്പം_സംസാരിക്കുന്നത്.
कमोवंक_नाशिल्लें: അധ്വാനിക്കാതെ_സമ്പാദിച്ച
कमोवपी: സമ്പാദിക്കുന്ന.
कम्युनिस्ट: സമത്വവാദിയായ. സമത്വവാദിയായ.
कर_आशिल्लो: കരം_ചുമത്താവുന്ന.
करंगळी: ചെറുവിരല് ചെറുത്.
करणारो: പ്രവര്‍ത്തിക്കുന്നവന്‍.
करपी: പ്രവര്‍ത്തിക്കുന്നവന്‍. ചെയ്യുന്ന പ്രവറ്ത്തിക്കുന്ന സാധിക്കുന്ന പണ്ണുന്ന ആക്കുന്ന ഉണ്ടാക്കുന്ന പയറ്റുന്ന നിറ്വ്വഹിക്കുന്ന നിറവേറ്റുന്ന പ്രയോഗിക്കുന്ന വ്യപരിക്കുന്ന.
करमुक्त: നികുതി_വിമുക്തരാക്കല്.
करयुक्त: കരം_ചുമത്താവുന്ന.
करहीण: നികുതി_വിമുക്തരാക്കല്.
कराराचें: ബന്ധിക്കപ്പെടാത്ത സ്വാധീനമായ മുക്തമായ.
करूंक_नाशिल्लें: ചെയ്യാത്തത്.
कर्कश: കര്‍ണഭേദകമായ.
कर्तव्यवादी: കര്തവ്യവാദി.
कर्तृत्ववादी: കര്തവ്യവാദി.
कर्तो: പ്രവര്‍ത്തിക്കുന്നവന്‍. ചെയ്യുന്ന പ്രവറ്ത്തിക്കുന്ന സാധിക്കുന്ന പണ്ണുന്ന ആക്കുന്ന ഉണ്ടാക്കുന്ന പയറ്റുന്ന നിറ്വ്വഹിക്കുന്ന നിറവേറ്റുന്ന പ്രയോഗിക്കുന്ന വ്യപരിക്കുന്ന.
कर्मनिश्ठ: കര്‍ത്തവ്യ_ബോധമുള്ള
कर्मवादी: കര്തവ്യവാദി. കറ്മ്മവാദി.
कर्‍या_भशेनचें: ആലിപ്പഴം.
कलंकीत: കളങ്ങ്കപ്പെട്ട.
कलात्मक: കലാത്മകമായ
कलापूर्ण: കലാത്മകമായ
कलाप्रेमी: കലാസ്നേഹി.
कलामोगी: കലാസ്നേഹി.
कलाहीण: പ്രവ്ര്ത്തിയിലെ_കൌശലമില്ലായ്മ.
कल्पनेंतलें: കാല്പനീകമായ സാങ്കല്‍പ്പീകമായ വാസ്തവമല്ലാത്ത സങ്കല്പത്തിലുള്ള യാഥാറ്ത്ഥ്യമല്ലാത്ത സത്യ്മല്ലാത്ത ഭാവനയിലുള്ള കല്പിതമായ ഭാവനം_ചെയ്ത അനനുക്ര്‌തമായ മിഥ്യയായ അയഥാറ്ത്ഥമായ മായികമായ.
कल्पनेभायलें: അപരിചിതമായ പരിചിതമല്ലാത്ത അന്യമായ അവിദിതമായ പുതുമയുള്ള അജ്ഞാതമായ മുന്നറിവു_കിട്ടാത്ത.
कल्पीत: സങ്കല്പ_സ്ര്‌ഷ്ടിയായ.
कल्याणकारी: നന്മ_നല്കുന്ന
कळवळप: ദയ_നിറഞ്ഞ.
कळवळ्यां_येवपी: വളരെ_താഴ്മയോടെ_യാചിക്കുക.
कळाव_जाल्लें: താമസിച്ച.
कवच_घाल्लें: കവചധാരി.
कवचधारी: കവചധാരി.
कवितामोगी: കാവ്യ_പ്രേമി.
कशे_तरेचें: എങ്ങനത്തെ.
कशें: എങ്ങനത്തെ.
कश्टकरी: പരിശ്രമിക്കുക പ്രയത്നിക്കുക അധ്വാനിക്കുക കഠിനയത്നം_ചെയ്യുക
कश्टदिणें: ദു
कश्टाची: ദു ദു
कश्टी: കഷ്ട്ടത്തിലായ.
कसलें: എങ്ങനത്തെ.
कांटयारें: മുള്ളുകളുള്ള.
कांटे_नाशिल्लें: മുള്ളില്ലാത്ത.
कांटेहीण: മുള്ളില്ലാത്ത.
कांट्याबगरचें: മുള്ളില്ലാത്ത.
कांठाचें: വക്കുള്ള
कांतिमान: സ്വര്‍ണ്ണം_കൊണ്ടലങ്ങ്കരിച്ച കാന്തിപൂര്‍ണ്ണമായ ഉജ്ജ്വലമായ.
कांतीमय: കാന്തിമത്തായ.
कांय: അനേകം ഒന്നിലധികമായ പല വളരെയേറേ അസംഖ്യം. കുറച്ചു. ചെറിയ.
कागदपत्री: പ്രമാണം_സംബന്ധിച്ച.
कागाळ: പരാതി.
कागाळ_करपी: ആവലാദി.
कागाळकार: ആവലാദി.
काजारी: വിവാഹിതന്‍ കല്യാണം_കഴിഞ്ഞവന്‍.
काटू: പിശുക്കന്‍ ലുബ്ധന്‍ ലോഭന്‍ കൃപണന്‍
काटूक: പിശുക്കന്‍ ലുബ്ധന്‍ ലോഭന്‍ കൃപണന്‍
काडिल्लें: ജോലിയില്‍_നിന്നു_മാറ്റി_നിര്‍ത്തിയ. കളയുവാനായി_ഉപേക്ഷിച്ച.
काणो: ഒറ്റക്കണ്ണുള്ള.
कातरिल्लें: മുറിഞ്ഞ
कातारी: ഖത്തറി.
कादंबरीक: നോവലിനെ_സംബന്ധിച്ച.
कादयेचे: പോലീസിന്റെ_കീഴിലുള്ള.
कान_फोडपी: കര്‍ണഭേദകമായ.
कानडी: കന്നഡ കന്നടത്തിലെ
कापिल्लें: മുറിഞ്ഞ
कापूंक_नाशिल्लें: പരുക്കില്ലാത്ത
काबार: അവസാനിക്കുക.
काबीज: സ്വായത്തമാക്കിയ.
काबुली: കാബൂളിനെ_സംബന്ധിക്കുന്നത്.
कामचोर: മടിയനായ.
कामनेचें: ത്ര്പ്തിയുള്ള മനസ്സാലെയുള്ള.‌ ഇച്ഛിച്ച് ആഗ്രഹിച്ച താല്പര്യപ്പെട്ട.
कामवती: കാമാസക്തയായ
कामहीण: അതീന്ദ്രിയമായ.
कामूक: കാമാസക്തയായ
कायदेशीर: ന്യായ_പൂറ്ണ്ണമായ ന്യായോചിതമായ.
कायम: സ്ഥായിയായ
कारक: ചെയ്യുന്ന പ്രവറ്ത്തിക്കുന്ന സാധിക്കുന്ന പണ്ണുന്ന ആക്കുന്ന ഉണ്ടാക്കുന്ന പയറ്റുന്ന നിറ്വ്വഹിക്കുന്ന നിറവേറ്റുന്ന പ്രയോഗിക്കുന്ന വ്യപരിക്കുന്ന.
कारण_नासतना: അകാരണമായ
कारणा_बगर: അകാരണമായ
कारबारी: ജോലിത്തിരക്കുള്ള ഉദ്യോഗമുള്ള പരിശ്രമിയായ കര്‍മ്മനിരതയായ വ്യവസായ_നിരതയായ തൊഴില്‍_നിരതയായ. ഉപയോഗമുള്ള ഗുണമുള്ള പ്രയോജനകരമായ പ്രയോജനപ്രദമായ ഉപയോഗയോഗ്യമായ യൌഗികമായ പ്രയുക്തമായ കൊള്ളാവുന്ന പറ്റിയ.
कारस्थानी: കുടിലമായ കള്ളത്തരത്തിലുള്ള.
कार्यरत: നടപ്പാക്കല്. ഏര്പ്പെട്ടിരിക്കുന്ന.
कार्यालयीन: ഓഫീസിനെ_സംബന്ധിക്കുന്ന.
कालजयी: അമരന്‍ മൃത്യുഞ്ഞയന്‍ ചിരഞ്ഞീവി അമര്‍ത്യന്‍
काल्पनीक: കാല്പനീകമായ സാങ്കല്‍പ്പീകമായ വാസ്തവമല്ലാത്ത സങ്കല്പത്തിലുള്ള യാഥാറ്ത്ഥ്യമല്ലാത്ത സത്യ്മല്ലാത്ത ഭാവനയിലുള്ള കല്പിതമായ ഭാവനം_ചെയ്ത അനനുക്ര്‌തമായ മിഥ്യയായ അയഥാറ്ത്ഥമായ മായികമായ. സങ്കല്പ_സ്ര്‌ഷ്ടിയായ.
काळ_सोंपिल्लें: സമയം_കഴിഞ്ഞു_പോയ കാലാവധി_കഴിഞ്ഞ.
काळखी: ഇരുട്ട്_നിറഞ്ഞ.
काळजांतल्यान: ഹ്ര്ദയംഗമമായ ഹ്ര്ദയപൂറ്വ്വമായ ആത്മാറ്ഥമായ ഹ്ര്ദയത്തില്_നിന്നുള്ള യഥാറ്ത്ഥ നിഷ്കളങ്കമായ.
काळजाक_लागपी: ഭാവനാത്മകമായ.
काळजाथावन: ഹ്ര്ദയംഗമമായ ഹ്ര്ദയപൂറ്വ്വമായ ആത്മാറ്ഥമായ ഹ്ര്ദയത്തില്_നിന്നുള്ള യഥാറ്ത്ഥ നിഷ്കളങ്കമായ.
काळजेचें: ചിന്തിക്കേണ്ടതായ.
काळींगकार: ധനികനായ പണക്കാരനായ
काळीज_पिंजपी: കീറുന്ന തകരുന്ന.
काळें: കറുപ്പ്.
काळें_कुळकुळीत: ഭയങ്ങ്കരമായി_കറുത്ത.
काळो: കറുത്ത
काव्यप्रेमी: കാവ്യ_പ്രേമി.
काव्यमोगी: കാവ്യ_പ്രേമി.
काव्यात्मक: കാവ്യാത്മകമായ.
काश्मिरी: കശ്മീരി. കാശ്മീരിലെ കാശ്മീരി
कासादोर: നായാ‍ട്ടുകാരനായ വേട്ടക്കാരനായ.
कास्तिसांवाचें: ദുരൂഹതയുള്ള.
किंकोत: ഉപേക്ഷിക്കത്തക്ക അവഹേളിക്കത്തക്ക.
किजिली: കര്‍ക്കസയായ. കലഹപ്രിയമുള്ള.
किटनाशक: കീട_നാശിനി.
किटभक्षी: കീടഭക്ഷി.
किडकिडीत: അസ്ഥി_പഞരം_പോലെ എല്ലും_തോലും_മാത്രമാവുക. മെലിഞ്ഞ എല്ലും_തോലാകുക.
किडकिडें: ലോലമായ സുകുമാരമായ കോമളമായ
किड्यांचें_वखद: കീട_നാശിനി.
कितल्योश्योच: അനേകം ഒന്നിലധികമായ പല വളരെയേറേ അസംഖ്യം.
किमती: വില_പിടിച്ച വിലപിടിപ്പുള്ള വിലയേറിയ മൂല്യമേറിയ
किरंगळी: ചെറുത്.
किरकोळ: അല്ലറ_ചില്ലറ
किर्तशाळी: കീര്ത്തിമാന്.
किसमिसाचें: കിശ്മിശുള്ള. കിശ്മിശിന്റെ.
कुकुलें: ചെറിയ. ലോലമായ ചെറിയ
कुचकामी: സന്ദേഹമില്ലാതെ ധാരണയോടെ ഉപായത്തോടെ നിശ്ചയത്തോടെ ധൈര്യത്തോടെ ഉറ്പ്പോടെ തീറ്ച്ചയോടെ.
कुचकुचीत: സാന്ദ്രമായ ഉറപ്പുള്ള മേഘമുള്ള.
कुच्छित्री: ദുസ്വഭാവിയ്യായ ചീത്ത_സ്വഭാവമുള്ള
कुटील: കുടിലമായ കള്ളത്തരത്തിലുള്ള. അറിവില്ലാത്ത
कुटुंबहीण: കുടുംബം_ഇല്ലാത്ത.
कुटुंबीक: കുടുംബപരമായ
कुडके_जाल्लें: പൊടിഞ്ഞു_പോകുക.
कुडीचो: ശരീരമുള്ള
कुड्डो: അന്ധനായ കാഴ്ചയില്ലാത്ത കണ്ണില്ലാത്ത
कुड्डो_विश्वासी: അന്ധവിശ്വാസി
कुड्डो_विस्वासू: മത_കാര്യങളില്_വിട്ടുവീഴ്ചയില്ലാത്ത.
कुतां_काडपी: കുറ്റം_തിരക്കി_നടക്കുന്നയാള്.
कुतां_काडिनासपी: ചിദ്രമില്ലാത്ത ദോഷരഹിതമായ
कुपथ्य: ആരോഗ്യത്തിനു_ഹാനികരമായ ആരോഗ്യത്തിനു_ഹാനികരമായ
कुपां_नाशिल्लें: സ്വച്ഛമായ സ്പഷ്ട്ടമായ തെളിഞ്ഞ.
कुपां_बगरचें: സ്വച്ഛമായ സ്പഷ്ട്ടമായ തെളിഞ്ഞ.
कुपां_विरयत: സ്വച്ഛമായ സ്പഷ്ട്ടമായ തെളിഞ്ഞ.
कुपांवीण: സ്വച്ഛമായ സ്പഷ്ട്ടമായ തെളിഞ്ഞ.
कुपात्र: അയോഗ്യനായ കൊള്ളരുതാത്ത.
कुप्रसिद्द: കുപ്രസിദ്ധി ദുഷ്കീര്‍ത്തി അപഖ്യാതി
कुमारिका: കുമാരി.
कुमारी: കുമാരി.
कुरूप: വിരൂപനായ വിലക്ഷണമായ ഭംഗിയില്ലാത്ത വികൃതമായ
कुलिखीत: ചീതയായി_എഴുതിയത്.
कुविख्यात: കുപ്രസിദ്ധി ദുഷ്കീര്‍ത്തി അപഖ്യാതി
कुवेटी: കുവൈറ്റിയന്‍.
कुशळ: പ്രാവീണ്യമുള്ള നിപുണതയുള്ള സാമറ്ത്ഥ്യമുള്ള മിടുക്കമുള്ള നൈപുണ്യമുള്ള പ്രായോഗികയോഗ്യതയുള്ള ചാതുര്യമുള്ള കുശലതയുള്ള വിരുതുള്ള വിചക്ഷണതയുള്ള പാടവമുള്ള തഴക്കമുള്ള പ്രാപ്തിയുള്ള. യോഗ്യനായ കാര്യശേഷിയുള്ള നിപുണനായ സമര്ത്ഥനായ ശക്തനായ വിദഗ്ദ്ധനായ ചുണയുള്ള ചെയ്തുതഴക്കമുള്ള ചതുരനായ ചുറുചുറുക്കുള്ള ജ്ഞാനമുള്ള കെല്‍പ്പുള്ള പാടവമുള്ള കൌശലമുള്ള കഴിവുള്ള
कुशिल्ले: ചീഞ്ഞു_പോയ.
कुशिल्लें: ചീഞ്ഞഅഴുകിയ അളിഞ്ഞ ജീര്‍ണ്ണിച്ച
कुशीक: മാറ്റിയ നീക്കിയ മാറ്റം_ചെയ്ത.
कुशीक_काडिल्लें: മാറ്റിവെച്ച.
कुशीकचें: അടുത്തുള്ള.
कुसकें: ചീഞ്ഞഅഴുകിയ അളിഞ്ഞ ജീര്‍ണ്ണിച്ച
कूट: പ്രയാസമുള്ള ഗൂഢമായ
कूडहीण: ദേഹമില്ലാത്ത.
कूपाळू: ദയാലുവായ ക്രിപാലുവായ കാരുണികനായ മഹാമനസ്കനായ
कूळहीण: താഴ്ന്ന.
कृतघ्न: നന്ദികെട്ട ഉപകാരസ്മരണയില്ലാത്ത.
कृतज्ञ: നന്ദിയുള്ള ഉപകാര_സ്മരണയുള്ള.
कृतार्थ: ക്ര്താര്ഥന്.
कृत्रीम: പ്രകടനപരമായ കപടമായ ക്ര്‌ത്രിമമായ.
कृशोदरी: ശോഷിചച_വയറുള്ള_സ്ത്രി.
कॅथोलीक: കാത്തോലിക്കകാരന്‍.
कॅनेडीयन: കാനഡയുടെ.
केंद्रशासीत: കേന്ദ്രഭരണ കേന്ദ്രം_ഭരിക്കുന്ന.
केंद्रीय: കേന്ദ്രത്തിന്റെ_.
केनियायी: കെനിയന്.
केल्लें: ഉത്പന്നമായ ജനിച്ച പരിസമാപ്തമായ.
केसरी: കുംകുമ_നിറമുള്ള.
केसाळ: രോമമുള്ള.
केस्ताळ: കലഹപ്രിയമുള്ള.
कैदी: പോലീസ്_കസ്റ്റഡിയിലുള്ള
कोंकणी: കൊങ്കിണി കൊങ്കിണി കൊങ്കിണി
कोंगरे: ചുരുണ്ട.
कोंड्याचें: മുള_കൊണ്ടുള്ള മുളയാലുള്ള.
कोट्याधीश: കോടിപതി.
कोडू: ചവര്‍പ്പുള്ള. കൈപ്പേറിയ ചവര്‍പ്പുള്ള
कोडू_काजरो: വളരെ_കൈപ്പുള്ള അത്യധികം_കൈപ്പേറിയ അപ്രിയമായ. വളരെ_കൈപ്പുള്ള അത്യധികം_കൈപ്പേറിയ അപ്രിയമായ.
कोडू_वीख: വളരെ_കൈപ്പുള്ള അത്യധികം_കൈപ്പേറിയ അപ്രിയമായ.
कोडूभाशी: ഇഷ്ട്ടമില്ലാത്തത്_സംസാരിക്കുന്ന സ്നേഹന്മില്ലാത്തതു_പറയുന്ന.
कोमल: മൃദുവായ മൃദുലമായ പേലവമായ ലോലമായ കോമളമായ സുകുമാരമായ ലോലമായ
कोमलांगिनी: കോമളാങ്കിനി കോമളാങ്കീ സുന്ദരിയായ_സ്ത്രീ.
कोमेल्ले: മുളച്ച.
कोमोरोजी: കോമൊരോസീയ
कोयराचें: വ്രിത്തികെട്ട വ്രിത്തി_ഇല്ലാത്ത.
कोरियन: കൊറിയയിലെ
कोरियी: കൊറിയയിലെ
कोरी: കോടിആയ.
कोलंबियी: കൊളംബിയയുടെ.
कोलकाती: കല്‍കത്തയെ_സംബന്ധിക്കുന്ന.
कोलवाचें: പുല്ലോ_വൈക്കോലോ_കൊണ്ടുണ്ടാക്കിയ.
कोसळिल्लें: തകര്‍ത്ത നിലത്തു_വീണ.
कौमार्ययुक्त: കുമാരാവസ്ഥ കന്യകാത്വം.
क्युबी: ക്യൂബയിലെ.
क्रमहीण: ക്രമമല്ലാത്ത.
क्रमा_बगरचें: ക്രമമല്ലാത്ത.
क्रमान: ക്രമത്തിലുള്ള.
क्रियाशीळ: ഏര്പ്പെട്ടിരിക്കുന്ന.
क्रिस्ती: കാത്തോലിക്കകാരന്‍.
क्रुर: ദ്രോഹിയായ കരുണയില്ലാത്ത ഉപദ്രവിക്കുന്ന
क्रूर: സദാചാരമില്ലാത്ത മറ്റുള്ളവരേ_ഉപദ്രവിക്ക്ല്.
क्रॅऑली: മിശ്രഭാഷയുടെ.
क्रोएशियन: ക്രോഏശിയക്കാരന്‍. ക്രോഏശിയായിലുള്ള
क्षणजिवी: നശിക്കുന്ന.
क्षणभंगूर: നശിക്കുന്ന.
क्षणीक: ക്ഷണികമായ നൈമിഷികമായ.
क्षमायाचक: ക്ഷമ_യാചിക്കുന്ന.
क्षमायोग्य: ക്ഷമിക്കപ്പെടാവുന്ന മാപ്പാക്കാവുന്ന.
क्षमावान: ക്ഷമിക്കുന്നവന്.
क्षमाशीळ: ക്ഷമിക്കുന്നവന്.
क्षम्य: ക്ഷമിക്കപ്പെടാവുന്ന മാപ്പാക്കാവുന്ന.
क्षय_रोगी: ക്ഷയ_രോഗമുള്ള.
क्षीण: എല്ലും_തോലാകുക.
क्षुद्र: താഴ്ന്ന.
क्षुद्र_कुळाचें: താഴ്ന്ന_കുലത്തിലേ.
क्षेत्रीय: പ്രദേശത്തെ_സംബന്ധിക്കുന്ന.
क्षेपक: വിക്ഷേപിക്കുന്ന
क्षेपणक: വിക്ഷേപിക്കുന്ന
खंडणीय: തകര്‍ക്കാവുന്ന ഖണ്ടിക്കാവുന്ന. വെട്ടാവുന്നത് മുറിക്കാവുന്നത്.
खंडी: ഭൂഖണ്ഡ.
खंडीत: നിരസിക്കപ്പെട്ട റദ്ദാക്ക്പ്പെട്ട. കഷണമായത്.
खंतदिणी: ദു
खंती: നിരാശയുള്ള. പ്രതീക്ഷ_ഇല്ലാത്ത ആശ_നഷ്ട്ടപ്പെട്ട ആശയറ്റ.
खंतीची: ദു ദു
खंबीर: ദ്രിഢമായ. മുട്ടു_മടക്കാത്ത കുനിയാത്തത വളയാത്ത.
खंयचेंय_एक: ഒന്നോ_രണ്ടോ
खगोली: ജ്യോതിശാസ്ത്രപരമായ.
खडतर: ബുദ്ധിമുട്ടുള്ള_.
खडबडीत: പരുപരുപ്പുള്ള ഉയര്‍ന്നതും_താണതുമായ തുല്യമല്ലാത്ത പൊങിറ്യതും_താണതുമായ കുണ്ടും_കുഴിയുമായ യോജിക്കാത്ത ചേര്‍ച്ചയില്ലാത്ത. പരുപരുത്ത
खड्डो: കഷണ്ടിയുള്ള കഷണ്ടി_രോഗമുള്ള. മൊട്ട.
खणखणीत: മ്ര്‌ദുവായ നേറ്മ്മയുള്ള‌ കനം_കുറഞ്ഞ ആറ്ദ്രമായ സൌമ്യതയുള്ള.
खणपी: തുളയുള്‍ള.
खणिल्लें: കുഴിച്ച ഖനനം_ചെയ്ത കുഴിയാക്കിയ.
खतखतीत: നല്ല_ചൂടുള്ള.
खदूळ: പൊടി_നിറഞ്ഞ മണ്ണു_നിറഞ്ഞ
खबर_आशिल्लें: അറിവുള്ള
खबर_नाशिल्लें: ബോധ്യമില്ലാത്ത അറിവില്ലാത്ത.
खर: അടക്കാന്_പടാത്ത പ്രബലമായ ജയിക്കാന്_പറ്റാത്ത. സൂക്ഷ്മ_ഗ്രാഹിത്വം. ദാരുണമായ. ഉറപ്പുള്ള ബലമുള്ള കര്ക്കശ_സ്വഭാവമുള്ള. മ്ര്‌ദുവായ നേറ്മ്മയുള്ള‌ കനം_കുറഞ്ഞ ആറ്ദ്രമായ സൌമ്യതയുള്ള.
खरसाणीचे: പ്രബലമായി.
खरी: ശുദ്ധമായതു. വാസ്തവികമായ യദാര്ഥമായ.
खरें: സത്യം നിപത്തി നേര് നേറ്റി ശരിആയത്.
खरो: സത്യസന്ധനായ നെറിയുള്ള വിശ്വസ്തനായ
खर्चीक: നന്നായി_ചിലവു_ചെയ്യുന്ന ദുര്‍വ്യയം_ചെയ്യുന്ന.
खळबळीत: സ്തോഭജനകമായ
खांदो: ശാഖകളുള്ള.
खांपें: പ്രാവീണ്യമുള്ള നിപുണതയുള്ള സാമറ്ത്ഥ്യമുള്ള മിടുക്കമുള്ള നൈപുണ്യമുള്ള പ്രായോഗികയോഗ്യതയുള്ള ചാതുര്യമുള്ള കുശലതയുള്ള വിരുതുള്ള വിചക്ഷണതയുള്ള പാടവമുള്ള തഴക്കമുള്ള പ്രാപ്തിയുള്ള.
खाजगी: അവനവന്റെ സ്വന്തമായ തന്റെ തന്റേതായ. വ്യക്തിപരമായ സ്വകാര്യ്മായ തനതായ സ്വയംക്ര്‌തമായ സ്വീയമായ സ്വകീയമായ തന്റ്റേതായ സ്വന്തമായ രഹസ്യമായ വൈക്ത്യമായ അനന്യമായ.
खाडयो: താടിയുള്ള.
खातेदार: നിക്ഷേപകന്
खादाड: അധികം_ഭക്ഷിക്കുന്ന വേഗം_വേഗം_ഭക്ഷിക്കുന്ന ഭക്ഷണപ്രിയനായ വയറനായ കൊതിയനായ.
खाद्य: ഭക്ഷണയോഗ്യമായ ഭക്ഷണ_പദാര്‍ഥം.
खापो: വലിയ.
खायलें: പ്രാധാന്യമില്ലാത്ത. കീഴ്പെട്ട അധീനതയുള്ള. താഴെയുള്ള അടിയിലുള്ള കീഴെയുള്ള.
खायलो: കുറഞ്ഞ ചെറിയതായ.
खायल्या_कुळाचें: താഴ്ന്ന. താഴ്ന്ന_കുലത്തിലേ.
खाली: ഒഴിഞ്ഞ ശൂന്യമായ കാലിയായ ഒഴിവുള്ള പ്രയോജനമില്ലാത്ത ശൂന്യമായ.
खावंक_नाशिल्लें: ഭക്ഷിക്കാത്ത അനുഭവിക്കാത്ത.
खावगें: അധികം_ഭക്ഷിക്കുന്ന വേഗം_വേഗം_ഭക്ഷിക്കുന്ന ഭക്ഷണപ്രിയനായ വയറനായ കൊതിയനായ.
खावपाचें: ഭക്ഷണയോഗ്യമായ ഭക്ഷണ_പദാര്‍ഥം.
खावपी: ഭക്ഷിക്കുന്നവന്‍ തിന്നുന്നവന്‍ ഉണ്ണുന്നവന്‍ ഭുജിക്കുന്നവന്‍ തീന്‍_കഴിക്കുന്നവന്‍ അകത്താക്കുന്നവന്‍ വാരി_വിഴുങുക. തിന്നുന്ന ഭക്ഷിക്കുന്ന കഴിക്കുന്ന ഭോജിക്കുന്ന ആഹരിക്കുന്ന.
खाशेलें: വിശേഷതയുള്ള ശ്രേഷ്ഠമായ നിശ്ചിതമായ.
खाश्या: കൂടെ_പിറന്ന.
खाश्श्या: എന്നെ_സംബന്ധിക്കുന്ന എന്റേതായ സ്വന്തം തന്റേതായ. ഉറ്റബന്ധത്തിലുള്ള അടുത്ത_ബന്ധത്തിലുള്ള.
खास: വിശേഷതയുള്ള ശ്രേഷ്ഠമായ നിശ്ചിതമായ. അസാമാന്യമായ സാധാരണമല്ലാത്ത. വിശേഷവും
खिणयाळें: ക്ഷണികമായ നൈമിഷികമായ.
खीणयाळें: നശിക്കുന്ന.
खुटें: രുചിയില്ലാത്ത.
खुनी: കൊലപാതകികള്.
खूब: അനേകം ഒന്നിലധികമായ പല വളരെയേറേ അസംഖ്യം. വളരേ. പൂര്‍ണ്ണമായ നിറഞ്ഞു_കവിഞ്ഞ ആഴമേറിയ.
खूब_कोडू: വളരെ_കൈപ്പുള്ള അത്യധികം_കൈപ്പേറിയ അപ്രിയമായ.
खूब_चड: വളരേയധികം.
खेदहीण: ശോകരഹിതന്.
खेरीज: വ്യത്യസ്ഥമായ ഭിന്നമായ
खेळीमेळीचें: സ്നേഹബുദ്ധിയായ ഇടപഴകുന്ന ആത്മാര്‍ത്ഥതയുള്ള.
खोटे: ക്രിത്രിമമായ.
खोटें: നുണയന്‍ അസത്യം_പറയുന്നവന്‍ അസത്യം_പറയുന്നവന്‍ എതിര്‍_വാദം_ചെയ്യുന്നയാള്‍ കള്ളം_പറയുന്നയാള്‍. നുണ കള്ളം അസത്യം ആശ്രയമില്ലാത്ത അടിസ്ഥാനമില്ലാത്ത. തെറ്റായ_കുറ്റാരോപണം അപകീര്‍ത്തിപ്പെടുത്തല്‍.
खोटो: ചീത്ത_ആശയം ചീത്ത_ലക്ഷ്യം ദ്രോഹബുദ്ധി. ക്രിത്രിമമായ_രേഖയുണ്ടക്കുന്ന വ്യാജമായ_രേഖയുണ്ടാക്കുന്ന തെറ്റായ_രേഖയുണ്ടാക്കുന്ന.
खोडाचें: വിറകിന്റെ തടിയുടെ.
खोदूळ: പൊടി_നിറഞ്ഞ മണ്ണു_നിറഞ്ഞ
खोल: ആഴമേറിയ. ആഴമുള്ള താഴ്ചയുള്ള
खोशी: ആനന്ദം_നിറഞ്ഞ സന്തോഷം_പ്രകടിപ്പിക്കുന്ന. വിനോദപ്രിയനായ ആനന്ദം_പൂണ്ടവന്‍ സന്തോഷമുള്ള്വരാകുക.
खोसदिणें: ആനന്ദപ്രദം ആനന്ദ_ദായകം സുഖപ്രദം പ്രസന്നതാദായകം ആനന്ദദായി ആനന്ദകാരി ആഹ്ലാദി.
खोसयाळें: ആനന്ദപൂര്‍ണ്ണം ആനന്ദമയം ഉല്ലാസപൂര്‍ണ്ണം സാനന്ദം.
गंदीत: വാസനയുള്ള
गंधहीण: മണമില്ലാത്ത.
गंधीत: മണമുള്ള.
गच्च: സാന്ദ്രമായ ഉറപ്പുള്ള മേഘമുള്ള.
गडबडें: സൂക്ഷ്മതയില്ലാത്ത വേണ്ടപോലെ_ആലോചിക്കാത്ത ദ്രുതഗതിയിലുള്ള.
गडबडो: ചഞ്ചലചിത്തനായ അസ്ഥിരനായ
गणनीय: എണ്ണപ്പെടാവുന്ന കണക്കാക്കത്തക്ക അംഗീകരിക്കപ്പെടേണ്ട്.
गण्य: എണ്ണപ്പെടാവുന്ന കണക്കാക്കത്തക്ക അംഗീകരിക്കപ്പെടേണ്ട്.
गतिहीण: സ്ഥിരമായ.
गतीचें: ചലനാത്മകമായ പുരോഗമനപരമായ ക്രിയാത്മകമായ.
गतीशील: ചലനാത്മകമായ പുരോഗമനപരമായ ക്രിയാത്മകമായ.
गरजू: അപേക്ഷിക്കുന്നവന്
गरजे_भायर: അനാവശ്യമായ.
गरजेचें: ആവശ്യമുള്ള പ്രധാനമായ തീര്‍ച്ചയായും_വേണ്ട്തായ കടപ്പാടുള്ള ഒഴിച്ച്കൂടാനാവാത്ത. അനിവാര്യം.
गरजेवंत: അപേക്ഷിക്കുന്നവന്
गरम: ചൂടു ഉഷ്ണം കമ്പിളി. ചൂടുള്ള
गरमागरम: നല്ല_ചൂടുള്ള.
गराचें: കാമ്പുള്ള.
गरीब: പാവപെട്ട ദരിദ്രനായ നിര്‍ദ്ധനനായ പാപപരായ അഗതിയായ
गर्भेस्त: ഗര്ഭവതി ഗര്ഭിണി.
गर्वहीण: അഹങ്കാരമില്ലാത്ത വിനയമുള്ള ഗര്‍വ്വില്ലാത്ത. മഹത്വമില്ലാത്ത.
गर्विश्ट: ഉദ്ധതനായ അഹങ്കാരി_ആയ അഹന്തയുള്ള ഞാന്‍_വമ്പനാണെന്ന_ഭാവം അഹമ്മതിഉള്ള അകനിന്ദയുള്ള അഹമ്മമതയുള്ള കെര്രുവുള്ള ഞാനെന്ന_ഭാവമുള്ള. അഹങ്കാരിയായ അഹന്തയുള്ള അഹമ്മതിയുള്ള പൊങ്ങച്ചക്കാരിയായ
गवत_खावपी: പുല്ലു_തിന്നുന്ന_മ്രിഗങ്ങള്‍
गवताचें: പുല്ലോ_വൈക്കോലോ_കൊണ്ടുണ്ടാക്കിയ.
गवय्यो: പാടുന്ന_ആള്‍ ആലപിക്കുന്ന_ആള്‍ ഗായകന്‍ പാട്ടുകാരന്‍ ഗായനന്‍.
गवाय: ദ്രിക്സാക്ഷി.
गांजपी: മുഴങ്ങിയ.
गांधीवादी: ഗാന്ധിവാദി. ഗാന്ധിവാദി.
गांबियायी: ഗാംബിയന്
गांवगिरी: ഗ്രാമീണമായ ഗ്രാമത്തെ_സംബന്ധിക്കുന്ന.
गांवगिरे: ഗ്രാമീണ.
गांवटी: വളര്‍ത്തപ്പെടുന്ന
गाबायी: ഗാബായന്.
गायक: പാടുന്ന_ആള്‍ ആലപിക്കുന്ന_ആള്‍ ഗായകന്‍ പാട്ടുകാരന്‍ ഗായനന്‍.
गायब: കണ്ണുകൊണ്ടു_കാണാന്_പറ്റാത്തത്.
गावपी: പാടുന്ന_ആള്‍ ആലപിക്കുന്ന_ആള്‍ ഗായകന്‍ പാട്ടുകാരന്‍ ഗായനന്‍.
गिन्यानान_भरिल्लें: അറിവുള്ള ബോധപൂര്‍ണ്ണമായ.
गिन्यानी: വിദ്വാന്‍മാരായിട്ടുളള പാണ്ഡിത്യമുള്ള അറിവുള്ള
गिमाळ्याचो: ഗ്രീഷ്മ_കാലത്തെ.
गिरेस्त: സമര്‍ത്ഥനായ. ധനികനായ പണക്കാരനായ
गुंगेचें: വേദന_സംഹാരി.
गुजराती: ഗുജറാത്തിന്റെ. ഗുജറാത്തിലെ ഗുജറാത്തി
गुजराथी: ഗുജറാത്തിലെ ഗുജറാത്തി
गुडहीण: ഒളിവില്ലാത്ത.
गुणगुणपी: വണ്ടുകളുടെ_മുരള്‍ച്ച_നിറഞ്ഞ.
गुणयुक्त: ഗുണമേന്മയുള്ള
गुणवंत: സദ്ഗുണമുള്ള
गुणवत्तायुक्त: ഗുണമേന്മയുള്ള
गुणवत्ताहीण: ഗുണമില്ലാത്തത്.
गुणी: സദ്ഗുണമുള്ള
गुणीत: ഗുണിച്ച.
गुन्यांवकार: അപരാധിയായ നിയമലംഘകനായ കുറ്റവാളിയായ പാപിയായ തെറ്റുകാരനായ
गुन्यांवकारी: തെറ്റായ ദുഷ്ക്ര്തമായ ചീത്തയായ ദുഷിച്ച തിന്മ_നിറഞ്ഞ ദോഷമുള്ള ദോഷകരമായ അധാറ്മ്മികമായ സദാചാര_വിരുദ്ധമായ അസന്മാറ്ഗ്ഗികമായ അന്യായമായ. ആരോപിക്കപ്പെട്ടയാള്‍.
गुन्यांवी: ആരോപിക്കപ്പെട്ടയാള്‍.
गुन्यावंकार: തെറ്റ്_ചെയ്യുന്ന കുറ്റം_ചെയ്യുന്ന പാപം_ചെയ്യുന്ന അക്രമം_ചെയ്യുന്ന കുറ്റക്ര്‌ത്യം_ചെയ്യുന്ന ദ്രോഹം_ചെയ്യുന്ന.
गुपीत: ഒളിക്കേണ്ടതായിട്ടുള്ള. മൂടിയ ഒളിച്ച. രഹസ്യപൂര്ണ്ണം. നിഗൂഢത
गुप्त: ഒളിക്കേണ്ടതായിട്ടുള്ള. മൂടിയ ഒളിച്ച. നിഗൂഢത
गुप्तहेरी: രഹസ്യാന്വേഷണം കുറ്റാന്വേഷണം.
गुबगुबीत: നല്ലവണ്ണം_മാംസമുള്ള തടിച്ച.
गुरवार: ഗര്ഭവതി ഗര്ഭിണി.
गुलाम: മുഖസ്തുതിക്കാരന്‍ വ്യാജ_പ്രശംസക്കാരന്‍
गुल्ल: മുഴുകിയ. തിരക്കുള്ള
गुळगुळीत: മിനുസം മാര്‍ദ്ദവം മിനുമിനുപ്പ്
गूढ: ഒളിക്കേണ്ടതായിട്ടുള്ള. മൂടിയ ഒളിച്ച. പ്രയാസമുള്ള ഗൂഢമായ രഹസ്യപൂര്ണ്ണം.
गेय: പാടാന്‍_പറ്റിയ ആലാപനയോഗ്യമായ.
गैरहजर: അസന്നിഹിതനായ ഇല്ലാത്ത ഹാജരില്ലാത്ത വരത്ത
गोड: മധുര_സ്വരമുള്ള. മധുരമുള്ള മധുരിമയുള്ള മാധുര്യമുള്ള ഇനിപ്പുള്ള മധുരമുള്‍ള.
गोड_उलोवपी: ഇഷ്ട്ടം_സംസാരിക്കുന്ന പ്രിയം_വദമായി_സംസാരിക്കുന്ന.
गोडभाशी: ഇഷ്ട്ടം_സംസാരിക്കുന്ന പ്രിയം_വദമായി_സംസാരിക്കുന്ന.
गोरो: വെളുത്ത വെളുത്ത_നിറമുള്ള.
गोरो-गुलाबी: തേജസ്വിയായ
गोरो_धवो: വെളുത്ത വെളുത്ത_നിറമുള്ള.
गोल: ഗോളാകൃതി വൃത്താകൃതി
गौण: പ്രമുഖനലാത്ത.
गौरवपूर्ण: മഹത്വപൂര്ണ്ണമായ.
गौरवशीळ: മഹത്വപൂര്ണ്ണമായ.
ग्रंथिकी: പുസ്തകത്തിലെ.
ग्रिनलॅण्डी: ഗ്രീന്‍ലാന്‍ഡിന്റെ. ഗ്രീന്‍ലാന്‍ഡിനെ_കുറിച്ചുള്ള.
ग्रीक: യവനയിലേ ഗ്രീസിലേ. യുനാനി
घट: അടുത്ത. ദ്രിഢമായ. പേടിയില്ലാത്ത. ഉറപ്പുള്ള ദൃഢമായ കര്‍ക്കശമായ ദൃഢചിത്തനായ ഉറപ്പുള്ള ബലമുള്ള നല്ല. സുദ്ര്‌ഢമായ കൂടുതല്‍_ശക്തിയുള്ള ദ്ര്‌ഢതയുള്ള ബലമുള്ള ഉറപ്പുള്ള സുസ്ഥാപിതമായ കനത്ത കഠിനമായ കരുത്തുള്ള ഗാഢമായ.
घट_काळजाचो: കഠിനഹ്രിദയനായ കഠോരഹ്രിദയനായ ദയ_ഇല്ലാത്ത. വികാരമില്ലാത്ത.
घडपाचें: കുറഞ്ഞ.
घडपी: കുറഞ്ഞ.
घडयिल्लें: സങ്കല്പ_സ്ര്‌ഷ്ടിയായ. രചിക്കപ്പെട്ട എഴുതപ്പെട്ട.
घडिल्लें: സംഭവിച്ച ഉണ്ടായ രചിക്കപ്പെട്ട കഴിഞ്ഞു_പോയ കടന്നു_പോയ.
घडूंक_नाशिल्लें: സംഭവിക്കാത്ത അസാധ്യമായ.
घणघणीत: മ്ര്‌ദുവായ നേറ്മ്മയുള്ള‌ കനം_കുറഞ്ഞ ആറ്ദ്രമായ സൌമ്യതയുള്ള.
घन: ഉറപ്പുള്ള ദൃഢമായ
घमेंडखोर: അഹങ്കാരിയായ അഹങ്കാരമുള്ള ആത്മപ്രശംസകനായ
घमेंडी: ഉദ്ധതനായ അഹങ്കാരി_ആയ അഹന്തയുള്ള ഞാന്‍_വമ്പനാണെന്ന_ഭാവം അഹമ്മതിഉള്ള അകനിന്ദയുള്ള അഹമ്മമതയുള്ള കെര്രുവുള്ള ഞാനെന്ന_ഭാവമുള്ള. അഹങ്കാരിയായ അഹന്തയുള്ള അഹമ്മതിയുള്ള പൊങ്ങച്ചക്കാരിയായ
घरगुती: കുടുംബപരമായ വളര്‍ത്തപ്പെടുന്ന
घरहीण: വീടില്ലാത്തവര്.
घरावें: കുടുംബപരമായ വളര്‍ത്തപ്പെടുന്ന
घसरड: വഴുക്കലുള്ള.
घसरिल्लें: കുറയുക.
घाई_करपी: സൂക്ഷ്മതയില്ലാത്ത വേണ്ടപോലെ_ആലോചിക്കാത്ത ദ്രുതഗതിയിലുള്ള.
घाणयारें: മുഷിഞ്ഞ ശുചിയല്ലാത്ത അഴുക്കായ മലിനപ്പെട്ട വൃത്തിഹീനമായ മുഷിഞ്ഞ
घाणीचें: ദുര്‍ഗന്ധപൂര്‍ണ്ണമായ.
घातकी: ഹിംസകന്. വിശ്വാസവഞ്ചന_ചെയ്യുന്ന. അപകടകരമായ.
घातिल्लें: അടിച്ചേല്പ്പിച്ച
घानायी: ഘാനിയന്
घामान_भिजिल्ली: വിയര്ത്തു_കുളിച്ച.
घामेल्ली: വിയര്ത്തു_കുളിച്ച.
घायाळ: മുറിവേറ്റ ക്ഷതമേറ്റ. തുളഞ്ഞു_കയ്രിയ
घार्मिक: ധാര്‍മ്മികനായ മതഭക്തിയുള്ള സദാചാരതത്പരനായ ധര്‍മ്മനിഷ്ഠനായ ധര്‍മ്മബോധമുള്ള നീതിബോധമുള്ള
घाळ: ജാഗ്രതയില്ലാത്ത.
घुमपी: മുഴങ്ങിയ.
घुवळी_वखदां: കറപ്പ്_തിന്നുന്നവന്‍.
घुवळीचें: വേദന_സംഹാരി. ലഹരിയുണ്ടാക്കുന്ന ലഹരി_ബാധിച്ച.
घुसपटिल्लें: കുരുക്കുള്ള് കുഴപ്പത്തില്_പെട്ട.
घुसपलिल्लो: ഒടക്കിയ.
घुसपल्लें: കുരുക്കുള്ള് കുഴപ്പത്തില്_പെട്ട.
घुस्पागोंदळाचें: ദുരൂഹതയുള്ള.
घुस्पूंक_नाशिल्लें: കെട്ടു_കുടുങ്ങാത്ത.
घृणास्पद: വെറുക്കപ്പെട്ട നിന്ദിക്കപ്പെട്ട.
घृणीत: വെറുക്കപ്പെട്ട നിന്ദിക്കപ്പെട്ട.
घेरिल्लो: ചുറ്റപ്പെട്ട ചുറ്റിയ.
घोनें: അവിവേകിയായ ജളനായ ഭോഷനായ മൂഢനായ മന്ദതയുള്ള ജളത്വമുള്ള
घोस्ताचें: മനസ്സിനിണങ്ങിയ
चंचळ: മാറിയ ഇളക്കപ്പെട്ട അസ്ഥിരമായ ചഞ്ചലമായ പരിഭ്രമിച്ച. ചഞ്ചലചിത്തനായ അസ്ഥിരനായ ശാന്തമല്ലാത്ത. ദ്രിഢാഭിപ്രായമില്ലാത്ത. അന്യമനസ്കനായ
चंदनाचें: ചന്ദന_നിറ്മുള്ള ചന്ദനം_പോലെയുള്ള.
चंदनी: ചന്ദന_നിറ്മുള്ള ചന്ദനം_പോലെയുള്ള.
चकचकपी: തേജസ്സാര്ന്ന തിളങുന്ന. പ്രശോഭിക്കുന്ന തിളങ്ങുന്ന മിന്നുന്ന ശോഭിക്കുന്ന ജ്വലിക്കുന്ന സ്ഫുരിക്കുന്ന ദ്യോതിപ്പിക്കുന്ന മിനുങ്ങുന്ന ഉജ്ജ്വലിക്കുന്ന.
चकचकीत: പ്രകാശപൂര്‍ണ്ണമായ പ്രകാശമാനമായ. തിളങ്ങുന്ന ശോഭയുള്ള തെളിമയുള്ള ശുദ്ധമായ സ്പഷ്ട്ടമായ. തിളങ്ങുന്ന ശോഭയുള്ള പ്രഭയുള്ള പകിട്ടുള്ള കാന്തിയുള്ള സ്ഫുരിക്കുന്നപ്രകാശിക്കുന്ന
चक्रम: അവിവേകിയായ ജളനായ ഭോഷനായ മൂഢനായ മന്ദതയുള്ള ജളത്വമുള്ള
चक्रवर्ती: സമ്രാട്ട് ചക്രവര്ത്തി.
चड: അനേകം ഒന്നിലധികമായ പല വളരെയേറേ അസംഖ്യം. വളരേ. ആഴമേറിയ.
चड_काळाचें: നീണ്ട_കാലത്തെ.
चड_कोडो: വളരെ_കൈപ്പുള്ള അത്യധികം_കൈപ്പേറിയ അപ്രിയമായ.
चड_गरजेचें: അത്യന്താപേക്ഷിതമാണ്‍ അനിവാര്യമാണ്‍ അവശ്യം_വേണ്ടുന്ന അപരിഹാര്യ വേണ്ടതായ ഒഴിച്ചു_നിര്‍ത്താനാവാത്ത ഒഴിവാക്കാനാവാത്ത അത്യാവശ്യമായ സര്‍വപ്രധാനമായ കൂടിയെ_കഴിയു_എന്നുള്ള ആവശ്യകമായ അടിസ്ഥാനപരമായ മര്‍മ്മപ്രധാനമായ.
चड_रागीश्ट: വളരേ_ഭയങ്കരമായ കഠിനമായ.
चडपा_सारक्या: കയറുവാന്‍_പറ്റുന്ന.
चडपी: ആരോഹണ കയറുന്ന ആരോഹണം_ചെയ്യുന്ന.
चडाक्षरी: അനേകാക്ഷരമുള്ള
चडिल्लें: ആരോഹണം_ചെയ്യപ്പെട്ട
चतूर: ചുറുചുറുക്കുള്ള ഉന്‍മേഷമുള്ള ചൊടിയുള്ള ഉത്സാഹമുള്ള ഊറ്‍ജ്ജസ്വലതയുള്ള പ്രസരിപ്പുള്ള ഓജസ്സുള്ള ചുണയുള്ള മിടുക്കുള്ള നിപുണനായ സമര്‍ഥനായ മിടുക്കുള്ള ചാതുര്യമുള്ള
चपळ: നിപുണനായ സമര്‍ഥനായ മിടുക്കുള്ള ചാതുര്യമുള്ള
चमचो: മുഖസ്തുതിക്കാരന്‍ വ്യാജ_പ്രശംസക്കാരന്‍
चमत्कारी: വര്ണ്ണ_ശബളമായ.
चरित्रहीण: പരപുരുഷനുമായി_ലൈംഗികബന്ധം_പുലര്ത്തുന്നവള്. ദുശ്ചരിത്രം.
चर्चीत: ചര്ച്ച_ചെയ്യപ്പെട്ടത്.
चलणुकेंत_नाशिल्लो: പ്രചാരത്തിലില്ലാത്ത നടപ്പില്ലാത്ത പ്രസിദ്ധന്മില്ലാത്ത പരസ്യമല്ലാത്ത യുക്തമല്ലാത്ത പ്രാബല്യത്തിലില്ലാത്ത ആയുസ്സില്ലാത്ത.
चलपी: നടത്തപ്പെടുന്ന പ്രവര്‍ത്തിക്കപ്പെറ്ടുന്ന. കാല്നടയായി. നടക്കാന്തുടങ്ങിയ
चलयिल्लें: നിയന്ത്രിക്കപ്പെട്ട നിര്‍വഹിക്കപ്പെട്ട.
चवथें: നാലാം
चवदा: പതിനാലാം പതിനാലാമത്തെ
चवद्यांयश्यांवें: എണ്പത്തിനാലാമത്തെ
चवद्याण्णवावें: തൊണ്ണൂറ്റി_നാല്
चवद्यात्तरावें: എഴുപത്തി_നാലാം
चवपन: അന്പത്തി_നാല്
चवपनावें: അന്പത്തിനാലാമത്തെ
चवसठावें: അരുപത്തി_നാലാമത്തെ.
चाडी: ചാഡീയ.
चामटो: പിശുക്കനായ ക്ര്പണനായ.‌ പിശുക്കന്‍ ലുബ്ധന്‍ ലോഭന്‍ കൃപണന്‍
चायनीस: ചൈനക്കാരന്റെ
चार: നാല്‌ 4
चार_खावपी: പുല്ലു_തിന്നുന്ന_മ്രിഗങ്ങള്‍
चारतर्फी: നാലു_ഭാഗത്ത്_നിന്നും.
चारपट: നാലുമടങ്ങ് നാലിരട്ടി
चारशेंवीस: ചതിയനായ വഞ്ചകനായ.
चालंत: ചലനാത്മകമായ പുരോഗമനപരമായ ക്രിയാത്മകമായ.
चालक: പ്രവാഹകന്‍.
चालाक: നിപുണനായ സമര്‍ഥനായ മിടുക്കുള്ള ചാതുര്യമുള്ള ക്രിത്രിമം_ചെയ്യുന്ന.
चालू: ചലനാത്മകമായ പുരോഗമനപരമായ ക്രിയാത്മകമായ. നടത്തപ്പെടുന്ന പ്രവര്‍ത്തിക്കപ്പെറ്ടുന്ന. കാമിയായ കാമ_വികാരമുള്ള ക്രീഡാസക്തിയുള്ള. തുടരുന്ന ആവറ്ത്തിക്കുന്ന നടക്കുന്ന നിരന്തരമായ. ആരംഭിച്ച തുടക്കമിട്ട പ്രാരംഭിച്ച സമാരംഭിച്ച.
चाळपाचें: കടയുവാനുള്ള.
चाळीस: നാല്‍പ്പത്.
चाहतें: തിരയുന്ന അന്വേഷിക്കുന്ന
चिंतनशील: വേണ്ട്വിധം_പഠനം_ചെയ്യപ്പെടുക
चिंतपाचें: ചിന്തനീയമായ ചര്‍ച്ചാവിഷയമാകാന്‍_പറ്റിയ സന്ദിഗ്ദ്ധമായ പരിശോധിക്കപ്പെടേണ്ടതായ.
चिंताजनक: ചിന്തിക്കേണ്ടതായ.
चिंताहीण: വിചാരിക്കാത്തത്.
चिंतेबगरची: വിചാരിക്കാതെ അവിചാരിതമായി.
चिंतेस्त: ചിന്തയോടു_കൂടിയ ഉത്കണ്ഠയുള്ള ചിന്താകുലനായ.
चिकलाचें: മാലിന്യമുള്‍ള ചേറുള്‍ള.
चिकित्सा: ചികിത്സാ_സംബന്ധമായ.
चिकू: പിശുക്കനായ ക്ര്പണനായ.‌
चिकू_मारवाडी: പിശുക്കന്‍ ലുബ്ധന്‍ ലോഭന്‍ കൃപണന്‍
चिकें: കുറച്ചു.
चिखलाचें: വ്രിത്തികെട്ട വ്രിത്തി_ഇല്ലാത്ത.
चिखलामेकळें: ചെളിയില്ലാത്ത പങ്കിലമല്ലാത്ത
चिडिल्लें: ചവിട്ടി_അരച്ച. കേടു_വന്ന നാശം_പറ്റിയ അയോഗ്യമായ കൊള്ളാത്ത ചീഞ്ഞ അഴുകിയ.
चिड्डयिल्लें: നിയന്ത്രിക്കപ്പെട്ട.
चितारिल्लें: ചിത്രീകരിച്ച ചിത്രീകരിക്കപ്പെട്ട ചിത്രം_വരച്ച ചിത്രിതമായ.
चित्रांकीत: ചിത്രാങ്കിതമായ ചിത്രത്തിലു്_അറ്റയാളപ്പെടുത്തിയ.
चित्रायिल्लें: ചിത്രാങ്കിതമായ ചിത്രത്തിലു്_അറ്റയാളപ്പെടുത്തിയ. ചിത്രീകരിച്ച ചിത്രീകരിക്കപ്പെട്ട ചിത്രം_വരച്ച ചിത്രിതമായ.
चित्रीत: ചിത്രാങ്കിതമായ ചിത്രത്തിലു്_അറ്റയാളപ്പെടുത്തിയ. ചിത്രീകരിച്ച ചിത്രീകരിക്കപ്പെട്ട ചിത്രം_വരച്ച ചിത്രിതമായ. ചിത്രീകരിച്ച ചിത്രീകരിക്കപ്പെട്ട ചിത്രം_വരച്ച ചിത്രിതമായ.
चिनी: ചൈനക്കാരന്റെ ചൈന_ഭാഷ
चिपचिपीत: വെള്ളമയം
चिप्प_भिजील्लेंप: കുതിര്‍ന്ന
चिरंजीव: അമരന്‍ മൃത്യുഞ്ഞയന്‍ ചിരഞ്ഞീവി അമര്‍ത്യന്‍ ചിരഞ്ജീവി.
चिरिल्लें: മുറിഞ്ഞ
चिली: ചിലി_രാജ്യത്തെ.
चुकीची: അനുചിതമായ അയുക്‌തമായ ശരിയല്ലാത്ത ഔചിത്യമില്ല്ലാത്ത അരുതാത്ത
चुकीचो_समज_जाल्लें: തെറ്റിദ്ധരിച്ച
चुरगळिल्ल्या: ചുരുങ്ങുക.
चुलत: അച്ഛന്റെ_ഇളയ_സഹോദരനെ_സംബന്ധിക്കുന്ന. അച്ഛന്റെ_അനിയനെ_സംബന്ധിക്കുന്ന.
चेंचिल्लें: ചവിട്ടി_അരച്ച.
चेंपिल्लें: ചവിട്ടി_അരച്ച.
चेक: ചെക്ക് ചെക്ക്
चेडी: പരപുരുഷനുമായി_ലൈംഗികബന്ധം_പുലര്ത്തുന്നവള്.
चेतन: ജീവനുള്ള ശ്വാസോച്ഛ്വാസമുള്ള
चेतनायुक्त: ചേതനയോടു_കൂടിയ.
चेपटें: പരന്ന.
चोंचरें: കൊഞ്ചി_പ്പറയുന്ന
चोंयवटेनचें: നാലു_ഭാഗത്ത്_നിന്നും.
चोकपा_सारकें: വലിച്ചു_കുടിക്കാവുന്ന.
चोपनावें: അന്പത്തിനാലാമത്തെ
चोरपाचें: തട്ടിപ്പറിയ്ക്കാവുന്ന_വസ്തു.
चोरिल्लें: അപഹരിക്കാവുന്നത്. അപഹരിക്കപ്പെട്ട്. അപഹരിക്കപ്പെട്ട്. അപഹരിക്കപ്പെട്ട.
चोवपन: അന്പത്തി_നാല്
चौकस: ചോദ്യങള്ക്കുള്ള
चौपट: നാലുമടങ്ങ് നാലിരട്ടി
छंदबद्ध: ബന്ധിക്കപ്പെട്ട.
छाप्पनावें: അന്പത്തിയാറാമത്തെ
जंगम: ചലിക്കുന്ന ചലിക്കാന്‍_സാധിക്കുന്ന ജീവനുള്ള.
जंगली: വനത്തെ_സംബന്ധിക്കുന്ന.
जखमी: മുറിവേറ്റ ക്ഷതമേറ്റ. തുളഞ്ഞു_കയ്രിയ
जगजयी: ലോകം_ജയിച്ചവന്‍.
जगजाहीर: എല്ലാവരും_അറിയുന്ന.
जड: ഭാരിച്ച കനത്ത തൂക്കമുള്ള മഹത്ത്വമുള്ള ശ്രേഷ്ഠമായ ഗംഭീരമായ ഉല്ക്ര്ഷ്ടമായ പ്രൌഢമായ ഉത്തമമായ വിശിഷ്ഠമായ സ്തുത്യറ്ഹമായ മികച്ച മഹിമയുള്ള.
जननेंद्री: ജനനേന്ദ്രിയം
जपानी: ജപ്പാന്‍_ഭാഷയിലെ
जप्त_केल्लें: കണ്ടുകെട്ട്പ്പെട്ട്.
जबरदस्त: വളരെ_വലിയ ബ്ര്ഹത്തായ.‌
जबाबदार: ചുമതലപ്പെടാത്ത.
जमैकी: ജമൈക്കയിലെ.
जयी: സഫലമായ വിജയകരമായ.
जर्मन: ജര്‍മ്മന്‍ ജര്‍മ്മനിയുടെ
जलस्थलचर: ഉഭയചര വെള്ളത്തിലും_കരയിലും_ജീവിക്കുന്ന.
जल्म_घेतिल्लें: ഉല്പന്ന് ഉണ്ടായ ജനിച്ച.ഉത്ഭവിച്ച രൂപപ്പെട്ട ഉല്പാദിപ്പിച്ച.
जल्मल्लें: ഉല്പന്ന് ഉണ്ടായ ജനിച്ച.ഉത്ഭവിച്ച രൂപപ്പെട്ട ഉല്പാദിപ്പിച്ച.
जल्मांध: ജന്മാന്ധന്
जल्माक_आयिल्लें: ഉല്പന്ന് ഉണ്ടായ ജനിച്ച.ഉത്ഭവിച്ച രൂപപ്പെട്ട ഉല്പാദിപ്പിച്ച.
जल्मीत: ഉല്പന്ന് ഉണ്ടായ ജനിച്ച.ഉത്ഭവിച്ച രൂപപ്പെട്ട ഉല്പാദിപ്പിച്ച.
जळिल्लें: കത്തി_ദഹിച്ച.
जस्ताचें: നാകത്തിന്റെ_നിറമുള്ള.
जागरूक: ഉണര്ന്നിരിക്കുന്ന.
जागृत: ഉണര്ന്നിരിക്കുന്ന.
जागें: ഉണര്ന്നിരിക്കുന്ന.
जाड: കട്ടിയുള്ള കനമുള്ള
जाणकार: പ്രായോഗികന്ജ്ഞാനമുള്ള അനുഭവന്ജ്ഞാനം_ഉള്ള പരിചയസമ്പന്നത_ഉള്ള ഇടപഴക്കമുള്ള പ്രായോഗികജ്ഞാനം_ഉള്ള വിദ്വാന്‍മാരായിട്ടുളള പാണ്ഡിത്യമുള്ള അറിവുള്ള
जाणटी: വയസ്സായ_സ്ത്രീ വ്ര്ദ്ധ_സ്ത്രീ.‌
जाणटें: വയസ്സായ.
जाणपी: മനസ്സിലാക്കാവുന്ന ധരിക്കാവുന്ന.
जाणा_आशिल्लें: അറിവുള്ള
जाणाजाल्लें: അറിവുള്ള
जाती_भितरलें: സ്വജാതീയ ഒരേ_വറ്ഗ്ഗത്തില്‍_പെട്ട സജാതീയ.
जाती_विशींचें: ജാതീയമായ വര്‍ഗ്ഗീയമായ.
जातीचें: ജാതീയമായ വര്‍ഗ്ഗീയമായ.
जाप_दिवपी: ഉത്തരം_നല്‍കുന്ന ഉത്തരം_പറയുന്ന.
जापसालदार: ചുമതലപ്പെടാത്ത. ഉത്തരവാദിത്വമുള്ള ഉത്തരവാദപ്പെട്ട
जापे_बगर: ഉത്തരമില്ലാത്ത.
जाबाबदार: ഉത്തരവാദിത്വമുള്ള ഉത്തരവാദപ്പെട്ട
जाम: സാമര്ഥ്യം_ഇല്ലാത്ത.
जाम_जाल्लें: ക്ഷീണിച്ച.
जायत्यो: അനേകം ഒന്നിലധികമായ പല വളരെയേറേ അസംഖ്യം.
जार्डनी: ജോറ്ദാന്‍ ജോറ്ദാനി.
जाल्लें: ഉത്പന്നമായ ജനിച്ച പരിസമാപ്തമായ. സംഭവിച്ച ഉണ്ടായ രചിക്കപ്പെട്ട കഴിഞ്ഞു_പോയ കടന്നു_പോയ.
जावन_गेल्लें: സംഭവിച്ച ഉണ്ടായ രചിക്കപ്പെട്ട കഴിഞ്ഞു_പോയ കടന്നു_പോയ.
जावायी: ജാവയിലെ ജാവായുടെ
जासुसी: രഹസ്യാന്വേഷണം കുറ്റാന്വേഷണം.
जाहीर: രഹസ്യസ്വഭാവമല്ലാത്ത രഹസ്യമല്ലാത്ത. വ്യക്തമാക്കപ്പെട്ട സ്പഷ്ട്ടമായ.
जिखिल्लें: ജയിക്കത്തക്ക.
जिखिल्लो: ജേതാവ് വിജയി
जिज्ञासु: അറിയാനാഗ്രഹമുള്ള ജിജ്ഞാസു.
जिज्ञासू: ചോദ്യങള്ക്കുള്ള
जितो: ജീവനുള്ള ശ്വാസോച്ഛ്വാസമുള്ള ചേതനയോടു_കൂടിയ.
जिद्दी: വാശിക്കാരനായ.
जिल्ल्याचें: വിഭജിച്ച.
जिवंत: ജീവനുള്ള ശ്വാസോച്ഛ്വാസമുള്ള
जिवघेणें: ജീവനൊടുക്കുന്ന.
जिवनदान: മരണം_ഇല്ലാതാക്കുന്നവന്‍ ജീവന്‍_നല്‍കുന്നവന്‍ സഞീവനി.
जिवीत: ജീവനുള്ള ശ്വാസോച്ഛ്വാസമുള്ള
जिवो: ജീവനുള്ള ശ്വാസോച്ഛ്വാസമുള്ള ചേതനയോടു_കൂടിയ.
जीबमुळयीं: നാക്കിന്റെ_ചുവട്
जुंव्याचें: ദ്വീപ്
जुगारी: ചൂതുകളിക്കുന്ന
जुनें: ജീര്‍ണ്ണിച്ച.
जुल्मी: സദാചാരമില്ലാത്ത മറ്റുള്ളവരേ_ഉപദ്രവിക്ക്ല്.
जुवळीं: ഇരട്ട.
जुवान: യുവാവ്
जेझू_विशीं: യേശുവിനെ_സംബന്ധിക്കുന്നതു് ഈശോമിശിഹ യേശു_ക്രിസ്തു മരിച്ചവനെ_ജീവിപ്പിക്കുന്നവന്‍.
जेवपाचें: ഭക്ഷണയോഗ്യമായ ഭക്ഷണ_പദാര്‍ഥം.
जेवपी: തിന്നുന്ന ഭക്ഷിക്കുന്ന കഴിക്കുന്ന ഭോജിക്കുന്ന ആഹരിക്കുന്ന.
जैतवंत: ജയിക്കത്തക്ക. സഫലമായ വിജയകരമായ.
जैतीवंत: ജേതാവ് വിജയി
जॉर्जियायी: ജോറ്ജിയന്‍.
जोखिल्लें: തൂക്കിയ
जोडपी: സമ്പാദിക്കുന്ന.
जोडिल्लें: ആഗിരണം_ചെയ്ത അനുബന്ധമായ. കൂട്ടിചേര്ത്ത നേടിയത്
जोतपा_सारकें: ഉഴാനുള്ള.
जोर_काडपी: ഊഷ്മാവ്മാറ്റുന്ന ചൂട്_മാറ്റുന്ന.
जोरनाशक: ഊഷ്മാവ്മാറ്റുന്ന ചൂട്_മാറ്റുന്ന.
ज्ञात: പേരു_കേട്ട.
ज्ञानपूर्ण: അറിവുള്ള ബോധപൂര്‍ണ്ണമായ.
ज्ञानमय: അറിവുള്ള ബോധപൂര്‍ണ്ണമായ.
ज्ञेय: മനസ്സിലാക്കാവുന്ന ധരിക്കാവുന്ന.
झगझगीत: പ്രകാശപൂര്‍ണ്ണമായ പ്രകാശമാനമായ. തിളങ്ങുന്ന മിന്നുന്ന പുറമ്പകിട്ടൂള്ള.
झगडपी: കര്‍ക്കസയായ.
झगडाळ: കര്‍ക്കസയായ. കലഹപ്രിയമുള്ള.
झगडूल: കര്‍ക്കസയായ.
झगड्याचें: തര്‍ക്കിക്കപ്പെടാവുന്ന വിവാദത്തിനു_കാരണമാകാവുന്ന.
झडिल्लें: ശക്തിയായ_മഴ.
झांकपी: വ്യര്ഥ_ഭാഷണം_ചെയ്യുന്ന.
झिंबाबेयी: സിംബ്ബാവെവിയന്.
झिपरे: അഴിഞ്ഞു_ചിതറിയ.
झिरझिरिल्ली: ജീര്‍ണ്ണിച്ച.
झिरमिरीत: നേര്‍മയുള്ള
झुजपी: പലായനം_ചെയ്യാത്ത.
झुजा_इत्सुक: യുദ്ധം_ഇഷ്ട്ടപ്പെടുന്നയാള്.
झेंपें: അവിവേകിയായ ജളനായ ഭോഷനായ മൂഢനായ മന്ദതയുള്ള ജളത്വമുള്ള
झेमें: അവിവേകിയായ ജളനായ ഭോഷനായ മൂഢനായ മന്ദതയുള്ള ജളത്വമുള്ള
झेलाचें: ഐസ്സുള്ള.
टकलू: മൊട്ട.
टकलो: കഷണ്ടിയുള്ള കഷണ്ടി_രോഗമുള്ള.
टणक: ഉറപ്പുള്ള ബലമുള്ള
टवटवीत: പുതിയ പുത്തന്‍ പുതിയ പുത്തനായ പുതിയ പുതുമ_നിറഞ്ഞ നവമായ ആധുനികമായ പുതുതായ അഭിനവ പുതുമയുള്ള.
टायप_केल्लें: ടയിപ്പ്_ചെയ്ത.
टाळपी: സംയമനം_പാലിക്കുന്ന മനോനിയന്ത്രണം_ഉള്ള ഇന്ദ്രിയ_നിഗ്രഹം_പാലിക്കുന്ന വിരക്തിയുള്ള ആത്മ_സംയമമുള്ള സംയാമമുള്ള.
टाळूं_येना: അനിവാര്യമായ.
टिकाकार: നിന്ദിക്കുന്ന.
टिकात्मक: പരിഹാസപൂര്‍വം
टिपक्यांचें: ചെറിയ_പൊട്ടുകളുള്ള
ट्युनीशी: ട്യൂനിസിയന്.
ठगो: തെമ്മാടി പോക്കിരി താന്തോന്നി ആഭാസന്‍ നെറികെട്ടവന്‍
ठिपक्यांचें: ചെറിയ_ജലകണങള്‍_വെച്ചുണ്ടാക്കിയ_തുണി.
डच: ഡച്. ഡച്ചിന്റെ
डेनमार्की: ഡേനിഷിന്റെ ഡെന്മാര്‍ക്കി_ഭാഷ
ढोंगी: കപടമായ.
णव: ഒന്‍പത് 9
णवपट: ഒന്‍പതുമടങ്ങ്
णववें: ഒന്‍പതാം
णव्याण्णवावें: തൊണ്ണൂറ്റ്_ഒന്പതാമത്തെ
णव्वदावें: തൊണ്ണൂറാമത്തെ. തൊണ്ണൂറാമത്തെ
तंजानियायी: ടാന്സാനിയന്.
तंत्रांविशींचें: സാങ്കേതിക.
तंत्राबगरचें: സാങ്കേതികമല്ലാത്ത.
तंत्रीक: സാങ്കേതിക.
तकलेंतलें: കാല്പനീകമായ സാങ്കല്‍പ്പീകമായ വാസ്തവമല്ലാത്ത സങ്കല്പത്തിലുള്ള യാഥാറ്ത്ഥ്യമല്ലാത്ത സത്യ്മല്ലാത്ത ഭാവനയിലുള്ള കല്പിതമായ ഭാവനം_ചെയ്ത അനനുക്ര്‌തമായ മിഥ്യയായ അയഥാറ്ത്ഥമായ മായികമായ.
तकलेचें: തലച്ചോറിനെ_സംബന്ധിക്കുന്ന.
तटवासी: തീരത്ത്_വസിക്കുന്ന.
तटस्थ: താല്പര്യ_മില്ലായ്മ നിഷ്പക്ഷത.
तड्डकी: നുണയന്‍ അസത്യം_പറയുന്നവന്‍ അസത്യം_പറയുന്നവന്‍ എതിര്‍_വാദം_ചെയ്യുന്നയാള്‍ കള്ളം_പറയുന്നയാള്‍.
तण_खावपी: പുല്ലു_തിന്നുന്ന_മ്രിഗങ്ങള്‍
तत्पर: തത്പരമായ ആഭിമുഖ്യമുള്ള പ്രതിപത്തിയുള്ള ശുഷ്കാന്തിയുള്ള വാഞ്ജയുള്ള താല്‍പര്യമുള്ള ഉത്സാഹമുള്ള സന്നദ്ധതയുള്ള
तत्पुरते: സ്ഥിരം_അല്ലാത്ത
तथ्यपूर्ण: സത്യാവസ്ഥയിലുള്ള് യാഥാര്‍ത്ഥ്യപൂര്‍ണ്ണമായ.
तननशील: വലിച്ചു_നീട്ടാവുന്ന.
तपाशिल्लें: അവലോകനം_ചെയ്യപ്പെട്ട. പരീക്ഷിക്കപ്പെട്ട
तपासणी: ചികിത്സാ_സംബന്ധമായ.
तपासणे_बगरचें: പരിശോധിക്കാത്ത അന്വേഷിക്കാത്ത പരീക്ഷിക്കാത്ത.
तपासूंक_नाशिल्लें: പരിശോധിക്കാത്ത അന്വേഷിക്കാത്ത പരീക്ഷിക്കാത്ത.
तमीळ: തമിഴിന്റെ തമിഴ് തമിഴ്
तयवानी: തായ്‌വാനിന്റെ
तयार: തത്പരമായ ആഭിമുഖ്യമുള്ള പ്രതിപത്തിയുള്ള ശുഷ്കാന്തിയുള്ള വാഞ്ജയുള്ള താല്‍പര്യമുള്ള ഉത്സാഹമുള്ള സന്നദ്ധതയുള്ള റെഡീമേഡ്.
तयार_करूंक_नाशिल्लें: നിര്മ്മിക്കാത്ത.
तयार_केल्लें: രചിക്കപ്പെട്ട എഴുതപ്പെട്ട.
तयार_जाल्लें: ഉത്പാദിപ്പിക്കുന്ന ഉത്ഭവിക്കുന്ന ഔല്പാദികമായ ഉല്പാദിക്കപ്പെട്ട് ഉല്പാദിത ഉല്പാദിപ്പിക്കപ്പെട്ട ഉല്പാദ്യ് സ്ര്‌ഷ്ടിപരമായ നിറ്മ്മാണാത്മകമായ രചനാത്മകമായ.
तरंगपी: പൊങ്ങികിടക്കുന്ന പൊന്തി_കിടക്കുന്ന.
तरणें: യുവാവ്
तरबेज: ശിക്ഷണം_ചെയ്യപ്പെട്ട.
तरातरांचें: പലവിധേനയുള്ള
तरेकवार: പലവിധേനയുള്ള
तर्क_नाशिल्लें: തര്ക്കമില്ലാത്ത.
तर्कपुर्ण: യുക്തി_നിറഞ്ഞ.
तर्कहीण: തര്ക്കമില്ലാത്ത. തര്ക്കത്തിന്നതീതമായ.
तर्का_बगरचें: തര്ക്കത്തിന്നതീതമായ.
तर्काबगरचें: തര്ക്കമില്ലാത്ത.
तर्र: ലഹരി_പിടിച്ച.
तलवारधारी: വാള്‍പ്രയോഗ_വിദ്ഗ്ധന്‍.
तळ्याचें: ചളി.
तशाक_तशें: തനിപ്പകര്‍പ്പ്.
तांकीवंत: ശക്തിയുള്ള ബലമുള്ള ദ്രിഢമായ
तांतया_आकाराचो: അണ്ണ്ഡാക്ര്തിയിലുള്ള_.
तांबडो: ചുവന്ന്. തേജസ്വിയായ
ताकतिकेन: വേഗതയുള്ള ചുണയുള്ള തീക്ഷ്ണമായ.
ताकतीक_करपी: സൂക്ഷ്മതയില്ലാത്ത വേണ്ടപോലെ_ആലോചിക്കാത്ത ദ്രുതഗതിയിലുള്ള.
ताचे_खेरीज: കൂടാതെ അല്ലാതെ
ताचे_बगर: കൂടാതെ അല്ലാതെ
ताचे_भायर: കൂടാതെ അല്ലാതെ
ताचे_शिवाय: കൂടാതെ അല്ലാതെ
ताजिकिस्तानी: തസികിസ്താനി.
ताजें: പുതിയതായ പുത്തനായ പുതിയ പുത്തനായ പച്ചയായ സജീവമായ ഹരിതാഭമായ ചൈതന്യത്തോടെ. പുതിയ പുതുമ_നിറഞ്ഞ നവമായ ആധുനികമായ പുതുതായ അഭിനവ പുതുമയുള്ള.
ताजो: പുതിയ പുത്തന്‍
ताठ: മുട്ടു_മടക്കാത്ത കുനിയാത്തത വളയാത്ത.
तात्काळीचें: താമസം_വിനാ താമസം_കൂടാതെ വിളംബിക്കാതെ അമാന്തിക്കാതെ.
तानेल्लें: ദാഹമുള്ള തൊണ്ടവരള്‍ച്ചയുള്ള
ताप_काडपी: ഊഷ്മാവ്മാറ്റുന്ന ചൂട്_മാറ്റുന്ന.
तापट: ദ്വേഷ്യമുള്ള. ക്രോധമുള്ള.
तापनाशक: ഊഷ്മാവ്മാറ്റുന്ന ചൂട്_മാറ്റുന്ന.
तापिल्लें: ചൂടുള്ള
तामीळ: തമിഴിന്റെ തമിഴ് തമിഴ്
तार्कीक: തര്‍ക്കിക്കുന്ന വാദിക്കുന്ന. അവിരുദ്ധമായ.
तार्‍याविणें: നക്ഷത്ര_വിഹീനമായ.
तालीक_केल्लें: പകര്‍ത്തപ്പെട്ട്
ताळो: ശാഖകളുള്ള.
तिकतीकपी: തേജസ്സാര്ന്ന തിളങുന്ന.
तिक्ष्ण: സൂക്ഷ്മ_ഗ്രാഹിത്വം.
तिखट: എരിവുള്ള തീക്ഷ്ണതയുള്ള.
तिख्याचें: ഉരുക്കുകൊണ്ടുള്ള. ഉരുക്കുകൊണ്ട്_നിര്മ്മിച്ച. ഉറപ്പുള്ള.
तिगाय: മൂവരും.
तिप्पट: മൂന്നു_മടങ്ങ്
तिबेटी: തിബത്തുകാരന്റെ തിബത്തിലെ തിബത്തിലെ_ഭാഷ
तिरकटी: കഠിന_വാക്കു_പറയുന്ന അപ്രിയം_പറയുന്ന.
तिरसुवादीक: കഠിന_വാക്കു_പറയുന്ന അപ്രിയം_പറയുന്ന.
तिरायताचें: മറ്രുള്ളവരുടെ അന്യരുടെ അന്യമായ വേറെ_ആയ വൈദേശികമായ വിദേശിയായ തറ്റേതല്ലാത്ത പുറമേയുള്ള മറ്രൊന്നായ മറ്രേതായ ഇതരമായ സ്വന്തമല്ലാത്ത അപര.
तिव्र: സൂക്ഷ്മ_ഗ്രാഹിത്വം.
तीख: എരിവുള്ള തീക്ഷ്ണതയുള്ള. മ്ര്‌ദുവായ നേറ്മ്മയുള്ള‌ കനം_കുറഞ്ഞ ആറ്ദ്രമായ സൌമ്യതയുള്ള.
तीग: മൂവരും.
तीगजाण: മൂവരും.
तीन_फावटीचें: മൂന്നു_തവണ_ഉഴുത.
तीनतर्फी: മൂന്ന്_ഭാഗത്ത്_നിന്നും.
तीनपायी: മുക്കാലി.
तुंबिल्लें: പ്രവഹിക്കാത്ത ശാന്ത_മായ നില്‍ക്കുന്ന സ്ഥിരമായ ഗതിഹീനമായ.
तुंबिल्लो: അടഞ്ഞുപ്പോയ
तुजें: നിങ്ങളുടെ നിന്റെ
तुमचें: താങ്കളുടെ
तुमचें.: നിങ്ങളുടെ നിന്റെ
तुर्कमेनिस्तानी: തുര്‍ക്കമേനിസ്താനിന്റെ.
तुर्की: തുര്‍ക്കി_ഭാഷയിലെ
तुल्य: താരതമ്യപ്പെടുത്താന്‍_യോഗ്യം.
तुश्ट: സന്തോഷമുള്ള_.
तुस्ततोखणायेचें: പ്രശംസിക്കപ്പെട്ട
तुस्तेचें: അഭിനന്ദിക്കപ്പെട്ട.
तृणजिवी: പുല്ല്_തിന്നുന്ന
तृप्त: ത്ര്പ്തനായ്.
तेंगशेचें: ഉയര്‍ന്ന പൊക്കമുള്ള
तेजपूर्ण: സ്വര്‍ണ്ണം_കൊണ്ടലങ്ങ്കരിച്ച കാന്തിപൂര്‍ണ്ണമായ ഉജ്ജ്വലമായ.
तेजस्वी: സ്വര്‍ണ്ണം_കൊണ്ടലങ്ങ്കരിച്ച കാന്തിപൂര്‍ണ്ണമായ ഉജ്ജ്വലമായ. കാന്തിമത്തായ.
तेजहीण: തേജസ്സില്ലാത്ത ചുണയില്ലാത്ത ശോഭയില്ലാത്ത.
तेजाबी: അമ്ലതയുള്ള
तेमकाचें: ഉയര്‍ന്ന പൊക്കമുള്ള
तेरावें: പതിമൂന്നാം പതിമൂന്നാമത്തെ
तेलगू: തെലുംഗ് തെലുംഗ് തെലുംഗ്
तेलुगू: തെലുംഗ് തെലുംഗ് തെലുംഗ്
तैवानी: തായ്‌വാനിന്റെ
तोंकाचें: ഉയര്‍ന്ന പൊക്കമുള്ള
तोंडा_वयलें: അടുത്തു_വന്ന അടുത്തെത്തിയ.
तोखणायेचे: പ്രശംസനീയം
तोखणायेचें: അഭിനന്ദിക്കപ്പെട്ട. പ്രശംസിക്കപ്പെട്ട
तोतरें: കൊഞ്ചി_പ്പറയുന്ന
तोलाचें: മഹത്ത്വമുള്ള ശ്രേഷ്ഠമായ ഗംഭീരമായ ഉല്ക്ര്ഷ്ടമായ പ്രൌഢമായ ഉത്തമമായ വിശിഷ്ഠമായ സ്തുത്യറ്ഹമായ മികച്ച മഹിമയുള്ള.
तोलूंक_नाशिल्लें: കണക്കില്ലാത്ത
त्याज्य: ഉപേക്ഷിക്കപ്പെടേണ്ടതായ ഉപേക്ഷിക്കത്തക്ക ചീത്തയായ വര്‍ജ്ജിക്കത്തക്കതായ.
त्रस्त: പീടിപ്പിക്കപ്പെട്ട.
त्रासदिणी: ദു
त्रासदिणें: ദു
त्रासाची: ദു
त्रासिल्लो: പീടിപ്പിക്കപ്പെട്ട.
त्रासीक: ദു
त्रिपद: മുക്കാലി.
त्रिबुनालीन: ന്യായ_സൂചകമായ.
त्रेप्पन: അന്പത്തി_മൂന്ന്
त्रेप्पनावें: അന്പത്തി_മൂന്നാം
त्रेसठ: അറുപത്തി_മൂന്ന്
त्रेसठावो: അറുപത്തി_മൂന്നാം
त्र्यांयश्यावें: എണ്പത്തി_മൂന്നാം
त्र्याण्णवावें: തൊണ്ണൂറ്റി_മൂന്നാം
त्र्यात्तरावें: എഴുപത്തി_മൂന്നാം
थंड: സൌമ്യനായ. സൌമ്യമ്മായ സുശീലയായ. ഗൌരവമുള്ള പതറാത്ത സുദൃഢമായ സുസ്ഥിരമായ തണുത്ത. തണുത്ത ശീതളമായ കുളിരുള്ള കുളിറ്‍മയുള്ള തണുത്ത. തണുപ്പേകുന്ന കുളിരേകുന്ന.
थकिल्लें: ക്ഷീണിച്ച.
थकूंक_नाशिल्लें: ക്ഷീണിക്കാത്ത മടുക്കാത്ത.
थपकटें: സമതലമായ നിരപ്പായ പരന്ന.
थपथपिल्लें: കുതിര്‍ന്ന
थपथपीत: വെള്ളമയം
थपथपीतप: കുതിര്‍ന്ന
थरांचें: മടക്കുകളുള്ള തട്ടുകളുള്ള.
थळावें: സ്വദേശീയ തത്സ്ഥാനത്തുള്ള ജനിച്ച_സ്ഥലത്തുള്ള.
थांबिल्ली: ചലനമില്ലാത്ത ചലിക്കാത്ത ഗതിരോധമുള്ള.
थायां_पडपी: കാണാവുന്ന.
थायी: ഥായുടെ ഥായ് ഥായ്
थारायिल्लें: വിധിപ്രകാരമുള്ള. നിയോഗിക്കപ്പെട്ട ചുമതലപ്പെടുത്തിയ.
थीर: മാറാത്ത ഇളക്കപ്പെടാത്ത സ്ഥിരമായ അചഞ്ഞലമായ. ഗൌരവമുള്ള പതറാത്ത സുദൃഢമായ സുസ്ഥിരമായ ദ്രിഢമായ. മുട്ടു_മടക്കാത്ത കുനിയാത്തത വളയാത്ത.
थीर_चित्ताचो: വളരേ_ശാന്തമായ_മനസ്സുള്ള.
थीर_मताचें: ദ്രിഢമായ.
थीरनिश्चयी: സ്ഥിരമായി_പരിശ്രമിക്കുന്ന
थोटें: മുടന്തന്‍ ഞൊണ്ടി
थोटो: അങ്ഗ_വൈകല്യമുള്ള.
थोडें: കുറച്ചു.
थोडें_उलोवपी: അല്പം_സംസാരിക്കുന്നത്.
थोडोसो: ചെറിയ.
दंग: തിരക്കുള്ള
दक्षिणी: തെക്കേദിക്കിനെ_സംബന്ധിക്കുന്ന.
दक्षीण_अफ्रिकी: ദക്ഷിണാഫ്രിക്കന്.
दक्षीण_अमेरिकी: ദക്ഷിണ_അമേരിക്ക.
दक्षीण_कोरियायी: ദക്ഷിണ_കൊറിയന്‍.
दणकट: ദൃഢതയുള്ള ഉറപ്പുള്ള
दनपारचें: ഉച്ച മദ്ധ്യാഹ്ന.
दयाळू: ദയാലുവായ ക്രിപാലുവായ കാരുണികനായ മഹാമനസ്കനായ
दयेस्त: ദയാലുവായ ക്രിപാലുവായ കാരുണികനായ മഹാമനസ്കനായ
दर्याचें: സമുദ്ര സമുദ്രവുമായി_ബന്ധപ്പെട്ട.
दर्शनीय: കാണാന്_കഴിയുന്ന. കാണാന്_കൊള്ളാത്ത.
दलीत: ചവിട്ടിമെതിക്കപ്പെട്ട.
दळडिरें: ഇല്ലായ്മ_പിടിപ്പെട്ട.
दळडिरो: പാവപെട്ട ദരിദ്രനായ നിര്‍ദ്ധനനായ പാപപരായ അഗതിയായ
दळभद्री: ഇല്ലായ്മ_പിടിപ്പെട്ട.
दळिद्री: ഇല്ലായ്മ_പിടിപ്പെട്ട.
दळिद्रो: പാവപെട്ട ദരിദ്രനായ നിര്‍ദ്ധനനായ പാപപരായ അഗതിയായ
दस्तावेजी: പ്രമാണം_സംബന്ധിച്ച.
दांडगट: ദൃഢതയുള്ള ഉറപ്പുള്ള
दांत_नाशिल्लो: പല്ലില്ലാത്ത.
दांतयाळी: പല്ലു_പൊങിയ.
दांतोळी: പല്ലു_പൊങിയ.
दाट: സാന്ദ്രമായ ഉറപ്പുള്ള മേഘമുള്ള. ഇടതൂര്‍ന്ന്. കട്ടിയുള്ള കനമുള്ള
दाडयेकार: താടിയുള്ള.
दाडयेवालो: താടിയുള്ള.
दानवीर: വളരെ_ദാനശീലനായ.
दानशूर: ഉദാരമതിയായ ദാനശീലനായ വളരെ_ദാനശീലനായ.
दानी: ഉദാരമതിയായ ദാനശീലനായ വളരെ_ദാനശീലനായ.
दाबखीळदार: പൂറ്വ്വസ്ഥിതിഗമ്യമുള്ള സ്പ്രിംഗുള്ള.
दावकें: ഇടങ്കൈ_കൂടുതലായി_ഉപയോഗിക്കുന്ന
दावखुरें: ഇടങ്കൈ_കൂടുതലായി_ഉപയോഗിക്കുന്ന
दिकाहीण: വഴി_തെറ്റിപ്പോകുന്ന
दिखावटी: പ്രകടനപരമായ കപടമായ ക്രിത്രിമമായ. ഔപചാരികമായി ഉപചാരപൂര്വ്വമുള്ള ആചാരപരമായ ഔദ്യോഗപരമായ.
दिखावू: മിടുക്കുള്ള ചുറുചുറുക്കുള്ള.
दिग्गज: വലിയ. വലിയ. വലിയ ശ്രേഷ്ഠമായ.
दिनवाशी: നന്ദിയുള്ള ഉപകാര_സ്മരണയുള്ള.
दिल्लें: ലഭിച്ച നേടിയ സ്വീകരിക്കപ്പെട്ട. അറ്പ്പിച്ച സമറ്പ്പിച്ച തറ്പ്പിച്ച
दिवंगत: മരിച്ച അന്തരിച്ച സമാധിയായ മഹാനിദ്രയിലായ നിര്യാതനായ
दिवाणी: ദിവാന്‍_സ്ഥാനം.
दिवाळखोर: പാപ്പരായ.
दिशाहीण: വഴി_തെറ്റിപ്പോകുന്ന
दिश्टी_पडपी: കാണാവുന്ന.
दिसपी: കാണാവുന്ന.
दीन: ദയനീയമായ.
दीर्घ: ദീറ്ഘ നീളമുള്ള നീണ്ട നെടിയ.
दीर्घ_काळाचें: നീണ്ട_കാലത്തെ.
दुकाळिल्लो: അശ്രു_പൂര്ണ്ണം.
दुकुमेती: പ്രമാണം_സംബന്ധിച്ച.
दुखदिणें: ദു
दुखापती_बगरचे: നസിക്കാതെ.
दुखावल्लें: മുറിവേറ്റ ക്ഷതമേറ്റ.
दुख्खदिणी: ദു
दुख्खहीण: ശോകരഹിതന്.
दुख्खांती: ദു
दुख्खाची: ദു ദു
दुख्खी: ദു വ്യഥാപൂര്‍വം അനുശോചനപൂര്‍ണ്ണം. ദു കഷ്ട്ടത്തിലായ.
दुडवांकार: ധനികനായ പണക്കാരനായ
दुतर्फी: ഇരുവശത്തും_ചേരുന്ന.
दुतोंडी: ഇരു_വായുള്ള. രണ്ടു_വിധം_സംസാരിക്കുന്ന.
दुबळो: സാമര്ഥ്യം_ഇല്ലാത്ത.
दुबावा_बगरचो: സംശയാസ്പദമല്ലാത്ത സുനിശ്ചിതാവസ്ഥയിലുള്ള്.
दुबावा_विरयत: സംശയാസ്പദമല്ലാത്ത സുനിശ്ചിതാവസ്ഥയിലുള്ള്. അവിശ്വാസമില്ലാത്ത.
दुबावीत: ആശങ്കിക്കപ്പെട്ട ചിന്തയുള്ളവന്‍ വിചാരമുള്ളവന്‍ ഭയപ്പെടുന്നവന്‍ ആപത്തു_പ്രതീക്ഷിക്കുന്നവന്‍ അശുഭം_പ്രതീക്ഷിക്കുന്നവന്‍ പരുങുന്നവന്‍ അറച്ചു_നില്‍ക്കുന്നവന്‍ സന്ദേഹിക്കുന്നവന്‍. ഇതികര്‍ത്തവ്യതാമൂഢത_ഉണ്ടാക്കുന്ന ഇതികര്‍തവ്യതാമൂഢത_ജനിപ്പിക്കുന്ന. സംശയം.
दुयेंती: രോഗി രോഗാതുരന്‍ രോഗബാധിതന്‍
दुरदर्शिकायहीण: മുന്നാലോചന_ഇല്ലാത്ത.
दुरदर्शी: അകലെ_കാണുന്ന വിവേകമുള്ള പണ്ഡിതാന്‍.
दुर्गूण: ദുര്ഗുണ്ങളുള്ള
दुर्जन: ദുഷ്ട ദുഷിച്ച ചീത്ത നീച
दुर्दशाग्रस्त: ദുര്ദശ_പിടിപ്പെട്ട.
दुर्भागी: ദുര്ഭാഗ്യശാലി.
दुर्मीळ: ബുദ്ധിമുട്ടുള്ള_. ദുര്ലഭമായ.
दुर्वेव्हारी: ദുര്വ്യവഹാരികള്.
दुश्ट: ദുഷ്ട ദുഷിച്ച ചീത്ത നീച ദുഷ്ട്ടാത്മാവു.
दुसरे_जातीचें: വിഭിന്ന_ജാതിയിപ്പെട്ട.
दुसरें: രണ്ടാം ദ്വിതീയ
दुसर्‍यांचेर_आदारून: പരാശ്രയി.
दुसर्‍याचें: മറ്രുള്ളവരുടെ അന്യരുടെ അന്യമായ വേറെ_ആയ വൈദേശികമായ വിദേശിയായ തറ്റേതല്ലാത്ത പുറമേയുള്ള മറ്രൊന്നായ മറ്രേതായ ഇതരമായ സ്വന്തമല്ലാത്ത അപര.
दुस्मानकेचो: ശത്രു_ഭാവത്തോടു_കൂടി വൈരാഗ്യപൂര്‍വ്വം_.
दुस्मानहीण: ശത്രുഹീനന്.
दुस्मानी: ശത്രുപൂര്‍ണ്ണം വിരോധമുള്ള വൈരിയുള്ള.
दुस्वाशी: അവജ്ഞയുള്ള നിന്ദയുള്ള ജുഗുപ്സയുള്ള. ദുഷ്ട ദുഷിച്ച ചീത്ത നീച
दूर: അകലേയുള്ള ദൂരത്തുള്ള.
दूरचें: ദൂരെയുള്ള അകലെയുള്ള.അപാറ്ണ്ണമായ വിപ്രക്ര്‌ഷ്ടമായ പര വിദൂരമായ ബഹുദൂരെയുള്ള.
दृढ: ദ്രിഢമായ.
दृश्टियुक्त: ദ്ര്‌ഷ്ട്ടിയുള്ള കാഴ്ച്ചയുള്ള.
दृश्टिहीण: അന്ധനായ കാഴ്ചയില്ലാത്ത കണ്ണില്ലാത്ത
देंवतें: കുറയുക.
देंवयिल्लें: ജോലിയില്‍_നിന്നു_മാറ്റി_നിര്‍ത്തിയ.
देखघेणे: ആദര്ശവാനായ
देखणें: സൌന്ദര്യമുള്ള സുമുഖമുള്ള ചേലുള്ള ചന്തമുള്ള മനോഹരമാ‍യ സുന്ദരമായ കോമളമായ ഹ്ര്‌ദ്യമായ ആകറ്ഷകമായ അഴകുള്ള മനോജ്ഞമായ.
देगेचें: അടുത്തുള്ള.
देड: ഒന്നര
देण्याचें: കൊടുക്കാവുന്നത് കൊടുക്കാനുളള്‍ത്.
देशद्रोही: ദേശ_ദ്രോഹി.
देशभक्त: ദേശഭക്തന്‍.
देशी: സ്വദേശീയ തത്സ്ഥാനത്തുള്ള ജനിച്ച_സ്ഥലത്തുള്ള.
देशी.: പ്രാദേശിക പ്രദേശികമായ സ്വദേശിയമായ ദേശിയതദ്ദേശീയമായ.
दैववादी: എല്ലാം_ഭാഗ്യത്തിനധീനമെന്നു_വിശ്വസിക്കുന്ന.
दैवी: ഈശ്വരനെ_സംബന്ധിക്കുന്ന ദേവിയെ_സംബന്ധിക്കുന്ന പരമേശ്വരിയെ_സംബന്ധിക്കുന്ന.
दोंगराळ: പര്‍വതത്തിലുള്ള പര്‍വതത്തില്‍_വസിക്കുന്ന. പര്‍വ്തപ്രദേശം.
दोट्टी: രണ്ടിഴയുള്ള.
दोतर्फी: ഇരുവശത്തും_ചേരുന്ന.
दोन_तोंडांचें: ഇരു_വായുള്ള. രണ്ടു_വിധം_സംസാരിക്കുന്ന.
दोन_दाबांचें: രണ്ടിതളുകളുള്ള ദ്വിദലീയ.
दोन_हाताचें: രണ്ടുകയ്യുള്ള.
दोनदाबी: രണ്ടിതളുകളുള്ള ദ്വിദലീയ.
दोननाळी: ഇരട്ട_കുഴല്.
दोनवर्सुकी: ദ്വി_വര്‍ഷി രണ്ടു_വര്‍ഷം_നില്‍ക്കുന്നത്.
दोनांय_वटांतलें: രണ്ടു_പക്ഷമുള്ള രണ്ടു_വശമുള്ള.
दोळ्यांनी_भरपी: നയനാഭിരാമാ‍മായ നയനരമ്യമായ നേത്രാഭിരമാമായ.
दोशी: അപരാധിയായ നിയമലംഘകനായ കുറ്റവാളിയായ പാപിയായ തെറ്റുകാരനായ നിന്ദിക്കപ്പെടാവുന്നത്.
द्रवीत: ഉരുകിയ.
द्विधाग्रस्थ: പ്രശ്നത്തില്_അകപ്പെടുക ഇതികര്ത്തവ്യതാമൂഢത_പിടിപ്പെട്ട.
द्विवर्शी: ദ്വി_വര്‍ഷി രണ്ടു_വര്‍ഷം_നില്‍ക്കുന്നത്.
धंदेकार: പെരുമാറുന്നതില്‍_സമര്‍ഥനായ.
धडधाकट: ദൃഢതയുള്ള ഉറപ്പുള്ള
धनलाबाचें: പണം_കൊടുക്കുന്നവന്.
धनवान: സമര്‍ത്ഥനായ.
धनी: സമര്‍ത്ഥനായ. ധനികനായ പണക്കാരനായ
धन्य: ക്ര്താര്ഥന്.
धन्यवादी: നന്ദിയുള്ള ഉപകാര_സ്മരണയുള്ള.
धर्म_मानपी: മതാനുയായി.
धर्मकुड्डें: മതഭ്രാന്തുള്ള
धर्मनिश्ट: ധാര്‍മ്മികനായ മതഭക്തിയുള്ള സദാചാരതത്പരനായ ധര്‍മ്മനിഷ്ഠനായ ധര്‍മ്മബോധമുള്ള നീതിബോധമുള്ള
धर्मभिरु: മത_വിരുദ്ധമായി_പ്രവര്‍ത്തിക്കാന്‍_ഭയപ്പെടുന്നവന്‍.
धर्मांध: മതഭ്രാന്തുള്ള
धर्मार्थ: മതപരമായ
धर्मालंबी: മതാനുയായി.
धर्मावलंबी: മതാനുയായി.
धर्मिक: ധാര്‍മ്മികനായ മതഭക്തിയുള്ള സദാചാരതത്പരനായ ധര്‍മ്മനിഷ്ഠനായ ധര്‍മ്മബോധമുള്ള നീതിബോധമുള്ള
धर्मिश्ठ: മതാനുയായി.
धर्मीक: മതാനുയായി.
धवें: വെളുത്തത്.
धवो: വെളുത്ത വെളുത്ത_നിറമുള്ള.
धा: പത്ത് ദശം ദശകം 10
धा_आनी_आठ: പതിനെട്ടാം പതിനെട്ടാമത്തെ
धा_आनी_चार: പതിനാലാം പതിനാലാമത്തെ
धा_आनी_पांच: പതിനഞ്ചാം പതിനഞ്ചാമത്തെ
धा_पट: പത്തുമടങ്ങ്
धा_लाख: പത്ത്_ലക്ഷം മില്ല്യണ്‍ 100000.
धा_हजार: പതിനായിരം പത്ത്_ആയിരം.
धांपिल्लें: മറയ്ക്കപ്പെട്ട് ഒളിയ്ക്കപ്പെട്ട്.
धांपिल्लो: മൂടിയ നിറഞ്ഞ.
धांवडायिल्लें: ജോലിയില്‍_നിന്നു_മാറ്റി_നിര്‍ത്തിയ. ബഹിഷ്ക്കരിക്കപ്പെട്ട.
धांवपी: നാടുവിട്ട
धाकटो: അപ്രധാനമായപങ്കു_വഹിക്കുന്ന_അനുജന്‍.
धाडशी: ധൈര്യശാലി നിര്‍ഭയനായ ചങ്കൂറ്റമുള്ള ഉള്‍ക്കരുത്തുള്ള സഹസി_ആയ_വ്യക്തി.
धाडसाचें: സാഹസിക സാഹസികമായ ധീരമായ.
धाडसी: സാഹസിക സാഹസികമായ ധീരമായ.
धातूचें: ലോഹപരമായ ആന്തരികമായ
धात्वीय: ലോഹപരമായ ആന്തരികമായ
धादोशी: സന്തോഷമുള്ള_.
धादोस: ത്ര്പ്തനായ്.
धार_गेल्लें: മൂര്‍ച്ചയില്ലാതാക്കപെട്ട മുനയില്ലാതായ
धार_पडिल्लें: മൂര്‍ച്ചയില്ലാതാക്കപെട്ട മുനയില്ലാതായ
धारदार: മൂര്‍ച്ചുള്ള മുനയുള്ള
धारेचें: മൂര്‍ച്ചുള്ള മുനയുള്ള
धावें: പത്താം
धिराचें: രക്ഷിക്കുന്ന.
धिरिश्ट: ധൈര്യശാലി നിര്‍ഭയനായ ചങ്കൂറ്റമുള്ള ഉള്‍ക്കരുത്തുള്ള
धीट: ധൈര്യശാലി നിര്‍ഭയനായ ചങ്കൂറ്റമുള്ള ഉള്‍ക്കരുത്തുള്ള സഹസി_ആയ_വ്യക്തി.
धील: മുറുക്കമില്ലാത്ത.
धुंवराळ: മങ്ങലുള്ള വ്യ്ക്‌തമല്ലാത്ത അസ്പഷ്ടമായ അവ്യക്‌തമായ
धुक्याचें: മങ്ങലുള്ള വ്യ്ക്‌തമല്ലാത്ത അസ്പഷ്ടമായ അവ്യക്‌തമായ
धुगधुगीत: നേരിയ_ചോടുള്ള_വെള്ളം.
धुल्लाचें: പൊടിപടലമായ
धुळकट: പൊടിപിടിച്ച പൊടിപടലമായ
धुवंक_नाशिल्लें: കഴുകാത്ത
धैर्यहीण: ധൈര്യമില്ലാത്ത_അവസ്ഥ.
धोंगी: ഇരുമുഖങ്ങളുള്ള
धोदेल: തടിച്ച സ്ഥുലശരീരിയായ
धोनयो: അധികം_ഭക്ഷിക്കുന്ന വേഗം_വേഗം_ഭക്ഷിക്കുന്ന ഭക്ഷണപ്രിയനായ വയറനായ കൊതിയനായ.
धोलपी: വിധിപ്രകാരം_നല്കാത്ത.
ध्यानहीन: ശ്രദ്ധയില്ലാത്ത.
न_फेडी_सारकें: വീട്ടാന്_പറ്റാത്തത്.
नकली: പ്രകടനപരമായ കപടമായ ക്ര്‌ത്രിമമായ. മിടുക്കുള്ള ചുറുചുറുക്കുള്ള. ഒരേപോലത്തെ ഡ്യൂപ്ലികേറ്റ്.
नकसूद: വിഷമകരമായ.
नकारात्मक: നിഷേധാത്മകമായി.
नक्षत्रहीण: നക്ഷത്ര_വിഹീനമായ.
नक्षत्रांविणें: നക്ഷത്ര_വിഹീനമായ.
नखेत्रांनी_भरिल्लें: നക്ഷത്രങ്ങളോടു_കൂടിയ.
नगरवासी: പട്ടണവാസി നഗരവാസി.
नगरेंतले: പട്ടണവാസി നഗരവാസി.
नग्न: നഗ്നനായ വിവസ്ത്രനായ ദിഗംബരനായ അനംബരനായ
नदर: ശ്രദ്ധിക്ക്ത്തക്കതായ.
नदर_आशिल्लो: ദ്ര്‌ഷ്ട്ടിയുള്ള കാഴ്ച്ചയുള്ള.
नदरेक_पडपी: കാണാവുന്ന.
नपियेवपा_सारकें: കുടിക്കുവാന്‍_പറ്റാത്ത.
नमळायेचो: ശ്രദ്ധയുള്ള.
नम्र: വിനീതമായ_പെരുമാറ്റമുള്ള.
नयनरम्य: നയനാഭിരാമാ‍മായ നയനരമ്യമായ നേത്രാഭിരമാമായ.
नरभक्षक: നരഭോജിയായ മനുക്ഷ്യനെ_ഭക്ഷിക്കുന്ന. നരഭോജിയായ_രാക്ഷസന്
नरभक्षी: നരഭോജിയായ മനുക്ഷ്യനെ_ഭക്ഷിക്കുന്ന.
नरम: സൌമ്യനായ. വളയുന്ന വഴങ്ങുന്ന. മൃദുവായ മൃദുലമായ പേലവമായ ലോലമായ കോമളമായ സുകുമാരമായ
नळ्यांचें: ഓടിട്ട ഓടു_മേഞ്ഞ.
नवलकाणीक: നോവലിനെ_സംബന്ധിച്ച.
नवशिकें: പുതുതായി_പഠിച്ച അപക്വമായ ശിക്ഷണം_ചെയ്യപ്പെട്ട സിദ്ധിക്കപ്പെടാത്ത അഭ്യസിക്കാത്ത.
नवशिक्षीत: പുതുതായി_പഠിച്ച അപക്വമായ ശിക്ഷണം_ചെയ്യപ്പെട്ട സിദ്ധിക്കപ്പെടാത്ത അഭ്യസിക്കാത്ത.
नविनीकरणी: ആധുനികവല്ക്കരണം.
नवीन: പുതിയ പുത്തനായ നവീനതമായ നൂതനമായ പുതിയ പുതുമ_നിറഞ്ഞ നവമായ ആധുനികമായ പുതുതായ അഭിനവ പുതുമയുള്ള.
नवे: പുതിയ പുത്തനായ നവീനതമായ നൂതനമായ
नवें: അപരിചിതമായ പരിചിതമല്ലാത്ത അന്യമായ അവിദിതമായ പുതുമയുള്ള അജ്ഞാതമായ മുന്നറിവു_കിട്ടാത്ത.
नवेंच_शिकिल्लें: പുതുതായി_പഠിച്ച അപക്വമായ ശിക്ഷണം_ചെയ്യപ്പെട്ട സിദ്ധിക്കപ്പെടാത്ത അഭ്യസിക്കാത്ത.
नवो: ആധുനികം.
नशीबवान: സൌഭാഗ്യമുള്ള ഭാഗ്യമുള്ള.
नशेचें: ലഹരിയുണ്ടാക്കുന്ന ലഹരി_ബാധിച്ച.
नशेबाज: ലഹരിക്കടിമയായവന്.
नश्ट: മരിച്ച നശിച്ച നശിപ്പിക്കപ്പെട്ട.
नश्टो: അവജ്ഞയുള്ള നിന്ദയുള്ള ജുഗുപ്സയുള്ള. ദുഷ്ട്ടാത്മാവു.
नश्वर: നശിക്കുന്ന.
नसायहीण: അസൂയ_ഇല്ലാതിരിക്കുക.
नस्तार: നിഷേധാത്മകമായി.
नांवाजतो: പ്രസിദ്ധയായ കേള്‍വിപ്പെട്ട പേരുകേട്ട യശസ്വിയായ പ്രഖ്യാതമായ അറിയപ്പെട്ട വിഖ്യാതിയായ
नांवादीक: പ്രസിദ്ധയായ കേള്‍വിപ്പെട്ട പേരുകേട്ട യശസ്വിയായ പ്രഖ്യാതമായ അറിയപ്പെട്ട വിഖ്യാതിയായ
नाउमेदी: ഉത്സാഹമില്ലാത്ത.
नाकाजाल्लें: അനാവശ്യമായ.
नाखूश: ദു
नागडो: നഗ്നനായ വിവസ്ത്രനായ ദിഗംബരനായ അനംബരനായ
नागोवणेचें: അപഹരിക്കപ്പെട്ട.
नागोवणो: തെമ്മാടി പോക്കിരി താന്തോന്നി ആഭാസന്‍ നെറികെട്ടവന്‍ തട്ടിപ്പറിക്കുന്ന.
नाजूक: കോമളം സുകുമാരം. ലോലമായ സുകുമാരമായ കോമളമായ ലോലമായ വിഷമകരമായ.
नाटकी: പ്രകടനപരമായ കപടമായ ക്ര്‌ത്രിമമായ. ഔപചാരികമായി ഉപചാരപൂര്വ്വമുള്ള ആചാരപരമായ ഔദ്യോഗപരമായ.
नाड: ക്രിത്രിമം_ചെയ്യുന്ന.
नापसंतीचें: വിരിദ്ധമായ അസന്തുഷ്ടമായ.
नापास: തോറ്റുപോയ തോറ്റ പരാജയപ്പെട്ട വിഫലമായ അപജയപ്പെട്ട.
नामंजुर: സമ്മതമില്ലാത്ത.
नामंजूर: നിരാകരിച്ച സമ്മതിക്കാത്ത് സമ്മതമില്ലാത്ത സമ്മതം_ലഭിക്കാത്ത സമ്മതംകിട്ടാത്ത. സ്വീകരിക്കാത്ത.
नामनेचो: പ്രസിദ്ധയായ കേള്‍വിപ്പെട്ട പേരുകേട്ട യശസ്വിയായ പ്രഖ്യാതമായ അറിയപ്പെട്ട വിഖ്യാതിയായ
नामिबियायी: നമീബിയന്
नायजिरियायी: നൈജീരിയന്.
नालायक: അയോഗ്യനായ ഉപയോഗമില്ലാത്ത പറ്റാത്ത കൊള്ളാത്ത തെറ്റായ അശക്തമായ കഴിവില്ലാത്ത പ്രാപ്തിയില്ലാത്ത അനുയോജ്യമില്ലാത്ത അനുരൂപമല്ലാത്ത സന്മുചിതമല്ലാത്ത അനറ്ഘമായ യുക്തമല്ലാത്ത. പണിയെടുക്കാത്ത.
नावडटें: ഇഷ്ട്ടപ്പെടാത്ത വെറുപ്പുണ്ടാക്കുന്ന.
नावडीचें: വിരിദ്ധമായ അസന്തുഷ്ടമായ.
नावाडगें: കുസൃതിയായ വികൃതിയായ
नावाडगो: കുപ്രസിദ്ധി ദുഷ്കീര്‍ത്തി അപഖ്യാതി
नावेश: വംശനാശം_സംഭവിച്ചത്.
नाशवंत: നശിക്കുന്ന.
नाशिवंत: നശിക്കുന്ന ധ്വംസിക്കാവുന്ന ഇല്ലാതാകവുന്ന അസ്ഥിരമായ ശാസ്വതമല്ലാത്ത.
निंदक: നിന്ദിക്കുന്ന.
निंदा_करपी: നിന്ദിക്കുന്ന.
निंदात्मक: നിന്ദാത്മകമായ
निंदे_बगरचें: നിന്ദിക്കാത്ത
निंदे_विरयत: നിന്ദിക്കാത്ത
निंदेस्त: നിന്ദിക്കപ്പെടാവുന്നത്.
निखळपी: വേറെ_ആക്കാവുന്നത് കഷ്ണമാക്കാവുന്നത്.
नितळ: സ്വച്ഛമായ സ്പഷ്ട്ടമായ തെളിഞ്ഞ. സ്പഷ്ടമായ ശരിയായ നിര്‍മ്മലമായ വിമലമായ പവിത്രമായ് ശുദ്ധമായ ശുദ്ധമാക്കിയ.
नितीकतायपूर्ण: സാന്മാര്‍ഗ്ഗികത സാന്മാര്‍ഗ്ഗികാചരണം.
नितीपूर्ण: സാന്മാര്‍ഗ്ഗികത സാന്മാര്‍ഗ്ഗികാചരണം.
नितीभायरें: നിയമം_അറിയാത്ത
निद्रागत: നിദ്രാനിമഗ്നനായ_‍ ഉറങ്ങിയ.
निद्राहीण: നിദ്രയില്ലാത്ത
निपक्ष: താല്പര്യ_മില്ലായ്മ നിഷ്പക്ഷത.
निपूण: പ്രാവീണ്യമുള്ള നിപുണതയുള്ള സാമറ്ത്ഥ്യമുള്ള മിടുക്കമുള്ള നൈപുണ്യമുള്ള പ്രായോഗികയോഗ്യതയുള്ള ചാതുര്യമുള്ള കുശലതയുള്ള വിരുതുള്ള വിചക്ഷണതയുള്ള പാടവമുള്ള തഴക്കമുള്ള പ്രാപ്തിയുള്ള. യോഗ്യനായ കാര്യശേഷിയുള്ള നിപുണനായ സമര്ത്ഥനായ ശക്തനായ വിദഗ്ദ്ധനായ ചുണയുള്ള ചെയ്തുതഴക്കമുള്ള ചതുരനായ ചുറുചുറുക്കുള്ള ജ്ഞാനമുള്ള കെല്‍പ്പുള്ള പാടവമുള്ള കൌശലമുള്ള കഴിവുള്ള
निबर: ദ്രോഹിയായ കരുണയില്ലാത്ത ഉപദ്രവിക്കുന്ന പേടിയില്ലാത്ത. കര്‍ക്കശമായ ദൃഢചിത്തനായ കഠോരം ദ്രിഢം ക്ലേശകരമായ. കഠിനഹ്രിദയനായ കഠോരഹ്രിദയനായ ദയ_ഇല്ലാത്ത. ഉറപ്പുള്ള ബലമുള്ള വികാരമില്ലാത്ത.
निमंत्रक: ക്ഷണിക്കുന്ന.
निमणें: അവസാനത്തേതല്ലാത്ത
निमसरकारी: അര്‍ദ്ധ്_സര്‍ക്കറിന്റെ.
निमाणें: അവസാനത്തേതല്ലാത്ത
निमाणो: അപ്രധാനമായപങ്കു_വഹിക്കുന്ന_അനുജന്‍.
निमाण्या: അവസാനം.
नियंत्रक: നിയന്ത്രിക്കുന്ന.
नियाळिल्लें: അവലോകനം_ചെയ്യപ്പെട്ട.
नियुक्तीत: നിയുക്തനാക്കിയ.
नियोजीत: നിയോഗിക്കപ്പെട്ട ചുമതലപ്പെടുത്തിയ.
नियोज्य: നിയമിക്കാവുന്ന ഏറ്പ്പെടുത്താവുന്ന
निरंकूश: സ്വേച്ഛാധിപതിയായ അനിയന്ത്രിതനായ നിരങ്കുശനായ കടിഞ്ഞാണില്ലാത്ത.
निरंहकारी: അഹങ്കാരമില്ലാത്ത വിനയമുള്ള ഗര്‍വ്വില്ലാത്ത.
निरक्षर: വിദ്യാഭാസമില്ലാത്ത പഠിപ്പില്ലാത്ത
निरपराधी: നല്ല.
निरपेक्ष: ആഗ്രഹമില്ലാത്ത_പക്ഷപാതമില്ലാത്ത.
निरपेक्षी: ആഗ്രഹമില്ലാത്ത
निरभिमानी: അഹങ്കാരമില്ലാത്ത വിനയമുള്ള ഗര്‍വ്വില്ലാത്ത.
निरर्थक: അസംബന്ധം.
निराकार: ക്ലിപ്തരൂപമില്ലാത്ത. അശരീരി.
निराधार: നിസ്സഹായ സഹായമില്ലാത്ത ആശ്രയമില്ലാത്ത നിരാലംബ അശരണ കെല്പില്ലാത്ത നിറ്ധനനായ. ആശ്രയമില്ലാത്ത അടിസ്ഥാനമില്ലാത്ത.
निरावासीत: വാസമില്ലാത്ത നശിച്ചു_പോയ ഉപേക്ഷിച്ച അന്യമായ.
निराश: പ്രതീക്ഷ_ഇല്ലാത്ത ആശ_നഷ്ട്ടപ്പെട്ട ആശയറ്റ.
निराशादायी: നിരാശാജനകമായ.
निराशावादी: നിരാശവാദി.
निराशेवणेचें: നിരാശാജനകമായ.
निराश्रीत: ദരിദ്രനായ.
निरीच्छ: ആഗ്രഹമില്ലായ്മ
निरुत्तर: ഉത്തരം_ഇല്ലാത്ത.
निरुत्साही: ഉത്സാഹമില്ലാത്ത.
निरुपायी: ഉപായമില്ലാതെ നിവാരണമില്ലാത്ത
निरुपेगी: ഉപയോഗശൂന്യ്മായ.
निरूपयोगी: സന്ദേഹമില്ലാതെ ധാരണയോടെ ഉപായത്തോടെ നിശ്ചയത്തോടെ ധൈര്യത്തോടെ ഉറ്പ്പോടെ തീറ്ച്ചയോടെ.
निरोगी: ആരോഗ്യപൂര്‍ണ്ണമായ ആരോഗ്യകരമായ
निर्जन: നിര്ജ്ജനം ഏകാന്തം.
निर्जाप: ഉത്തരം_ഇല്ലാത്ത. ഉത്തരമില്ലാത്ത.
निर्जीव: ജീവനില്ലാത്ത. ജഡം.
निर्दयी: ദ്രോഹിയായ കരുണയില്ലാത്ത ഉപദ്രവിക്കുന്ന വികാരമില്ലാത്ത.
निर्देशीत: നിര്‍ദേശിച്ച.
निर्दोश: നല്ല.
निर्बंध: നിയമം_പാലിക്കുന്ന.
निर्बळ: സാമര്ഥ്യം_ഇല്ലാത്ത.
निर्भय: പേടിയില്ലാത്ത.
निर्भेळ: ശുദ്ധമായ ഒന്നാംതരമായ നിര്‍മ്മലമായ വിമലമായ പവിത്രമായ് ശുദ്ധമായ
निर्मळ: നിര്‍മ്മലമായ വിമലമായ പവിത്രമായ് ശുദ്ധമായ
निर्माण_केल्लें: രചിക്കപ്പെട്ട എഴുതപ്പെട്ട.
निर्मिल्लें: രചിക്കപ്പെട്ട എഴുതപ്പെട്ട.
निर्मीत: രചിക്കപ്പെട്ട എഴുതപ്പെട്ട.
निर्लज्ज: നാണ്മില്ലാത്ത.
निर्वासीत: പുറത്താക്കപ്പെട്ട.
निर्विकार: നിര്‍വികാരനാണ്‍.
निर्विवाद: അതിക്രമിച്ചുകൂടാത്ത.
निर्वीख: വിഷരഹിതമായ.
निर्वेसनी: ദു
निर्शेल्लें: വിഷമിച്ച.
निर्शेवप: നിരാശയുള്ള.
निलंबीत: ജോലിയില്‍_നിന്നു_മാറ്റി_നിര്‍ത്തിയ.
निवडिल्ली: നിയുക്തനാക്കിയ.
निवडिल्लें: വേര്പ്പെടുത്തുക.
निवळ: നിര്‍മ്മലമായ വിമലമായ പവിത്രമായ് ശുദ്ധമായ തിളങ്ങുന്ന ശോഭയുള്ള തെളിമയുള്ള ശുദ്ധമായ സ്പഷ്ട്ടമായ. ശുദ്ധമാക്കിയ.
निवृत्तीवेतना_विशींचें: പെന്‍ഷനിന്റെ
निव्वळ: സ്പഷ്ടമായ ശരിയായ
निशस्त्र: നിരായുധനായ
निशाणी__केल्ली: ഒപ്പുവെച്ച്ത്.
निशाणे_बगर: ഒപ്പു_കൂടാതെയുള്ള ഒപ്പു_വൈക്കാത്ത.
निशाणे_विरयत: ഒപ്പു_കൂടാതെയുള്ള ഒപ്പു_വൈക്കാത്ത.
निशुल्क: പണമില്ലാതെ.
निश्कपट: നിര്‍മ്മലമായ വിമലമായ പവിത്രമായ് ശുദ്ധമായ
निश्कपटी: സത്യസന്ധനായ നെറിയുള്ള വിശ്വസ്തനായ കാപഠ്യമില്ലാത്ത.
निश्चींत: ചിന്താഹീനനായ.
निश्चीत: അനിവാര്യമായ. വിധിപ്രകാരമുള്ള.
निश्टूर: ദ്രോഹിയായ കരുണയില്ലാത്ത ഉപദ്രവിക്കുന്ന
निश्ठाहीण: വിശ്വസ്തത_ഇല്ലാത്ത.
निश्पर्णी: ഇലകളില്ലാത്ത.
निश्पाप: നിര്‍മ്മലമായ വിമലമായ പവിത്രമായ് ശുദ്ധമായ നല്ല.
निश्प्राण: ജീവനില്ലാത്ത.
निसरटी_(निसट्टी): വഴുക്കലുള്ള.
निस्तेज: വിഷണ്ണതയുള്ള മ്ലാനമായ.
निस्वार्थी: സ്വാര്ഥഹീനനായ നിസ്വാര്ഥിയായ.
नीच: ബസാറിനോട്_ബന്ധപ്പെട്ട തരം_താണ്. നീചമായ ഹീനമായ.
नीच_कुळाचें: താഴ്ന്ന_കുലത്തിലേ.
नुतनीकरणी: ആധുനികവല്ക്കരണം.
नेटाचें: പ്രബലമായി. കൊടുംകാറ്റിനോടു_ബന്ധപ്പെട്ട.
नेटान: വേഗതയുള്ള ചുണയുള്ള തീക്ഷ്ണമായ.
नेणटें: വയസ്സില്ലാത്ത.
नेणार: സാമറ്ത്ഥ്യമില്ലാത്ത മിടുക്കില്ലാത്ത നൈപുണ്യമില്ലാത്ത കുശലതയില്ലാത്ത കാര്യക്ഷമയില്ലാതാത്ത വൈദ്ഗദ്ധ്യമില്ലാത്ത പ്രാഗ്ലഭ്യമില്ലാത്ത പ്രവീണ്യമില്ലാത്ത ചാതുര്യമില്ലാത്ത മികവില്ലാത്ത പാടവമില്ലാത്ത വിരിതില്ലാത്ത. അവിവേകി. അറിവില്ലാത്ത് അറിഞ്ഞുകൂടാത്ത.
नेत्याबगरचें: നാഥനില്ലാത്ത
नेत्रसुखी: നയനാഭിരാമാ‍മായ നയനരമ്യമായ നേത്രാഭിരമാമായ.
नेपाळी: നേപ്പാളിക്കാരി നേപ്പാളിയിലുള്‍ള്‍
नेम_पाळपी: നിയമം_പാലിക്കുന്ന സ്വയമേ_പാലിക്കുന്ന__അച്ചടക്കം.
नेमिल्लें: ജോലിക്ക്_വെച്ച നിയമിതനായ
नेमी: നിയമം_പാലിക്കുന്ന സ്വയമേ_പാലിക്കുന്ന__അച്ചടക്കം.
नैसर्गीक: സ്വാഭാവികമായ ഭൌതികമായ നൈസര്‍ഗ്ഗികമായ
नॉर्वेयी: നോര്‍വെയുടെ. നോര്‍വീജിയന്‍.
नोंदणी: രജിസ്റ്റര്‍_ചെയ്തത്.
नोंदीत: രജിസ്റ്റര്‍_ചെയ്തത്. ചുറ്റിക്കറങുന്ന അലഞ്ഞു_തിരിയുന്ന.
न्याय_करपी: ന്യായാധിപന്‍ ന്യായി ന്യായമുള്ള വിശ്വസ്ഥതയുള്ള നിഷ്പക്ഷനായ പക്ഷപാതമില്ലാത്ത.
न्यायकरतो: ന്യായാധിപന്‍ ന്യായി ന്യായമുള്ള വിശ്വസ്ഥതയുള്ള നിഷ്പക്ഷനായ പക്ഷപാതമില്ലാത്ത.
न्यायालयीन: ന്യായ_സൂചകമായ.
न्यायी: ന്യായാധിപന്‍ ന്യായി ന്യായമുള്ള വിശ്വസ്ഥതയുള്ള നിഷ്പക്ഷനായ പക്ഷപാതമില്ലാത്ത.
न्युझीलॅण्डी: ന്യൂസിലാന്റിയന് ന്യൂസിലാന്റിയ.
न्हयकार: നിഷേധാത്മകമായി.
न्हिदखुरें: ക്ഷീണിതനായ ക്ഷീണിച്ച തളറ്ന്ന മടുത്ത വാടിയ ചുണകെട്ട.
न्हिदनाशिल्लो: നിദ്രയില്ലാത്ത
न्हिदसुरें: ക്ഷീണിതനായ ക്ഷീണിച്ച തളറ്ന്ന മടുത്ത വാടിയ ചുണകെട്ട.
न्हिदिल्लें: നിദ്രാനിമഗ്നനായ_‍ ഉറങ്ങിയ.
न्हिदेभायरें: നിദ്രാവിഹീനന്‍
न्हीदमग्न: നിദ്രാനിമഗ്നനായ_‍ ഉറങ്ങിയ.
न्हेसनाशिल्लें: ഇട്ടിട്ടില്ലാത്ത
पंचकोनी: പഞ്ച_കോണം.
पंचतारंकीत: പഞ്ച_നക്ഷത്ര.
पंचवार्शीक: പഞ്ച_വത്സര അഞ്ചാം_വറ്ഷം_തോറും_ഉള്ള.
पंचावनावें: അന്പത്തി_അഞ്ചാമത്തെ
पंचेचाळिसावें: നാല്‍പ്പത്തി_അഞ്ഞ്ചാമത്തെ.
पंच्यांयश्यावें: അന്പതാമത്തെ
पंच्याण्णवावें: തൊണ്ണൂറ്റി_അഞ്ചാമത്തെ.
पंच्यात्तरावें: അന്പത്തി_അഞ്ചാം
पंजाबी: പഞ്ചാബി പഞ്ചാപിലെ
पंडीत: ബുദ്ധിമാന്‍ ധാരണാശക്‌തിയുള്ള വിവേകമുള്ള വിദ്വാന്‍മാരായിട്ടുളള പാണ്ഡിത്യമുള്ള അറിവുള്ള
पंदरा: പതിനഞ്ചാം പതിനഞ്ചാമത്തെ
पकदस्त: ഭാരിച്ച കനത്ത തൂക്കമുള്ള സ്വാധീനശ്ക്തിയുള്ള.
पक्को: യാഥാസ്തികനായ നിയന്മത്തില്‍_നിന്നും_അണുപോലും_വ്യതിചലിക്കാതത് നിര്‍ബ്ന്ധ_ബുദ്ധിയായ.
पक्षपाती: പക്ഷം_പിടിക്കുന്നവന്‍ സമര്‍ഥിക്കുന്നവന്‍.വാദിക്കുന്നവന്‍.
पक्षबदलू: കാലുമാറല്‍.
पगारी: ശംബളം_പറ്റി_ജോലി__ചെയ്യുന്ന.
पचकळ: വ്യര്ഥ_ഭാഷണം_ചെയ്യുന്ന.
पचनाशिल्लें: വേവാത്തത്.
पच्छतापी: പശ്ചാത്തപിക്കുന്നവന്‍
पच्छातापी: പശ്ചാതപിക്കുന്നവന്
पठारी: യുദ്ധക്കളത്തിന്റെ പോറ്ക്കളത്തിന്റെ.
पडकें: തകര്‍ത്ത നിലത്തു_വീണ.
पडमूर: നന്ദികെട്ട ഉപകാരസ്മരണയില്ലാത്ത.
पडिंग: ക്ര്‌ഷിയില്ലാത്ത ക്ര്‌ഷിപ്പണി_നടക്കാത്ത.
पडिल्लें: തകര്‍ത്ത നിലത്തു_വീണ. വിഷമിച്ച. കുറയുക. ശക്തിയായ_മഴ.
पड्डो: നേരിയ_പാഡ_പോലെയുള്ള_തൊലി.
पड्डो_नाशिल्लें: തിരശ്ശീല_ഇല്ലാത്ത ആവരണം_ഇല്ലാത്ത യവനിക_ഇല്ലാത്ത.
पड्ड्या_बगरचें: തിരശ്ശീല_ഇല്ലാത്ത ആവരണം_ഇല്ലാത്ത യവനിക_ഇല്ലാത്ത.
पथी: സംയമനം_പാലിക്കുന്ന
पदचारी: കാല്നടയായി.
पनवतीचो: താഴേക്കു_പോകുന്നവന്‍.
पयलींचें: ജീര്‍ണ്ണിച്ച.
पयलें: പ്രഥമ ഒന്നാമത്തെ ആദ്യത്തെ
पयशेकार: ധനികനായ പണക്കാരനായ
पयश्यांची: സാമ്പത്തിക_സ്ഥിതി.
पयस: അകലേയുള്ള ദൂരത്തുള്ള. എടുത്തു_കളയപ്പെട്ട രഹിതമായ ചതിക്കപ്പെട്ട വഞ്ചിക്കപ്പെട്ട.
पयसचें: ദൂരെയുള്ള അകലെയുള്ള.അപാറ്ണ്ണമായ വിപ്രക്ര്‌ഷ്ടമായ പര വിദൂരമായ ബഹുദൂരെയുള്ള.
पयसुल्लें: ദൂരെയുള്ള അകലെയുള്ള.അപാറ്ണ്ണമായ വിപ്രക്ര്‌ഷ്ടമായ പര വിദൂരമായ ബഹുദൂരെയുള്ള.
परक्याचें: മറ്രുള്ളവരുടെ അന്യരുടെ അന്യമായ വേറെ_ആയ വൈദേശികമായ വിദേശിയായ തറ്റേതല്ലാത്ത പുറമേയുള്ള മറ്രൊന്നായ മറ്രേതായ ഇതരമായ സ്വന്തമല്ലാത്ത അപര.
परजळपी: തേജസ്സാര്ന്ന തിളങുന്ന.
परजळीत: പ്രകാശപൂര്‍ണ്ണമായ പ്രകാശമാനമായ.
परजातीचें: വിഭിന്ന_ജാതിയിപ്പെട്ട.
परत_घेतिल्लो: പഴയസ്ഥിതിയില്‍_ത്തന്നെ
परत_दिल्लो: പഴയസ്ഥിതിയില്‍_ത്തന്നെ
परतिल्लें: മടക്കികൊണ്ടുവന്ന.
परतुपाचें: മടക്കയാത്രക്കുള്ള
परतें: വിപരീതമ്മയ്. വിപരീതം.
परतेचें: മടക്കയാത്രക്കുള്ള
परदेशी: വിദേശി അന്യദേശക്കാരന്‍ വൈദേശികന്‍ അന്യന്‍ അന്യദിക്കുകാരന്‍ കുടിയേറ്രക്കാരന്‍.
परपंरावादी: പാരമ്പര്യമായിട്ടുള്ള.
परमळहीण: മണമില്ലാത്ത.
परमळीत: സുഗന്ധമുള്ള. മണമുള്ള. വാസനയുള്ള
परवानगे_बगरचें: കല്പ്പിക്കപ്പെടാത്ത
परवानगे_भायरें: അനുവാദം_കൂടാതെ
पराग्वेयी: പരാഗ്വേയിലെ.
पराजीत: തോറ്റ
पराधीन: സ്വാതന്ത്ര്യമില്ലാത്ത അടിമയായ.
परावलंबी: പരാവലംബിനി പരാശ്രയതോടെ_ജീവിക്കുന്നവള്‍. ആശ്രയിക്കപ്പെട്ട.
परिचीत: അറിവുള്ള പേരു_കേട്ട.
परित्यागी: ഉപേക്ഷിക്കപ്പെടേണ്ടതായ ഉപേക്ഷിക്കത്തക്ക ചീത്തയായ വര്‍ജ്ജിക്കത്തക്കതായ.
परिपक्व: പ്രായോഗികന്ജ്ഞാനമുള്ള അനുഭവന്ജ്ഞാനം_ഉള്ള പരിചയസമ്പന്നത_ഉള്ള ഇടപഴക്കമുള്ള പ്രായോഗികജ്ഞാനം_ഉള്ള പഴുത്ത പാകംവന്ന
परिपूर्ण: പരിപൂര്ണ്ണന്.
परिमाणीत: അളക്കാവുന്ന
परिवर्तन: മാറ്റം_വരുത്തിയ മാറിയ.
परिवर्तनशील: മാറുന്ന.
परिवर्तीत: കൂട്ടിചേര്‍ത്ത
परिवारांतलें: കുടുംബപരമായ
परोपकारी: പരോപകാരി അന്യനു_നന്മ_ചെയ്യുന്നയാള്‍ അന്യനു_ഉപകാരം_ചെയ്യുന്നവന്‍ ഔദാര്യം_ചെയ്യുന്നയാള്‍ മഹാമനസ്ക്കനായ_ആള്‍.
पर्यायहीण: സന്ദേഹമില്ലാതെ ധാരണയോടെ ഉപായത്തോടെ നിശ്ചയത്തോടെ ധൈര്യത്തോടെ ഉറ്പ്പോടെ തീറ്ച്ചയോടെ.
पर्यायी: ഇച്ഛയനുസരിച്ചുള്ള തിരഞെടുക്കാനുള്ള ആഗ്രഹന്മനുസരിച്ചുള്ള തിതമനുസരിച്ചുള്ള അഭിലാഷം_അനുസരിച്ചുള്ള ഇച്ഛിത ഉദ്ദിഷ്ടമായ താ‍ത്പര്യമുള്ള തിതകരമായ.
पर्यावरणी: പരിസ്ഥിതി_സംബന്ധമായ പാരിസ്ഥിതികമായ.
पर्शियन: ഇറാനി പേര്‍ശ്യന്‍ ഇറാനിന്റെ
पळपी: അഭയാര്‍ത്ഥിയായി_ഓടിപോകുന്നവന്‍ ഭീരു.
पळपुटो: അഭയാര്‍ത്ഥിയായി_ഓടിപോകുന്നവന്‍ ഭീരു.
पळयिल्लें: അവലോകനം_ചെയ്യപ്പെട്ട. അപഹരിക്കാവുന്നത്. അറിയാവുന്ന.
पळून_गेल्लो: സൈന്യം_ഉപേക്ഷിച്ച.
पळोवंक_नाशिल्लें: നിരീക്ഷിക്കതക്കതല്ലാത്ത.
पळोवपा_सारकें: കാണാന്_കഴിയുന്ന. കാണാന്_കൊള്ളാത്ത.
पवित्र: പൂജിച്ച നിവേദിച്ച.
पसंतीचें: പ്രിയപെട്ട ഇഷ്ടപെട്ട
पसरिल्लें: സ്ഥാനത്തു_നിന്നു_നീക്കിയ സ്ഥലത്തു_നിന്നു_അകറ്റപ്പെട്ട. ചിതറിയ പരന്നു_കിടക്കുന്ന നുറുക്കുകളായ.
पांखां_बगरचें: ചിറകൊടിഞ്ഞ
पांगळो: അങ്ഗ_വൈകല്യമുള്ള.
पांच: അഞ്ച് 5
पांचकोनी: പഞ്ച_കോണം.
पांचवर्सुकी: പഞ്ച_വത്സര അഞ്ചാം_വറ്ഷം_തോറും_ഉള്ള.
पांचवें: അഞ്ചാമത്തെ അഞ്ചാം
पांय_ओडपी: അപകര്‍ഷതയുള്ള
पांसठावें: അറുപത്തി_അഞ്ചാം
पाखंडी: കപടമായ.
पाखाट्यांविरयत: ചിറകൊടിഞ്ഞ
पाचवें: പച്ചയായ സജീവമായ ഹരിതാഭമായ ചൈതന്യത്തോടെ.
पाचवेंचार: പച്ച_നിറഞ്ഞ സംര്‌ദ്ധമായ_. പച്ചയാര്‍ന്ന.
पाझरप: ദയ_നിറഞ്ഞ.
पाठ्य: വായിക്കുവാന്_പറ്റിയ
पाड: മുഷിഞ്ഞ ശുചിയല്ലാത്ത അഴുക്കായ മലിനപ്പെട്ട വൃത്തിഹീനമായ ഇന്ന ഇന്നതായ. മോശമായ
पाड_जाल्लें: ചീഞ്ഞഅഴുകിയ അളിഞ്ഞ ജീര്‍ണ്ണിച്ച
पाडे_बुद्धीचो: ദുഷ്ട്ടാത്മാവു.
पाडें: മുഷിഞ്ഞ ശുചിയല്ലാത്ത അഴുക്കായ മലിനപ്പെട്ട വൃത്തിഹീനമായ
पाडो: അവജ്ഞയുള്ള നിന്ദയുള്ള ജുഗുപ്സയുള്ള. ദുഷ്ട്ടാത്മാവു.
पाणाविल्लो: അശ്രു_പൂര്ണ്ണം.
पातयेवणें: വിശ്വസിക്കാവുന്ന വിശ്വസനീയമായ വിശ്വസ്തനായ വിശ്വസാമുള്ള വിശ്വസ്ത വിശ്വാസിയായ.
पातळ: ഇടതൂര്ന്നതല്ലാത്ത. മുറുക്കമില്ലാത്ത അയഞ്ഞ അഴിഞ്ഞ. നേര്‍മയുള്ള
पातळिल्लें: ചിതറിയ പരന്നു_കിടക്കുന്ന നുറുക്കുകളായ.
पात्र: അര്ഹതയുള്ള_വ്യക്തി.
पादिसेर: ഇല്ലായ്മ_പിടിപ്പെട്ട.
पानाळ: ഇലയുള്ള.
पापी: ദുഷ്ട്ടാത്മാവു.
पापूय_नाशिल्लो: പിതാവില്ലാത്ത താതന്‍_ഇല്ലാത്ത.
पारखणे_बगरचें: പരിശോധിക്കാത്ത അന്വേഷിക്കാത്ത പരീക്ഷിക്കാത്ത.
पारखुपी: അകലെ_കാണുന്ന വിവേകമുള്ള പണ്ഡിതാന്‍.
पारखूंक_नाशिल्लें: പരിശോധിക്കാത്ത അന്വേഷിക്കാത്ത പരീക്ഷിക്കാത്ത.
पारपांरीक: പരമ്പരാസിദ്ധമായ.
पाळिल्लें: വളര്‍ത്തപ്പെടുന്ന
पावयिल्लें: അടച്ചുതീര്ന്ന.
पावली_घालपी: നടക്കാന്തുടങ്ങിയ
पावली_मारपी: നടക്കാന്തുടങ്ങിയ
पाशाणी: കല്ലു_കൊണ്ടുണ്ടാക്കിയ.
पास: വിജയിച്ച ജയിച്ച്ച സഫലമായ. പാസ്സാകുക.
पिकसावं: ചിന്തയോടു_കൂടിയ ഉത്കണ്ഠയുള്ള ചിന്താകുലനായ.
पिकाळ: ഉല്പാദനക്ഷമമായ ഫലഭൂയിഷ്ഠമായ സംരിദ്ധമായ സമ്പന്നമായ.
पिकिल्लें: പഴുത്ത പാകംവന്ന
पिकें: പഴുത്ത പാകംവന്ന
पिडिल्लो: പീടിപ്പിക്കപ്പെട്ട.
पिडेस्त: രോഗി രോഗാതുരന്‍ രോഗബാധിതന്‍ ദു
पितळेचें: പിച്ചള_കൊണ്ടുള്ള.
पितारिल्लें: ചിത്രീകരിച്ച ചിത്രീകരിക്കപ്പെട്ട ചിത്രം_വരച്ച ചിത്രിതമായ.
पितारीत: ചിത്രീകരിച്ച ചിത്രീകരിക്കപ്പെട്ട ചിത്രം_വരച്ച ചിത്രിതമായ.
पितूळचें: പിച്ചള_കൊണ്ടുള്ള.
पितृहीण: പിതാവില്ലാത്ത താതന്‍_ഇല്ലാത്ത.
पित्ताचें: പിത്ത_സംബന്ധി_ആയ.
पियेनासपाचें: കുടിക്കുവാന്‍_കൊള്ളാത്ത. കുടിക്കുവാന്‍_പറ്റാത്ത.
पिळिल्लें: നന്നായി_പിഴിഞ്ഞ.
पिशें: വീതി
पिसांट: അവിവേകിയായ ജളനായ ഭോഷനായ മൂഢനായ മന്ദതയുള്ള ജളത്വമുള്ള
पुंवाळ: പഴുത്ത്_ചീഞ്ഞ.
पुनरावृत्तीचें: പെന്‍ഷനിന്റെ
पुनरुक्त: ആവര്‍ത്തനം വീണ്ടുമുള്‍ള_പറച്ചില്‍.
पुनर्नियुक्ती: പഴയസ്ഥിതിയില്‍_ത്തന്നെ
पुरवणीत: അനുബന്ധം
पुराय: ദ്ര്ഢമായ പാകമായ. ആകെ മുഴുവനും ഒട്ടാകെ ആകപ്പാടെ പൂര്‍ണ്ണമായ
पुरो: തികയുന്നത്.
पुरो_जाल्लें: ക്ഷീണിച്ച.
पुर्णायू: പൂര്‍ണ്ണ്_ആയുസ്സുള്ള.
पुर्तगाली: പോര്‍ത്തുഗലിന്റെ.
पुर्तुगेझ: പോര്‍തുഗലിന്റെ.
पुर्विल्लें: പഴയ പുരാതനമായ. പുരാതനം പണ്ടേയുള്ള പൂര്‍വ്വ_കാലത്തെ
पुश्टीक: പുഷ്ടികരമായ
पुसट: അസ്പഷ്ട്ടമായ. മങ്ങലുള്ള വ്യ്ക്‌തമല്ലാത്ത അസ്പഷ്ടമായ അവ്യക്‌തമായ
पुस्तकी: പുസ്തകത്തിലെ.
पूर्ण: ആകെ മുഴുവനും ഒട്ടാകെ ആകപ്പാടെ
पूर्णप्रभावीत: ഊടും_പാവും_പോലെ_കോര്ക്കപ്പെട്ട.
पूर्वकथित: മുന്‍പ്_ഉച്ചരിച്ച
पृश्ठ: കഴിഞ്ഞ താമസിച്ച പിന്നിലത്തെ.
पृश्ठांकीत: ഒപ്പിട്ടത്
पेज: വ്യര്ഥ_ഭാഷണം_ചെയ്യുന്ന.
पेजाद: സുദ്ര്‌ഢമായ കൂടുതല്‍_ശക്തിയുള്ള ദ്ര്‌ഢതയുള്ള ബലമുള്ള ഉറപ്പുള്ള സുസ്ഥാപിതമായ കനത്ത കഠിനമായ കരുത്തുള്ള ഗാഢമായ.
पेझाद: ശക്തിയുള്ള ബലമുള്ള ദ്രിഢമായ വളരെ_വലിയ ബ്ര്ഹത്തായ.‌
पेय: കുടിക്കുവാനുള്ള.
पेयहीण: കുടിക്കുവാന്‍_കൊള്ളാത്ത.
पेरणेचें: വിതയ്ക്കാവുന്ന വിതയ്ക്കാന്_പറ്റിയ നടാവുന്ന പാകവുന്ന.
पेरपी: വിതയ്ക്കുന്ന വിത്തു_പാകുന്ന വിത്തു_നടുന്ന.
पेरिल्लें: വിതച്ച വിതയ്ക്കപ്പെട്ട വിത്തു_പാകിയ വിത്തു_നട്ട
पेरूंक_नाशिल्लें: വിതക്കാത്ത
पेशीपुंजुल्याचें: ശരീര_കോശത്തിന്റെ.
पॉलिशा_बगरचें: ശരിയായ_രൂപമില്ലാത്ത രൂപപെടുത്ത ആക്ര്‌തിയില്ലാത്ത വടിവില്ലാത്ത.
पोंदलें: താഴെയുള്ള അടിയിലുള്ള കീഴെയുള്ള.
पोकळ: പൊള്ളയായ ശൂന്യമായ
पोको: പൊള്ളയായ ശൂന്യമായ
पोजडें: അശ്ലീലം.
पोटभर: വയറ്_നിറയേ.
पोटयो: അധികം_ഭക്ഷിക്കുന്ന വേഗം_വേഗം_ഭക്ഷിക്കുന്ന ഭക്ഷണപ്രിയനായ വയറനായ കൊതിയനായ.
पोटसरें: ഇഴയുന്ന പതുക്കെ_നടക്കുന്ന.
पोरणें: ജീര്‍ണ്ണിച്ച. പഴയ പുരാതനമായ. പുരാതനം പണ്ടേയുള്ള പൂര്‍വ്വ_കാലത്തെ കഴിഞ്ഞുപോയ.
पोल: പൊള്ളയായ ശൂന്യമായ
पोलिशी: പോളണ്ടിനെ_സംബന്ധിക്കുന്നത്. പോളിഷ്
पोलो: പൊള്ളയായ ശൂന്യമായ
पोशिल्लें: വളര്‍ത്തപ്പെടുന്ന
पोशेगवाली: വസ്ത്രധാരി
प्रक्षेपक: വലിച്ചെറിയുന്നവന്
प्रक्षेपीत: വിക്ഷേപിച്ച
प्रखर: സൂക്ഷ്മ_ഗ്രാഹിത്വം.
प्रगट: വ്യക്തമാക്കപ്പെട്ട സ്പഷ്ട്ടമായ.
प्रगतिशील: വികസിതമായ.
प्रगती_केल्लो: പുരോഗതിയുള്ള ഉയര്‍ച്ചയുള്ള ഉന്നതിയുള്ള.
प्रगतीकर्तो: പുരോഗമന_വാദി.
प्रचलीत: നടത്തപ്പെടുന്ന പ്രവര്‍ത്തിക്കപ്പെറ്ടുന്ന.
प्रचारीत: പ്രചരിക്കപ്പെട്ട പ്രചരിച്ച വ്യാപിച്ച പ്രസിദ്ദമാക്കിയ പരസ്യമാക്കിയ കൊട്ടിഘോഷിച്ച വിളംബരം_ചെയ്ത അവഘോഷിച്ച.
प्रतिकारी: പ്രതികാരം_ചെയ്യുന്ന.
प्रतिगामी: പിന്തിരിപ്പന്‍.
प्रतिपादीत: പ്രതിപാതിച്ചിട്ടുള്ളത് പ്രതിപാദിച്ചിട്ടുള്ള വിവരിച്ചിട്ടുള്ള പ്രസ്താവിച്ചിട്ടുള്ള സ്ഥാപിച്ചിട്ടുള്ള വിസ്തരിച്ചിട്ടുള്ള വിശകലനം_ചെയ്തിട്ടുള്ള.
प्रतिभावान: പ്രതിഭാശാലി കഴിവുള്ള ബുദ്ധിയുള്ള.
प्रतिभाशाली: പ്രതിഭാശാലി കഴിവുള്ള ബുദ്ധിയുള്ള.
प्रतिरुपी: ത്ത്സ്വരൂപമായ പ്ര്തിരൂപമായ പകറ്പ്പായ സാദ്ര്ശ്മായ പ്തിച്ഛായയുള്ള്.‌
प्रतिश्ठीत: ബഹുമാനിക്കപ്പെട്ട ആദരിക്കപ്പെട്ട.
प्रत्यक्ष: ഇന്ദ്രിയങള്‍ക്ക്_വിഷയമാകത്തക്ക.
प्रथम: പ്രഥമ ഒന്നാമത്തെ ആദ്യത്തെ
प्रदर्शनी: പ്രദറ്ശനീയമായ പ്രദറ്ശിപ്പിക്കാന്‍_യോഗ്യ്മാ‍യ പരസ്യപ്പെടുത്താന്‍_യോഗ്യ്മായ.
प्रदुशीत: മലിനീകരിച്ചത്.
प्रधान: പ്രധാന മുഖ്യ.
प्रभावशुन्य: അസമറ്ത്ഥനായ നിഷ്ഫലനായ അപ്രാപ്ത്നായ.
प्रभावहीण: അസമറ്ത്ഥനായ നിഷ്ഫലനായ അപ്രാപ്ത്നായ. നിഷ്ഫലമായ ഫലശ്യൂന്യമായ നിഷ്പ്രയോജനമായ വ്യ്ര്ത്ഥ്മായ.
प्रमाणीक_वेव्हारी: സന്മാര്ഗ്ഗപൂര്ണ്ണമായ_പെരുമാറ്റമുള്ള്.
प्रमाणीत: തെളിയിക്കപ്പെട്ട വ്യക്തമാക്കപ്പെട്ട പ്രകാശിപ്പിച്ച.
प्रमाणें: യോജിക്കുന്ന അനുകൂലമായ ചേര്‍ച്ചയുള്ള പൊരുത്തമുള്ള ഐക്യമുള്ള കൂടികലരുന്ന സംയോജിക്കുന്ന. തുല്യമായ സമമായ സമാനമായ
प्रमेयी: യഥാറ്ത്ഥ_ജ്ഞാനം_അനുസരിച്ചുള്ള ശാസ്ത്രം_അനുസരിച്ചുള്ള തെളിയിച്ചിട്ടുള്ള. തെളിയിക്കേണ്ട സ്ഥാപിക്കേണ്ട.
प्रयत्नशील: പരിശ്രമിക്കുന്ന പ്രയത്നിക്കുന്ന.
प्रयोजनार्थी: ഉദ്ദേശയം_.
प्रवेशाचें: പ്രവേശനം കടക്കല്‍.
प्रवेशीत: പ്രവേശിച്ച ഏര്പ്പെട്ട.
प्रशंसक: പ്രശംസകന്.
प्रशिक्षीत: ശിക്ഷണം_ചെയ്യപ്പെട്ട.
प्रश्नसुचक: ചോദ്യത്തിന്റെ ചോദ്യത്തിന്റെ_ധ്വനിയുള്ള.
प्रश्नार्थी: ചോദ്യത്തിന്റെ ചോദ്യത്തിന്റെ_ധ്വനിയുള്ള.
प्रसन्न: ആനന്ദം_നിറഞ്ഞ സന്തോഷം_പ്രകടിപ്പിക്കുന്ന.
प्रसन्नचित्त: വിനോദപ്രിയനായ ആനന്ദം_പൂണ്ടവന്‍
प्रसन्नमूख: ചിരിച്ച_മുഖം.
प्रसिद्ध: പ്രസിദ്ധയായ കേള്‍വിപ്പെട്ട പേരുകേട്ട യശസ്വിയായ പ്രഖ്യാതമായ അറിയപ്പെട്ട വിഖ്യാതിയായ
प्रस्तुतीकरणाचें: അവതരണയോഗ്യമായത്.
प्रस्न_विचारपी: ചോദ്യം_ചെയ്യുന്ന ഉത്തരം_അന്വേഷിക്കുന്ന.
प्राकृतीक: സ്വാഭാവികമായ ഭൌതികമായ നൈസര്‍ഗ്ഗികമായ
प्राचीन: പഴയ പുരാതനമായ.
प्राणघातक: ജീവനൊടുക്കുന്ന.
प्राथमीक: മുമ്പുള്ള പ്രാരംഭികമായ ആദ്യമായ.
प्राप्त: കിട്ടിയ നേടിയ.
प्राप्त_करपी: ലഭിക്കുന്നവന്‍.
प्राप्त_केल्लें: ലഭിച്ച നേടിയ സ്വീകരിക്കപ്പെട്ട.
प्राप्य: നേടിയെടുക്കേണ്ട നേടേണ്ട ലഭിക്കേണ്ട കിട്ടേണ്ട കൈവരേണ്ട.
प्रामाणीक: വിശ്വസിക്കാവുന്ന വിശ്വസനീയമായ വിശ്വസ്തനായ വിശ്വസാമുള്ള വിശ്വസ്ത വിശ്വാസിയായ. സത്യാവസ്ഥയിലുള്ള് യാഥാര്‍ത്ഥ്യപൂര്‍ണ്ണമായ. സത്യസന്ധനായ നെറിയുള്ള വിശ്വസ്തനായ നിക്രിഷ്ഠമല്ലാത്ത ദുഷ്ട്ടനല്ലാത്ത
प्रायोजीत: പ്രയോചകര്
प्रारब्दवादी: എല്ലാം_ഭാഗ്യത്തിനധീനമെന്നു_വിശ്വസിക്കുന്ന.
प्रीयभाशी: ഇഷ്ട്ടം_സംസാരിക്കുന്ന പ്രിയം_വദമായി_സംസാരിക്കുന്ന.
प्रेमासक्त: പ്രേമാസക്തനായ.
प्रेमी: പ്രിയപ്പെട്ട പ്രിയം_ചെയ്യുന്ന ഇഷ്ടമുള്ള അഭിമതമായ പ്രീതികരമായ.
प्रेरणा_दिवपी: പ്രേരണാദായകം പ്രേരണാത്മകത പ്രേരണാസ്വാദ്യകത ഉത്സാഹിപ്പിക്കിക പ്രവര്‍ത്തിക്കാനായി_പറഞു_വിടുക .
प्रेरणादायक: പ്രേരണാദായകം പ്രേരണാത്മകത പ്രേരണാസ്വാദ്യകത ഉത്സാഹിപ്പിക്കിക പ്രവര്‍ത്തിക്കാനായി_പറഞു_വിടുക .
प्रेरणास्पद: പ്രേരണാദായകം പ്രേരണാത്മകത പ്രേരണാസ്വാദ്യകത ഉത്സാഹിപ്പിക്കിക പ്രവര്‍ത്തിക്കാനായി_പറഞു_വിടുക .
प्रेरीत: ഉത്പ്രേരിതമായ
प्रोत्साहीत: ഉത്പ്രേരിതമായ
फकत: മാത്രം ഒറ്റയ്ക്ക് പൂര്ണ്ണമായ.
फकांडीं: തമാശക്കാരന്‍.
फकिरी: ഇല്ലായ്മ_പിടിപ്പെട്ട.
फटकिरें: നുണയന്‍ അസത്യം_പറയുന്നവന്‍ അസത്യം_പറയുന്നവന്‍ എതിര്‍_വാദം_ചെയ്യുന്നയാള്‍ കള്ളം_പറയുന്നയാള്‍. നുണ കള്ളം അസത്യം
फटकिरो: ക്രിത്രിമമായ_രേഖയുണ്ടക്കുന്ന വ്യാജമായ_രേഖയുണ്ടാക്കുന്ന തെറ്റായ_രേഖയുണ്ടാക്കുന്ന.
फटकीरपणाचें: നുണ കള്ളം അസത്യം
फटिंग: തെറ്റായ_കുറ്റാരോപണം അപകീര്‍ത്തിപ്പെടുത്തല്‍.
फटींग: നുണയന്‍ അസത്യം_പറയുന്നവന്‍ അസത്യം_പറയുന്നവന്‍ എതിര്‍_വാദം_ചെയ്യുന്നയാള്‍ കള്ളം_പറയുന്നയാള്‍. ആശ്രയമില്ലാത്ത അടിസ്ഥാനമില്ലാത്ത. ചതിയനായ വഞ്ചകനായ. അപരിഷ്കൃതമായ മാന്യമല്ലാത്ത സംസ്കാരമില്ലാത്ത_പ്രാകൃതപ്പെരുമാറ്റമുള്ള തെമ്മാടി പോക്കിരി താന്തോന്നി ആഭാസന്‍ നെറികെട്ടവന്‍ ക്രിത്രിമമായ_രേഖയുണ്ടക്കുന്ന വ്യാജമായ_രേഖയുണ്ടാക്കുന്ന തെറ്റായ_രേഖയുണ്ടാക്കുന്ന.
फटीचें: നുണ കള്ളം അസത്യം സങ്കല്പ_സ്ര്‌ഷ്ടിയായ.
फटोवणेचें: അപഹരിക്കപ്പെട്ട.
फडफडीत: പുതിയ പുത്തന്‍ പുതിയ പുത്തനായ പുതിയ പുതുമ_നിറഞ്ഞ നവമായ ആധുനികമായ പുതുതായ അഭിനവ പുതുമയുള്ള.
फरारी: ഓടിപ്പോയ പിടി_കൊടുക്കാതെരക്ഷപ്പെട്ട്_ഒളിച്ചു_നടക്കുന്ന.
फळां_नाशिल्ले: ഫലഹീനമായത്.
फळादीक: സഫലമായ വിജയകരമായ.
फांकिल्लें: ചിതറിയ പരന്നു_കിടക്കുന്ന നുറുക്കുകളായ.
फांटो: ശാഖകളുള്ള.
फांफार्रांव: നിയന്ത്രണമില്ലാത്ത തോന്ന്യാസമുള്ള ധിക്കാരപരമായ.
फाकिवंत: പ്രസിദ്ധയായ കേള്‍വിപ്പെട്ട പേരുകേട്ട യശസ്വിയായ പ്രഖ്യാതമായ അറിയപ്പെട്ട വിഖ്യാതിയായ
फाटलें: കഴിഞ്ഞ താമസിച്ച പിന്നിലത്തെ.
फाटल्या: കഴിഞ്ഞുപോയ.
फाटल्यान_सरकिल्लें: വഴുതി_മാറിയ
फाटी_उरिल्लें: നല്ല_സ്വഭാവമുള്ള.
फाटी_पडिल्लें: നല്ല_സ്വഭാവമുള്ള.
फाटीं_उरिल्लो: പിന്നോക്കം_നില്‍ക്കുന്ന.
फाटीं_सरनासपी: പിന്നിലേക്ക്_മാറാത്ത പിന്വലിയാത്ത ഉത്സാഹം_ഉള്ള. പിന്നിലേക്ക്_മാറാത്ത പിന്വലിയാത്ത ഉത്സാഹം_ഉള്ള.
फाटीकणो_मोडिल्लें: പൊട്ടിയ_മുതുകെല്ല്.
फाटीचें: ക്രിത്രിമമായ.
फातरा_काळजाचो: കഠിനഹ്രിദയനായ കഠോരഹ്രിദയനായ ദയ_ഇല്ലാത്ത.
फातरांचो: കല്ലു_നിറഞ്ഞ.
फातराळो: കല്ലു_നിറഞ്ഞ.
फाफशिल्लें: ചിതറിയ പരന്നു_കിടക്കുന്ന നുറുക്കുകളായ.
फाम: കേട്ടു_കേള്‍വി.
फामाद: പ്രസിദ്ധയായ കേള്‍വിപ്പെട്ട പേരുകേട്ട യശസ്വിയായ പ്രഖ്യാതമായ അറിയപ്പെട്ട വിഖ്യാതിയായ സുപ്രസിദ്ധ്നായ
फायद्याचें: ലാഭദായകം ഗുണകരം ഉപയോഗപ്രദം.
फायस्टार: പഞ്ച_നക്ഷത്ര.
फारायल्लें: അപഹരിക്കപ്പെട്ട്.
फारायिल्लें: അപഹരിക്കാവുന്നത്.
फारावपी: തട്ടിപ്പറിക്കുന്ന.
फाराविल्लो: ഒടക്കിയ.
फारीक_करिनासपा_सारकें: വീട്ടാന്_പറ്റാത്തത്.
फारीक_करूंक_नाशिल्लें: പൂറ്ത്തിയാക്കാത്ത അനുഭവൈക്കപ്പെടാത്ത തീരാത്ത.
फारीक_करून_घेतिल्लें: പൂറ്ത്തിയാക്കപെട്ട തീറ്ന്ന അനുഭവിക്കപ്പെട്ട.
फारीक_केल्लें: അടച്ചുതീര്ന്ന.
फारीक_ना_करी_सारकें: വീട്ടാന്_പറ്റാത്തത്.
फालतू: അസംബന്ധം. ഉപയോഗശൂന്യ്മായ. ബസാറിനോട്_ബന്ധപ്പെട്ട തരം_താണ്. അനാവശ്യമായ.
फाळदीक: സാറ്ത്ഥകമായ ഉപയോഗമുള്ള ഫലമുള്ള ഗുണമുള്ള ഉപയുക്തിയുള്ള പ്രയോജനമുള്ള ഉപകാരമുള്ള.
फावोशें: യോജിക്കുന്ന അനുകൂലമായ ചേര്‍ച്ചയുള്ള പൊരുത്തമുള്ള ഐക്യമുള്ള കൂടികലരുന്ന സംയോജിക്കുന്ന. യുക്തമായ ഉചിതമായ ഒത്ത തക്ക അനുകൂലമായ മനുഷ്യോചിതമായ.
फिटफिटें: ലോലമായ സുകുമാരമായ കോമളമായ
फिन: ബുദ്ധിമാന്‍ ധാരണാശക്‌തിയുള്ള വിവേകമുള്ള
फिनलॅण्डी: ഫിന്‍ലൈംടിലെ ഫിന്‍ലൈംടിയുടെ
फिलिपियन: ഫിലിപ്പീന്സിന്റെ
फिल्मी: സിനിമ
फिशाल: യോഗ്യനായ കാര്യശേഷിയുള്ള നിപുണനായ സമര്ത്ഥനായ ശക്തനായ വിദഗ്ദ്ധനായ ചുണയുള്ള ചെയ്തുതഴക്കമുള്ള ചതുരനായ ചുറുചുറുക്കുള്ള ജ്ഞാനമുള്ള കെല്‍പ്പുള്ള പാടവമുള്ള കൌശലമുള്ള കഴിവുള്ള ബുദ്ധിമാന്‍ ധാരണാശക്‌തിയുള്ള വിവേകമുള്ള
फीट: ഫിറ്റ്
फुकट: പണമില്ലാതെ.
फुक्याचें_खावपी: പണിയെടുക്കാതെ_ജീവിക്കുന്ന.
फुटीर: ഐക്യം ഐഖ്യമത്യം അഖണ്ഡത ഏകത ഏകചിത്തത രജ്ഞിപ്പ് ഏകോപനം ഒരുമിപ്പ് ഏകമനസ്സ് ഏകീകരണം പൊരുത്തം ഇണക്കം ഏകീഭാവം സഹകരണം സ്വരുമ സ്വരുമിപ്പ്.
फुटें: രുചിയില്ലാത്ത.
फुडलो: ആദ്യത്തെ. മുന്പേ_നടക്കുന്ന മുന്പനായ ശ്രേഷ്ഠനായ.
फुडल्या: വരാന്_പോകുന്ന ഭാവിയിലുള്ള വരാനിരിക്കുന്ന.
फुडाराचें: വരാന്‍_പോകുന്ന ഭാവികാലത്തെ_സംബന്ധിച്ച.
फुडारी_नाशिल्लें: നാഥനില്ലാത്ത
फुडारीहीण: നാഥനില്ലാത്ത
फुलां_बगरचें: പുഷ്പങളില്ലാത്ത പൂക്കാത്ത പൂക്കലില്ലാത്ത പുഷ്പ്പിക്കാത്ത.
फुलांचें: പൂവു_കാരണം_പ്രസിദ്ധമായിരിക്കുന്ന_ചെടി. ചിത്രത്തയ്യലുകള്ളുള്ള പൂക്കളുള്ള.
फुलांनी_भरिल्लें: വിടര്‍ന്ന വികസിച്ച.
फुलिल्लें: പൂക്കുന്ന പുഷ്പ്പിക്കുന്ന. പൂക്കളുള്ള പൂവുകളുള്ള.
फुलूंक_नाशिल्लें: വിടരാത്ത.
फॅल: തോറ്റുപോയ തോറ്റ പരാജയപ്പെട്ട വിഫലമായ അപജയപ്പെട്ട.
फेडिनासपा_सारकें: വീട്ടാന്_പറ്റാത്തത്.
फोर्त: ഉറപ്പുള്ള ബലമുള്ള നല്ല.
फोलगी: ധൂര്ത്തടിക്കുന്നവന്.
फोल्गी: നന്നായി_ചിലവു_ചെയ്യുന്ന ദുര്‍വ്യയം_ചെയ്യുന്ന. സ്ത്രീ_ലംബടനായ വിലാസപ്രിയനായ ഭോഗപ്രിയനായ.
फौजदारी: സേനാനായകന്റെ_സ്ഥാനം.
फ्रान्सी: ഫ്രെഞ്ച്
फ्रेंच: ഫ്രെഞ്ച് ഫ്രെഞ്ച്
फ्रेन्च: ഫ്രെഞ്ച് ഫ്രെഞ്ച്
बंगळुरी: ബംഗളൂരിന്റെ.
बंगाली: ബംഗാളി ബംഗാളി
बंद: അടഞ്ഞുപ്പോയ
बंदखणीचे: പോലീസിന്റെ_കീഴിലുള്ള.
बंदनमुक्त: തടയപ്പെടാത്ത
बंदनहीण: തടയപ്പെടാത്ത
बंदना_बगरचो: തടയപ്പെടാത്ത
बंदिस्त: ബന്ദി_ആക്കപ്പെട്ട.
बंदो: മുഖസ്തുതിക്കാരന്‍ വ്യാജ_പ്രശംസക്കാരന്‍
बकासूर: അധികം_ഭക്ഷിക്കുന്ന വേഗം_വേഗം_ഭക്ഷിക്കുന്ന ഭക്ഷണപ്രിയനായ വയറനായ കൊതിയനായ.
बकें: മെലിഞ്ഞ എല്ലും_തോലാകുക.
बचत_केल्लें: ഗ്രഹിക്കപ്പെട്ട
बडबडे: വചാലന്‍ അതി_ഭാഷി.
बडबडें: വ്ര്ധാഭാഷണം നിരര്‍ദധകഭാഷണം്‌ അധികം_സംസാരിക്കുന്ന.
बडबडेचें: അസംബന്ധം.
बडबडो: വ്യര്ഥ_ഭാഷണം_ചെയ്യുന്ന. മുഖസ്തുതി_പറയുന്ന വ്യാജപ്രശംസ_പറയുന്ന.
बडीचें: പിന്തുടര്‍ച്ചയായി_ലഭിച്ച.
बदनामिकारक: നിന്ദാത്മകമായ
बदल: മാറ്റം_വരുത്തിയ മാറിയ.
बदलनासपी: മാറില്ലാത്ത മാറ്റംവരാത്ത.
बदलपी: മാറുന്ന.
बदिस्त: ബന്ധിക്കപ്പെട്ട.
बद्‍दल: സംബന്ധമായ സംബന്ധിക്കുന്ന.
बनावट: പ്രകടനപരമായ കപടമായ ക്രിത്രിമമായ. പ്രകടനപരമായ കപടമായ ക്ര്‌ത്രിമമായ. സങ്കല്പ_സ്ര്‌ഷ്ടിയായ.
बरमुडायी: ബറ്മൂഡിയന്‍.
बरयल्लो: എഴുതിയ..
बरयिल्लें: ലേഖകന്‍_എഴുതിയ.
बरी: ഉത്തമമായ. ഭാരിച്ച.
बरुंडी: ബുറുണ്ടീയ.
बरें: നല്ല നന്മയുള്ള വലിയ ഉത്തമമായ ഗുണമുള്ള മെച്ചപ്പെട്ട വൈശിഷ്ട്യമുള്ള സദ്ഗുണമുള്ള ഗുണകരമായ ശുദ്ധമായ ഉതകുന്ന കൊള്ളാവുന്ന. സഭ്യമായത്. ചികിത്സിക്കാവുന്നത്. സ്വാദിഷ്ട്ടമായ.
बरें_जायना__अशें: അസാദ്ധ്യമായത്.
बरो: സജ്ജനം കുലീനനായ മാന്യനായ മര്യാദയുള്ള. കുറേ_കൂടി_ഭേദമായ കൂടുതല്_മെച്ചപ്പെട്ടതായ. നല്ല.
बर्फा_भशेनचें: മഞ്ഞുപോലെയുള്ള.
बर्फाळ: ഐസ്സുള്ള. മഞ്ഞുമൂടിയ.
बर्मी: ബ്ര്‍മ്മക്കാരെ മ്യാന്മര്‍കാരെ ബ്ര്‍മ്മയുടെ മ്യാന്മറിന്റെ ബ്ര്‍മ്മ_ഭാഷ മ്യാന്മര്‍_ഭാഷ
बल्गेरी: ബുള്ഗേരിയയുടെ
बल्ल: തടിച്ച സ്ഥുലശരീരിയായ
बळकट: ദൃഢതയുള്ള ഉറപ്പുള്ള
बळादीक: ശക്തിയുള്ള ബലമുള്ള ദ്രിഢമായ
बळिश्ट: ശക്തിയുള്ള ബലമുള്ള ദ്രിഢമായ ഉറപ്പുള്ള ബലമുള്ള ദൃഢതയുള്ള ഉറപ്പുള്ള
बहरेनी: ബഹറിന്‍.
बहिर्दृश्टी: ബാഹ്യ_വിഷയങളില്‍_കുടുങിയ.
बहिर्मूख: ബാഹ്യ_വിഷയങളില്‍_കുടുങിയ.
बहिश्कृत: ബഹിഷ്ക്കരിക്കപ്പെട്ട. ബഹിഷ്ക്കരിക്കപ്പെട്ട.
बहुचर्चीत: വളരെ_ചറ്ച്ചചെയ്യപ്പെട്ട വളരെ_വിചിന്തനം_ചെയ്യപ്പെട്ട.
बांगलादेशी: ബംഗ്ലാദേശിലുള്ള ബംഗ്ലാദേശിയന്‍.
बांदिल्लें: രചിക്കപ്പെട്ട എഴുതപ്പെട്ട.
बाकी: മിച്ചം_വന്ന മിച്ചം_നില്‍ക്കുന്ന.
बागवल्लें: കുനിയിക്കപ്പെട്ടവന്‍.
बागविल्लें: മുന്നോട്ടു_കുനിഞ്ഞ.
बाजारांतलें: ബസാറിനോട്_ബന്ധപ്പെട്ട തരം_താണ അസഭ്യമായ.
बाजाराचें: ബസാറിനോട്_ബന്ധപ്പെട്ട തരം_താണ അസഭ്യമായ.
बाजारी: ബസാറിനോട്_ബന്ധപ്പെട്ട തരം_താണ അസഭ്യമായ.
बाद: പണിയെടുക്കാത്ത. ഇന്ന ഇന്നതായ.
बाधक: ഇന്സുലേറ്റര് തടയ്ല്.
बापोल: അച്ഛന്റെ_ഇളയ_സഹോദരനെ_സംബന്ധിക്കുന്ന.
बापोलयो: അച്ഛന്റെ_അനിയനെ_സംബന്ധിക്കുന്ന.
बायजणपणाचें: സ്ത്രീക്കു_ചേര്ന്നതായ.
बायलाडें: സ്ത്രീക്കു_ചേര്ന്നതായ.
बायलेचे: സ്ത്രീക്കു_ചേര്ന്നതായ.
बारामाही: നിത്യഹരിതം പന്ത്രണ്ടു_മാസം_മുഴുവനും_നീണ്ടു_നില്ലക്കുന്ന.
बारावें: പന്ത്ര്ണ്ടാമത്തെ പന്ത്രണ്ടാം
बारीक: മെലിഞ്ഞ എല്ലും_തോലാകുക. സൂക്ഷ്മമായ. ചെറിയ ചെറിയ.
बारीक-बारीक: ചെറിയ_ചെറിയ.
बारीक-सारीक: അല്ലറ_ചില്ലറ
बारीक_सारीक: ചെറിയതും_വലിയതഉമായ.
बारीकसाणेचो.: പിശുക്കനായ ക്ര്പണനായ.‌
बालपण: കുട്ടികള്ക്ക്_ചേര്ന്ന
बालोपयोगी: കുട്ടികള്ക്ക്_ഉപയോഗമുള്ള_.
बाळक: ഇപ്പോള്‍_ജനിച്ച.
बावगल्लें: മുന്നോട്ടു_കുനിഞ്ഞ.
बावन: അന്പത്തി_രണ്ട്.
बावनावें: അന്പത്തി_രണ്ടാം
बाविल्लें: തേജസ്സില്ലാത്ത ചുണയില്ലാത്ത ശോഭയില്ലാത്ത. വിഷണ്ണതയുള്ള മ്ലാനമായ. വിഷമിച്ച.
बावीस: ഇരുപത്തി_രണ്ട്.
बावीसावें: ഇരുപത്തി_രണ്ടാമത്തെ.
बाशें: പഴകിയ
बाश्पीत: വാറ്റിയ
बासठ: അറുപത്തി_രണ്ട്.
बासठावें: അറുപത്തിമൂന്നാം
बाह्य: ബാഹ്യമായ പുറമേയുള്ള.
बिंधास्त: ഉന്മാദമുള്ള ഭ്രാന്തുള്ള ഉന്മത്തനായ കിറുക്കുള്ള വട്ടുള്ള.
बिकट: വിപരീതമായ പ്രതികൂലമായ.
बिगरनिवासी: കുടിയേറി_പാര്ക്കുന്നവന്.
बिनकांटयारें: മുള്ളില്ലാത്ത.
बिनपांयाचो: പാദങ്ങളില്ലാത്ത
बिनराखीव: സംവരണം_ചെയ്തിറ്ട്ടില്ലാത്ത.
बियांचें: വിത്തുള്ള ധാന്യമുള്ള കായുള്ള ബീജമുള്ള.
बियाळ: വിത്തുള്ള ധാന്യമുള്ള കായുള്ള ബീജമുള്ള.
बिहारी: ബീഹാറിലെ
बीनविखारी: വിഷരഹിതമായ.
बीनविरोध: തിരിചചടിയില്ലാത്ത.
बुडिल्लो: ആഴ്ന്നിറങിയ മുങിയ.
बुदवंत: ബുദ്ധി_ജീവി. ബുദ്ധിമാന്‍ ധാരണാശക്‌തിയുള്ള വിവേകമുള്ള വിദ്വാന്‍മാരായിട്ടുളള പാണ്ഡിത്യമുള്ള അറിവുള്ള
बुद्दिजिवी: ബുദ്ധി_ജീവി.
बुद्दीक: ബുദ്ധിപരമായ.
बुद्धिवादी: നിരീശ്വരവാദി.
बुरखोधारी: മുഖപടം മുഖാവരണം മൂടുപടം.
बुरशें: മുഷിഞ്ഞ ശുചിയല്ലാത്ത അഴുക്കായ മലിനപ്പെട്ട വൃത്തിഹീനമായ അശ്ലീലം. മുഷിഞ്ഞ
बुराकाची: തുളയുള്ളത് ഓട്ടയുള്ളത്.
बेकायदेशीर: നിയമ_വിരുദ്ധമായ നിഷിദ്ധമായ.
बेकार: പരിശ്രമഹീനനായ ശക്തിഹീനനായ ബലഹീനനായ. പണിയെടുക്കാത്ത. നിയോഗിക്കപ്പെടാത്ത
बेकारलवडी: പണിയെടുക്കാത്ത.
बेगडी: പ്രകടനപരമായ കപടമായ ക്രിത്രിമമായ. പ്രകടനപരമായ കപടമായ ക്ര്‌ത്രിമമായ. മിടുക്കുള്ള ചുറുചുറുക്കുള്ള. ഔപചാരികമായി ഉപചാരപൂര്വ്വമുള്ള ആചാരപരമായ ഔദ്യോഗപരമായ.
बेगीन: വേഗതയുള്ള ചുണയുള്ള തീക്ഷ്ണമായ.
बेघर: താമസ_യോഗ്യമായ വീടുള്ളത് വീടില്ലാത്തവര്.
बेचैन: അസ്വസ്ഥമായ.
बेजार: ദു നിരാശയുള്ള. പ്രതീക്ഷ_ഇല്ലാത്ത ആശ_നഷ്ട്ടപ്പെട്ട ആശയറ്റ.
बेजारदिणें: മനസ്സ്_മുഷിഞ്ഞ മനസ്സ്_മടുത്ത.
बेजारिल्लें: മടുപ്പ് മുഷിച്ചില്.
बेनाळ: ഇരട്ട_കുഴല്.
बेनिनी: ബെനീനിയ.
बेपरवा: ഉപേക്ഷിക്കത്തക്ക അവഹേളിക്കത്തക്ക.
बेपरवाय: കൂസലില്ലാത്ത.
बेफिकीर: ഉന്മാദമുള്ള ഭ്രാന്തുള്ള ഉന്മത്തനായ കിറുക്കുള്ള വട്ടുള്ള.
बेबदड: ലഹരി_പിടിച്ച.
बेबदो: ലഹരിക്കടിമയായവന്. ലഹരി_പിടിച്ച.
बेमुदत: ആധിയില്ലാത്ത.
बेयमान: നന്ദികെട്ട ഉപകാരസ്മരണയില്ലാത്ത.
बेलगाम: കടിഞ്ഞാണില്ലാത്ത.
बेलरसी: ബേല്രസ്സിന്റെ. ബേല്രസ്സിന്റെ_.
बेल्जियन: ബെല്‍ജിയക്കാരുടെ.
बेल्जियमी: ബെല്‍ജിയക്കാരുടെ. ബെല്‍ജിയം.
बेवारशी: അനാഥ രക്ഷിതാവില്ലാത്ത രക്ഷയില്ലാത്ത ആശ്രയമില്ലാത്ത അഗതിയായ അഭയമില്ലാത്ത ഉടമയില്ലാത്ത. അവകാശികളില്ലാത്ത അനാഥനായ.
बेशुद्ध: ബോധമില്ലാത്ത.
बेसावध: ജാഗ്രതയില്ലാത്ത.
बोंडें: അവിവേകിയായ ജളനായ ഭോഷനായ മൂഢനായ മന്ദതയുള്ള ജളത്വമുള്ള
बोडकीं: ഇലകളില്ലാത്ത.
बोडको: ശോഷിക്കുന്ന കൊഴിയുന്ന ക്ഷയിക്കുന്ന ശുഷ്കിക്കുന്ന. ശുഷ്കിച്ച ശോഷിച്ച ക്ഷയിച്ച ചടച്ച ഉണങ്ങിയ.
बोत्सवानी: ബോസ്വാനീയ
बोधक: പറയുന്ന വിവരിക്കുന്ന.
बोधपूर्ण: അറിവുള്ള ബോധപൂര്‍ണ്ണമായ.
बोधहीण: ബോധ്യ_മാവാത്തത്ത്.
बोध्य: മനസ്സിലാക്കാവുന്ന ധരിക്കാവുന്ന.
बोलकें: വ്യക്തമാക്കുന്ന.
बोसनियन: ബോസ്നിയായിലെ ബോസിനായിലുള്ള
बौद्ध: ബുദ്ധമതത്തെ_സംബന്ധിക്കുന്ന.
बौद्ध_धर्मावलंबी: ബുദ്ധനെ_സംബന്ധിച്ച.
बौद्धीक: ബുദ്ധിപരമായ.
ब्यांयश्यांवें: എണ്ണപത്തി_രണ്ടാം
ब्याणव: തൊണ്ണൂറ്റി_രണ്ട്.
ब्याण्णवावें: തൊണ്ണൂറ്റി_രണ്ട്
ब्यात्तरावें: എഴുപത്തി_രണ്ടാം
ब्रह्मांडांतलें: ഈശ്വരന്_സ്രിഷ്ട്ടിച്ച_സമ്പൂര്ണ്ണ_വസ്തുക്കളുടേയും_സമൂഹത്തെ_സംബന്ധിക്കുന്നത്.
ब्राजीली: ബ്രസീലിലെ.
ब्रिटीश: ബ്രിട്ടീഷ് ബ്രിട്ടനിലെ
भंगीत: കഷണമായത്.
भंयकर: ഭയാനകമായ ഭീകരമായ ഉഗ്രമായ ഞെട്ടിക്കുന്ന ഭീതിജനകമായ ഭയാവഹമായ രുദ്രമായ
भंयभीत: ഭയവിഹ്വലനായ.
भक्षक: ഭക്ഷിക്കുന്നവന്‍ തിന്നുന്നവന്‍ ഉണ്ണുന്നവന്‍ ഭുജിക്കുന്നവന്‍ തീന്‍_കഴിക്കുന്നവന്‍ അകത്താക്കുന്നവന്‍ വാരി_വിഴുങുക.
भक्ष्य: ഭക്ഷണയോഗ്യമായ ഭക്ഷണ_പദാര്‍ഥം.
भगवो: കുംകുമ_നിറമുള്ള.
भटकें: അലഞ്ഞു_തിരിയുന്ന.
भडक: ഉത്തേജിപ്പിക്കുന്ന പ്രേരിപ്പിക്കുന്ന ജ്വലിപ്പിക്കുന്ന. തിളങ്ങുന്ന മിന്നുന്ന പുറമ്പകിട്ടൂള്ള.
भयभीत: ഭയപൂര്ണ്ണമായ.
भयरो: ബധിരരായ മൂകരായ ഊമയായ
भयांकृत: ദ്രോഹിയായ കരുണയില്ലാത്ത ഉപദ്രവിക്കുന്ന ഭയാനകമായ ഭീകരമായ ഉഗ്രമായ ഞെട്ടിക്കുന്ന ഭീതിജനകമായ ഭയാവഹമായ രുദ്രമായ
भयानक: ആക്രമിക്കുന്ന. ഭയാനകമായ ഭീകരമായ ഉഗ്രമായ ഞെട്ടിക്കുന്ന ഭീതിജനകമായ ഭയാവഹമായ രുദ്രമായ
भरदस्त: ഭാരിച്ച കനത്ത തൂക്കമുള്ള
भरपूर: വളരേയധികം. വളരേ. പൂര്‍ണ്ണമായ നിറഞ്ഞു_കവിഞ്ഞ
भरिल्लें: പരിപൂര്ണ്ണന്. അടച്ചുതീര്ന്ന. നിറച്ച. ഭാരപ്പെട്ട് ചുമക്കപ്പെട്ട് വഹിക്കപ്പെട്ട് എടുക്കപ്പെട്ട് പൊക്കപ്പെട്ട്.
भलायकेक_बरें: ആരോഗ്യപ്രദമായ.
भलायकेवंत: ആരോഗ്യപൂര്‍ണ്ണമായ ആരോഗ്യകരമായ
भलें: നല്ല നന്മയുള്ള വലിയ ഉത്തമമായ ഗുണമുള്ള മെച്ചപ്പെട്ട വൈശിഷ്ട്യമുള്ള സദ്ഗുണമുള്ള ഗുണകരമായ ശുദ്ധമായ ഉതകുന്ന കൊള്ളാവുന്ന.
भव्य: ഭീമകായനായ വളരേ_വലിയ. വലിയ വലുതായ വലിപ്പമുള്ള വന്‍ വമ്പിച്ച ബഹു വിപുലമായ പെരുത്ത വിശാലമായ വിസ്ത്ര്തമായ വ്യാപകമായ പരന്ന വണ്ണമുള്ള.
भशेन: തുല്യമായ സമമായ സമാനമായ
भश्टी_जायनाशिल्ली: ആര്ത്തവമില്ലാത്ത
भांगराळें: സ്വര്‍ണ്ണമയമായ.
भाग्यशाली: സൌഭാഗ്യമുള്ള ഭാഗ്യമുള്ള.
भाजिल्लें: കത്തി_ദഹിച്ച.
भाट: പ്രശംസകന്.
भाड्याच्यो: നികുതി_ഏര്പ്പെടുത്തല്.
भानगडींचें: പ്രയാസമുള്ള കുഴപ്പം_പിടിച്ച വിഷമമുള്ള ആയാസമുള്ള.
भायराविल्लें: ബഹിഷ്ക്കരിക്കപ്പെട്ട.
भायरें: ബഹിഷ്ക്കരിക്കപ്പെട്ട.
भायलें: ബാഹ്യമായ പുറമേയുള്ള.
भायलो: വിദേശി അന്യദേശക്കാരന്‍ വൈദേശികന്‍ അന്യന്‍ അന്യദിക്കുകാരന്‍ കുടിയേറ്രക്കാരന്‍.
भायल्याचें: മറ്രുള്ളവരുടെ അന്യരുടെ അന്യമായ വേറെ_ആയ വൈദേശികമായ വിദേശിയായ തറ്റേതല്ലാത്ത പുറമേയുള്ള മറ്രൊന്നായ മറ്രേതായ ഇതരമായ സ്വന്തമല്ലാത്ത അപര.
भारी: മഹത്ത്വമുള്ള ശ്രേഷ്ഠമായ ഗംഭീരമായ ഉല്ക്ര്ഷ്ടമായ പ്രൌഢമായ ഉത്തമമായ വിശിഷ്ഠമായ സ്തുത്യറ്ഹമായ മികച്ച മഹിമയുള്ള.
भावनाहीण: ഭാവരഹിത്മായ വികാരരഹിതമായ.
भावपूर्ण: ഭാവനാത്മകമായ.
भावहीण: ഭാവരഹിത്മായ വികാരരഹിതമായ.
भाविल्लें: പ്രിയപെട്ട ഇഷ്ടപെട്ട
भावी: വരാന്_പോകുന്ന ഭാവിയിലുള്ള വരാനിരിക്കുന്ന.
भावूक: മ്രിദുല_വികാരങള്ക്ക്_അടിമപ്പെടുന്ന.
भाशांतरकार: വിവവ്ര്ത്തകന്‍.
भाशांतरीत: ഭാഷാന്തരം_ചെയ്യപ്പെട്ട തര്‍ജ്ജിമ_ചെയ്യപ്പെട്ട വിവര്‍ത്തനം_ചെയ്യപ്പെട്ട ഭാഷാന്തരം_ചെയ്യപ്പെട്ട.
भाशातंर_करपी: വിവവ്ര്ത്തകന്‍.
भिकाड्डो: പിശുക്കനായ ക്ര്പണനായ.‌
भिकुड्डो: ഭീരുത്വമുള്ള ഭയശീലമുള്ള ആണത്തമില്ലാത്ത നെഞ്ഞുരപ്പില്ലാത്ത
भिजिल्लें: നനയ്ക്കപ്പെട്ട.
भिजूड: ഭീരുത്വമുള്ള ഭയശീലമുള്ള ആണത്തമില്ലാത്ത നെഞ്ഞുരപ്പില്ലാത്ത
भिडेस्त: ലജ്ജാശീലമുള്ള നാണമുള്ള
भितर_पावूंक_नाशिल्लो: ഒന്നിലും_ഏര്‍പ്പെടാത്ത.
भितरले: ആന്തരികമായ.
भित्रो: ഭീരുത്വമുള്ള ഭയശീലമുള്ള ആണത്തമില്ലാത്ത നെഞ്ഞുരപ്പില്ലാത്ത
भियेल्लो: പേടിച്ച.
भिरांकूळ: ഭയപൂര്ണ്ണമായ. ആക്രമിക്കുന്ന. ഭയാനകമായ ഭീകരമായ ഉഗ്രമായ ഞെട്ടിക്കുന്ന ഭീതിജനകമായ ഭയാവഹമായ രുദ്രമായ
भिवकुरो: ഭീരുത്വമുള്ള ഭയശീലമുള്ള ആണത്തമില്ലാത്ത നെഞ്ഞുരപ്പില്ലാത്ത
भिसाचें: അഴിഞ്ഞു_ചിതറിയ.
भुंयगत: ഉള്ളില്_വസിക്കുന്ന.
भुकेल्लो: വിശന്നിരുന്ന ബുഭുക്ഷയുള്ള വയറു_കാലിയായ
भुकेस्त: വിശന്നിരുന്ന ബുഭുക്ഷയുള്ള വയറു_കാലിയായ
भुतकाळ: കഴിഞ്ഞുപോയ.
भुतकाळीन: പശ്ഴയ_കാലത്തെ.
भुताचें: ഭൂതത്തെ_സംബന്ധിക്കുന്ന.
भुताटकेचें: ഭൂതത്തെ_സംബന്ധിക്കുന്ന.
भुतानी: ഭൂട്ടാന്‍കാരുടെ ഭൂട്ടാനിലെ_ഭാഷയിലുള്ള
भुरगें: വയസ്സില്ലാത്ത.
भुरगेपण: കുട്ടികള്ക്ക്_ചേര്ന്ന
भुरग्यांचें: കുട്ടികളുടെ_പോലുള്ള. സന്താന.
भुलयणें: ആകര്ഷണീയമായ. ആകര്‍ഷിക്കുന്ന ആകര്‍ഷകമായ ആകര്‍ഷണീയമായ വശ്യ മാസ്മരശക്‌തിയുള്ള മാദകമായ ചേതോഹാരിയായ ആനന്ദിപ്പിക്കുന്ന വശീകൃതമായ
भुलोवपी: ആകര്‍ഷിക്കുന്ന ആകര്‍ഷകമായ ആകര്‍ഷണീയമായ വശ്യ മാസ്മരശക്‌തിയുള്ള മാദകമായ ചേതോഹാരിയായ ആനന്ദിപ്പിക്കുന്ന വശീകൃതമായ
भूंयमंडळी: ഭൂപ്രദേശത്തിന്റെ വിശ്വത്തിന്റെ.
भेड्डो: ബധിരരായ മൂകരായ ഊമയായ
भेदक: വേര്‍തിരിക്കുന്ന.
भेदनीय: തുളയ്ക്കാവുന്ന മുറിവേല്‍പ്പിക്കാവുന്ന നിരീക്ഷിക്കാവുന്ന.
भेदपी: വേര്‍തിരിക്കുന്ന.
भेदभाव_करपी: വേര്‍തിരിക്കുന്ന.
भेदिल्ले: ഭേദിച്ച.
भेदीत: ഭേദിച്ച.
भेद्य: തുളയ്ക്കാവുന്ന മുറിവേല്‍പ്പിക്കാവുന്ന നിരീക്ഷിക്കാവുന്ന.
भेरो: ബധിരരായ മൂകരായ ഊമയായ
भेळशिल्लें: കേടുവന്ന വളിച്ച.
भेळशेल्लें: പഴകിയ
भेसळीचें: അശുദ്ധം കലര്‍പ്പുള്ള മായം_ചേര്‍ത്ത.
भोंवपी: അലഞ്ഞു_തിരിയുന്ന.
भोगसणी_मागपी: ക്ഷമ_യാചിക്കുന്ന.
भोगिल्लो: വിഷയാസക്തനായ സുഖാന്വേഷിയായ അനുഭവസ്ഥന്‍ ദു
भोगी: കാമിയായ കാമ_വികാരമുള്ള ക്രീഡാസക്തിയുള്ള.
भोगूंक_नाशिल्लें: അനുഭവിക്കാത്ത ധാരണയില്ലാത്ത തഴക്കമില്ലാത്ത ഉള്‍ക്കാഴ്ച്ചയില്ലാത്ത.
भोळें: അനായാസ_വിശ്വാസി.
भोळो: സൌമ്യനായ. കാപട്യമില്ലാത്ത നിഷ്കളങ്കരായ ശാന്തസ്വഭാവമുള്ള
भोवअर्थी: അനേകാര്‍ഥമുള്ള
भोवगुणी: യോഗ്യനായ കാര്യശേഷിയുള്ള നിപുണനായ സമര്ത്ഥനായ ശക്തനായ വിദഗ്ദ്ധനായ ചുണയുള്ള ചെയ്തുതഴക്കമുള്ള ചതുരനായ ചുറുചുറുക്കുള്ള ജ്ഞാനമുള്ള കെല്‍പ്പുള്ള പാടവമുള്ള കൌശലമുള്ള കഴിവുള്ള
भोवधर्मीक: നാനജാതി_മതങ്ങളുള്ള.
भोवमानेस्त: ആദരണീയനായ.
भोववर्शी: അനേകം_വര്ഷം_ജീവിക്കുന്ന.
भोवसंख्या: വളരേ_അധികം.
भ्रमिश्ट: വീതി
मंगलकारी: നന്മ_നല്കുന്ന
मंगोलियन: മംഗോളിയന്‍. മംഗോളിയന്‍.
मंगोलियायी: മംഗോളിയന്‍.
मंगोली: മംഗോളിയന്‍.
मंचनीय: അവതരണയോഗ്യമായത്.
मंजूर: സ്വീക്രിതമായ
मंद: മന്ദം സാവധാനം മടിയുള്ള അലസതയുള്ള. തണുത്ത.
मग्न: തിരക്കുള്ള
मचमचीत: സ്വാദിഷ്ട്ടമായ. മസാലയുള്ള. എരിവും_മസാലകളും_ഉള്ള.
मजत_घेवपी: സഹായം_ലഭിച്ചിട്ടുള്ള ധനസഹായം_ലഭിച്ചിട്ടുള്ള.
मजबूत: ഉറപ്പുള്ള ബലമുള്ള
मजेशीर: രസകരമായ തമാശക്കാരന്‍.
मडगास्करी: മഡഗാസ്കറിയന്
मडील्लें: നിര്‍മ്മാണം രൂപം ആക്രിതി_കൊടുക്കല്‍.
मढोवंक_नाशिल्लें: ശരിയായ_രൂപമില്ലാത്ത വിക്ര്‌ത്കമായ മോശമായ.
मणिपुरी: മണിപ്പൂരിലെ മണിപ്പൂരി
मतींतलें: കാല്പനീകമായ സാങ്കല്‍പ്പീകമായ വാസ്തവമല്ലാത്ത സങ്കല്പത്തിലുള്ള യാഥാറ്ത്ഥ്യമല്ലാത്ത സത്യ്മല്ലാത്ത ഭാവനയിലുള്ള കല്പിതമായ ഭാവനം_ചെയ്ത അനനുക്ര്‌തമായ മിഥ്യയായ അയഥാറ്ത്ഥമായ മായികമായ.
मदेवर्ती: മധ്യ_ഭാഗത്ത്.
मद्यम_पिरायेचें: മദ്ധ്യ_വയസ്ക്കനായ.
मद्रासी: മദ്രാസി.
मधलें: ഇടത്തരത്തിലുള്ള ഇടത്തരമായ മധ്യമമായ.
मधूर: ലോലമായ
मध्यकाळीन: മധ്യകാല.
मध्यम: ഇടത്തരത്തിലുള്ള ഇടത്തരമായ മധ്യമമായ.
मध्यवर्ती: മധ്യ_ഭാഗത്ത്.
मनभुलयणी: സുന്ദരമായ മനോഹരമായ.
मनभुलयणें: മനോഹരമാ‍യ സുന്ദരമായ കോമളമായ ഹ്ര്‌ദ്യമായ ആകറ്ഷകമായ അഴകുള്ള മനോജ്ഞമായ.
मनमानी: തന്നിഷ്ടം_പോലെ സ്വന്തം_ഇഷ്ടമനുസരിച്ച് സ്വതാത്പര്യം_അനുസരിച്ച്.
मनरिजवणेचें: രസകരമായ വിനോദപ്രദമായ.
मनशाक_सोबता: മനുഷ്യോചിതമായ.
मनसीक: ബുദ്ധിപരമായ.
मनायेचें: നിഷേധിക്കപ്പെട്ടത് നിരോധിക്കപ്പെട്ട തടയപ്പെട്ട.
मनीस_निर्मीत: മനുഷ്യ_നിര്മ്മിതം.
मनीसचलीत: മനുഷ്യചലിതമായ.
मनीसपण: നല്ല നന്മയുള്ള വലിയ ഉത്തമമായ ഗുണമുള്ള മെച്ചപ്പെട്ട വൈശിഷ്ട്യമുള്ള സദ്ഗുണമുള്ള ഗുണകരമായ ശുദ്ധമായ ഉതകുന്ന കൊള്ളാവുന്ന.
मनीसपणाचें: മനുഷ്യ_സംബന്ധിയായ മാനുഷികമായ.
मरणादीक: മരിക്കുവാന്‍_ഉതകുന്ന.
मराठी: മറാഠിയിലെ മഹാരാഷ്ട്രയിലെ മറാഠി മറാഠി മറാഠി_മാത്ര്ഭാഷയായ
मर्यादीत: ചിലവു_ചുരുക്കുന്ന പാഴ്_ചിലവൊഴിവാക്കുന്ന.
मलेशियायी: മലേഷ്യന്‍.
मल्ल्याळम: മലയാളിയായ മലയാള മലയാളികളുടെ
मल्ल्याळी: മലയാളിയായ മലയാള മലയാളികളുടെ
मळकें: മുഷിഞ്ഞ ശുചിയല്ലാത്ത അഴുക്കായ മലിനപ്പെട്ട വൃത്തിഹീനമായ
मळबभेदी: ആകാശത്തെ_ഭെദിക്കുന്ന.
मळबा_कोराचें: ആകാശനീല.
मळबांतलें: ആകാശത്തില്_കൂടിയുള്ള
मळाचें: യുദ്ധക്കളത്തിന്റെ പോറ്ക്കളത്തിന്റെ.
मळ्यांचीं: പല_നിലകളുള്ള.
मशागत: പോഷിപ്പിക്കപ്പെട്ട വളര്‍ത്തപ്പെട്ട.
मसालेदार: മസാലയുള്ള.
मसाल्याचें: മസാലയുള്ള. എരിവും_മസാലകളും_ഉള്ള.
मस्तिल्लें: ചവിട്ടി_അരച്ച. കേടു_വന്ന നാശം_പറ്റിയ അയോഗ്യമായ കൊള്ളാത്ത ചീഞ്ഞ അഴുകിയ.
मस्तें: കുസൃതിയായ വികൃതിയായ
महत्वाकांक्षी: ഔന്നത്ത്യത്തിനുള്ള_അഭിലാഷം വലുതാകാനുള്ള_ആഗ്രഹം.
महान: മഹാനായ ശ്രേഷ്ഠനായ ഉന്നതനായ വിശിഷ്ടനായ
महाराष्ट्री: മറാഠിയിലെ മഹാരാഷ്ട്രയിലെ
महाराष्ट्रीयन: മറാഠിയിലെ മഹാരാഷ്ട്രയിലെ
महाविद्यालयीम: കലാലയത്തിലെ.
मांडिल्लें: സംകേതം_കാട്ടിയ. പ്രതിപാതിച്ചിട്ടുള്ളത്
मागणेचें: അപേക്ഷ_സമര്‍പ്പിക്കുന്ന.
मागलें: കഴിഞ്ഞ താമസിച്ച പിന്നിലത്തെ.
मागारिल्लें: നല്ല_സ്വഭാവമുള്ള.
मागिल्लें: ചോദിച്ച യാചിച്ച അഭ്യറ്ത്ഥിച്ച അപേക്ഷിച്ച അവകാശപ്പെട്ട ആവശ്യപ്പെട്ട.
माजी: മുന്‍പ്_സംഭവിച്ച മുന്‍പത്തെ.
माडिल्लें: കേടു_വന്ന നാശം_പറ്റിയ അയോഗ്യമായ കൊള്ളാത്ത ചീഞ്ഞ അഴുകിയ.
माड्डिल्लें: ചവിട്ടി_അരച്ച.
माणकुलें: ചെറിയ. ലോലമായ ചെറിയ
मातयेभरवण: മരിച്ച നശിച്ച നശിപ്പിക്കപ്പെട്ട. ഭൂമിയോട്_സമാനമായി. ഭൂമിയില്‍_വീണ_.
मातसो: ലേശം_മാത്രം.
मातृहीण: അമ്മയില്ലാത്ത മാത്ര്ഹീനന്‍.‌
मातेराचें: പഴുത്ത്_ചീഞ്ഞ.
मादक: ലഹരിയുണ്ടാക്കുന്ന ലഹരി_ബാധിച്ച.
माननीय: ആദരിക്കപ്പെട്ട.
मानवल्लें: പ്രിയപെട്ട ഇഷ്ടപെട്ട
मानवी: മനുഷ്യ_സംബന്ധിയായ മാനുഷികമായ.
मानवीकृत: മനുഷ്യത്വമാരോപിക്കപ്പെട്ട.
मानसीक: മനസ്സിനെ_സംബന്ധിക്കുന്ന.
मानादीक: ആദരിക്കപ്പെട്ട. ആദരണീയനായ. പൂജ്യനായ
मानिल्लें: നിഷിദ്ധമല്ലാത്ത.
मान्य: നിഷിദ്ധമല്ലാത്ത. അങ്ഗീകാര_യോഗ്യമായ. പാസ്സാകുക.
मान्य_केल्ली: അങ്കീകരിച്ച സ്വീകരിച്ച.
मापनीय: അളക്കുവാന്‍_പറ്റുന്നത്.
मापिल्लें: തൂക്കിയ
मापूंक_नाशिल्लें: അളക്കാത്ത.
माफ_करी_सारकी: ക്ഷമിക്കപ്പെടാവുന്ന മാപ്പാക്കാവുന്ന.
माफी-बगरचो: ക്ഷമിക്കാന്_പറ്റാത്തത്.
मामे: അമ്മാവന്റെ_മകന്‍.
माया_नाशिल्लो: വികാരമില്ലാത്ത.
मायेस्त: സ്നേഹമുള്ള.
मारक: കൊല്ലുന്നവന്‍ നശിപ്പിക്കുന്നവന്‍.
मारवाडी: മാര്‍വാടി മാര്‍വാടി
मारिल्लें: പുറത്താക്കപ്പെട്ട.
मालक्रियाद: കുസൃതിയായ വികൃതിയായ
मालदिवी: മാലദ്വീപിയന്‍
माळी: പല_നിലകളുള്ള.
मावळिल्लो: ആഴ്ന്നിറങിയ മുങിയ.
मावशे: മാതൃസഹോദരിയെ_സംബന്ധിക്കുന്ന.
मावस: മാതൃസഹോദരിയെ_സംബന്ധിക്കുന്ന.
मासाळ: നല്ലവണ്ണം_മാംസമുള്ള തടിച്ച. കഴമ്പുള്ള.
मिजो: മീസൊ.
मिजोरमाचें: മീസൊ.
मिटना__अशें: നശിക്കാത്ത മായാത്ത സ്ഥായിയായ.
मित्रत्व: സ്നേഹബുദ്ധിയായ ഇടപഴകുന്ന ആത്മാര്‍ത്ഥതയുള്ള.
मिळमीळीत: ദ്രിഢാഭിപ്രായമില്ലാത്ത.
मिशनरी: വൈദികന്‍.
मिशयाळो: മീശയുള്ള.
मिशयेकार: മീശയുള്ള.
मिश्कील: നര്‍മ്മബോധമുള്ള രസികത്വമുള്ള തമാശക്കാരന്‍.
मिश्र: മിശ്രിതം.
मिश्रीत: കലറ്ത്താന്‍_യോഗ്യമായ കൂട്ടിയോജിപ്പിക്കാന്‍_യോഗ്യമാ‍യ കൂട്ടിചേറ്ക്കാന്‍_യോഗ്യമായ.
मिस्तुराद: അശുദ്ധം കലര്‍പ്പുള്ള മായം_ചേര്‍ത്ത. മിശ്രിതം.
मिस्री: ഈജിപ്ഷ്യന്‍.
मुंबयकार: മുംബൈയിലുള്ള ബോംബേയിലുള്ള.
मुंबयचें: മുബൈയുടെ മുംബൈ‌-
मुक्कामाचें: പോകേണ്ട
मुक्त: സ്വതന്ത്രമായ. സ്വ്തന്ത്റനായ
मुखार_धाडिल्लें: മുന്പില്_പോകുന്ന.
मुखार_येवपी: വരാന്_പോകുന്ന ഭാവിയിലുള്ള വരാനിരിക്കുന്ന.
मुखारचो: ആദ്യത്തെ.
मुखावयलो: ആദ്യത്തെ. മുന്പേ_നടക്കുന്ന മുന്പനായ ശ്രേഷ്ഠനായ.
मुखेल: പ്രാഥ്മികമായ മുഖയമായ പ്രധാനമായ പ്രധാന മുഖ്യ.
मुखेली: പ്രമുഖന്‍.
मुख्य: പ്രധാന മുഖ്യ.
मुदयाळे: ചുരുണ്ട.
मुदलांतलें: സ്വദേശീയ തത്സ്ഥാനത്തുള്ള ജനിച്ച_സ്ഥലത്തുള്ള.
मुदी_घातिल्लें: വാഗ്ദാനം_ചെയ്യപ്പെട്ട വാക്കു_കൊടുക്കപ്പെട്ട വാക്കു_കൊടുത്ത കരാറ്_ചെയ്ത.
मुनेल्लें: മൂര്‍ച്ചയില്ലാതാക്കപെട്ട മുനയില്ലാതായ
मुमुर्खें: അധികം_സംസാരിക്കാത്ത
मुर्ती: മൂര്‍തീകരിച്ച.
मुल्यवान: വിലയേറിയ വിലമതിക്കാനാവാത്ത വിലപിടിച്ച
मुळां_नाशिल्लें: വേരില്ലാത്ത അടിസ്ഥാനമില്ലാത്ത ആധാരമില്ലാത്ത മൂലമില്ലാത്ത മൂടില്ലാത്ത മാണമില്ലാത്ത ജടയില്ലാത്ത ശിഫയില്ലാത്ത.
मुळां_बगरचें: വേരില്ലാത്ത അടിസ്ഥാനമില്ലാത്ത ആധാരമില്ലാത്ത മൂലമില്ലാത്ത മൂടില്ലാത്ത മാണമില്ലാത്ത ജടയില്ലാത്ത ശിഫയില്ലാത്ത.
मुळाचें: വേരുള്ള
मुळावें: മുമ്പുള്ള പ്രാരംഭികമായ ആദ്യമായ.
मुस्तिल्लें: ചവിട്ടി_അരച്ച.
मूठ_आशिल्लें: മന്ത്രപ്രയോഗമുള്ള.
मूर्ख: അവിവേകിയായ ജളനായ ഭോഷനായ മൂഢനായ മന്ദതയുള്ള ജളത്വമുള്ള
मूर्त: ആകാരമുള്ള
मूळ: അടിസ്ഥാനപരമായ മൌലീക യഥാറ്ത്ഥമായ തനതായ അക്ര്‌ത്രിമമായ. സ്വദേശീയ തത്സ്ഥാനത്തുള്ള ജനിച്ച_സ്ഥലത്തുള്ള.
मृत: മരിച്ച അന്തരിച്ച സമാധിയായ മഹാനിദ്രയിലായ നിര്യാതനായ
मृदू: മൃദുവായ മൃദുലമായ പേലവമായ ലോലമായ കോമളമായ സുകുമാരമായ
मॅचींग: ചേര്‍ച്ചയുള്ള.
मेकळें: പരസ്യമായ. സ്വതന്ത്രമായ. ഒഴിഞ്ഞ ശൂന്യമായ കാലിയായ തുറന്ന പരസ്യമാക്കിയ ആരംഭിച്ച വെളിപ്പെടുത്തിയ.
मेकळो: സ്വ്തന്ത്റനായ
मेक्सिकन: മെക്സിക്കന്‍ മെക്സിക്കോവിന്റെ.
मेघहीण: സ്വച്ഛമായ സ്പഷ്ട്ടമായ തെളിഞ്ഞ.
मेजपा_योग्य: എണ്ണപ്പെടാവുന്ന കണക്കാക്കത്തക്ക അംഗീകരിക്കപ്പെടേണ്ട്.
मेजिल्लें: എണ്ണമില്ലാത്ത
मेजी_सारक्यो: എണ്ണപ്പെടാവുന്ന കണക്കാക്കത്തക്ക അംഗീകരിക്കപ്പെടേണ്ട്.
मेजूंक_नाशिल्लें: എണ്ണാത്ത
मेल्लें: മരിച്ചുകൊണ്ടിരിക്കുന്ന
मेल्लो: മരിച്ച അന്തരിച്ച സമാധിയായ മഹാനിദ്രയിലായ നിര്യാതനായ
मेळनाशिल्लें: ലഭിച്ചിട്ടില്ലാത്ത്.
मेळयल्लें: നേടിയെടുക്കേണ്ട നേടേണ്ട ലഭിക്കേണ്ട കിട്ടേണ്ട കൈവരേണ്ട.
मेळयिल्लें: നേടിയത് പൂറ്ത്തിയാക്കപെട്ട തീറ്ന്ന അനുഭവിക്കപ്പെട്ട.
मेळिल्लें: കിട്ടിയ നേടിയ.
मेळोवन_दिल्लें: ലഭിച്ച നേടിയ സ്വീകരിക്കപ്പെട്ട.
मेळोवपी: ലഭിക്കുന്നവന്‍.
मैत्री: മിത്രത മിത്രോചിതമായ_.
मैदानी: യുദ്ധക്കളത്തിന്റെ പോറ്ക്കളത്തിന്റെ.
मॉरेशीयी: മൌറീഷ്യസ്യന്_.
मोगाचें: അനുരാഗമുണ്ടാക്കുന്ന
मोगाळ: സ്നേഹമുള്ള. സ്നേഹം_നിറഞ്ഞ
मोगासक्त: പ്രേമാസക്തനായ.
मोगी: പ്രിയപ്പെട്ട പ്രിയം_ചെയ്യുന്ന ഇഷ്ടമുള്ള അഭിമതമായ പ്രീതികരമായ.
मोटे: വലിയ വലുതായ വലിപ്പമുള്ള വന്‍ വമ്പിച്ച ബഹു വിപുലമായ പെരുത്ത വിശാലമായ വിസ്ത്ര്തമായ വ്യാപകമായ പരന്ന വണ്ണമുള്ള.
मोटें: വലിയ
मोटो: തടിച്ച സ്ഥുലശരീരിയായ
मोड: സ്വാര്ഥം_ത്യജിച്ച.
मोडण: വളഞ്ഞ വക്രതയുള്ള ചുറ്റിക്കുന്ന
मोडणाचें: വളവും_തിരിവും_ഉള്ള_.
मोडपा_सारकें: അനുസരിക്കാതിരിക്കല്
मोडिल्लें: തകര്‍ത്ത നിലത്തു_വീണ. കഷണമായത്. നിയമം_ലംഘിക്കല്‍
मोडूं_नजो_अशें: അതിരുകടക്കാതെയുള്ള
मोडूं_येत_अशें: ഉടയ്ക്കാവുന്ന.
मोनें: വിടരാത്ത. വാക്കുകള്_തടയപ്പെട്ട.
मोनो: മൌനമായ. മൂകന്‍
मोफत: പണമില്ലാതെ.
मोरेक्की: മോസ്കോവിയന്
मोलादीक: വിലയേറിയ വിലമതിക്കാനാവാത്ത വിലപിടിച്ച വിലയേറിയത്.
मोव: സൌമ്യനായ. വളയുന്ന വഴങ്ങുന്ന. മൃദുവായ മൃദുലമായ പേലവമായ ലോലമായ കോമളമായ സുകുമാരമായ ലോലമായ സുകുമാരമായ കോമളമായ
मोव_काळजाचें: കോമള_ഹ്രിദയം.
मोसमाभायरो: കാലത്തിനല്ലാത്ത
मोसमी: കാലാനുസ്രിതമായ
मोहक: ആകര്ഷണീയമായ.
मोहीत: ആസക്തനായ താല്പര്യമുള്ള വിശ്വാസമുള്ള അനുരാഗമുള്ള താത്പര്യമുള്ള ശുഷ്കാന്തിയുള്ള മോഹമുള്ള അനുരക്തനായ.
म्यानमारी: ബ്ര്‍മ്മയുടെ മ്യാന്മറിന്റെ ബ്ര്‍മ്മ_ഭാഷ മ്യാന്മര്‍_ഭാഷ
म्हगेलो.: എന്റെ
म्हजो: എന്റെ
म्हत्व_नाशिल्लें: മഹത്വമില്ലാത്ത.
म्हत्वकांक्षा_नाशिल्लें: ഔന്നത്യത്തിനുള്ള_അഭിലാഷം_ഇല്ലാത്ത്.
म्हत्वपूर्ण: മഹത്വപൂര്ണ്ണമായ.
म्हत्वहीण: മഹത്വമില്ലാത്ത.
म्हत्वाचें: മഹത്വപൂര്ണ്ണമായ.
म्हा: വലിയ ശ്രേഷ്ഠമായ.
म्हातारी: വയസ്സായ_സ്ത്രീ വ്ര്ദ്ധ_സ്ത്രീ.‌
म्हातारें: വയസ്സായ.
म्हान: മഹാനായ ശ്രേഷ്ഠനായ ഉന്നതനായ വിശിഷ്ടനായ വലിയ ശ്രേഷ്ഠമായ.
म्हानगरीय: മഹാനഗരങളെ_സംബന്ധിച്ച.
म्हापापी: മഹാപാപി.
म्हारग: വിലയേറിയ വിലമതിക്കാനാവാത്ത വിലപിടിച്ച വിലയേറിയ വിലപിടിച്ച. വില_പിടിച്ച വിലപിടിപ്പുള്ള വിലയേറിയ മൂല്യമേറിയ
म्हालम्हातारी: വയസ്സായ_സ്ത്രീ വ്ര്ദ്ധ_സ്ത്രീ.‌
म्हालम्हातारें: വയസ്സായ.
म्हाविद्यालयीन: കലാലയത്തിലെ.
म्हेळें: ശുദ്ധീകരിക്കാത്ത പരിശോധിക്കാത്ത സംശുദ്ധിയാക്കാത്ത വിരേചനം_ചെയ്യാത്ത ശുചീകരിക്കാത്ത സംസ്കരിക്കാത്ത പരിപൂതമാക്കാത്ത. മുഷിഞ്ഞ ശുചിയല്ലാത്ത അഴുക്കായ മലിനപ്പെട്ട വൃത്തിഹീനമായ മുഷിഞ്ഞ
म्होंवाळ: മധുര_സ്വരമുള്ള. മധുരമുള്ള മധുരിമയുള്ള മാധുര്യമുള്ള ഇനിപ്പുള്ള മധുരമുള്‍ള.
म्होंवाळ_उलोवपी: ഇഷ്ട്ടം_സംസാരിക്കുന്ന പ്രിയം_വദമായി_സംസാരിക്കുന്ന.
म्होवल्याचें: കാമ്പുള്ള.
यंत्रचलीत: യന്ത്ര_ചാലിതം.
यत्नशील: പരിശ്രമിക്കുന്ന പ്രയത്നിക്കുന്ന.
यमनी: യമന്‍.
यशस्वी: ജേതാവ് വിജയി
यहुदी: യഹൂദ ജൂത.
याचक: അപേക്ഷകന്.
याद__नाशिल्लें: മറന്നു_പോയ.
यानहीण: വാഹനം_ഇല്ലാത്ത.
यानाचेर_चडिल्लें: വണ്ടിയില്_യാത്ര_ചെയ്യുന്ന.
यानारूड: വണ്ടിയില്_യാത്ര_ചെയ്യുന്ന.
युक्रेनी: യൂക്രേനിന്റെ. യൂക്രേനിന്റെ_ഭാഷ.
युगांडी: ഉഗാണ്ടിയന്
युगोस्लावियन: യൂഗോസ്ലാവിയായിലെ.
युनानी: യവനയിലേ ഗ്രീസിലേ. യുനാനി
युरेशियायी: യുരേശിയയുടെ.
येतें_वतें: രണ്ടു_പക്ഷമുള്ള രണ്ടു_വശമുള്ള.
येवंक_नाशिल्लें: പ്രാപ്യമല്ലാത്തത്.
येवंक_नाशिल्लो: വരാത്ത.
येवंनजशा: ദുര്ഗ്ഗമമായ
येवजिल्लें: ഇച്ഛയനുസരിച്ചുള്ള് ഇഷ്ടത്തിനനുസ്രിതമായ ഉദ്ദേശ്യത്തോടെയുള്ള.
येवपी: വരാന്‍_പോകുന്ന ഭാവികാലത്തെ_സംബന്ധിച്ച.
येवरोपी: യൂരോപിലെ.
येशस्वी: സഫലമായ വിജയകരമായ. കീര്ത്തിമാന്.
योग्य: യോഗ്യനായ കാര്യശേഷിയുള്ള നിപുണനായ സമര്ത്ഥനായ ശക്തനായ വിദഗ്ദ്ധനായ ചുണയുള്ള ചെയ്തുതഴക്കമുള്ള ചതുരനായ ചുറുചുറുക്കുള്ള ജ്ഞാനമുള്ള കെല്‍പ്പുള്ള പാടവമുള്ള കൌശലമുള്ള കഴിവുള്ള യോജിക്കുന്ന അനുകൂലമായ ചേര്‍ച്ചയുള്ള പൊരുത്തമുള്ള ഐക്യമുള്ള കൂടികലരുന്ന സംയോജിക്കുന്ന. വിധിപ്രകാരമുള്ള. അര്ഹതയുള്ള_വ്യക്തി. യുക്തമായ ഉചിതമായ ഒത്ത തക്ക അനുകൂലമായ മനുഷ്യോചിതമായ. ഉചിതമായ. മുഖത്തടിച്ച_പോലെ.
योग्य_वेळार: സമയോചിതമായ സന്ദര്‍ഭത്തിനു_ചേര്‍ന്ന സമകാലീനമായ.
योजक: യോജിപ്പിക്കുന്ന
योजिल्लें: യോജിച്ച അനുയോജ്യമായ ചേറ്ന്ന യുക്തമായ പൊരുത്തമുള്ള ഉചിതമായ ഹിതകരമായ ഇണങ്ങിയ അനുസ്ര്തമായ അനുഗുണമായ.
योजीत: യോജിച്ച അനുയോജ്യമായ ചേറ്ന്ന യുക്തമായ പൊരുത്തമുള്ള ഉചിതമായ ഹിതകരമായ ഇണങ്ങിയ അനുസ്ര്തമായ അനുഗുണമായ.
योज्य: ചേറ്ച്ചയുള്ള യോജ്യമായ പൊരുത്തമുള്ള യുക്തതയുള്ള സംയോജിക്കുന്ന രഞ്ജകമായ രഞ്ജിതമായ.
रंगयिल्लें: നിറമായ വറ്ണ്ണമായ ചായമായ രഞ്ജിതമായ അനുരഞ്ജിതമായ. നിറം_കൊടുത്ത.
रंगांचो: നിറമുള്ള.
रंगी: നിറമുള്ള വറ്ണ്ണമുള്ള
रंगीत: പല_നിറത്തിലുള്ള. നിറമുള്ള. നിറമായ വറ്ണ്ണമായ ചായമായ രഞ്ജിതമായ അനുരഞ്ജിതമായ.
रकाद_दिवपी: സന്ദേശം_വഹിക്കുന്ന_.
रकिल्लें: ശക്തിയായ_മഴ.
रक्तबंबाळ: രക്തരൂഷിതമായ
रक्तरंजीत: രക്തരൂഷിതമായ
रक्तहीण: രക്തഹീനന്‍ രുധിരഹീനന്‍.
रक्ताचें: കൊലയാളി കൊലപാതകി ഘാതകന്‍.
रक्षक: രക്ഷിക്കുന്നവന്‍ സംരക്ഷകന്‍ രക്ഷകന്‍ ഉദ്ധാരകന്‍ പരിപാലകന്‍.
रक्षकहीण: ആസ്രയമില്ലാത്ത രക്ഷ്കനില്ലാത്ത.
रगत_नाशिल्लें: രക്തഹീനന്‍ രുധിരഹീനന്‍.
रचिल्लें: കാല്പനീകമായ സാങ്കല്‍പ്പീകമായ വാസ്തവമല്ലാത്ത സങ്കല്പത്തിലുള്ള യാഥാറ്ത്ഥ്യമല്ലാത്ത സത്യ്മല്ലാത്ത ഭാവനയിലുള്ള കല്പിതമായ ഭാവനം_ചെയ്ത അനനുക്ര്‌തമായ മിഥ്യയായ അയഥാറ്ത്ഥമായ മായികമായ. രചിക്കപ്പെട്ട എഴുതപ്പെട്ട.
रचूंक_नाशिल्लें: നിര്മ്മിക്കാത്ത.
रडकुरें: കരയുവാന്‍_പോകുന്ന.
रडपी: കരയുന്ന നിലവിളിക്കുന്ന കേഴുന്ന തേങ്ങുന്ന.
रडयें: കരയുവാന്‍_പോകുന്ന.
रद्द: നിരസിക്കപ്പെട്ട റദ്ദാക്ക്പ്പെട്ട.
रमणीय: സുന്ദരമായ മനോഹരമായ.
रम्य: സുന്ദരമായ മനോഹരമായ. സൌന്ദര്യമുള്ള സുമുഖമുള്ള ചേലുള്ള ചന്തമുള്ള
रवांडी: റുവാണ്ടിയന്
रसहीण: രസഹീനമായത്.
रसात्मक: കാവ്യാത്മകമായ.
रसाळ: രസമുള്ള രുചിയുള്ള സ്വാദുള്ള.
रसीक: കലാസ്നേഹി.
रहस्य: രഹസ്യപൂര്ണ്ണം.
रहस्यहीण: ഒളിവില്ലാത്ത.
राखण_नाशिल्लें: സൂക്ഷിക്കാത്ത
राखणहीण: ആസ്രയമില്ലാത്ത രക്ഷ്കനില്ലാത്ത.
राखणे_बगरचें: ആസ്രയമില്ലാത്ത രക്ഷ്കനില്ലാത്ത.
राखीव: കരുതല്. പ്രത്യേക_അവസരത്തില്‍_ധരിക്കുന്ന.
राखीवतेबगरचें: സംവരണം_ചെയ്തിറ്ട്ടില്ലാത്ത.
राखूंक_नाशिल्लें: സൂക്ഷിക്കാത്ത
रागिश्ट: ദ്വേഷ്യമുള്ള. ക്രോധമുള്ള.
राजकारणाचे: രാഷ്ട്രീയമായ രാഷ്ട്ര_തന്ത്രപരമായ.
राजकारणी: രാഷ്ട്രീയമായ രാഷ്ട്ര_തന്ത്രപരമായ. നീതിജ്ഞന്‍ നിയമജ്ഞന്‍.
राजनितीक: രാഷ്ട്രീയമായ രാഷ്ട്ര_തന്ത്രപരമായ.
राजपूत: രജപുത്രരുടെ.
रानटी: വനത്തെ_സംബന്ധിക്കുന്ന. വന്യ കാടന്‍
रानवटी: വനത്തെ_സംബന്ധിക്കുന്ന. വന്യ കാടന്‍
राबित्याचें: താമസിക്കുന്ന നില്‍ക്കാന്‍_യോഗ്യമ്മായ.
राबित्याच्यो: ശബ്ദങളുടെ.
रावपी: താമസിക്കുന്ന നില്‍ക്കാന്‍_യോഗ്യമ്മായ.
राष्ट्रद्रोही: ദേശ_ദ്രോഹി.
राष्ट्रभक्त: ദേശഭക്തന്‍.
राष्ट्रीय: അന്തര്‍ദേശീയം.
रासायनीक: രസതന്ത്രപരമായ.
रिकामी: ഒഴിഞ്ഞ ശൂന്യമായ കാലിയായ ഒഴിവുള്ള പ്രയോജനമില്ലാത്ത ശൂന്യമായ.
रिटायर्ड: ജോലിയില്‍_നിന്ന്_വിരമിച്ച റിട്ടയറായ പെന്‍ഷന്‍_പറ്റിയ വിശ്രമയ_സമയം_പ്രാപിച്ച ഉദ്യോഗമൊഴിഞ്ഞ.
रितसर: നന്നായി_ക്രമപ്പെടുത്തപ്പെട്ട സുനിശ്ചിതമായ.
रीणकार: കടക്കാരന്.
रीतसर: ക്രമപ്പെടുത്തപ്പെട്ട നിശ്ച്ചിതമായ വ്യവസ്ഥപ്പെടുത്തിയ.
रुंद: വീതിയുള്ള
रुचीक: സ്വാദോടുകൂടിയ.
रुचीचें: സ്വാദോടുകൂടിയ.
रुजवणेक_घातिल्लें: വിതയ്ക്കപ്പെട്ട വിത്തു_പാകിയ വിത്തു_നട്ട
रुजवणेचें: വിതയ്ക്കാവുന്ന വിതയ്ക്കാന്_പറ്റിയ നടാവുന്ന പാകവുന്ന.
रुढ: നിലവിലുള്ള പരമ്പരഗതമായ പ്രചാരത്തിലുള്ള പ്രചാരത്തിലിരിക്കുന്ന സറ്വ്വസാധരണമായ പൊതുവായ സാറ്വ്വജനീനമായ ലോകചാരാമായ പ്രചലിതമായ പ്രാബല്യത്തിലുള്ള സ്ഥാപിതമായ ഇപ്പോഴുള്ള നടപ്പിലുള്ള.
रुमानियन: രുമാനിയയുടെ.
रुमानी: രുമാനിയയുടെ. രുമാനിയയുടെ.
रूक्ष: വരണ്ട് ഉണങ്ങിയ ശുഷ്കമായ
रूच_नाशिल्लें: സ്വാദില്ലാത്ത.
रूचीक: സ്വാദിഷ്ട്ടമായ.
रूप_नाशिल्लें: വിരൂപനായ വിലക്ഷണമായ ഭംഗിയില്ലാത്ത വികൃതമായ
रेंवटाळ: മ്രുഭൂമിയ.
रेबट: ചതുപ്പായ.
रेब्याचें: മാലിന്യമുള്‍ള ചേറുള്‍ള.
रोगी: രോഗി രോഗാതുരന്‍ രോഗബാധിതന്‍
रोयिल्लें: ഉഴുത.
रोवपा_सारकें: നടാവുന്ന പാകാവുന്ന നടാന്_യോഗ്യമായ.
रोवपी: നടുന്ന പാകുന്ന
रोवूंक_नाशिल्लें: വിതക്കാത്ത ക്ര്‌ഷിയില്ലാത്ത ക്ര്‌ഷിപ്പണി_നടക്കാത്ത.
रोहक: ആരോഹണ കയറുന്ന ആരോഹണം_ചെയ്യുന്ന.
लंगडें: മുടന്തന്‍ ഞൊണ്ടി
लंगडो: തുടയില്ലാത്ത അങ്ഗ_വൈകല്യമുള്ള.
लकलकीत: പ്രകാശപൂര്‍ണ്ണമായ പ്രകാശമാനമായ. തിളങ്ങുന്ന ശോഭയുള്ള തെളിമയുള്ള ശുദ്ധമായ സ്പഷ്ട്ടമായ.
लक्ष: ശ്രദ്ധിക്ക്ത്തക്കതായ.
लक्षवेदी: ഉന്നത്തില്_കൊള്ളിക്കുന്ന.
लक्षा_वसून_पयस: ലക്ഷ്യഹീനമായ.
लग्न_जाल्लें: വിവാഹിതന്‍ കല്യാണം_കഴിഞ്ഞവന്‍.
लग्न_थरिल्लें: വാഗ്ദാനം_ചെയ്യപ്പെട്ട വാക്കു_കൊടുക്കപ്പെട്ട വാക്കു_കൊടുത്ത കരാറ്_ചെയ്ത.
लग्नाचें: വിവാഹപ്രായമായ വിവാഹം_ചെയ്യപ്പെടതക്ക.
लज_नाशिल्लो: നാണ്മില്ലാത്ത.
लजेची: ലജ്ജാവഹമായ അപമാനകരമായ.
लजेस्त: ലജ്ജാശീലമുള്ള നാണമുള്ള
लटकें: നുണ കള്ളം അസത്യം ആശ്രയമില്ലാത്ത അടിസ്ഥാനമില്ലാത്ത. പ്രകടനപരമായ കപടമായ ക്രിത്രിമമായ.
लटको: തെമ്മാടി പോക്കിരി താന്തോന്നി ആഭാസന്‍ നെറികെട്ടവന്‍ ക്രിത്രിമമായ_രേഖയുണ്ടക്കുന്ന വ്യാജമായ_രേഖയുണ്ടാക്കുന്ന തെറ്റായ_രേഖയുണ്ടാക്കുന്ന.
लडकें: ക്രിത്രിമമായ.
लफड्याचें: പ്രയാസമുള്ള കുഴപ്പം_പിടിച്ച വിഷമമുള്ള ആയാസമുള്ള.
लवचीक: വളയുന്ന വഴങ്ങുന്ന.
लांकडाचें: വിറകിന്റെ തടിയുടെ.
लांचखोर: കൈക്കൂലിക്കാരന്‍.
लांडें: ചിറകൊടിഞ്ഞ
लांब: നീണ്ട നീളമുള്ള ദീറ്ഘ നീളമുള്ള നീണ്ട നെടിയ.
लांब-रुंद: നീണ്ട നീളമുള്ള
लांब_काळाचें: നീണ്ട_കാലത്തെ.
लाओ: ലാവൊയുടെ ലവോ.
लाओशियन: ലവോ.
लाखावें: ലക്ഷത്തിന്റെ
लागचें: അടുത്തുള്ള.
लागपी: മ്ര്‌ദുവായ നേറ്മ്മയുള്ള‌ കനം_കുറഞ്ഞ ആറ്ദ്രമായ സൌമ്യതയുള്ള.
लागवडीचें: ക്ര്‌ഷിക്ക്_ഉപയുക്തമായ ക്ര്‌ഷിക്ക്_യോഗ്യമായ ക്ര്‌ഷി_ചെയ്യാന്‍_കൊള്ളാവുന്ന.
लागींचे: അടുത്തു_വന്ന അടുത്തെത്തിയ.
लागींचें: അടുത്തുള്ള. ഏറ്റവും_അടുത്തുള്ള സമീപത്തുള്ള തൊട്ടടുത്തുള്ള.
लाचार: സന്ദേഹമില്ലാതെ ധാരണയോടെ ഉപായത്തോടെ നിശ്ചയത്തോടെ ധൈര്യത്തോടെ ഉറ്പ്പോടെ തീറ്ച്ചയോടെ. നിസ്സഹായനായ നിര്ബന്ധിതനായ
लाजरें: ലജ്ജാശീലമുള്ള നാണമുള്ള
लातवियायी: ലാത്വിയായിലെ ലാത്വിയായിലെ.
लाबदिणें: ലാഭദായകം ഗുണകരം ഉപയോഗപ്രദം.
लाभहीण: ലാഭഹീനമായ.
लाभार्थी: ലാഭം_കൊയ്യുന്ന.
लाल: ചുവന്ന്.
लाशिल्लें: കത്തി_ദഹിച്ച.
लिंगीक: ലൈങ്ഗിക
लिकलिकपी: പ്രശോഭിക്കുന്ന തിളങ്ങുന്ന മിന്നുന്ന ശോഭിക്കുന്ന ജ്വലിക്കുന്ന സ്ഫുരിക്കുന്ന ദ്യോതിപ്പിക്കുന്ന മിനുങ്ങുന്ന ഉജ്ജ്വലിക്കുന്ന.
लिकलिकीत: തിളങ്ങുന്ന ശോഭയുള്ള പ്രഭയുള്ള പകിട്ടുള്ള കാന്തിയുള്ള സ്ഫുരിക്കുന്നപ്രകാശിക്കുന്ന
लिकलीकपी: തേജസ്സാര്ന്ന തിളങുന്ന.
लिखीत: എഴുതിയ.. ലേഖകന്‍_എഴുതിയ.
लिपयिल्लें: നിഗൂഢത മറയ്ക്കപ്പെട്ട് ഒളിയ്ക്കപ്പെട്ട്.
लिबियायी: ലിബിയന്.
लिबेरियायी: ലൈബീരിയന്.
लुकसाणदिणें: ദോഷം_ചെയ്യുന്ന നാശം_ചെയ്യുന്ന.
लुकसाणीचें: ദോഷം_ചെയ്യുന്ന നാശം_ചെയ്യുന്ന.
लुकसाणीचो: ലാഭഹീനമായ.
लुटिल्लें: അപഹരിക്കപ്പെട്ട്. അപഹരിക്കപ്പെട്ട.
लुडबें: കൊഞ്ചി_പ്പറയുന്ന
लुप्त: വംശനാശം_സംഭവിച്ചത്.
लुळोपांगळो: അംഗവിഹീന വികലാംഗ അംഗഭംഗ അംഗവൈകല്യമുള്ള കോട്ടം_വന്ന ശരീരക്ഷ്തം_വന്ന.
लेंवाळ: രോമമുള്ള.
लेबनानी: ലബനോനിയന്‍.
लेबनीज: ലബനോനിയന്‍.
लेबनीस: ലബനോനിയന്‍.
लैंगीक: ലൈങ്ഗിക
लोककल्याणकारी: ജനങള്‍ക്കു്ഗുണം_ചെയ്യുന്നപ്രവ്ര്‌ത്തി ജനങള്‍ക്കു്_ഹിതമായതു്.
लोकचर्चीत: വളരെ_ചറ്ച്ചചെയ്യപ്പെട്ട വളരെ_വിചിന്തനം_ചെയ്യപ്പെട്ട.
लोकरी: കമ്പിളി.
लोकांमुखी: കേള്വി_കേട്ട.
लोकांमौखीक: കേള്വി_കേട്ട.
लोकाचें: മറ്രുള്ളവരുടെ അന്യരുടെ അന്യമായ വേറെ_ആയ വൈദേശികമായ വിദേശിയായ തറ്റേതല്ലാത്ത പുറമേയുള്ള മറ്രൊന്നായ മറ്രേതായ ഇതരമായ സ്വന്തമല്ലാത്ത അപര.
लोकोपयोगी: ജനങ്ല്ക്കുപകാരപ്രദമായത്.
लोकोपेगी: ജനങ്ല്ക്കുപകാരപ്രദമായത്.
लोखंडाचें: ഇരുമ്പുകൊണ്ടുള്ള.
लोखंडी: ഇരുമ്പുകൊണ്ടുള്ള.
लोभी: സ്വാര്‍ത്ഥ_താത്പര്യമുള്ള തങ്കാര്യത്തിലുള്ള_ശ്രദ്ധയുള്ള സ്വാര്‍ത്ഥ_ബുദ്ധിയുള്ള സ്വതാത്പര്യ്മുള്ള ആത്മാരാധന അഹങ്കാരോന്മാദിയായ പൊങച്ചം_കാണിക്കുന്ന സ്വജന_പക്ഷപാതമുള്ള ഭൌതിക_താത്പര്യങളുള്ളൈടുങിയ_മനസ്ത്ഥിതിയുള്ള_.
लोळकें: മുഷിഞ്ഞ ശുചിയല്ലാത്ത അഴുക്കായ മലിനപ്പെട്ട വൃത്തിഹീനമായ
लोळिल्लें: മുഷിഞ്ഞ ശുചിയല്ലാത്ത അഴുക്കായ മലിനപ്പെട്ട വൃത്തിഹീനമായ
ल्हव: കനം_കുറഞ്ഞ
ल्हव_ल्हव: മന്ദം സാവധാനം
ल्हान: ഇളയ പ്രായം_കുറഞ്ഞ. അപ്രധാനമായപങ്കു_വഹിക്കുന്ന_അനുജന്‍. ചെറിയ ചെറിയ.
ल्हान-सान: അല്ലറ_ചില്ലറ
ल्हान_ल्हान: ചെറിയ_ചെറിയ.
ल्हान_व्हड: ചെറിയതും_വലിയതഉമായ.
ल्हारांचो: തിരയടിക്കുന്ന ഇളകുന്ന.
वंचीत: എടുത്തു_കളയപ്പെട്ട രഹിതമായ ചതിക്കപ്പെട്ട വഞ്ചിക്കപ്പെട്ട.
वंशावळीचें: പിന്തുടര്‍ച്ചയായി_ലഭിച്ച.
वक्र: വിരൂപമായ.
वखदी: ഔഷധങള്_സംബന്ധിച്ച.
वचनबद्ध: വാക്ക്_കൊടുത്തിട്ടുള്ള
वजनदार: ഭാരിച്ച കനത്ത തൂക്കമുള്ള
वजनी: മഹത്ത്വമുള്ള ശ്രേഷ്ഠമായ ഗംഭീരമായ ഉല്ക്ര്ഷ്ടമായ പ്രൌഢമായ ഉത്തമമായ വിശിഷ്ഠമായ സ്തുത്യറ്ഹമായ മികച്ച മഹിമയുള്ള.
वट्ट: ആകെ മുഴുവനും ഒട്ടാകെ ആകപ്പാടെ
वनस्पतीहीण: സാസ്യങ്ങളില്ലാത്ത.
वयर_आयिल्लो: ഉദിച്ച ഉയര്ന്ന.
वयर_दिल्लो: മേല്പറഞ്ഞ മുമ്പേ_പറയപ്പെട്ട
वयरचो: മുകളിലുള്ള.
वयरसकयल: പരുപരുപ്പുള്ള ഉയര്‍ന്നതും_താണതുമായ തുല്യമല്ലാത്ത പൊങിറ്യതും_താണതുമായ കുണ്ടും_കുഴിയുമായ യോജിക്കാത്ത ചേര്‍ച്ചയില്ലാത്ത.
वयले: ഉയര്ന്ന്.
वयलें: ഉയര്‍ന്ന പൊക്കമുള്ള
वयलो: മേല്പറഞ്ഞ മുമ്പേ_പറയപ്പെട്ട മുകളിലുള്ള.
वयल्या_कुळांतलो: ഉന്നതകുലജാതനായ.
वयल्यावयलें: പ്രകടനപരമായ കപടമായ ക്രിത്രിമമായ.
वयस्क: പ്രായ_പൂര്ത്തിയായ.
वरिश्ठ: വയസ്സായ. ഏറ്റവും_പ്രായം_കൂടിയത്.
वर्ग: സമമായ തുല്യമൂല്യമായ.
वर्जीत: നിഷേധിക്കപ്പെട്ടത് നിരോധിക്കപ്പെട്ട തടയപ്പെട്ട.
वर्ज्य: നിഷേധിക്കപ്പെട്ടത് നിരോധിക്കപ്പെട്ട തടയപ്പെട്ട.
वर्णना_बगरचें: വര്ണ്ണിക്കാത്ത്
वर्णनीय: വര്‍ണ്ണിക്കാവുന്നത്.
वर्णी: നിറമുള്ള വറ്ണ്ണമുള്ള
वर्तमान: വറ്ത്തമാനകാലത്തുള്ള വറ്ത്തമാനസമയത്തുള്ള ഇപ്പൊഴുള്ള ഇന്നത്തെ വറ്ത്തമാനമായ.
वर्तमान_काळ: നിലവിലുള്ള്_കാലത്തെ
वर्सभराच्यो: നിത്യഹരിതം പന്ത്രണ്ടു_മാസം_മുഴുവനും_നീണ്ടു_നില്ലക്കുന്ന.
वर्साचें: വാര്‍ഷികം.
वर्सुकी: ഒരു_വര്‍ഷം_നീണ്ടു_നില്‍ക്കുന്ന_ചെടി.
वलें: നനവുള്ള ഈറനായ ആറ്‍ദ്രമായ കുതിറ്‍ന്ന ഈറ്‍പ്പമുള്ള
वळखीचें: അറിവുള്ള പേരു_കേട്ട. അറിയാവുന്ന.
वळखीचो: പരിചയമുള്ള.
वळखुपा_सारकें: പര്യവേക്ഷണത്തില്‍_നിന്ന്_കിട്ടുന്ന_വിശിഷ്ട്ട_ജ്ഞാനം.
वळणाचें: വളവും_തിരിവും_ഉള്ള_.
वळेरेंत: ക്രമത്തിലുള്ള.
वशिल्लें: താമസിക്കുന്ന നില്‍ക്കാന്‍_യോഗ്യമ്മായ.
वशीकरण: വശീകരിക്കല്‍
वसणुकेचें: വസിക്കുന്നതിനുള്ള.
वसतीघरवासी: വിദ്യാര്‍ഥികളുടെ_പാര്‍പ്പിടത്തില്‍_നില്‍ക്കുന്ന്.
वसाड: വാസമില്ലാത്ത നശിച്ചു_പോയ ഉപേക്ഷിച്ച അന്യമായ. വിജനമാ‍യ ആള്‍പാറ്പ്പില്ലാത്ത ജനങ്ങളില്ലാത്ത നിറ്ജ്ജനമായ മനുഷ്യരില്ലാത്ത സഹവാസമില്ലാത്ത.
वांकडो: വളഞ്ഞ വക്രതയുള്ള ചുറ്റിക്കുന്ന
वांकडो-तिकडो: വളഞ്ഞ വക്രതയുള്ള ചുറ്റിക്കുന്ന
वांगडी_आशिल्लो: കൂട്ടുകാരോടു_കൂടിയ.
वांगडें: വിരൂപമായ.
वाकडें: കുനിയിക്കപ്പെട്ടവന്‍. വക്രമായ
वाकिल्लें: മുന്നോട്ടു_കുനിഞ്ഞ.
वाक्प्रचारांनी_भरिल्लें: ചൊല്ലുകളെ_സം‍ബന്ധിക്കുന്ന.
वाचक: പറയുന്ന വിവരിക്കുന്ന.
वाचपा_योग्य: വായനായോഗ്യമായ
वाचपा_सारकें: വായനായോഗ്യമായ
वाचपायोग्य: വായിക്കുവാന്_പറ്റിയ
वाचयिल्लें: ഗ്രഹിക്കപ്പെട്ട
वाचाळ: വചാലന്‍ അതി_ഭാഷി.
वाचीक: വായിക്കുവാന്_പറ്റിയ
वाच्यनीय: വായനായോഗ്യമായ
वाट_पळोवपी: പ്രതീക്ഷിച്ചിരിന്ന കാത്തിരിന്ന
वाटकुळें: ഗോളാകൃതി വൃത്താകൃതി
वाटायिल्लें: ഗ്രഹിക്കപ്പെട്ട
वाठारी: പ്രദേശത്തെ_സംബന്ധിക്കുന്ന.
वाडयिल्ली: കൂട്ടിചേര്‍ത്ത
वाडयिल्लें: വിസ്തരിച്ച
वाडिल्लें: വളര്ന്നുകൊണ്ടിരിക്കുന്ന
वाडोवपी: വര്ദ്ധിപ്പിക്കുന്ന.
वादग्रस्त: തര്‍ക്കിക്കപ്പെടാവുന്ന വിവാദത്തിനു_കാരണമാകാവുന്ന.
वादाचें: തര്‍ക്കിക്കപ്പെടാവുന്ന വിവാദത്തിനു_കാരണമാകാവുന്ന.
वादास्पद: തര്‍ക്കിക്കപ്പെടാവുന്ന വിവാദത്തിനു_കാരണമാകാവുന്ന.
वान्शे_विरयत: ആഗ്രഹമില്ലാത്ത_പക്ഷപാതമില്ലാത്ത.
वापराचें: ഉപയോഗമുള്ള പ്രയോജനമുള്ള ഉപയോഗമുള്ള ഗുണമുള്ള പ്രയോജനകരമായ പ്രയോജനപ്രദമായ ഉപയോഗയോഗ്യമായ യൌഗികമായ പ്രയുക്തമായ കൊള്ളാവുന്ന പറ്റിയ.
वापरिल्लें: പ്രയോഗിച്ച ഉപയോഗിച്ച.
वाफेचें: വാറ്റിയ
वायट: ചീത്ത_ആശയം ചീത്ത_ലക്ഷ്യം ദ്രോഹബുദ്ധി. മുഷിഞ്ഞ ശുചിയല്ലാത്ത അഴുക്കായ മലിനപ്പെട്ട വൃത്തിഹീനമായ ബസാറിനോട്_ബന്ധപ്പെട്ട തരം_താണ്. നീചമായ ഹീനമായ. വിപരീതമായ പ്രതികൂലമായ. ചീത്ത മോശമായ അളിഞ്ഞ.
वायट_उलोवपी: ഇഷ്ട്ടമില്ലാത്തത്_സംസാരിക്കുന്ന സ്നേഹന്മില്ലാത്തതു_പറയുന്ന.
वायट_करपी: ദുഷ്കര്‍മ്മം_ചെയുന്നവന്‍.
वायट_गूण: ദുര്ഗുണ്ങളുള്ള
वायट_चिंतपी: അമംഗളകരം_ഇഷ്ട്ടപ്പെടുന്നവന് അശുഭ_ചിന്തകന്ന്.
वायट_वेव्हारी: ദുര്വ്യവഹാരികള്.
वायट_सभावाचो: ദുസ്വഭാവിയ്യായ ചീത്ത_സ്വഭാവമുള്ള
वायटकार: രോഗി രോഗാതുരന്‍ രോഗബാധിതന്‍
वावडी: കേട്ടു_കേള്‍വി.
वासनाहीण: അതീന്ദ്രിയമായ.
वासाचें: സുഗന്ധമുള്ള.
वास्तवीक: വാസ്തവികമായ യദാര്ഥമായ.
वाहक: വാഹിനി. സാധനങ്ങ്ള്‍_കൊണ്ട്പോകുന്ന. പ്രവാഹകന്‍.
विंगडविंगड: പലവിധേനയുള്ള
विकत_हाडिल्लें: വാങ്ങിയ.
विकतें_घेतिल्लें: വാങ്ങിയ.
विकपाच्यो: വില്പ്പനചരക്ക്.
विकल्पी: ഇച്ഛയനുസരിച്ചുള്ള തിരഞെടുക്കാനുള്ള ആഗ്രഹന്മനുസരിച്ചുള്ള തിതമനുസരിച്ചുള്ള അഭിലാഷം_അനുസരിച്ചുള്ള ഇച്ഛിത ഉദ്ദിഷ്ടമായ താ‍ത്പര്യമുള്ള തിതകരമായ.
विकसीत: പുരോഗതിയുള്ള ഉയര്‍ച്ചയുള്ള ഉന്നതിയുള്ള. വികസിതമായ.
विकासकर्तो: പുരോഗമന_വാദി.
विकासशील: മുന്നേറുന്ന.
विकिल्लें: വിറ്റഴിഞ്ഞ.
विकृत: മോശമായ ചീത്തയായ.
विक्रमी: വിക്രമമുള്ള ബലമുള്ള ശൂരതയുള്ള.
विक्राळ: ഭയാനകമായ ഭീകരമായ ഉഗ്രമായ ഞെട്ടിക്കുന്ന ഭീതിജനകമായ ഭയാവഹമായ രുദ്രമായ
विक्रेच्यो: വില്പ്പനചരക്ക്.
विखंडी: മുറിക്കുന്ന
विखाचें: വിഷമുള്ള വിഷം_കലര്‍ന്ന വിഷം_നിറഞ്ഞ.
विखारी: വിഷമുള്ള വിഷം_കലര്‍ന്ന വിഷം_നിറഞ്ഞ. വിഷതുല്യമായ.
विखाळ: വിഷമുള്ള വിഷം_കലര്‍ന്ന വിഷം_നിറഞ്ഞ. വിഷതുല്യമായ.
विचलीत: ശാന്തമല്ലാത്ത.
विचार_करपाचें: ചിന്തനീയമായ ചര്‍ച്ചാവിഷയമാകാന്‍_പറ്റിയ സന്ദിഗ്ദ്ധമായ പരിശോധിക്കപ്പെടേണ്ടതായ.
विचार_केल्लें: വിചാരിക്കപ്പെട്ട ചര്‍ച്ച_ചെയ്യപ്പെട്ട.
विचार_जाल्लें: വിചാരിക്കപ്പെട്ട ചര്‍ച്ച_ചെയ്യപ്പെട്ട.
विचारशील: വേണ്ട്വിധം_പഠനം_ചെയ്യപ്പെടുക
विचारशुन्य: ശ്രദ്ധയില്ലാത്ത.
विचारहीण: ശ്രദ്ധയില്ലാത്ത.
विचारी: ചിന്തനീയമായ ചര്‍ച്ചാവിഷയമാകാന്‍_പറ്റിയ സന്ദിഗ്ദ്ധമായ പരിശോധിക്കപ്പെടേണ്ടതായ.
विचारीक: ചിന്തയോറ്ടു_കൂടിയ
विचित्र: അസ്വാഭാവികമായ. അസാമാന്യമായ അത്ഭുതകരമായ വിസ്മയകരമായ.
विजयी: സഫലമായ വിജയകരമായ.
विजातीय: വിഭിന്ന_ജാതിയിപ്പെട്ട.
विजेवरी: മിന്നല്‍_രൂപിയായ
विज्ञानीक: ശാസ്ത്രപരമായ.
विटिल्लें: മടുപ്പ് മുഷിച്ചില്.
वितळिल्लें: ഉരുക്കിയ
विदेशी: വിദേശി അന്യദേശക്കാരന്‍ വൈദേശികന്‍ അന്യന്‍ അന്യദിക്കുകാരന്‍ കുടിയേറ്രക്കാരന്‍.
विद्यालयीन: വിദ്യാലയത്തിലെ
विद्रूप: വിരൂപനായ വിലക്ഷണമായ ഭംഗിയില്ലാത്ത വികൃതമായ മോശമായ ചീത്തയായ.
विद्वत्तापूर्ण: പാണ്ഡിത്യമുള്ള.
विद्वान: വിദ്വാന്‍മാരായിട്ടുളള പാണ്ഡിത്യമുള്ള അറിവുള്ള
विधीलिखीत: മുന്പേ_നിശ്ചയിച്ച.
विनम्र: വിനീതമായ_പെരുമാറ്റമുള്ള.
विनयी: സത്യസന്ധനായ നെറിയുള്ള വിശ്വസ്തനായ
विनवणेचें: അപേക്ഷ_സമര്‍പ്പിക്കുന്ന.
विनाकारण: അകാരണമായ
विनोदी: നര്‍മ്മബോധമുള്ള രസികത്വമുള്ള
विपक्षी: പ്രതിപക്ഷത്തിലുള്ള എതിറ്പക്ഷത്തിലുള്ള.
विपक्षीय: പ്രതിപക്ഷത്തിലുള്ള എതിറ്പക്ഷത്തിലുള്ള.
विभागणी: വേര്തിരിക്കുക.
विभागी: പ്രദേശത്തെ_സംബന്ധിക്കുന്ന. വകുപ്പനുസരിച്ചുള്ള
विभुशीत: അലംകരിക്കപ്പെട്ട ഒരുക്കപ്പെട്ട. അലങ്കരിച്ച ആഭരണമണിഞ്ഞ അലങ്ക്ര്തമായ.
विमूख: ലക്ഷ്യഹീനമായ.
वियेतनामी: വിയത്നാമിന്റെ.
विरक्त: വിരക്ത്തിയുള്ള_.
विरळ: ഇടതൂര്ന്നതല്ലാത്ത.
विरुद्ध: വിപരീതമ്മയ്. വിപരീതം.
विरुध्दार्थी: വിപരീതമായ
विरूपाक्ष: വിരൂപമായ_കണ്ണുകളുള്ള.
विरोधा_बगरचें: തിരിചചടിയില്ലാത്ത.
विरोधी: എതിര്‍ക്കപ്പെട്ട് തടയ്പ്പെട്ട്. വിരോധമുള്ള എതിര്‍പ്പുള്ള പ്രതിപക്ഷ_കക്ഷിയില്‍പ്പെട്ട.
विरोधी_अर्थी: വിപരീതമായ
विलक्षण: അസാമാന്യമായ അത്ഭുതകരമായ വിസ്മയകരമായ.
विलासी: കാമിയായ കാമ_വികാരമുള്ള ക്രീഡാസക്തിയുള്ള. സ്ത്രീ_ലംബടനായ വിലാസപ്രിയനായ ഭോഗപ്രിയനായ.
विवरणात्मक: വിസദീകരിക്കാവുന്ന
विवश: നിസ്സഹായനായ നിര്ബന്ധിതനായ
विवादास्पद: തര്‍ക്കിക്കപ്പെടാവുന്ന വിവാദത്തിനു_കാരണമാകാവുന്ന.
विवाहीत: വിവാഹിതന്‍ കല്യാണം_കഴിഞ്ഞവന്‍.
विवीध: അനേകം ഒന്നിലധികമായ പല വളരെയേറേ അസംഖ്യം.
विवेकी: വിവേചനശക്തിയുള്ള തിരിച്ചറിവുള്ള ശരിയായ_ജ്ഞാനമുള്ള.
विशाचें: വിഷമുള്ള വിഷം_കലര്‍ന്ന വിഷം_നിറഞ്ഞ.
विशारी: വിഷമുള്ള വിഷം_കലര്‍ന്ന വിഷം_നിറഞ്ഞ. വിഷതുല്യമായ.
विशाळ: വലിയ വലുതായ വലിപ്പമുള്ള വന്‍ വമ്പിച്ച ബഹു വിപുലമായ പെരുത്ത വിശാലമായ വിസ്ത്ര്തമായ വ്യാപകമായ പരന്ന വണ്ണമുള്ള.
विशाळकाय: ഭീമകായനായ വളരേ_വലിയ.
विशीं: സംബന്ധമായ സംബന്ധിക്കുന്ന.
विशेश: വിശേഷതയുള്ള ശ്രേഷ്ഠമായ നിശ്ചിതമായ. വിശേഷവും
विश्वविजेतो: ലോകം_ജയിച്ചവന്‍.
विश्वव्यापी: ലോകം_മുഴുവനും
विश्वासघातकी: വിശ്വാസവഞ്ചന_ചെയ്യുന്ന.
विश्वासी: വിശ്വാസമുള്ള.
विसंगत: അനുചിതമായ അയുക്‌തമായ ശരിയല്ലാത്ത ഔചിത്യമില്ല്ലാത്ത അരുതാത്ത
विसरिल्लें: മറന്നു_പോയ.
विसवदिणी: വിശ്രമദായകമായ വിശ്രമം_നല്കുന്ന ക്ഷീണമകറ്റുന്ന ആശ്വാസം_നല്കുന്ന.
विसावो: ഇരുപതാം
विस्कळ: ഇടതൂര്ന്നതല്ലാത്ത.
विस्कळीत: ക്രമപ്പെടുത്തപ്പെടാത്ത വ്യവസ്ഥയില്ലാത്ത മര്യാദയില്ലാത്ത. സ്ഥാനത്തു_നിന്നു_നീക്കിയ സ്ഥലത്തു_നിന്നു_അകറ്റപ്പെട്ട.
विस्तारीत: വിസ്തരിച്ച
विस्तीर्ण: പരന്ന വ്യാപിച്ചിരിക്കുന്ന.
विस्थापीत: സ്ഥാനത്തു_നിന്നു_നീക്കിയ സ്ഥലത്തു_നിന്നു_അകറ്റപ്പെട്ട.
विस्वासू: വിശ്വസിക്കാവുന്ന വിശ്വസനീയമായ വിശ്വസ്തനായ വിശ്വസാമുള്ള വിശ്വസ്ത വിശ്വാസിയായ.
वीज.: വൈദ്യുതിയുടെ.
वीर: വീരന്‍ ധൈര്യശാലി നിര്‍ഭയന്‍
वीरतायेचें: ധൈര്യപൂറ്വ്വം ധീരതയോടെ ധൈര്യത്തോടെ വീര്യത്തോടെ തന്റേടത്തോടെ മനക്കരുത്തോടെ.
वेंचणूक: തെരഞ്ഞെടുപ്പ്.
वेंचिल्ली: നിയുക്തനാക്കിയ.
वेंचिल्लें: വേര്പ്പെടുത്തുക.
वेगळी: അസ്വാഭാവികമായ.
वेगळे: വ്യത്യസ്ഥമായ ഭിന്നമായ
वेगळें: വിപരീതമ്മയ്.
वेगळेंवेगळें: പലവിധേനയുള്ള
वेगवेगळें: പലവിധേനയുള്ള
वेगहीण: ചലനമില്ലാത്ത ചലിക്കാത്ത ഗതിരോധമുള്ള.
वेगाचे: പ്രബലമായി.
वेगाचें: ചലനാത്മകമായ പുരോഗമനപരമായ ക്രിയാത്മകമായ. കൊടുംകാറ്റിനോടു_ബന്ധപ്പെട്ട. വേഗതയുള്ള. വേഗതയുള്ള.
वेगान: വേഗതയുള്ള ചുണയുള്ള തീക്ഷ്ണമായ.
वेनिजुएला: വെനിസ്വേലേയനായ വെനിസ്വേലേയന്
वेळ_पाळपी: സമയം_പാലിക്കുന്ന സമയത്തില്‍_ബന്ധിക്കപ്പെട്ട നിയമം_പാലിക്കുന്ന.
वेळ_पाळिनासपी: സമയം_പാലിക്കാത്തവന്‍.
वेळार: സമയോചിതമായ സന്ദര്‍ഭത്തിനു_ചേര്‍ന്ന സമകാലീനമായ.
वेवस्थीत: ക്രമപ്പെടുത്തപ്പെട്ട നിശ്ച്ചിതമായ വ്യവസ്ഥപ്പെടുത്തിയ. നന്നായി_ക്രമപ്പെടുത്തപ്പെട്ട സുനിശ്ചിതമായ. സുരക്ഷിതമായ.
वेव्हारी: പെരുമാറുന്നതില്‍_സമര്‍ഥനായ. കഠോരം ദ്രിഢം ക്ലേശകരമായ. ഉപയോഗമുള്ള ഗുണമുള്ള പ്രയോജനകരമായ പ്രയോജനപ്രദമായ ഉപയോഗയോഗ്യമായ യൌഗികമായ പ്രയുക്തമായ കൊള്ളാവുന്ന പറ്റിയ.
वेश्टिल्लो: മൂടിയ നിറഞ്ഞ.
वेश्यागामी: വേശ്യയെ_പ്രാപിക്കുന്ന.
वैचारीक: ചിന്തയോറ്ടു_കൂടിയ
वैतनीक: ശംബളം_പറ്റി_ജോലി__ചെയ്യുന്ന.
वैभवशाली: ധനികനായ പണക്കാരനായ
वैयक्तीक: വ്യക്തിപരമായ സ്വകാര്യ്മായ തനതായ സ്വയംക്ര്‌തമായ സ്വീയമായ സ്വകീയമായ തന്റ്റേതായ സ്വന്തമായ രഹസ്യമായ വൈക്ത്യമായ അനന്യമായ.
वैरपणाचो: ശത്രു_ഭാവത്തോടു_കൂടി വൈരാഗ്യപൂര്‍വ്വം_.
वैरी: ശത്രുപൂര്‍ണ്ണം വിരോധമുള്ള വൈരിയുള്ള.
व्यंगात्मक: പരിഹാസപൂര്‍വം
व्यंगीक: പരിഹാസപൂര്‍വം
व्यक्त: വ്യക്തമാക്കപ്പെട്ട സ്പഷ്ട്ടമായ.
व्यक्तीगत: വ്യക്തിപരമായ സ്വകാര്യ്മായ തനതായ സ്വയംക്ര്‌തമായ സ്വീയമായ സ്വകീയമായ തന്റ്റേതായ സ്വന്തമായ രഹസ്യമായ വൈക്ത്യമായ അനന്യമായ.
व्यभिचारी: നീച_വികാരങളുള്ള കാമാദ്ദീപകമായ. പരപുരുഷനുമായി_ലൈംഗികബന്ധം_പുലര്ത്തുന്നവള്.
व्यस्त: തിരക്കുള്ള
व्याकूळ: ഇളകിമറിഞ്ഞ തകിടം_മറിഞ്ഞ.
व्यापक: പരന്ന വ്യാപിച്ചിരിക്കുന്ന.
व्यायामी: വ്യായമത്തിന്റെ വ്യായമം_സംബന്ധിച്ച കസറ്ത്തിന്റെ ശാരീരികഭ്യാസത്തിന്റെ.
व्हड: മഹാനായ ശ്രേഷ്ഠനായ ഉന്നതനായ വിശിഷ്ടനായ നീണ്ട നീളമുള്ള വലിയ വലുതായ വലിപ്പമുള്ള വന്‍ വമ്പിച്ച ബഹു വിപുലമായ പെരുത്ത വിശാലമായ വിസ്ത്ര്തമായ വ്യാപകമായ പരന്ന വണ്ണമുള്ള. വലിയ
व्हड-मनाचो: ഉദാരമതിയായ വിശാലഹ്രിദയനായ .
व्हड_आंकडो: വളരേ_അധികം.
व्हड_काळजाचो: ഉദാരമതിയായ വിശാലഹ്രിദയനായ .
व्हडली: ഭാരിച്ച.
व्हडलें: വലിയ വലുതായ വലിപ്പമുള്ള വന്‍ വമ്പിച്ച ബഹു വിപുലമായ പെരുത്ത വിശാലമായ വിസ്ത്ര്തമായ വ്യാപകമായ പരന്ന വണ്ണമുള്ള.
व्हांवतें: ഒഴുക്ന്ന ഒഴുക്കിന്റെ_ഗതി തുടര്‍ച്ചയായ_ഗതി ശക്തിയേറിയ_പാച്ചില്‍ നീരൊഴുക്കു് തുടര്‍ച്ചയായ_ഗതി നിരന്തരമായി_പ്രവഹിക്കുന്ന.
व्हांवपी: ഒഴുക്ന്ന ഒഴുക്കിന്റെ_ഗതി തുടര്‍ച്ചയായ_ഗതി ശക്തിയേറിയ_പാച്ചില്‍ നീരൊഴുക്കു് തുടര്‍ച്ചയായ_ഗതി നിരന്തരമായി_പ്രവഹിക്കുന്ന.
शंखाचो: ശങ്ഖിന്റെ.
शंखाच्यो: ശങ്ഖിന്റേത്.
शंबरावें: നൂറാമത്തെ.
शक्य: സംഭവ്യമായ.
शटकोनी: ആറു_കോണുകളുള്ള ആറു_വശ്ങ്ങളുള്ള.
शत्रुजीत: ശത്രുവിനെ_ജയിക്കുന്ന.
शत्रुहीण: ശത്രുഹീനന്.
शब्दाचें: വാക്കുകളെ_സംബന്ധിക്കുന്ന.
शरण_आयिल्लो: ശരണം_പ്രപിച്ച ആശ്രയത്തില്_വന്ന.
शरणागत: ശരണം_പ്രപിച്ച ആശ്രയത്തില്_വന്ന.
शरीरहीण: ദേഹമില്ലാത്ത.
शर्मेची: ലജ്ജാവഹമായ അപമാനകരമായ.
शस्त्रधारी: ശസ്ത്ര_ധാരി. ആയുധധാരികളായ ആയുധം_ധരിച്ച ആയുധം_കൈയിലുള്ള.
शांत: സൌമ്യനായ. സൌമ്യമ്മായ സുശീലയായ. ഗൌരവമുള്ള പതറാത്ത സുദൃഢമായ സുസ്ഥിരമായ ശാന്തമായ നിശ്ചേഷ്ട്ടമായ അടക്കമുള്ള. വളരേ_ശാന്തമായ_മനസ്സുള്ള. ക്രോധമില്ലാത്ത്. ഉത്കണ്ഠയില്ലാത്ത ശ്രദ്ധയുള്ള.
शांयश्यावें: എണ്പത്തിയാറാം
शाखा: ശാഖകളുള്ള.
शाणो: അകലെ_കാണുന്ന വിവേകമുള്ള പണ്ഡിതാന്‍.
शाण्णवावें: തൊണ്ണൂറ്റി_ആറാമത്തെ
शात्तरावें: എഴുപത്തി_ആറാം
शापोती: നിയന്ത്രണമില്ലാത്ത തോന്ന്യാസമുള്ള ധിക്കാരപരമായ.
शाब्दीक: വാക്കുകളെ_സംബന്ധിക്കുന്ന.
शारांतले: പട്ടണവാസി നഗരവാസി.
शारिकरणाचें: നഗരവത്കരിക്കപെട്ട പരിഷ്കരിക്കപ്പെട്ട വികസിതമായ.
शारिरीक: ശരീരമുള്ള
शारी: പട്ടണവാസി നഗരവാസി. മഹാനഗരങളെ_സംബന്ധിച്ച.
शारीकरणी: നഗരവത്കരിക്കപെട്ട പരിഷ്കരിക്കപ്പെട്ട വികസിതമായ.
शाळचें: വിദ്യാലയത്തിലെ
शाश्वत: എന്നും_നിലനില്ക്കുന്ന.
शासकी: തലപ്പത്തിരിക്കുന്ന.
शास्वत: നശിക്കാത്ത മായാത്ത സ്ഥായിയായ.
शिंगां_नाशिल्लें: കൊമ്പില്ലാത്തതായ.
शिंगाबगरचें: കൊമ്പില്ലാത്തതായ.
शिंदुरी: കുംകുമ_നിറമുള്ള.
शिंपडिल्लें: ചിതറിയ പരന്നു_കിടക്കുന്ന നുറുക്കുകളായ.
शिंपणेली: നനയ്ക്കുന്‍ന അടിക്കുന്ന വെള്ളം_ഒഴിക്കുന്ന.
शिंपिल्लें: നനയ്ക്കപ്പെട്ട.
शिंप्पी: നനയ്ക്കുന്‍ന അടിക്കുന്ന വെള്ളം_ഒഴിക്കുന്ന.
शिंविल्लें: നിരയനുസരിച്ചു_തുന്നിയ
शिकपी: അദ്ധ്യാപനം
शिकयिल्लें: പഠിപ്പിച്ച
शिकारी: നായാ‍ട്ടുകാരനായ വേട്ടക്കാരനായ.
शिकिल्लें: അഭ്യസ്‌തവിദ്യനായ വിദ്യാഭ്യാസമുള്ള
शिक्षीत: അഭ്യസ്‌തവിദ്യനായ വിദ്യാഭ്യാസമുള്ള
शिटूक: അകലെ_കാണുന്ന വിവേകമുള്ള പണ്ഡിതാന്‍. ചുറുചുറുക്കുള്ള ഉന്‍മേഷമുള്ള ചൊടിയുള്ള ഉത്സാഹമുള്ള ഊറ്‍ജ്ജസ്വലതയുള്ള പ്രസരിപ്പുള്ള ഓജസ്സുള്ള ചുണയുള്ള മിടുക്കുള്ള കുശാഗ്രബുദ്ധിമാനായ.
शिटूक.: നിപുണനായ സമര്‍ഥനായ മിടുക്കുള്ള ചാതുര്യമുള്ള
शिडशिडीत: മെലിഞ്ഞ
शितळ: തണുത്ത. തണുത്ത ശീതളമായ കുളിരുള്ള കുളിറ്‍മയുള്ള തണുപ്പേകുന്ന കുളിരേകുന്ന.
शिमा_रक्षक: അതിര്‍ത്തി_കാവല്‍ക്കാര്‍ അതിര്‍ത്തി_രക്ഷകര്‍.
शिमांकीत: അതിര്‍ത്തി_നിശ്ചയിച്ച.
शिमीत: അതിരുള്ള.
शिल्लक: മിച്ചം_വന്ന മിച്ചം_നില്‍ക്കുന്ന.
शिश्ट: ഉത്തമനായ സര്‍വ്വശ്റേഷ്ടനായ അതിവിശിഷ്ടനായ ഉല്‍കൃഷ്ടനായ അതുല്യനായ അദ്വിതീനായ മികവുള്ളവനായ
शिस्त_नाशिल्लो: ആത്മ_നിയന്ത്രണമില്ലാത്ത മിതത്വമില്ലാത്ത മിത_ഭോജി_അല്ലാത്ത സമചിത്തതയില്ലാത്ത.
शिस्तीची: അച്ചടക്ക_സംബന്ധിയായ നിഷ്കര്‍ഷണ_സംബന്ധിയായ അനുനയ_സംബന്ധിയായ.
शींगां_आशिल्लें: കൊമ്പുള്ള.
शीत: തണുപ്പേകുന്ന കുളിരേകുന്ന.
शीम_रक्षक: അതിര്‍ത്തി_കാവല്‍ക്കാര്‍ അതിര്‍ത്തി_രക്ഷകര്‍.
शीलवान: നല്ല_സ്വഭാവം_ഉള്ള.
शुद्ध: ശുദ്ധമായ ഒന്നാംതരമായ നിര്‍മ്മലമായ വിമലമായ പവിത്രമായ് ശുദ്ധമായ ശുദ്ധമായതു. ശുദ്ധമാക്കിയ.
शुल्लक: അല്ലറ_ചില്ലറ
शूर: വീരന്‍ ധൈര്യശാലി നിര്‍ഭയന്‍
शेणलेलो: വഴി_തെറ്റിയ ലക്ഷ്യമില്ലാതെ_അലയുന്ന അമ്പരമ്മു_പോകുന്ന.
शेणिल्लो: വഴി_തെറ്റിയ ലക്ഷ്യമില്ലാതെ_അലയുന്ന അമ്പരമ്മു_പോകുന്ന.
शेतकी: ക്ര്‌ഷിക്ക്_ഉപയുക്തമായ ക്ര്‌ഷിക്ക്_യോഗ്യമായ ക്ര്‌ഷി_ചെയ്യാന്‍_കൊള്ളാവുന്ന.
शेपडीहीण: വാലുമുറിഞ്ഞ.
शेपडे_बगरचें: വാലുമുറിഞ്ഞ.
शेपडे_विरयत: വാലുമുറിഞ്ഞ.
शेळें: പഴകിയ
शेष: മിച്ചം_വന്ന മിച്ചം_നില്‍ക്കുന്ന.
शोकहीण: ശോകരഹിതന്.
शोकांती: ദു
शोधक: അന്വേഷണ
शोधीत: ഗവേഷണപരമായ
शौकीन: സ്ത്രീ_ലംബടനായ വിലാസപ്രിയനായ ഭോഗപ്രിയനായ.
श्रवणीय: കേള്ക്കത്തക്ക. കേള്ക്കുവാന്_സാധിക്കുന്നത്.
श्रीमंत: ധനികനായ പണക്കാരനായ
श्रुंगारीत: വേഷമിട്ട.
श्रेष्ठ: മഹാനായ ശ്രേഷ്ഠനായ ഉന്നതനായ വിശിഷ്ടനായ
स_पटींनी: ആറുമടങ്ങ്
संकटग्रस्त: സംകടം_പിടിപ്പെട്ട വിഷമത്തില്പെട്ട വിഷമതയില്‍പെട്ട ദുറ്ഘടസ്ഥിതിയിലായ ദുഃഖപൂറ്ണ്ണനായ.
संकटनाशक: സംകട_മോചകന്.
संकटनाशी: സംകട_മോചകന്.
संकटमय: സംകടപ്രദമായ.
संकटाचें: സംകടപ്രദമായ.
संकलीत: ശേഖരിക്കപ്പെട്ട സമ്പാദിക്കപ്പെട്ട കൂട്ടിവയ്ക്കപ്പെട്ട കൂമ്പാരം_കൂട്ടിവെച്ച.
संकेतीक: ആംഗ്യം_കാണിച്ച അടയാളം_കാണിച്ച ചൂണ്ടിക്കാണിച്ച.
संगणकाचें: കമ്പ്യൂട്റ്ററിന്റെ
संगणकी: കമ്പ്യൂട്റ്ററിന്റെ
संगणकीकरणी: കമ്പ്യൂട്ടറ്വത്കരിച്ച കമ്പ്യൂട്ടറ്വത്ക്രിതമായ. കമ്പ്യൂട്ടറ്വത്കരിച്ച കമ്പ്യൂട്ടറ്വത്ക്രിതമായ.
संग्रहीत: ശേഖരിക്കപ്പെട്ട സമ്പാദിക്കപ്പെട്ട കൂട്ടിവയ്ക്കപ്പെട്ട കൂമ്പാരം_കൂട്ടിവെച്ച.
संघटनेचें: സംഘത്തിന്റെ
संघर्शशीळ: സംഘറ്ഷശീലമുള്ള കലപ്രിയനായ വഴക്കാളിയായ വിപ്ലവകാരിയായ കുഴപ്പകാരനായ.
संघर्शी: സംഘറ്ഷശീലമുള്ള കലപ്രിയനായ വഴക്കാളിയായ വിപ്ലവകാരിയായ കുഴപ്പകാരനായ.
संघर्शीत: സംഘറ്ഷമുണ്ടാക്കുന്ന വഴക്കുണ്ടാക്കുന്ന കലഹമുണ്ടാക്കുന്ന വിപ്ലവമുണ്ടാക്കുന്ന.
संघीय: സംഘത്തിന്റെ
संचारीत: നീക്കപ്പെട്ട.
संचालीत: നിയന്ത്രിക്കപ്പെട്ട നിര്‍വഹിക്കപ്പെട്ട.
संतती: സന്താന.
संतुश्ट: സന്തോഷമുള്ള_.
संतुश्टी: ത്രിപ്തിപ്പെടുത്തുന്നയാള്‍.
संथ: നിശ്ചലമായ
संदेश_दिवपी: സന്ദേശം_വഹിക്കുന്ന_.
संदेशवाहक: സന്ദേശം_വഹിക്കുന്ന_.
संप_करपी: സമരം_ചെയ്യുന്ന പണിമുടക്കുന്ന.
संपादीत: പ്രസിദ്ധീകരണയോഗ്യമാക്കപെട്ട.
संबंद_दवरिनासपी: നിയോഗമില്ലാത്ത
संबंदीं: സംബന്ധമായ സംബന്ധിക്കുന്ന.
संबंदीत: സംബന്ധിക്കുന്ന കുറിച്ചുള്ള.
संबोधक: സംബോധന_ചെയ്യുന്നവന്‍.
संभव: സംഭവ്യമായ.
संभोग_घेवपी: പിന്തുടരുന്ന അനുഗമിക്കുന്ന
संभोगी: പിന്തുടരുന്ന അനുഗമിക്കുന്ന
संयमी: സംയമനം_പാലിക്കുന്ന
संयोगी: യോജിപ്പിക്കുന്ന
संयोजक: യോജിപ്പിക്കുന്ന
संवगडी_आशिल्लो: കൂട്ടുകാരോടു_കൂടിയ.
संवसार_जिखपी: ലോകം_ജയിച്ചവന്‍.
संवसारीक: ഈ_ലോകത്തുള്ള ലൌഗികമായ. ലോകം_മുഴുവനും
संवेदनशीळ: സംവേദനശീലമുള്ള (എളുപ്പം_അനുഭൂതികള്_ഉള്കൊള്ളുന്ന്)
संवेदनाहारी: വേദന_സംഹാരി.
संशयी: സംശയം.
संशोधक: കണ്ടു_പിടിത്തം_നടത്തിയ_ആള്‍.
संसर्गीक: പകറ്ന്ന സംക്രമിച്ച.
संस्कारी: സംസ്കാരമുള്ള സംസ്ക്ര്തിയുള്ള പക്വതയുള്ള.
संस्कृत: സംസ്ക്രിതം
सकयलें: താഴെയുള്ള അടിയിലുള്ള കീഴെയുള്ള.
सकयलो: കുറഞ്ഞ ചെറിയതായ.
सकयल्ल्या__कुळाचें: താഴ്ന്ന_കുലത്തിലേ.
सकलें: പ്രാധാന്യമില്ലാത്ത.
सक्तीचें: അനിവാര്യം.
सक्रीय: ഏര്പ്പെട്ടിരിക്കുന്ന.
सक्षम: വൈദഗ്ദ്ധ്യം സാമര്ഥ്യം യോഗ്യത
सख्खें: കൂടെ_പിറന്ന.
सख्खो: എന്നെ_സംബന്ധിക്കുന്ന എന്റേതായ സ്വന്തം തന്റേതായ.
सगली: ആകെ മുഴുവനും ഒട്ടാകെ ആകപ്പാടെ
सगलें_खावपी: എല്ലാം_ഭക്ഷിക്കുന്ന എല്ലാം_കഴിക്കുന്ന എല്ലാം_ഭുജിക്കുന്ന.
सगल्या_गुणांनी_भरिल्लो: സ്ര്വ്വ_ഗുണ_സമ്പന്ന്.
सगल्यांक_खबर_आशिल्लें: എല്ലാവരും_അറിയുന്ന.
सच्चरित्री: നല്ല_സ്വഭാവം_ഉള്ള.
सजिल्लें: വേഷമിട്ട.
सज्ज: തയ്യാറാക്കിയ ഒരുക്കിയ സജ്ജമാക്കിയ പൂറ്ത്തിയാക്കിയ.
सज्जन: സജ്ജനം കുലീനനായ മാന്യനായ മര്യാദയുള്ള.
सडसडीत: ആരോഗ്യപൂര്‍ണ്ണമായ ആരോഗ്യകരമായ
सडेतोड: മുഖത്തടിച്ച_പോലെ.
सत: സത്യം നിപത്തി നേര് നേറ്റി
सत_उलोवपी: സത്യസന്ധനായ നേരുപറയുന്ന
सतरा: പതിനേഴ്. പതിനേഴാം പതിനേഴാമത്തെ
सतर्क: ചുറുചുറുക്കുള്ള ഉന്‍മേഷമുള്ള ചൊടിയുള്ള ഉത്സാഹമുള്ള ഊറ്‍ജ്ജസ്വലതയുള്ള പ്രസരിപ്പുള്ള ഓജസ്സുള്ള ചുണയുള്ള മിടുക്കുള്ള
सतर्क.???????????: ബോധമുള്ള കരുതലുള്ള ധാരണാശക്തിയുളള
सत्कर्मी: പുണ്യകര്മ്മങള്_ചെയ്യുന്നവന്.
सत्तर: എഴുപത്.
सत्तरावें: എഴുപതാം
सत्ताधारी: അധികാരത്തിലേറിയ
सत्तावनावें: അന്പത്തിയേഴാമത്തെ
सत्त्याण्णवावें: തൊണ്ണൂറ്റി_ഏഴ് തൊണ്ണൂറ്റി_ഏഴാമത്തെ
सत्त्यात्तरावें: എഴുപത്തി_ഏഴാമത്തെ
सत्यभाशी: സത്യസന്ധനായ നേരുപറയുന്ന
सत्यवादिनी: സത്യവാദിനി സത്യഭാഷിണി.
सत्यवादी: സത്യസന്ധനായ നേരുപറയുന്ന
सत्यांयश्यावें: എണ്പത്ത്യേഴാമത്തെ
सत्याग्रही: സത്യാഗ്രഹം_ചെയ്യുന്ന.
सदळ: അയഞ്ഞ. അഴിഞ്ഞ. മുറുക്കമില്ലാത്ത.
सदां__खातीरचें: നശിക്കാത്ത മായാത്ത സ്ഥായിയായ.
सदाचरणी: നല്ല_സ്വഭാവം_ഉള്ള.
सदापर्णपाती: നിത്യഹരിതം.
सदापर्णी: നിത്യഹരിതം.
सदाहरीत: നിത്യഹരിതം.
सद्चरित्री: നല്ല_സ്വഭാവം_ഉള്ള.
सद्वेव्हारी: സന്മാര്ഗ്ഗപൂര്ണ്ണമായ_പെരുമാറ്റമുള്ള്.
सनसनाटी: സ്തോഭജനകമായ
सनातन: എന്നും_നിലനില്ക്കുന്ന.
सपाट: സമതലമായ നിരപ്പായ നിരപ്പായ മിനുസമായ.
सप्तकाचें: ആഴ്ചയിലുള്ള.
सफळ: സാറ്ത്ഥകമായ ഉപയോഗമുള്ള ഫലമുള്ള ഗുണമുള്ള ഉപയുക്തിയുള്ള പ്രയോജനമുള്ള ഉപകാരമുള്ള.
सभावीक: സ്വാഭാവികമായ.
सभ्य: ഉത്തമനായ സര്‍വ്വശ്റേഷ്ടനായ അതിവിശിഷ്ടനായ ഉല്‍കൃഷ്ടനായ അതുല്യനായ അദ്വിതീനായ മികവുള്ളവനായ
सम: തുല്യമായ സമമായ സമാനമായ
समकालीन: സ്മയോചിതമായ സന്ദര്‍ഭത്തിനു_ചേര്‍ന്ന സമകലീനമായ.
समजिकायचें: യോജിപ്പോടുകൂടിയ.
समजूतदार: വിവേചനശക്തിയുള്ള തിരിച്ചറിവുള്ള ശരിയായ_ജ്ഞാനമുള്ള.
समजूतदारपणाचें: യോജിപ്പോടുകൂടിയ.
समन्वयीत: ചേര്ച്ചയുള്ള
समरुपी: ത്ത്സ്വരൂപമായ പ്ര്തിരൂപമായ പകറ്പ്പായ സാദ്ര്ശ്മായ പ്തിച്ഛായയുള്ള്.‌
समाजीक: സാമൂഹികമായ.
समाधानकारी: ത്രിപ്തി_അല്ലെങ്കില്‍_സന്തോഷം_നല്‍കുന്നത്.
समाधानी: പ്രശ്നം_പരിഹരിച്ച സംശയ_നിവാരണം_കഴിഞ്ഞ കുരുക്കഴിഞ്ഞ പരിഹ്ര്‌തമായ. പരിഹാരം_കാണുക സ്പഷ്ട്ടമാക്കുക. സന്തോഷിപ്പിക്കുന്ന ത്രിപ്തിപ്പെടുത്തുന്ന. വിശ്വസിക്കുന്ന സമ്മതിക്കുന്ന അംഗീകരിക്കുന്ന.
समान: പര്യായം ഒരേപോലത്തെ ഡ്യൂപ്ലികേറ്റ്.
समाप्त: അവസാനിക്കുക.
समाही: അരകൊല്ലത്തെ.
समुद्री: സമുദ്രത്തിന്റെ. സമുദ്ര സമുദ്രവുമായി_ബന്ധപ്പെട്ട.
समृद्ध: സംരിദ്ധമായ സമ്പന്നമായ.
समृद्धिदिणें: അഭിവ്ര്ദ്ധിപ്രദമായ ഐശ്വര്യപ്രദമായ സംര്‌ദ്ധിപ്രദമായ.
समेटाचें: ബന്ധിക്കപ്പെടാത്ത സ്വാധീനമായ മുക്തമായ.
समेस्त: ആകെ മുഴുവനും ഒട്ടാകെ ആകപ്പാടെ
सम्मानीत: ബഹുമാനിക്കപ്പെട്ട.
सम्राट: സമ്രാട്ട് ചക്രവര്ത്തി.
सय__केल्ली: ഒപ്പുവെച്ച്ത്.
सयल: മുറുക്കമില്ലാത്ത.
सरकटें: ഇഴയുന്ന പതുക്കെ_നടക്കുന്ന.
सरकारी: തലപ്പത്തിരിക്കുന്ന.
सरपटें: ഇഴയുന്ന പതുക്കെ_നടക്കുന്ന.
सरबियन: സര്‍ബിയായിലെ.
सरळ: കെട്ടു_കുടുങ്ങാത്ത. ലളിതമായ സരളമായ എളുപ്പമുള്ള സ്വാഭാവികമായ. മനസ്സിലാക്കാവുന്ന ധരിക്കാവുന്ന. കാപട്യമില്ലാത്ത നിഷ്കളങ്കരായ ശാന്തസ്വഭാവമുള്ള സൌകര്യപ്രദമായ സൌകര്യങളിണങിയ സൌകര്യമായ ലഘു_ആയിരിക്കുന്ന. നിവാരണമുള്ള്_അവസ്ഥ. നേരേ സ്പഷ്ടമായ വ്യക്തമായ സ്ഫുടമായ
सरळमार्गी: നേരെ_പോകുന്ന
सरींचें: അടുത്തുള്ള.
सर्गेस्त: മരിച്ച അന്തരിച്ച സമാധിയായ മഹാനിദ്രയിലായ നിര്യാതനായ
सर्वकालीक: എന്നും_നില_നില്‍ക്കുന്ന.
सर्वकालीन: എന്നും_നില_നില്‍ക്കുന്ന.
सर्वगुणी: സ്ര്വ്വ_ഗുണ_സമ്പന്ന്.
सर्वगूणसंपन्न: സ്ര്വ്വ_ഗുണ_സമ്പന്ന്.
सर्वभक्षी: എല്ലാം_ഭക്ഷിക്കുന്ന എല്ലാം_കഴിക്കുന്ന എല്ലാം_ഭുജിക്കുന്ന.
सर्वमान्य: സര്വസമ്മതമായ
सर्वश्रेश्ट: ഉത്തമമായ.
सर्वोच्च: എല്ലാറ്റിലും_ഉപരി.
सर्वोपरी: എല്ലാറ്റിലും_ഉപരി.
सळसळीत: നല്ല_ചൂടുള്ള.
सवकाश: മന്ദം സാവധാനം
सवकास: മന്ദം സാവധാനം
सवाय: വിലക്കുറവു ഒന്നേകാല്‍ വിലകുറഞ്ഞ
सवें: ആറാം ആ‍റാമത്തെ
सव्वा: ഒന്നേകാല്‍
सशस्त्र: ശസ്ത്ര_ധാരി.
सस्तन: ഗര്‍ഭത്തില്‍_നിന്നു_ജനിക്കുന്നത്. മുലകുടിക്കുന്ന.
सहकारी: സഹകരിക്കുന്ന യോജിച്ചു_പ്രവറ്ത്തിക്കുന്ന.
सहज: ലളിതമായ സരളമായ എളുപ്പമുള്ള സ്വാഭാവികമായ. സൌകര്യപ്രദമായ സൌകര്യങളിണങിയ സൌകര്യമായ ലഘു_ആയിരിക്കുന്ന. നിവാരണമുള്ള്_അവസ്ഥ.
सहन_करपी: സഹിഷ്ണുതയുള്ള സഹനശക്തിയുള്ള.
सहप्रवासी: സഹയാത്രിക
सहयात्री: സഹയാത്രിക
सांगपा_सारकी: പറയത്തക്ക പറയാന്‍_കൊള്ളാവുന്ന.
सांगि_सारकी: പറയത്തക്ക പറയാന്‍_കൊള്ളാവുന്ന.
सांगिल्लें: പ്രതിപാതിച്ചിട്ടുള്ളത്
सांगिल्ल्यो: പ്രചരിക്കപ്പെട്ട പ്രചരിച്ച വ്യാപിച്ച പ്രസിദ്ദമാക്കിയ പരസ്യമാക്കിയ കൊട്ടിഘോഷിച്ച വിളംബരം_ചെയ്ത അവഘോഷിച്ച.
सांगूंक_नाशिल्लें: പറയാത്ത
सांचिल्लें: പ്രവഹിക്കാത്ത ശാന്ത_മായ നില്‍ക്കുന്ന സ്ഥിരമായ ഗതിഹീനമായ.
सांठयिल्लें: ഗ്രഹിക്കപ്പെട്ട
सांठिल्लें: പ്രവഹിക്കാത്ത ശാന്ത_മായ നില്‍ക്കുന്ന സ്ഥിരമായ ഗതിഹീനമായ.
सांठोवपी: സൂക്ഷിപ്പുകാരന്‍.
सांठ्याचें: ഒരാവശ്യത്തിന്‍_വെച്ചിട്ടുള്ള.
सांसठावें: അറുപത്തി_ആറാം
साकरीचें: മധുരമുള്ള.
साक्षर: അഭ്യസ്‌തവിദ്യനായ വിദ്യാഭ്യാസമുള്ള
साक्षात: ആകാരമുള്ള
साक्षिदार: ദ്രിക്സാക്ഷി.
साठ: അറുപത്.
साठयिल्लें: ഒരാവശ്യത്തിന്‍_വെച്ചിട്ടുള്ള.
साठावें: അറുപതാമത്തെ
साडे_तीन: മൂന്നര
सात.: ഏഴ്‌ 7
सातपटीचें: ഏഴുമടങ്ങ്.
सातवें: ഏഴാം ഏഴാമത്തെ
सातसठ: അറുപത്തി_ഏഴ്
सातसठावें: അറുപത്ത്തി_എട്ടാം
सातोळ्याचें: ആഴ്ചയിലുള്ള.
सादरीकरणाचें: അവതരണയോഗ്യമായത്.
सादारण: പ്രാധാന്യമില്ലാത്ത. സാധാരണ. അല്ലറ_ചില്ലറ
सादूर: ബോധമുള്ള കരുതലുള്ള ധാരണാശക്തിയുളള
सादें: പ്രാധാന്യമില്ലാത്ത. സൌകര്യപ്രദമായ സൌകര്യങളിണങിയ സൌകര്യമായ ലഘു_ആയിരിക്കുന്ന. സാധാരണമായ
सादें.: നേരേ
सादो: കാപട്യമില്ലാത്ത നിഷ്കളങ്കരായ ശാന്തസ്വഭാവമുള്ള
साधनयुक्त: ധനവിഭവങ്ങളോട്‌_കൂടിയ ധനത്താല്‍_സമ്പന്നനായ സമ്പന്നനായ.
साधनसंपन्न: ധനവിഭവങ്ങളോട്‌_കൂടിയ ധനത്താല്‍_സമ്പന്നനായ സമ്പന്നനായ.
साधनहीण: സാധനങ്ങളില്ലാത്ത.
साधनां_नाशिल्लें: സാധനങ്ങളില്ലാത്ത.
साधवी: നല്ല_സ്വഭാവം_ഉള്ള.
साध्य: ചികിത്സിക്കാവുന്നത്.
सान: ചെറിയ
सानुलें: ചെറിയ. ചെറിയ
साफ: സ്പഷ്ടമായ ശരിയായ ശുദ്ധമാക്കിയ.
सामकें_गरजेचें: അത്യന്താപേക്ഷിതമാണ്‍ അനിവാര്യമാണ്‍ അവശ്യം_വേണ്ടുന്ന അപരിഹാര്യ വേണ്ടതായ ഒഴിച്ചു_നിര്‍ത്താനാവാത്ത ഒഴിവാക്കാനാവാത്ത അത്യാവശ്യമായ സര്‍വപ്രധാനമായ കൂടിയെ_കഴിയു_എന്നുള്ള ആവശ്യകമായ അടിസ്ഥാനപരമായ മര്‍മ്മപ്രധാനമായ.
सामको: ദ്ര്ഢമായ പാകമായ.
सामको_उणो: ലേശം_മാത്രം.
सामान्य: സാധാരണ. സാമൂഹികമായ.
सामुहीक: സാമൂഹികമായ.
साम्यवादी: സമത്വവാദിയായ. സമത്വവാദിയായ.
सारकें: തുല്യമായ സമമായ സമാനമായ ഒരു_പോലെയുള്ള സമാനരൂപിയായ നന്നായി_ക്രമപ്പെടുത്തപ്പെട്ട സുനിശ്ചിതമായ.
सारको: ദ്ര്ഢമായ പാകമായ. നല്ല.
सारहीण: നിസ്സാരമായ കഴ്മ്പില്ലാത്ത. നിസ്സാരമായ കാര്യമില്ലാത്ത.
सार्थ: അര്‍ത്ഥ്യുക്തമായ സാര്‍ത്ഥകമായ
सार्थक: സാറ്ത്ഥകമായ ഉപയോഗമുള്ള ഫലമുള്ള ഗുണമുള്ള ഉപയുക്തിയുള്ള പ്രയോജനമുള്ള ഉപകാരമുള്ള.
सार्वभौमीक: സാര്വഭൌമികമായ.
साव: ഉത്തമനായ സര്‍വ്വശ്റേഷ്ടനായ അതിവിശിഷ്ടനായ ഉല്‍കൃഷ്ടനായ അതുല്യനായ അദ്വിതീനായ മികവുള്ളവനായ സത്യസന്ധനായ നെറിയുള്ള വിശ്വസ്തനായ നിക്രിഷ്ഠമല്ലാത്ത ദുഷ്ട്ടനല്ലാത്ത
सावध: ബോധമുള്ള കരുതലുള്ള ധാരണാശക്തിയുളള
सावधी: ത്വണകളായുള്ള ഗടുക്കളായുള്ള.
सावळो: കറുത്ത
सासणा_खातीरचें: നശിക്കാത്ത മായാത്ത സ്ഥായിയായ.
साहसी: സാഹസിക സാഹസികമായ ധീരമായ.
साहित्यप्रेमी: സാഹിത്യ_സ്നേഹി.
साहित्यमोगी: സാഹിത്യ_സ്നേഹി.
सिंगापुरी: സിംഗപ്പൂരിയന്‍.
सिंधी: സിന്ധി സിന്ധി സിന്ദ്ധ്
सिंहली: സിംഹള ശ്രീലംഗന്‍ സിംഹള സിംഹള സിംഹള_ഭാഷ
सिने: സിനിമ
सिनेगली: സിനഗളിയന്
सिरियायी: സിറിയന്‍.
सुंदर: സൌന്ദര്യമുള്ള സുമുഖമുള്ള ചേലുള്ള ചന്തമുള്ള മനോഹരമാ‍യ സുന്ദരമായ കോമളമായ ഹ്ര്‌ദ്യമായ ആകറ്ഷകമായ അഴകുള്ള മനോജ്ഞമായ.
सुंदर_अक्षरवळणाचो: സുന്ദരമായ_കയ്യക്ഷരമുള്ള
सुकडें: മെലിഞ്ഞ എല്ലും_തോലാകുക.
सुकुमार: കോമളം സുകുമാരം.
सुकें: മെലിഞ്ഞ വരണ്ട് ഉണങ്ങിയ ശുഷ്കമായ
सुक्षीम: അത്യധികം_സൂക്ഷ്മമായ. സൂക്ഷ്മമായ.
सुक्ष्म: അത്യധികം_സൂക്ഷ്മമായ.
सुख: സന്തോഷത്തോടെ സസുഖത്തോടെ ആഹ്ലാദപൂര്‍വ്വം
सुखदिणी: സന്തോഷമേറിയ.
सुखांतीक: സന്തോഷാത്മകം
सुखाची: സന്തോഷമേറിയ.
सुखात्मक: സന്തോഷാത്മകം
सुखाळ: സന്തോഷമേറിയ.
सुखासीन: സുഖമായി_ഇരിക്കുന്ന.
सुखी: സന്തോഷത്തോടെ സസുഖത്തോടെ ആഹ്ലാദപൂര്‍വ്വം
सुगंधीत: സുഗന്ധമുള്ള.
सुचक: പറയുന്ന വിവരിക്കുന്ന.
सुचरित्री: നല്ല_സ്വഭാവം_ഉള്ള.
सुचीत: പറഞ്ഞ സംകേതം_കാട്ടിയ.
सुझ्य: മുഷിഞ്ഞ
सुटनासपी: അറിവില്ലാത്ത.
सुटसुटीत: ആകാരവടിവുള്ള.
सुडानी: സുഡാനിയന്
सुतलावपी: തട്ടിപ്പറിക്കുന്ന.
सुदरपा_सारकें: അച്ചടക്കം_പാലിക്കുന്ന
सुदारिल्लो: പുരോഗതിയുള്ള ഉയര്‍ച്ചയുള്ള ഉന്നതിയുള്ള.
सुदारीत: പുരോഗതിയുള്ള ഉയര്‍ച്ചയുള്ള ഉന്നതിയുള്ള. പരിഷ്ക്കരിച്ച ശുദ്ധീകരിച്ച സ്ഫുടം_ചെയ്ത.
सुपीक: ഉല്പാദനക്ഷമമായ ഫലഭൂയിഷ്ഠമായ സംരിദ്ധമായ സമ്പന്നമായ.
सुपुल्लें: ചെറിയ
सुप्रसिद्ध: സുപ്രസിദ്ധ്നായ
सुबेज: നിയന്ത്രണമില്ലാത്ത തോന്ന്യാസമുള്ള ധിക്കാരപരമായ.
सुरक्षीत: സുരക്ഷിതമായ. സുരക്ഷിതമായ സംരക്ഷിതമായ സുരക്ഷിതമായ.
सुरवातीचें: മുമ്പുള്ള പ്രാരംഭികമായ ആദ്യമായ.
सुरू: തുടരുന്ന ആവറ്ത്തിക്കുന്ന നടക്കുന്ന നിരന്തരമായ. ആരംഭിച്ച തുടക്കമിട്ട പ്രാരംഭിച്ച സമാരംഭിച്ച.
सुरू_आशिल्लें: നടത്തപ്പെടുന്ന പ്രവര്‍ത്തിക്കപ്പെറ്ടുന്ന.
सुलक्षण: നല്ല_ലക്ഷണമുള്ള ഭാഗ്യമുള്ള.
सुलभ: പോകത്തക്ക. ലളിതമായ സരളമായ എളുപ്പമുള്ള സുലഭമായിട്ട.
सुळसुळीत: മിനുസം മാര്‍ദ്ദവം മിനുമിനുപ്പ്
सुवर्णी: നല്ല_നിറമുള്ള.
सुवादाचें: സ്വാദോടുകൂടിയ.
सुवादीक: സ്വാദോടുകൂടിയ. സ്വാദിഷ്ട്ടമായ.
सुवार्थी: സ്വാര്‍ത്ഥ_താത്പര്യമുള്ള തങ്കാര്യത്തിലുള്ള_ശ്രദ്ധയുള്ള സ്വാര്‍ത്ഥ_ബുദ്ധിയുള്ള സ്വതാത്പര്യ്മുള്ള ആത്മാരാധന അഹങ്കാരോന്മാദിയായ പൊങച്ചം_കാണിക്കുന്ന സ്വജന_പക്ഷപാതമുള്ള ഭൌതിക_താത്പര്യങളുള്ളൈടുങിയ_മനസ്ത്ഥിതിയുള്ള_.
सुवासहीण: മണമില്ലാത്ത.
सुवासाचें: സുഗന്ധമുള്ള.
सुवासीक: മണമുള്ള.
सुवासीत: വാസനയുള്ള
सुशिक्षीत: അഭ്യസ്‌തവിദ്യനായ വിദ്യാഭ്യാസമുള്ള
सुशेगाद: അലസനായ മടിയനായ ആലസ്യമുള്ള
सुश्रूत: നന്നായി_കേട്ട് പൂറ്ണ്ണമായി_കേട്ട.
सुसंस्कृत: ഉദാരമായ ദാനശീലമുള്ള.
सुसेगदिणी: വിശ്രമദായകമായ വിശ്രമം_നല്കുന്ന ക്ഷീണമകറ്റുന്ന ആശ്വാസം_നല്കുന്ന.
सुसेगाद: ശാന്തമായ നിശ്ചേഷ്ട്ടമായ അടക്കമുള്ള.
सुस्त: അലസനായ മടിയനായ ആലസ്യമുള്ള
सूखदिणें: ആനന്ദപ്രദം ആനന്ദ_ദായകം സുഖപ്രദം പ്രസന്നതാദായകം ആനന്ദദായി ആനന്ദകാരി ആഹ്ലാദി.
सेवक: ശുശ്രൂഷിക്കുന്ന
सेवनाचें: ഉപയോഗിക്കാന്‍_കൊള്ളാവുന്ന സേവിക്കാന്‍_അര്‍ഹമായ ആരാധ്യമായ.
सेवानिवृत्त: ജോലിയില്‍_നിന്ന്_വിരമിച്ച റിട്ടയറായ പെന്‍ഷന്‍_പറ്റിയ വിശ്രമയ_സമയം_പ്രാപിച്ച ഉദ്യോഗമൊഴിഞ്ഞ.
सेवाभावी: ശുശ്രൂഷിക്കുന്ന
सेवीत: സേവിക്കപ്പെട്ട.
सैनिकी: സേനാനായകന്റെ_സ്ഥാനം.
सैमीक: സ്വാഭാവികമായ ഭൌതികമായ നൈസര്‍ഗ്ഗികമായ സ്വാഭാവികമായ.
सैल: അയഞ്ഞ. അഴിഞ്ഞ.
सोंपते_तारखेचें: സമയം_കഴിഞ്ഞു_പോയ കാലാവധി_കഴിഞ്ഞ.
सोंपूंक_नाशिल्लें: മുഴുവനാകാത്ത.
सोंपे: സുലഭമായിട്ട.
सोंपें: പോകത്തക്ക. മനസ്സിലാക്കാവുന്ന ധരിക്കാവുന്ന. സൌകര്യപ്രദമായ സൌകര്യങളിണങിയ സൌകര്യമായ ലഘു_ആയിരിക്കുന്ന. നിവാരണമുള്ള്_അവസ്ഥ.
सोंपेपणाचें: സൌകര്യപ്രദമായ സൌകര്യങളിണങിയ സൌകര്യമായ ലഘു_ആയിരിക്കുന്ന.
सोंपो: ലളിതമായ സരളമായ എളുപ്പമുള്ള
सोंशीक: സഹിഷ്ണുതയുള്ള സഹനശക്തിയുള്ള.
सोडिल्ले: ഭാര്യയേയോ_ഭര്‍ത്താവിനേയോ_ഉപേക്ഷിച്ച.
सोडिल्लें: പുറത്താക്കപ്പെട്ട.
सोडून_गेल्लें: ഭാര്യയേയോ_ഭര്‍ത്താവിനേയോ_ഉപേക്ഷിച്ച.
सोडोवंक_जायना_अशें: അറിവില്ലാത്ത.
सोदपी: അന്വേഷണ
सोदिल्लें: ഗവേഷണപരമായ
सोप्पाचें: സമാപിപ്പിക്കേണ്ടതായ.
सोबता_अशें: മാന്യമായ.
सोबना_अशे: മാന്യമല്ലാത്ത.
सोबपी: മാന്യമായ.
सोबसारकें: മാന്യമായ.
सोबीत: സൌന്ദര്യമുള്ള സുമുഖമുള്ള ചേലുള്ള ചന്തമുള്ള മനോഹരമാ‍യ സുന്ദരമായ കോമളമായ ഹ്ര്‌ദ്യമായ ആകറ്ഷകമായ അഴകുള്ള മനോജ്ഞമായ.
सोयरीक_जाल्लें: വാഗ്ദാനം_ചെയ്യപ്പെട്ട വാക്കു_കൊടുക്കപ്പെട്ട വാക്കു_കൊടുത്ത കരാറ്_ചെയ്ത.
सोयरीक_जुळिल्ले: വാഗ്ദാനം_ചെയ്യപ്പെട്ട വാക്കു_കൊടുക്കപ്പെട്ട വാക്കു_കൊടുത്ത കരാറ്_ചെയ്ത.
सोलिल्लें: തൊലി_കളഞ്ഞ
सोलूंक_नाशिल्लें: തൊലി_കളയാത്ത
सोळावें: പതിനാറാം പതിനാറാമത്തെ
सोशीक: സഹിക്കാവുന്നത്.
सोसूंक_जायना_अशें: അസഹ്യമായ.
सौम्य: സൌമ്യനായ.
स्कॅण्डिनेवियी: സ്കാന്റിനേവിയന്‍
स्तन्य: സ്തന_സംബന്ധമായ.
स्तराचें: നിലവാരമുള്ള
स्तरीय: നിലവാരമുള്ള
स्तुतीपाठक: പ്രശംസകന്.
स्थगीत: സതംഭിച്ച.
स्थापणूक_करी_सारकें: സ്ഥാപിക്കപ്പെടാന്_യോഗ്യം.
स्थापी_सारकें: സ്ഥാപിക്കപ്പെടാന്_യോഗ്യം.
स्थापीत: സ്ഥാപിക്കപ്പെട്ട.
स्थायी: സ്ഥിരമായ ശാശ്വതമായ സ്ഥായിയായ അനശ്വരമായ സ്ഥായിയായ
स्थायीक: താമസിക്കുന്ന നില്‍ക്കാന്‍_യോഗ്യമ്മായ.
स्थालांतरीत: കുടിയേറി_പാര്ക്കുന്നവന്.
स्थावर: സ്ഥാവരങള്.
स्थीर: ചലനമില്ലാത്ത ചലിക്കാത്ത ഗതിരോധമുള്ള. സ്ഥാവരങള്. സ്ഥിരമായ.
स्थूल: തടിച്ച സ്ഥുലശരീരിയായ
स्नेही: സ്നേഹമുള്ള.
स्पर्श_करूंक_नाशिल्लें: തൊടാത്ത
स्पश्ट: സ്പഷ്ടമായ ശരിയായ സ്പഷ്ടമായ വ്യക്തമായ സ്ഫുടമായ
स्पश्टवादी: സ്പഷ്ട്ട_വാദി.
स्पॅनीश: സ്പാനിഷ് സ്പയ്നിഷ്.
स्फूर्तहीण: അനുത്സാഹികളായ.
स्फूर्तीदायक: ഉത്സാഹം_തരുന്ന.
स्फोटक: സ്പോടകാത്മകമായ
स्लोवाकी: സ്ലൊവാക്കിയയുടെ. സ്ലൊവാക്കിന്റെ.
स्वखोसयेचें: സ്വന്തം_ഇഷ്ട്ടാനുസരണം.
स्वच्छ: ശുദ്ധമാക്കിയ.
स्वजातीय: സ്വജാതീയ ഒരേ_വറ്ഗ്ഗത്തില്‍_പെട്ട സജാതീയ.
स्वतंत्र: സ്വതന്ത്രമായ.
स्वता_कमयिल्लें: തനിയെ_ഉണ്ടാക്കിയത് താന്‍_സമ്പാദിച്ച്.
स्वता_जोडिल्लें: തനിയെ_ഉണ്ടാക്കിയത് താന്‍_സമ്പാദിച്ച്.
स्वता_मेळयिल्लें: തനിയെ_ഉണ്ടാക്കിയത് താന്‍_സമ്പാദിച്ച്.
स्वताचें: അവനവന്റെ സ്വന്തമായ തന്റെ തന്റേതായ.
स्वदेशी: പ്രാദേശിക പ്രദേശികമായ സ്വദേശിയമായ ദേശിയതദ്ദേശീയമായ.
स्वपक्षी: എന്റെ_പക്ഷത്തുള്ള സ്വ്ന്തം_ഭാഗത്തുള്ള തന്റെ തന്റെ_പക്ഷത്തുള്ള സ്വപക്ഷത്തുള്ള.
स्वप्रशंसी: പ്രതീക്ഷിച്ച കാത്തിരിന്ന.
स्वभावीक: സ്വാഭാവികമായ.
स्वयंसिद्ध: സ്വമേധയാ_ശരിയായത്.
स्वराचें: സ്വരം_ചേര്‍ന്ന.
स्वराळ: സ്വരം_ചേര്‍ന്ന.
स्वर्णीम: സ്വര്‍ണ്ണമയമായ.
स्वशिक्षीत: സ്വന്തം_ശിക്ഷണം_കൊണ്ട്_വിദ്യ_കൈവരിച്ച.
स्वाजी: സ്വാസിലാന്റിയന്
स्वाभावीक: സ്വാഭാവികമായ.
स्वाभिमानहीण: സ്വാഭിമാനം_ഇല്ലാത്ത.
स्वाभिमानी: ആത്മാഭിമാനമുള്ള.
स्वायत्त: സ്വാശ്രയ സ്വയം_പര്യാപ്തമായ സ്വായത്തമായ സ്വയം_ഭരണാവകാശമുള്ള.
स्वावलंबी: സ്വതന്ത്രമായ. സ്വയം_ആശ്രയിക്കുന്ന.
स्विकार_करी_सारकें: സ്വീകാര്യമായ.
स्विकारपा_सारकें: സ്വീകാര്യമായ.
स्विकारिल्ली: അങ്കീകരിച്ച സ്വീകരിച്ച. അങ്ഗീകാര_യോഗ്യമായ.
स्विकारिल्लें: സ്വന്തമായി_തിരഞ്ഞെടുത്ത.
स्विकारूंक_नाशिल्लें: നിരാകരിച്ച സമ്മതിക്കാത്ത് സമ്മതമില്ലാത്ത സമ്മതം_ലഭിക്കാത്ത സമ്മതംകിട്ടാത്ത.
स्विकृत: സ്വീകരിച്ച സ്വീകരിക്കപ്പെട്ട അനുമതി_കിട്ടിയ അനുമതി_പ്രദാനം_ചെയ്ത. അങ്ഗീകാര_യോഗ്യമായ.
स्विडीश: സ്വീടിഷ് സ്വീഡന്റെ.
स्वित्झरलॅण्डी: സ്വിറ്റ്സര്‍ലാന്റിന്റെ.
हक्क_आशिल्लो: അവകാസപ്പെട്ട് അധികാരപ്പെട്ട.
हजर: ഹാജരുള്ള സന്നിഹിതമായ വന്ന ഉള്ള
हजारावें: ആയിരക്കണക്കിന്.
हट्टी: ദുരാഗ്രഹി. വാശിക്കാരനായ.
हरवें: പച്ചയായ പാകമല്ലാത്ത പച്ചയായ. പച്ചയായ സജീവമായ ഹരിതാഭമായ ചൈതന്യത്തോടെ.
हलको: കനം_കുറഞ്ഞ
हळडुवें: മഞ്ഞയായ പാണ്‌ഡുരമായ പീതവറ്‍ണ്ണമായ പിംഗലവര്‍ണ്ണമായ
हळू_हळू: മന്ദം സാവധാനം
हवाई: ആകാ‍ശ ആകാശസ്ഥമായ വായു_ചരമായ വായു_മണ്ഡല_സംബന്ദിയായ.
हसतमूख: ചിരിച്ച_മുഖം.
हस्तनिर्मीत: കരകൌശല കൈ_കൊണ്ട്_നിറ്മ്മിച്ച.
हांडेकार: ധനികനായ പണക്കാരനായ
हांश्यास्पद: ചിരിപ്പിക്കുന്ന.
हांसकुरें: ചിരിപ്പിക്കുന്ന.
हांसपी: ചിരിക്കുന്ന ചിറിക്കുന്ന പുഞ്ചിരിക്കുന്ന.
हांसमूख: ചിരിച്ചമുഖം പുഞ്ചിരി_തൂകുക
हांसयाळें: ചിരിപ്പിക്കുന്ന.
हांसरें: ചിരിച്ചമുഖം പുഞ്ചിരി_തൂകുക
हांस्यहीण: തമാശയില്ലാത്ത.
हाचे_सारको: ഇതതരത്തിലുള്ള.
हाडकुळें: അസ്ഥി_പഞരം_പോലെ എല്ലും_തോലും_മാത്രമാവുക. മെലിഞ്ഞ എല്ലും_തോലാകുക.
हाडांचें: അസ്ഥികളെ_കൊണ്ട്_നിര്‍മ്മിച്ചത്.
हाता_खालचें: കീഴ്പെട്ട അധീനതയുള്ള.
हातांत_जाता_अशें: സ്വതന്ത്ര്മായ നിയന്ത്രണമില്ലാത്ത.
हातांत_जाय_सारकें: സ്വതന്ത്ര്മായ നിയന്ത്രണമില്ലാത്ത.
हारिल्लो: പിന്നോക്കം_നില്‍ക്കുന്ന. പരാജിതനായ.
हालपी: വിധിപ്രകാരം_നല്കാത്ത.
हालयिल्लें: മാറ്റിവെച്ച.
हावरट: അത്യാഗ്രഹമുള്ള അത്യാറ്‍ത്തിയുള്ള ലോഭമുള്ള ദുരാഗ്രഹമുള്ള അതിതൃഷ്ണയുള്ള അതിമോഹമുള്ള
हावरें: അത്യാഗ്രഹമുള്ള അത്യാറ്‍ത്തിയുള്ള ലോഭമുള്ള ദുരാഗ്രഹമുള്ള അതിതൃഷ്ണയുള്ള അതിമോഹമുള്ള
हावी: സാമറ്ത്ഥ്യമുള്ള കീഴടക്കുന്ന നിപുണതയുള്ള വൈദഗദ്ധ്യമുള്ള പ്രാപ്തിയുള്ള യോഗ്യതയുള്ള പ്രവറ്ത്തനക്ഷമമായ ചാതുര്യമുള്ള.
हावेसाचें: ത്ര്പ്തിയുള്ള മനസ്സാലെയുള്ള.‌ ഇച്ഛിച്ച് ആഗ്രഹിച്ച താല്പര്യപ്പെട്ട.
हासयाळें: ചിരിച്ചമുഖം പുഞ്ചിരി_തൂകുക
हिंसक: ഹിംസകന്.
हितकारी: നന്മ_നല്കുന്ന
हिमटो: പിശുക്കന്‍ ലുബ്ധന്‍ ലോഭന്‍ കൃപണന്‍
हीणपणाचें: നീചമായ ഹീനമായ.
हुंपूंक_जायनाशिल्लो: അസീമമായ ചെന്നെത്താന്_പറ്റാത്ത.
हुनहुनीत: നല്ല_ചൂടുള്ള. ചൂടുള്ള
हुबेहुब: തനിപ്പകര്‍പ്പ്.
हुमटपी: തുളഞ്ഞ.
हुमटायिल्लें: തുള ദ്വാരം.
हुमेल्ली: വിയര്ത്തു_കുളിച്ച.
हुलपल्लें: കത്തി_ദഹിച്ച.
हुशार: യോഗ്യനായ കാര്യശേഷിയുള്ള നിപുണനായ സമര്ത്ഥനായ ശക്തനായ വിദഗ്ദ്ധനായ ചുണയുള്ള ചെയ്തുതഴക്കമുള്ള ചതുരനായ ചുറുചുറുക്കുള്ള ജ്ഞാനമുള്ള കെല്‍പ്പുള്ള പാടവമുള്ള കൌശലമുള്ള കഴിവുള്ള ബുദ്ധിമാന്‍ ധാരണാശക്‌തിയുള്ള വിവേകമുള്ള കുറേ_കൂടി_ഭേദമായ കൂടുതല്_മെച്ചപ്പെട്ടതായ. ചുറുചുറുക്കുള്ള ഉന്‍മേഷമുള്ള ചൊടിയുള്ള ഉത്സാഹമുള്ള ഊറ്‍ജ്ജസ്വലതയുള്ള പ്രസരിപ്പുള്ള ഓജസ്സുള്ള ചുണയുള്ള മിടുക്കുള്ള നിപുണനായ സമര്‍ഥനായ മിടുക്കുള്ള ചാതുര്യമുള്ള
हुसक्यामेकळें: ആശങ്കയില്ലാത്ത ഭയമില്ലാത്ത ശങ്കയില്ലാത്ത ചിന്തയില്ലാത്ത കൂസലില്ലാത്ത.
हुसक्यामेकळो: ചിന്താഹീനനായ.
हुस्को: ചിന്തയോടു_കൂടിയ ഉത്കണ്ഠയുള്ള ചിന്താകുലനായ.
हुस्क्याचें: ചിന്തിക്കേണ്ടതായ.
हून: ചൂടു ഉഷ്ണം ചൂടുള്ള
हे_तरेचो: ഇതതരത്തിലുള്ള.
हे_सारको: ഇതതരത്തിലുള്ള.
हेडगें: അലഞ്ഞു_തിരിയുന്ന.
हेर: വേറെയും മറ്റു മറ്റൊന്ന് രണ്ടാമത് അതല്ലാത്തത്.
हेरगिरीचें: രഹസ്യാന്വേഷണം കുറ്റാന്വേഷണം.
हैदराबादी: ഹൈദരബാദിനെ_സംബന്ധിക്കുന്ന.
होंवरेंत_रावपी: ഗുഹാവാസി.
