21: एक्काइस २१
27: सत्ताइस २७
53: त्रिपन्न त्रिपन ५३
6: छ ६
68: अडसठ अडसठ्टी_६८
79: उनासी उन्यासी ७९
अंकीत: लिखित लिपिबद्ध अङ्कित लेखिएको छापिएको चित्रित
अंगरक्षक: रक्षक रक्षा_कर्ता अभिरक्षक रक्षी वार्डन परिरक्षक
अंगोलायी: अङ्गोली अङ्गोलन
अंडज: अण्डज डिंबज द्विज अण्डज डिम्बज
अंतरीम: अन्तरिम
अंतर्दर्शी: आत्मनिरीक्षक अन्तर्दर्शी आत्मदर्शी अन्तर्दृष्टा
अंतर्निश्ट: अन्तर्निहित भित्रीरूपमा_रहेको
अंतर्मुखी: अन्तर्मुखी अन्तराभिमुखी अन्तर्मनस्क अन्तर्लीन आत्माभिमुखी
अंत्य: महाशङ्ख
अंधविश्वासी: अन्धविश्वासी अन्ध-विश्वासी
अंधश्रद्धाळू: मतान्ध कट्टरवादी कट्टरपन्थी
अंधूक: धमिलो अस्पष्ट
अंयशांवें: अस्सीऔं असिऔं
अंयशीं: असी ८०
अंशीक: आंशिक
अकथनीय: अकथनीय अकथ्य अकथ अव्यक्तव्य अवाच्य
अकर्मी: अकर्ता अकर्तार
अकलात्मक: कलाहीन अकलात्मक
अकल्पीत: कल्पनातीत अकल्पनीय अकल्पित अचिन्त्य
अकल्याणकारी: अकल्याणकारी अनिष्टकर अमङ्गलकारी अमाङ्गलिक अकुशल अशुभकारी अनभीष्ट अहितकारी
अकस्मात: आकस्मिक अनपेक्षित अप्रत्याशित अचानक दैवी दैविक दैवागत
अकारण: बिनासित्ति अकारण
अकार्यक्षम: अकर्मण्य निकम्मा अयोग्य
अकाळीक: अकालजात अकाल_प्रसूत असामयिक कुयामको बेमौकाको अकालिक अवसर_प्रतिकूल
अकुळीन: अकुलीन पानी_नचल्ने अछुत निम्न_वंशीय
अकूशळ: अप्रवीण अनाडी अकुशल अदक्ष अनिपुण अधकचरा अनाप्त अनारी अनैपुण अपटु अपाटव अपात्र
अकृत: नगरिएको अकृत अरचित अकृत नरचेको अनिर्मित अकृत
अकृतज्ञ: कृतघ्न अकृतज्ञ
अकृतार्थ: अकृतार्थ अकृतकार्य
अक्री: अक्रिय क्रियारहित क्रियाहीन
अक्षम्य: अक्षम्य क्षमाशून्य
अक्षय: अमर अक्षय अनश्वर शाश्वत अक्षुण्ण अक्षुण अनष्ट अविनाशी अविनासी अक्षय्य अच्युत अभङ्ग अनाश अनाश्य अनाशवान अभङ्गुर अखय अक्षुण्य
अक्षरी: अक्षरी
अक्षीय: अक्षीय
अखंड: अवेध्य अभेद अभेद्य दुर्भेद्य अभेदनीय अछेद्य अछेद अपरिच्छिन्न भञ्जनशील अभञ्जनीय बेजोड अजोड़ पूर्ण अभङ्ग अखण्ड
अखंडीत: अखण्डनीय अखंडनीय अखण्ड्य अखंड्य अभन्जित अक्षत अखण्डित अखंडित खंडहीन खण्डहीन अनवच्छिन्न अक्षुण्ण अक्षुण अविभाजित अखंड अखण्ड अभग्न अविभक्त अखण्डित अखंडित अटूट अभिन्न अजस्र अनन्तरित अनंतरित अनन्तर्हित अनंतर्हित अनवच्छिन्न अभङ्ग अभंग अभङ्गी अभंगी अभञ्जन अभंजन अभेदनीय
अखाद्य: अखाद्य अभोज्य अभोज
अखेरचें: अन्तिम
अखेरच्या: अन्तिम अंतिम आखिरी अन्त्य अंत्य
अग्निशामक: आगो_निभाउने
अग्नीमुखी: अनलमुख
अग्नीशामक: प्रशामक शमक शान्तिकर शामक
अग्रगामी: अग्रगामी अग्रनी
अग्रणी: अग्रगामी पुरोगामी पूर्वगामी
अग्राह्य: अग्राह्य अग्रहणीय
अघटीत: अघटित नघटेको अघटनीय अघट्य
अघोशीत: अघोषित
अचंचळ: अविचलित अडिग अविचल
अचंबीत: विलक्षण अद्भुत अनौठो अचम्भको विचित्र आश्चर्यजनक आश्चर्यभूत अभूतपूर्व अपूर्व
अचकीत: आकस्मिक अनपेक्षित अप्रत्याशित अचानक दैवी दैविक दैवागत
अचल: अचल गतिहीन स्थावर अग अगतिक अचर स्थिर थिर दृढ अचल अविचल निश्चल गतिहीन अविचलित अटल
अचूक: अचूक अमोघ नचुक्ने भुल_नगर्ने विफल_नहुने मुखतोड मुखभरिको
अचेतन: जड अचैतन्य जडत्वयुक्त स्थूल अजैव भौतिक अचेतन चेतनारहित अजीव अनात्म आत्मारहित निष्क्रिय असक्रिय सुप्‍त
अजय: अजेय अजय अजित अपराजेय दुर्जेय अजीत अयुध्य
अजरंवर: अमर मृत्यु_कालजयी चिरञ्जीवी चिरञ्जीव चिरञ्जीवी चिरजीवी दीर्घजीवी दीर्घायु आयुष्मान चिरायु
अजरबॅजानी: अजरबैजानी अजरबैजानी
अजागळ: ढङ्ग सिप
अजाण: अज्ञेय अगम्य ज्ञानातीत बोधातीत अगम आगम अमेय अमेव अविवेकी विवेकहीन अबोध अबुझ
अजातशत्रू: शत्रुहीन अजातशत्रु शत्रुविहीन अरिहीन अभूतशत्रु
अजाप: प्राकृतिक
अजापाचें: अभूतपूर्व अपूर्व
अजापीत: अनपेक्षित अप्रत्याशित निरपेक्षित
अजितेंद्री: अजितेन्द्रिय अयतेन्द्रिय अनियतात्मा
अजीर्ण: अजीर्ण अजर्जर
अजैत: अपराजित अपरास्त अविजित अनभिभूत अप्रतिहत अजेय अजय अजित अपराजेय दुर्जेय अजीत अयुध्य
अज्ञात: अज्ञात नजानेको अविदित अनवगत अपरिचित अपरिगत अनधिगत अनभिज्ञ अज्ञ अपरिचित नजानेको नचिनेको अज्ञात अपरिगत अनभिज्ञ
अज्ञानी: अज्ञेय अगम्य ज्ञानातीत बोधातीत अगम आगम अमेय अमेव ज्ञानहीन अज्ञानपूर्ण
अज्ञेय: अज्ञेय अगम्य ज्ञानातीत बोधातीत अगम आगम अमेय अमेव
अटूट: घनिष्ठ आत्मीय अन्तरङ्ग अन्तरंग गाढा अनन्य अभिन्न प्रगाढ अङ्गरङ्गी अन्तरंगी इष्ट अन्यतम अखण्डनीय अखंडनीय अखण्ड्य अखंड्य भञ्जनशील अभञ्जनीय
अठरा: अठार अठारौं १८_औ 18औं
अठ्ठावन: अन्ठाउवन्न अन्ठाउन
अठ्ठावनावें: अन्ठाउन्नौं अन्ठाउनौं
अठ्ठाविसावो: अट्ठाइसौँ
अठ्ठावीस: अट्ठाइस २८
अठ्ठेचाळिसावें: अठचालीसौँ
अठ्ठेचाळीस: अठचालीस
अठ्ठ्यांयशीं: अट्ठासी अठासी
अठ्ठ्यांयश्यांवें: अट्ठासीऔं अठासीऔं
अठ्ठ्याण्णव: अन्ठानब्बे अन्ठानबे
अठ्ठ्याण्णवावें: अन्ठानब्बेऔं
अठ्ठ्यात्तर: अठहत्तर अठत्तर
अठ्ठ्यात्तरावें: अठहत्तरौं
अडचणीन_भरिल्लें: अवरोधपूर्ण अवरोधात्मक रोधात्मक
अडांगी: चकचके चुलबुले उदण्ड ऊछृङ्खल
अडाणी: अप्रवीण अनाडी अकुशल अदक्ष अनिपुण अधकचरा अनाप्त अनारी अनैपुण अपटु अपाटव अपात्र अशिक्षित अनपढ निरक्षर ज्ञानहीन अज्ञानपूर्ण नबुझ्ने अकडो
अडेचें: देखावटी नकली बनावटी बनौटी कृत्रिम अप्रकृत अयाथार्थिक
अडेज: अढाई अढाइ
अणकार_करपाचें: अनुवाद्य अनुवाद_गर्न_योग्य
अणकार_करपी: अनुवादक भाषान्तरकार उल्थाकार अनुवादी
अणकार_करी_सारकें: अनुवाद्य
अणकारक: अनुवादक भाषान्तरकार उल्थाकार अनुवादी
अणकारपी: अनुवादक भाषान्तरकार उल्थाकार अनुवादी
अणकाराचें: अनुवाद्य
अणकारीत: अनूदित अनुवादित अनुदित भाषांतरित भाषान्तरित
अणभवदिणें: अनुभावक
अणभवशुन्य: अनुभवहीन काँचो कच्चा अल्हरे स्वाँठ
अणभवसिद्ध: अनुभवी अनुभवसिद्ध
अणभवहीण: अनुभवहीन काँचो कच्चा अल्हरे स्वाँठ
अणभवी: अनुभवी जानकार परिपक्व खारिएको अभ्यस्त अभ्यसित सिपालु प्रवीण ज्ञानी जान्ने
अणभावी: अनुभावी
अतंत्रीक: गैर-प्रविधि प्रविधिहीन
अतिंद्रीय: अतीन्द्रिय अप्रत्यक्ष परोक्ष अभौतिक
अतिक्रमी: अतिक्रामक
अतिक्रमीत: अतिक्रमित अतिक्रान्त अधिग्रहीत अधिकृत अधिगत अधिक्रान्त
अती: भारी भीषण घनघोर अत्याधिक
अती_धाडशी: दुस्साहसी ढीठ दुःसाहसी
अतीरागिश्ट: अति_आविष्ट अत्युग्र धेरै_क्रुद्ध अत्युग्र
अतुलनीय: अतुलनीय अतुल्य अतुल अप्रतुल
अतुल्य: अतुलनीय अतुल्य अतुल अप्रतुल
अतुळीत: अतुल्य अतुलनीय
अतूट: अवेध्य अभेद अभेद्य दुर्भेद्य अभेदनीय अछेद्य अछेद अपरिच्छिन्न अटुट मिलेको अभिन्न अपृथक अभेद
अतृप्त: अतृप्त असन्तुष्ट अतुष्ट
अत्याचारी: अन्यायी अन्याय_कर्ता अत्याचारी अनाचारी आततायी बर्बर नृशंस अतिचारी अनीतिमान् उत्पीडक
अथक: नथाक्ने अक्लान्त अक्लांत अथक नथाक्ने अश्रान्त
अथांग: अथाह अगाध अपार अगाध्य अनवगाह अनवगाह्य अगाह गहिरो
अदमासाचें: अनुमानित अनुमित अडकलबाज अनुमान
अदमासीत: अनुमानित अनुमान_गरिएको अनुमित अनुमेय
अदीम: अनन्त_काल
अदृश्य: अदृश्य अदृष्टिगोचर लोचनातीत अदृश्यमान विलीन अन्तर्हित
अद्वैत: अद्वैत परमतत्त्‍व ब्रह्‍म।
अधर: अधर
अधर्मी: धर्महीन अधर्मी
अधाशिल्ले: लुब्ध लोभित लालची
अधाशी: लोभी लालची चुइयाँ कन्जुस स्वादे चखुवा
अधिकार: शासित प्रशासित
अधिकार_नाशिल्लें: अधिकारहीन
अधिकारहीण: अधिकारहीन बेदखल अधिकारच्युत अनधिकारी स्वत्वहीन
अधिकारा_भायरें: अनधिकृत स्वत्वहीन अनधिकार अधिकारशून्य अप्रमाणिक अनधिकारी स्वत्वहीन
अधिकाराची: अधिकारपूर्ण साधिकार
अधिकारिकी: आधिकारिक अधिकारिक अधिकार_विषयको
अधिकारी: अधिकारी अधिकार_प्राप्त अधिकारयुक्त अधिकारिक हकदार अधिकारक
अधिकृत: आधिकारिक अधिकारिक अधिकार_विषयको
अधीन: अधीनस्थ अधीन मातहत अधस्तन अमुख्य अधीन
अधोगतीक: अवनतिशील पतनशील पतनोन्मुख
अधोगामी: अधोगामी
अध्यक्ष: अनुशासक अनुशासी
अध्यक्षा_विरयत: अध्यक्षरहित अध्यक्षहीन
अनंत: असीम अनंत अनन्त अनादि अपरंपार अपरम्पार अपरिमित अपार असीमित अगाध अमित अनंता अनन्ता अनन्त्य अनंत्य अनधिक अनवधि अनिर्दिष्ट अपरिच्छिन्न अप्रमाण अबाध सीमारहित अमर्याद अमात्र मात्रारहित अमान अमाप अमित
अनंताचो: अनन्त असमाप्य अन्त्यहीन अनंत अंतहीन
अनधिकृत: अनधिकृत स्वत्वहीन अनधिकार अधिकारशून्य अप्रमाणिक
अनन्यवृत्ती: अनन्यवृत्ति अनन्य-वृत्ति
अनन्यार्थ: अन्य
अनपेक्षीत: अनपेक्षित अप्रत्याशित निरपेक्षित अप्रत्याशित आशातीत प्रत्याशातीत अनुमानातीत
अनभिप्रेत: अनभिप्रेत अभिप्रायविरुद्ध अनभिमत
अनमननासपी: अनिवर्ती
अनमन्या_बगर: नि
अनर्जीत: अनर्जित नकमएको
अनर्थकारी: अनर्थकारी
अनर्थनाशी: अनर्थनाशी
अनळंकृत: अनलङ्कृत नसजिएको अमण्डित अलङ्कारहीन अविभूषित
अनवळखी: अज्ञात नजानेको अविदित अनवगत अपरिचित अपरिगत अनधिगत अनभिज्ञ अज्ञ अपरिचित नजानेको नचिनेको अज्ञात अपरिगत अनभिज्ञ पराई बिरानो परचक्री अपरिकल्पित
अनवाणी: नाङ्गा_खुट्टे
अनाज्ञाकारी: अनाज्ञाकारी
अनात्म: अनात्म आत्मरहित अनात्मीय अनाप्त
अनात्मदर्शी: बहिर्मुखी बहिर्भिमुखी
अनाथ: टुहुरो अनाथ यतीम लावारिस अनाथ टुहुरो
अनाथांउपेगी: अनाथ
अनादरी: अनादरणीय असम्माननीय अमाननीय अपूजनीय अपूज्य अमान्य
अनादरीत: अनादृत अनादरित
अनामीक: बेनामी गुमनाम
अनासक्त: अनासक्त अलिप्त निर्लिप्त मायारहित मायाशून्य अमुग्ध
अनासीक: नाकहीन
अनिंदनी: अनिन्दनीय निर्दोष निष्कलङ्क अनिन्दित बदनाम_नभएको निन्दा_नगरिएको कलङ्क_नलागेको निन्दारहित निष्कलङ्क अनिन्द्य
अनितीक: अनैतिक नैतिकताहीन अनीतिपूर्ण अनुचित गलत नीतिविरुद्ध
अनित्सूक: अनुत्सुक निरुत्सुक अनुत्क जिज्ञासाहीन अजिज्ञासु उत्सुक्ताहीन निरुत्सुक अनिच्छुक अनभिलाषी निस्पृही अनिच्छु निराकाङ्क्षी अभिलाषारहित
अनिमंत्रीत: अनिमन्त्रित अनामन्त्रित नबोलाइएका
अनियंत्रीत: बेकाबु अनियन्त्रित अनगन्ती असङ्ख्य अपरिमित सीमारहित असीम अगणित
अनियमीत: अनियत अनिश्चित अनियमित अनिर्दिष्ट अध्रुव अनियमित नियमरहित बेफाइदा
अनिर्णीत: अनिर्णय बेनिधो अनिर्णित
अनिर्धारीत: अनिर्धारित अनिश्चित वैकल्पिक अप्रतिपन्न अप्रतीयमान अनिर्धारित
अनिर्मीत: अरचित अकृत नरचेको अनिर्मित
अनिर्वाह्य: अनिर्वाह्य
अनिवासी: अस्थायी
अनिश्चित: अनिर्धारित
अनिश्चीत: अनिच्छित अचाहा अनपेक्षित अवाञ्छित नचिताएको अनिष्ट अनभिलषित अनीप्सित अनियत अनिश्चित अनियमित अनिर्दिष्ट अध्रुव
अनिश्र्वर: प्रभुहीन अनीश्वर ईश्वरहीन
अनुकंपीत: अनुगृहीत अनुकम्पित उपकृत
अनुकरण_करपी: अनुकर्ता अनुकरणकर्ता अनुकारी
अनुकरणावपी: अनुकर्ता अनुकरणकर्ता अनुकारी
अनुकरणीय: अनुकरणीय
अनुकृतीत: अनुकृत अमौलिक
अनुक्रमान: क्रमिक अनुक्रमिक क्रमबद्ध विन्यस्त क्रमानुसार क्रमानुकूल शृङ्खलाबद्ध अनुपूर्व
अनुग्रहीत: अनुगृहीत अनुकम्पित उपकृत
अनुचीत: अनुचित खराब बेठिक
अनुत्तीर्ण: अनुत्तीर्ण फेल
अनुत्पादीत: अनुत्पादक अनुत्पादित
अनुदक: निर्जल अजल जलहीन जलरहित
अनुपकारादीक: अपकारी अपकर्ता अपकर्त्ता अपकारक अनर्थकारी अनिष्टकारी अपकार_कर्ता अपकार_कर्त्ता अनहित अनुपकारी
अनुपचारीक: अनौपचारिक
अनुपलब्ध: अनुपलब्ध अप्राप्य अलभ्य अनधिगम्य अनमिलता अप्राप्त अमिल
अनुपस्थीत: अनुपस्थित गैरहाजिर अविद्यमान अप्रस्तुत अप्राप्त
अनुपेक्षीत: अनुपेक्षित अवेक्षित अनवहेलित
अनुपेगी: अनुपयोगी अनावश्यक उपयोगहीन निरर्थक व्यर्थ फालतू रद्दी अनर्थक
अनुमतीत: स्वीकृत अनुमति_दत्त अनुमति_प्रदत्त
अनुमतीप्राप्त: स्वीकृत अनुमति_दत्त अनुमति_प्रदत्त
अनुमोदीत: समर्थित अनुमोदित
अनुयायी: अनुयायी अनुगामी
अनुवंशीक: आनुवंशिक वंशागत वंशानुक्रमिक पैतृक आनुवांशिक अनुवांशिक पुर्ख्यौली
अनुवादक: अनुवादक भाषान्तरकार उल्थाकार अनुवादी
अनुवादपी: अनुवादक भाषान्तरकार उल्थाकार अनुवादी
अनुवादीत: अनूदित अनुवादित अनुदित भाषांतरित भाषान्तरित
अनुशासक: अनुशासक अनुशासी
अनुसरण_करपी: अनुयायी अनुचर अनुगामी
अनुसरपी: अनुयायी अनुचर अनुगामी
अनुसरून: अनुकूल अनुसार अनुरूप मुताबिक
अनेक: अनेक कैयौं विविध नाना एकाधिक अनेकानेक तमाम
अनेकाक्षरी: अनेकार्थी नानार्थक नानार्थी अनेकार्थक
अनेकार्थी: अनेकार्थी अनेकार्थक अनेकार्थ
अनैतिहासीक: अनैतिहासिक
अनैतीक: अनैतिक नैतिकताहीन अनीतिपूर्ण अनुचित गलत नीतिविरुद्ध
अनैत्शीक: अनैच्छिक
अन्न_खावपी: अन्नाहारी अन्नाहरी
अन्न_मागपी: अन्नार्थी
अन्नहारी: अन्नाहारी अन्नाहरी
अन्नाचें: अन्नज
अन्नान_भरिल्लें: अन्नमय
अन्य.: अन्य अर्को इतर अर्कै
अन्याय_संबंदी: अनैयायिक अन्याय_विषयक
अन्यायपुर्ण: न्यायहीन अन्यायपूर्ण
अन्यायी: अन्यायी अन्याय_कर्ता
अपंग: विकलाङ्ग अपाहिज अंगहीन अपंग अपाहज निपंग अपाङ्ग बिकलाङ्ग
अपंगूळ: विकलाङ्ग अपाहिज अंगहीन अपंग अपाहज निपंग अपाङ्ग अङ्गहीन अपांग
अपक्ष.: निर्दल निर्दलीय
अपक्षपाती: पक्षपातहीन भेदभावहीन निष्पक्ष
अपठनीय: अपठनीय अपठ्य
अपतीत: अपतित अच्युत
अपथ्य: नपच्ने कुपथ्य अपच्य कुपथ्य अपथ्य अहितकर
अपभ्रंशीत: पतित च्युत बिग्रेको विकृत अपभ्रंश अपभ्रंशित अपभ्रष्ट
अपमान_करपी: अपकर्षक अपकर्ष_गर्ने अपकर्ष_भएको अपमानकर्त्ता अपकारी
अपमानकर्तो: अपकर्षक अपकर्ष_गर्ने अपकर्ष_भएको अपमानकर्त्ता
अपमानकारक: अपमानजनक
अपमानकारी: अपमानजनक अपमानजनक
अपमानाचें: अपमानजनक
अपरंपार: अनगन्ती असङ्ख्य अपरिमित सीमारहित असीम अगणित
अपराजीत: अपराजित अपरास्त अविजित अनभिभूत अप्रतिहत
अपराधी: अपराधी दोषी कसुरवार अपराधशील आपराधिक अपराघमूलक अपराधमूलक
अपरिपक्व: अधकल्चो अपरिपक्व काँचो
अपरिवर्तनशील: अपरिवर्तनीय अपरिवर्तनशील
अपरिवारीक: अपारिवारिक अपरिवारीय
अपरूप: अनुपम अतुलनीय अद्वितीय असाधारण बेजोड न्यारो अप्रतिम अद्वैत एकल सर्वोकृष्ट अनुत्तम उपमारहित अनुपमित अनुपमेय अपूर्व अप्रतिमान अप्रतिरूप अभूत
अपरोक्त: अकथित नभनिएको अनुक्त नबताइएको नकहिएको
अपवित्र: अशोधित अपरिशोधित अशुद्ध असंशोधित अपवित्र अपावन अपुण्य अशुद्ध अशुचि अपुनीत दुषित अमेध्य
अपसव्य: दाहिने दायाँ
अपहरण_केल्लें: अपहृत अपहारित थुनिएको
अपात्र: अयोग्य अनुपयुक्त नालायक ना-लायक अनलायक अपारग अप्रभु अयथा अयुक्त अयुक्तरूप अयोग नचुनिएको अनिर्वाच्य नछानिएको
अपारदर्शक: अपारदर्शक अपारदर्शी
अपुज्य: अपूज्य अपूजनीय
अपुरबायेचें: प्यारो प्रिय
अपुरें: अपूर्ण अपरिपूर्ण अधुरो अपर्याप्त अपूर्ण अपरिपूर्ण
अपूर्ण: अपूर्ण अपरिपूर्ण अधुरो अधुरो बाँकी शेष असमाप्त अनिष्पादित असम्पादित अपूर्ण असम्पन्न असिद्ध अनिष्पन्न
अपेक्षा_नासतना: अनपेक्षित अप्रत्याशित निरपेक्षित
अपेक्षाहीण: अनपेक्ष्य
अपेक्षीत: इच्छित अभिलषित अभिलाषित अभीष्ट आकाङ्क्षित वाञ्छित इष्ट अपेक्षित अभिप्रेत मनोवाञ्छित वाञ्छनीय कमनीय अनुकाङ्क्षित अभिकाङ्क्षित अभिमत अभिवांछित अभिवाञ्छित अभीप्सित अपेक्षणीय
अपेक्षे_भायलें: अप्रत्याशित आशातीत प्रत्याशातीत अनुमानातीत
अपेक्षेचें: प्रत्याशित प्रयाशानुकूल यथावांछित आशानुकूल इच्छापूर्ण अभिलाषापूर्ण कामनापूर्ण सकाम
अपेशी: अकीर्तिकर अपकीर्तिकर अजसी अयशस्वी अकीर्तिमान्
अपैठ: अगम्य अगम
अपैतृक: अपैतृक
अप्रकाशीत: अप्रकाशित गुप्त नदेखिएको अप्रकाशित अप्रकाश्य अप्रकाशनीय
अप्रगट: अव्यक्त अप्रकट अप्रकटित अनभिव्यक्त अव्यक्त अप्रकट अप्रकटित अनभिव्यक्त
अप्रचलीत: अप्रचलित अप्रचरित अव्यवहृत अप्रयुक्त आउटडेटेड आउट_आफ_डेट
अप्रतिकार: अप्रतिकार अप्रतिकार
अप्रतिकारी: अप्रतिकार अप्रतिकारी
अप्रतिघात: अप्रतिघात
अप्रतिदेय: अप्रतिदेय
अप्रतिभा: निर्बुद्धि;_हतप्रभ।
अप्रतियोगी: अप्रतियोगी
अप्रतिवीर्य: अप्रतिवीर्य
अप्रतिश्ठीत: अप्रतिष्ठित अप्रतिष्ठ प्रतिष्ठारहित अमर्याद
अप्रतीबंद: अबाध्य अरोक
अप्रतीम: अन्यतम विशेष
अप्रत्यक्ष: असमक्ष अप्रत्यक्ष परोक्ष
अप्रमत्त: अप्रमत्त नशाहीन नशारहित
अप्रमाणीक: छक्याउने अप्रमाणित
अप्रमाणीत: असत्यापित अप्रमाणित अनुपपन्न अपरीक्षित अप्रमाणित अप्रमित अप्रमेय असिद्ध
अप्रमादी: अप्रमाद प्रमादरहित सतर्क सावधान
अप्रयोजक: अप्रासाङ्गिक अप्रासंगिक प्रसङ्गहीन प्रसंगहीन अनुपयुक्त नमिल्दो अप्रयोजक
अप्रवर्तक: अप्रवर्तक
अप्रवृत्त: अप्रवृत्त अकार्यसाधक अव्यवहारीय
अप्रवृद्ध: अप्रवृद्ध
अप्रवेश्य: अप्रवेश्य अगम्य अगत अगम आगम
अप्रशंसनीय: अप्रशंसनीय
अप्रशिक्षीत: अप्रशिक्षित
अप्रसन्न: उदास खिन्न म्लान अन्यमनस्क अन्यमन विरक्त अप्रसन्न अभितप्त
अप्रसिद्ध: अख्यात अप्रसिद्ध अनाम अविख्यात बेनाम अनामक
अप्राकृतीक: अप्राकृतिक अप्राकृत
अप्राप्त: अप्राप्त अलब्ध अनवाप्त अनापन्न अनाप्त अलभ्य अप्राप्त
अप्राप्य: दुर्लभ अलभ्य अप्राप्त अप्राप्य
अप्रामाणीक: असभ्य अभद्र अशिष्ट
अप्रासंगीक: अप्रासाङ्गिक अप्रासंगिक प्रसङ्गहीन प्रसंगहीन अनुपयुक्त नमिल्दो अप्रासङ्गिक अप्रासाङ्गिक
अप्रीय: मन_नपर्दो अप्रिय अनभीष्ठ अनभिमत अमनोनीत अप्रिय अप्रीतिकर नमिठो नचाहिँदो
अफगाणी: अफगानी अफगानी
अफवा: होहल्ला अफवाही हल्ला
अफेण: फिँज फेन
अबंधक: अबन्धक
अबध्य: अबध्य अबधार्ह अबध्य
अबादीत: अनाहत अक्षत क्षतिहीन अनुपहत
अबाध्य: अबाध्य अरोक
अबुद्ध: अविवेकी विवेकहीन अबोध अबुझ
अबोध्य: अबोध्य अनबोध्य अबोधगम्य अबोधनीय
अबोल: नबोल्ने
अब्ज: अरब
अभंग: पूर्ण अभङ्ग अखण्ड
अभक्ष्य: अनाहार्य अखाद्य अभोज्य अभक्ष्य अग्राह्य अभक्ष अभोज अखाद्य अभोज्य अभोज
अभागी: दुर्भाग्यशाली अभागी भाग्यहीन
अभितृप्त: अभितृप्त
अभिनंदीत: अभिनन्दित अभिनंदित वंदित
अभिप्राया_आड: अनभिप्रेत अभिप्रायविरुद्ध अनभिमत
अभेद्य: अवेध्य अभेद अभेद्य दुर्भेद्य अभेदनीय अछेद्य अछेद अपरिच्छिन्न
अभोज्य: अनाहार्य अखाद्य अभोज्य अभक्ष्य अग्राह्य अभक्ष अभोज
अभ्यासमोगी: अध्यायी अध्ययनशील
अभ्यासहीण: अनभ्यस्त अभ्यासहीन अभ्यासरहित अनभ्यसित
अभ्यासू: अभ्यस्त अभ्यसित अध्यायी अध्ययनशील अध्यायी अध्ययनशील
अभ्यासोपयोगी: अनुशीलनकारी अनुशीलनीय
अभ्रमीत: अभ्रमित भ्रमरहित अभ्रान्त अभरम अप्रमाद भ्रान्तिशून्य
अमंगळ: अशुभ नराम्रो अमङ्गल अमाङ्गलिक अनिष्‍‍टसूचक अरिष्ट
अमतिक्रमीत: अनतिक्रमित अनुत्क्रमित
अमर: अमर अक्षय अनश्वर शाश्वत अक्षुण्ण अक्षुण अनष्ट अविनाशी अविनासी अक्षय्य अच्युत अभङ्ग अनाश अनाश्य अनाशवान अभङ्गुर अखय अक्षुण्य अमर मृत्यु_कालजयी चिरञ्जीवी चिरञ्जीव चिरञ्जीवी चिरजीवी दीर्घजीवी दीर्घायु आयुष्मान चिरायु
अमहॅरिकी: अमहेरिक
अमानवी: अमानवीय अमानुषिक पाशविक पशुवत अलौकिक अनौठो अद्‍भुत लोकोत्तर
अमानूश: अमानवीय अमानुषिक पाशविक पशुवत
अमान्य: मना मना_गरिएको निषिद्ध वर्जित प्रतिबन्धित प्रतिबंधित निषेधित वर्ज्य व्याहत
अमापीत: अतुल्य अतुलनीय
अमिश्रीत: अमिश्रित विशुद्ध अमिश्र
अमीट: अमिट नमेटिने
अमुरपिकें: कटमिरो आधा_पाकेको
अमुर्त: निराकार अमूर्त निरङ्कार आकारविहीन अनवाय अनवय निरवयव अनाकार अपिरच्छन्न अमूर्त्त अमूर्त्ति अमूर्ति आकृतिहीन अमूर्तमान अमूर्तिमान अमूर्त्तिमान मूर्तिरहित अरूप अरूपक
अमुल्य: बहुमूल्य मूल्यवान अमूल्य अनमोल दामी अमूल्य अनमोल अमोल अमोलक मूल्यातीत
अमूर्त: अतीन्द्रिय अप्रत्यक्ष परोक्ष अभौतिक अशरीरी अशारीरिक
अमेरिकन: अमेरिकी अमरिकाको
अमेरिकी: अमेरिकी अमरिकाको
अमोघ: अचूक अमोघ नचुक्ने भुल_नगर्ने विफल_नहुने
अयशस्वी: असफल विफल निष्फल अजसी अयशस्वी अकीर्तिमान्
अयाचक: अयाचक अयाची
अयोग्य: अयोग्य अनुपयुक्त नालायक ना-लायक अनलायक अपारग अप्रभु अयथा अयुक्त अयुक्तरूप अयोग अनुचित खराब बेठिक विपरीत प्रतिकूल खिलाफ अकर्मण्य निकम्मा अयोग्य
अरचीत: अरचित अकृत नरचेको अनिर्मित
अरबी: अरबी
अरमेनियायी: अरमेनियाई अर्मेनियाई
अराजक: अराजक राजाहीन अराज अराजक
अराजपत्रीत: अराजपत्रित
अरुचीक: अरोचक अरुचिकर नीरस रसहीन रुचिहीन फीका असार
अरूंद: साँघुरो साँगुरो साङ्ग्रो
अरेखीत: असीमाङ्कित
अर्ज_करपी: प्रार्थी निवेदक अभ्यर्थी प्रार्थना_कर्ता
अर्ज_केल्लें: आवेदक आवेदन_कर्ता
अर्जदार: आवेदक आवेदन_कर्ता प्रार्थी निवेदक अभ्यर्थी प्रार्थना_कर्ता
अर्जेन्टिनी: अर्जेन्टिनी अर्जेन्टिनाई
अर्थपूर्ण: सार्थक अर्थयुक्‍त अर्थपूर्ण
अर्थशास्त्राचें: अर्थशास्त्रीय
अर्थशास्त्रीय: अर्थशास्त्रीय
अर्थशुन्य: अर्थहीन निरर्थक
अर्थहीन: अर्थहीन निरर्थक
अर्थाचें: सार्थक अर्थयुक्‍त अर्थपूर्ण
अर्थीक: आर्थिक वित्तीय रुपिया
अर्द: आधा अर्द्ध पचास_प्रतिशत अर्ध अद्ध
अर्दउकतें: आधा_खोलिएको अर्ध_मुकुलित
अर्दकच्चें: अधकल्चो
अर्दकुटें: अपूर्ण अपरिपूर्ण अधुरो अधुरो बाँकी शेष असमाप्त अनिष्पादित असम्पादित अपूर्ण असम्पन्न असिद्ध अनिष्पन्न
अर्दपिकें: कटमिरो आधा_पाकेको
अर्दमेलो: आधामरो अर्ध_मृत
अर्दवट: अपूर्ण अपरिपूर्ण अधुरो
अर्दवर्सुकी: छ_महिने अर्ध_वार्षिक षटमासिक
अर्दवेळ: अङ्शकालिक पार्टटाइम
अर्दशिजिल्लें: काँचो अधकल्चो आधा_पाकेको
अर्दुकुटें: अपूर्ण अपरिपूर्ण अधुरो
अलंकृत: अलङ्कृत अलंकृत उपाधित विभूषित
अलबानियन: अलबानियाई अल्बानियन अल्बेनियन अलबानियन अलबेनियन अलबानियाई अलवेनियाई अलबेनियाई अल्बानियाई
अलभ्य: अप्राप्त अलब्ध अनवाप्त अनापन्न अनाप्त अलभ्य
अलिखीत: अलिपिबद्ध अलिखित
अलोकीक: परलौकिक अलौकिक परलोकिय दिव्यलोक आधिदैविक आमुष्मिक
अलौकीक: अलौकिक अनौठो अद्‍भुत लोकोत्तर
अल्पआहारी: अल्पाहारी अल्पहारी अल्पभोजी मिताहारी स्वल्पाहारी
अल्पसंख्यांक: अल्पसङ्ख्यक अल्पसंख्य
अल्पायुशी: अल्पायु स्वल्पायु अल्प_जीवी
अळंकारहीण: अनलङ्कृत नसजिएको अमण्डित अलङ्कारहीन अविभूषित
अळंकारा_बगरचें: अनलङ्कृत नसजिएको अमण्डित अलङ्कारहीन अविभूषित
अळंकारीत: अलङ्कृत अलंकृत आभूषित भूषित सज्जित विभूषित अलंकारिक अलंकारपूर्ण अभिलमंडित अभिलमण्डित
अवगुणी: गुणरहित गुणहीन अगुणी
अवयस्क: अवयस्क नाबालिग अल्पवयस्क अप्रौढ़ अप्राप्तयौवन
अवर्णनी: अवर्णनीय अवर्ण्य
अवर्णनीय: अवर्णनीय अकथनीय वर्णनातीत शब्दातीत अकथ अकथ्य अनभिधेय अनिर्वचनीय अनिर्वाच्य
अवाचनीय: अपठनीय अपठ्य अपाठ्य
अविकृत: अविकृत नबिग्रेको
अविचारी: नचाहिँदो वाहियात अनुचित निरर्थक अनर्थक अर्थहीन अनुचित अर्थरहित निरर्थक
अविचारीक: अविचारणीय अचिन्तनीय अविचार्य अविचारित अचिन्तित अचिंतित नसोचिएको
अविज्ञानीक: अवैज्ञानिक विज्ञान_विरूद्ध अवैज्ञानिक अविज्ञानीय
अविभाज्य: अविभाज्य अभाज्य
अविश्वासी: अविश्वासी अपत्यारिलो
अविश्वासू: अविश्वसनीय अप्त्यारिलो अविश्वस्त अविश्वासी
अवेवस्थीत: अव्यवस्थित व्यवस्थाहीन लथालिङ्ग छरप्रस्ट
अवेव्हारी: अव्यवहारिक व्यवहार_अकुशल
अव्यक्त: अव्यक्त अप्रकट अप्रकटित अनभिव्यक्त अकथनीय अकथ्य
अव्यस्त: खाली अव्यस्त
अशक्त: कमजोर दुर्बल अशक्‍त कमजोर दुर्बल निम्छरो अबला दुब्लो लुते क्षीण
अशक्य: असम्भव असंभव नघट्नु_पर्ने असंभावित असाध्य
अशांत: अशान्त अशांत चंचल अस्थिरचित्त उत्कंठित उत्कण्ठित विचलित अस्थिर अनुपशांत अनेकांत अनेकान्त क्षुब्ध
अशिक्षीत: अशिक्षित अनपढ निरक्षर
अशिमांकीत: असीमाङ्कित
अशीम: असीम अनंत अनन्त अनादि अपरंपार अपरम्पार अपरिमित अपार असीमित अगाध अमित अनंता अनन्ता अनन्त्य अनंत्य अनधिक अनवधि अनिर्दिष्ट अपरिच्छिन्न अप्रमाण अबाध सीमारहित अमर्याद अमात्र मात्रारहित अमान अमाप अमित
अशीर: साँघुरो साँगुरो साङ्ग्रो साँगुरो छोटो
अशुद्ध: अशोधित अपरिशोधित अशुद्ध असंशोधित अशुद्ध मिलावट मिसिएको अपमिश्रित मैलो फहोर अशुद्ध अशुद्ध भूल गलत फोहोरी मैलाधैला
अशूभ: अशुभ नराम्रो अमङ्गल अमाङ्गलिक अनिष्‍‍टसूचक अरिष्ट अकल्याणकारी अनिष्टकर अमङ्गलकारी अमाङ्गलिक अकुशल अशुभकारी अनभीष्ट अहितकारी
अशें-तशें: नगण्य यस्तो-उस्तो अगण्य अनुदात्त
अशेंच: यस्तै_खालको यसकै_जस्तो
अश्र्वारोही: अश्‍वारोही
अश्लील: अश्लील कामुकतापूर्ण
असंख्य: असङ्ख्य अगणनीय अनगन्ती अगण्य अगणित
असंतुश्ट: अतृप्त असन्तुष्ट अतुष्ट
असंतोशजनक: असन्तोषजनक असन्तोषप्रद
असंप्रदायीक: असाम्प्रदायिक
असंबंदीत: असम्बन्धित असम्बद्ध सम्बन्धरहित अनन्वित अप्रसङ्ग असम्बन्धित असम्बद्ध सम्बन्धरहित अमेल अयुक्त
असंबंद्द: अप्रासङ्गिक अप्रासाङ्गिक
असंयमी: असंयमी अतिग्रही असंयत
असंस्कृत: अपरिष्कृत अमार्जित असंस्कृत
असत्य: असत्य झूटो
असत्यपणाचें: असत्य झूटो
असत्यापीत: असत्यापित अप्रमाणित अनुपपन्न अपरीक्षित
असफळ: असफल विफल निष्फल निष्फल असफल विफल व्यर्थ निरर्थक
असभावीक: अस्वाभाविक अप्राकृतिक अनैसर्गिक अप्राकृत अप्रकृत अनौठो
असभ्य: असभ्य अभद्र अशिष्ट
असमंजस: नबुझ्ने अकडो
असमक्ष: असमक्ष
असमजिकाय: सामञ्जस्यहीन असामञ्जस्य अनमेल असामञ्जस्यपूर्ण
असमजुतदार: अविवेकी विवेकहीन अबोध अबुझ
असमतल: असमतल असम अग्लो_होचो
असमाजीक: असामाजिक
असमाधानी: असमाधानित नसुल्झिएको
असमृद्धिदिणें: असमृद्धिप्रद अनैश्वर्यप्रद
असलें: त्यस्तो
असलेंच: यस्तै_खालको यसकै_जस्तो
असहमत: असहमत असम्मत नामन्जुर अमत असहमत असम्मत अमत अनभिमत
असादारण: असामान्य असाधारण खास विशेष यस्तो-उस्तो जस्तो-त्यस्तो अपसामान्य स्पेसल
असाध्य: असाध्य असाध्य अचिकित्स्य चिकित्सातीत दुस्साध्य दुःसाध्य
असामान्य: असामान्य असाधारण खास विशेष यस्तो-उस्तो जस्तो-त्यस्तो अपसामान्य स्पेसल
असुसंस्कृत: असभ्य अभद्र अशिष्ट
असैमीक: अप्राकृतिक अप्राकृत
अस्कळीत: अव्यवस्थित व्यवस्थाहीन लथालिङ्ग छरप्रस्ट
अस्तंती: पाश्‍चात्य पश्‍चिमी पश्‍चिमी पच्छिमी
अस्ता-व्यस्त: छरिएको छ्यान्नब्यान्न छरपुष्ट
अस्ताचें: निभृत
अस्ताव्यस्त: अव्यवस्थित व्यवस्थाहीन लथालिङ्ग छरप्रस्ट
अस्तित्व_नाशिल्लें: मिथ्या झुटो असत्य अविद्यमान
अस्तित्वहीण: मिथ्या झुटो असत्य अविद्यमान
अस्तुरी: पोथी
अस्तूंक_नाशिल्लें: अनस्त
अस्थायी: अस्थायी
अस्थिहीण: अस्थिहीन
अस्थीमय: अस्थिमय अस्थिनिर्मित अस्थि_निर्मित
अस्थीर: गतिशील गतिपूर्ण गतिमान चल चालू चलायमान अविराम अस्थिर अथिर अध्रुव संचारी सञ्चारी उडन्ते चञ्चल डुलुवा चुलबुले छुकछुके चनमते अधीर हतपत्ते सम्भ्रमी अस्थिर चञ्चल चकचके अधीर दृढमतहीन डाँवाडोल डाँवाँडोल अस्थिर
अस्पर्शीत: अछुत अस्पृष्ट अपरस
अस्पश्ट: अस्पष्ट अप्रतीत धमिलो अस्पष्ट
अस्पृश्य: अस्पृश्य अछुत पानि_नचल्ने
अस्वच्छ: फोहोरी मैलाधैला
अस्वस्थ: उद्विग्न हताश_भएको डराएको
अस्विकृत: अस्वीकृत नामंजूर सहमतिहीन सहमति_अप्राप्त
अस्सल: राम्रो शुद्ध चोखो असल खारिएको असली शुद्ध राम्रो खोटहीन विशुद्ध
अहंकारी: अभिमानी अहङ्कारी घमण्डी
अहिंसक: अहिंसक अहिंस्र
अहीतकारी: अवनतिकारी अधोपतनकारी पतनकारी
आंकवार: अविवाहित कुमार बिहे_नभएको
आंगाचे: विज्ञान_सङ्गत विज्ञानानुकूल
आंगीक: विज्ञान_सङ्गत विज्ञानानुकूल
आंतकड्यांचें: आँत्रीय
आंतरदेशी: अन्तर्देशीय देशान्तर्गत
आंतरराज्य: अन्तर्प्रदेशीय अन्तर्प्रांतीय अन्तर्प्रदेश_स्तरीय अन्तर्राज्यीय अन्तर्राज्यिक
आंतरराष्ट्रीय: अन्तर्राष्ट्रीय अन्तर्देशीय
आंतरीक: आन्तरिक भित्री अन्तः अन्तरङ्ग अन्तर्वर्ती अंतर्वर्ती आंतरिक अन्तः अन्तरंग अन्तरित
आंतर्राष्ट्रीय: अन्तर्राष्ट्रीय अंतर्राष्ट्रीय अन्तराष्ट्रीय बहुदेशीय बहुराष्ट्रीय
आंधळो: अन्धो नेत्रहीन
आंबट: अमिलो तित्री कागती
आंबट_गोड: अमिलो-पिरो
आंवुळिल्ल्या: खुम्चिएको संकुचित निकुंचित निकुञ्चित
आकर्शक: आकर्षक मनोहर राम्रो सुन्दर मनोरम मनोहर सुन्दर
आकर्शीत: आकर्षित आकृष्ट मोहित मुग्ध
आकलनीय: गणनीय गण्य
आकसपी: खुम्चिने सङ्कोचन_हुने
आकस्मीक: आकस्मिक अनपेक्षित अप्रत्याशित अचानक दैवी दैविक दैवागत
आकाराचें: बनाएको आकार_दिइएको
आकारीक: आयामयुक्त आयामी
आकालीक: बेमौसमी
आक्रमक: आक्रामक आक्रामकतापूर्ण अभिधावक
आक्रमणकारी: आक्रमणकारी आक्रामक आक्रान्ता आक्रमण_कर्ता आक्रमण_कर्त्ता अभिसारी
आक्रमणा_बगरचें: अनाक्रान्त आक्रान्तरहित
आक्रमणा_विरयत: अनाक्रान्त आक्रान्तरहित
आक्रांत: पराजित आक्रान्त
आख्खें: सम्पूर्ण जम्मै
आगंतूक: फलानो अमुक ढिस्कानो
आगळीक_करपी: बलात्कारी बलात्कार_कर्ता
आगळें: अलग छुट्टै पृथक् फरक
आगळो: अनुपम अतुलनीय अद्वितीय असाधारण बेजोड न्यारो अप्रतिम अद्वैत एकल सर्वोकृष्ट अनुत्तम उपमारहित अनुपमित अनुपमेय अपूर्व अप्रतिमान अप्रतिरूप अभूत
आगामी: आगामी भविष्य_कालीन सम्भावित भविष्णु भाविता भावी भव्य अगत्तर भवितव्य अनागत
आग्रही: अनुरोधी आग्रही अनुरोधक
आचारवान: सभ्य भद्र सुशील शिष्ट
आजापीत: विलक्षण अद्भुत अनौठो अचम्भको विचित्र आश्चर्यजनक आश्चर्यभूत अभूतपूर्व अपूर्व
आज्ञा_पाळपी: आज्ञाकारी आज्ञापालक
आज्ञाकारी: आज्ञाकारी आज्ञापालक
आज्ञापाळक: आज्ञाकारी आज्ञापालक
आज्ञाभंगी: अनाज्ञाकारी
आटिल्ल्या_दुदाचें: थनटुट्टु
आठ: आठ आठौं ८ 8
आठपट: आठगुना
आठवड्याचें: साप्ताहिक
आठवें: आठौँ अष्टम
आठसठ: अडसठ अडसठ्टी_६८
आठसठावें: अडसठौं
आठेक: गोडा_आठेक
आठ्ठिसावें: अडतीसौँ
आठ्ठीस: अडतीस
आड_पडिल्लें: अधिशायित
आडखळ_हाडपी: अवरोधक अवरोधी बाधक अनुरोधक अनुरोधी
आडखळहीण: अवरोधहीन अकण्टक अनवरुद्ध अबाधित अरोधित निर्बाध अबाध बाधाहीन निर्विघ्न निष्कन्टक अखण्ड अखंड अखण्डित अखंडित बाधारहित अनिरुद्ध अनिर्बंध अनिर्बन्ध अपविघ्न अप्रतिहत
आडखळिल्लें: उल्झिनु उल्झनु
आडखळिल्लो: अढकिनु अल्झिनु फँस्नु बन्द थुनिएको रोकिएको
आडखळीन_भरिल्लें: अवरोधपूर्ण अवरोधात्मक रोधात्मक
आडखळीबगरचें: अवरोधहीन अकण्टक अनवरुद्ध अबाधित अरोधित निर्बाध अबाध बाधाहीन निर्विघ्न निष्कन्टक अखण्ड अखंड अखण्डित अखंडित बाधारहित अनिरुद्ध अनिर्बंध अनिर्बन्ध अपविघ्न अप्रतिहत
आडनदर: उपेक्षित उपेक्ष्य उपेक्षणीय
आडमेळी_हाडपी: अवरोधक अवरोधी बाधक अनुरोधक अनुरोधी
आडवादा_बगरचें: निरपवाद
आडावपा_भायरें: अवश्यम्भावी अनवग्रह अत्यावश्यक परमावश्यक
आतर्जाती: अन्तर्जातीय
आतांचें: वर्तमान अभूत हाल
आतिरिक्त: अतिरिक्‍त बाहेक
आतूर: आतुर अधीर कातर व्याकुल बेचैन विकल अधैर्य अधैर्यवान् अधैर्यवान अधैर्यवान् अभिभूत क्षुब्ध
आत्मकथनात्मक: आत्मकथा आत्मजीवनी
आत्मदर्शी: आत्मनिरीक्षक अन्तर्दर्शी आत्मदर्शी अन्तर्दृष्टा
आत्मनिरीक्षक: आत्मनिरीक्षक अन्तर्दर्शी आत्मदर्शी अन्तर्दृष्टा
आत्मनिर्भर: आत्मनिर्भर स्वनिर्भर
आत्मपरक: आत्मपरक
आत्मप्रशंसी: आत्मप्रशंसक
आत्मविस्वासू: आत्मविश्वासी
आदखळीचे: कठिन दुर्गम अगम्य अगम दुरूह दुर्गम्य अगत आगम
आदर्श: आदर्श
आदर्शवादी: आदर्शवादी
आदलें: जीर्ण जर्जर प्राचीन पुरानो पूर्व-कालीन अनन्त_काल
आदारवान: ससहाय सहायकयुक्त सहायतायुक्त
आदारहीन: निराधार
आदारा_बगर: निराधार
आदारीत: आश्रित अवलम्बित आलंबित अवलम्बित आलम्बित निर्भर आधारित अवलंबी
आदिवासी: जनजातीय
आदी: आदि इत्यादि
आदेशपूर्ण: आदेशात्मक आज्ञात्मक अनुज्ञात्मक आदेशपूर्ण आज्ञापूर्ण
आदेशीत: आदेशात्मक आज्ञात्मक अनुज्ञात्मक आदेशपूर्ण आज्ञापूर्ण
आधीन: अधीन
आधुनीक: आधुनिक अद्यतन आजको अर्वाचीन अधुनातन नया अप्राचीन अकालातीत अपूरातन अपूर्वकालीन नवीन अपूराण साम्प्रतिक
आनंद_दिवपी: सन्तोषप्रद सन्तोषजनक आनन्द
आनंददायी: रमाइलो आनन्दप्रद आनन्दप्रद आनन्द-दायक आह्लादक सुखप्रद खुशनुमा प्रसन्नतादायक आनंददायक आनन्ददायक आनन्ददायी आनन्दकारी आनंदकारी आह्लादी अनंद अनन्द नंदक नन्दक रमन रमण
आनंददिणें: सन्तोषप्रद सन्तोषजनक आनन्द
आनंदी: प्रसन्नचित्त
आनंदीत: आनन्दपूर्ण आनन्दमय उल्लासपूर्ण सानन्द प्रसन्न खुसी खुश आनन्दित पुलकित हर्षित विह्वल आह्लादित प्रफुल्ल परितुष्ट प्रफुल्लित प्रफुलित उल्लसित उल्लासित उल्लासी आनन्दी विनोदित पुलकित तुष्ट
आनिकूय: अरू अर्को
आनीक: अरू अर्को
आनीक_कोणूय: अरू अर्को
आपखोसयेचें: स्वेच्छार्थ
आपणायिल्ली: स्वीकृत मन्जुर सहमति_प्राप्त अभ्युपगत
आपणायिल्लें: अङ्गीकृत स्वकृत परिग्रहीत गृहीत स्वीकृत स्वाङ्गीकृत अभ्युपगत
आपयिल्लें: सम्बोधित सम्बोध्य
आपरोसहीण: निस्सार निसार साररहित सारहीन निस्सार खोखला निसार साररहित
आपले_सुवातेर_बरयिल्लें: तोकिएको निर्धारित चिह्नित
आपलें: निजी आफ्नो स्वकीय स्वायत्त आत्म
आपल्या_पक्षाचो: स्वपक्षीय अपना स्वपक्षी
आपसांतलें: पारस्परिक आपसी
आपसुवार्थी: स्वार्थी मतलबी स्वार्थपर तनपोषक अपस्वार्थी अपरता स्वार्थपरायण
आपार: अनगन्ती असङ्ख्य अपरिमित सीमारहित असीम अगणित
आपेक्षीक: आपेक्षिक सापेक्ष
आपोवंक_नाशिल्ले: अनिमन्त्रित अनामन्त्रित नबोलाइएका
आफडीचें: रजस्वला ऋतुमती रजवती पुष्पवती
आफडूंक_नाशिल्लें: अछुत अस्पृष्ट अपरस नछोइएको नछोएको अस्पर्शित
आफताबी: आफताबी
आफ्रिकी: अफ्रिकी
आबुझाद: विचलित हटेको
आबूझ: विचलित हटेको
आभारी: कृतज्ञ आभारी धन्यवादी उपकृत अनुगृहीत
आभुशीत: अलङ्कृत अलंकृत आभूषित भूषित सज्जित विभूषित अलंकारिक अलंकारपूर्ण अभिलमंडित अभिलमण्डित
आम: सामान्य आम साधारण कामचलाउ अविशिष्ट
आमंत्रीत: निमन्त्रित आमनत्रित निम्त्याइएको बोलाइएको निम्तो_गरिएको
आमट-चींच: अत्यम्ल
आमल: तेजाबी
आम्लीक: तेजाबवाला तेजाबी
आयकल्यो: श्रुत सुनेको आश्रुत
आयकूंक_नाशिल्ली: नसुनेको अश्रुत
आयचो_काळ: वर्तमानकालीन सामयिक आधुनिक वर्तमान हाल
आयच्या_काळांतलें: आधुनिक अद्यतन आजको अर्वाचीन अधुनातन नया अप्राचीन अकालातीत अपूरातन अपूर्वकालीन नवीन अपूराण साम्प्रतिक
आयताकार: आयताकार
आयतोबा: अजिङ्गर
आयरलॅंडी: आयरलेन्डी
आयरिश: आयरल्यान्डी
आयसलॅण्डाचें: आइसल्यान्डी
आयसलॅण्डी: आइसल्यान्डी
आयात_करपी: आयातकर्ता
आयाती: आयातकर्ता
आयातीत: आयातित इम्पोर्टेड
आयामी: आयामयुक्त आयामी
आयिल्लें: निस्केको
आयिल्लो: आएका समागत
आयोजीत: आयोजित
आरक्षीत: आरक्षित व्याससिद्ध
आरतें_परतें: उल्टापाल्टा उलटपलट हेरफेर अदलीबदली
आरमेनियी: अरमेनियाई अर्मेनियाई
आरास: सजाउने
आरूढ: चढेको बसेको
आरोग्याक_बरें: स्वास्थ्यप्रद आरोग्यप्रद निरोगकर
आरोप_करपी: आरोपक
आरोपमुक्त: रिहा आरोप_मुक्‍त
आरोपी: दोषी दागी अधिरोपित आरोपी
आर्थीक: आर्थिक वित्तीय रुपिया
आर्य_जातीचें: आर्य_जातीय
आलतडचें: नतरेको
आलमपेड्ड्यार: अकर्मण्य निकम्मा बेकार फालतू अकर्मा नालायक ना-लायक अनलायक_नालायक ना-लायक
आलायतें: अतिरिक्‍त बाहेक
आल्जेरियी: अल्जिरेली अल्जेरियाई
आल्त: अग्लो अल्को लामो
आल्मिखुशाल: अधुर
आल्मीखुशाल: निश्शङ्क अनाशङ्कित आशङ्काहीन संशयहीन निश्शंक अनाशंकित आशंकाहीन
आळशी: अल्छी सुस्त ढिलो
आवटें: मूर्ख अज्ञानी बुद्धु बौलाहा बहुला पागल
आवटो: पागल पगला बौलाहा
आवडना_अशें: अरूचिकर रुचि_नभएको
आवडनाशिल्लें: मन_नपर्दो अप्रिय अनभीष्ठ अनभिमत अमनोनीत अरोचक अरुचिकर नीरस रसहीन रुचिहीन फीका असार अरूचिकर रुचि_नभएको
आवडीचें: इच्छित अभिलषित अभिलाषित अभीष्ट आकाङ्क्षित वाञ्छित इष्ट अपेक्षित अभिप्रेत मनोवाञ्छित वाञ्छनीय कमनीय अनुकाङ्क्षित अभिकाङ्क्षित अभिमत अभिवांछित अभिवाञ्छित अभीप्सित मनपर्दो प्रिय रुचिकर अभीष्ट प्रिय प्यारो मन-पर्ने रुचिकर मनपर्दो
आवय_नाशिल्लो: मातृहीन माताहीन मातृविहीन माताविहीन अमातृक
आवरणहीण: खुला उघारो उदाङ्गो
आवरणाचें: गाता_लगाएको गाता_भएको
आवर्तक: आवर्तक
आवेगपूर्ण: आविष्ट आवेशपूर्ण आवेशग्रस्त
आशादायी: आशातीत आशाजनक
आशावादी: आशान्वित आशांवित आशावान आशापूर्ण प्रत्याशी उम्मीदवार उम्मेदवार
आशियायी: एसियाली
आशेखोर: लोभी लालची चुइयाँ कन्जुस
आशेचें: इच्छापूर्ण अभिलाषापूर्ण कामनापूर्ण सकाम स्वादे चखुवा
आशेभगत: लोभी लालची चुइयाँ कन्जुस
आशेल्ले: लुब्ध लोभित लालची
आश्चर्य: प्राकृतिक
आश्चर्याचें: अभूतपूर्व अपूर्व
आश्रमहीण: आश्रमहीन
आश्रमा_बगरचें: आश्रमहीन
आश्वस्त: आश्‍वस्त आशा_प्राप्‍त
आश्वासनीय: आश्‍वस्त
आसक्त: आसक्त मुग्ध मोहित
आसपतीचें: साम्पत्तिक सम्पत्तिसम्बन्धी धनमालको
आसपावीत: समन्वित
आसा: स्थित अधिष्ठित अवस्थित
आसामी: असमिया असमीया असमीया असमिया आसामी
आस्ट्रियायी: आस्ट्रियाई आस्ट्रिआई
आस्पाविल्ले: समाविष्ट समाहित अङ्गभूत समन्वित
आस्वासक: आश्‍वासक आश्‍वासी
आस्वासनां_दिवपी: आश्‍वासक आश्‍वासी
आहाराचें: खाद्य भोज्य आहार्य ग्राह्य भक्ष्य अशनीय
इंग्रजी: अङ्ग्रेजी अङ्ग्रेजी इङ्गलिस्तानी
इंग्लीश: अङ्ग्रेजी इङ्गलिस्तानी
इंग्लेज: अङ्ग्रेजी अङ्ग्रेजी इङ्गलिस्तानी
इंद्रीयगम्य: इन्द्रियगम्य इंद्रिय_गोचर गोचर इंद्रियग्राह्य इन्द्रियगोचर इंद्रियगोचर प्रत्यक्ष अपरोक्ष
इंद्रीयगोचर: इन्द्रियगम्य इंद्रिय_गोचर गोचर इंद्रियग्राह्य इन्द्रियगोचर इंद्रियगोचर प्रत्यक्ष अपरोक्ष
इकरा: एघार एकादश ११
इकरावें: एघारौं एघार
इक्कें: यत्रो
इटाली: इटालेली इटालियन
इटालीयन: इटालेली इटालियन इटालेली इटालियन
इण्डोनेशियन: इन्डोनेसियाई इन्डोनेसियन
इतकें: यत्रो
इतलें: समान तुल्य सदृश बराबर यत्रो
इतिहासा_बगरचें: अनैतिहासिक
इत्शीक: वैकल्पिक विकल्पयुक्त विकल्पी ऐच्छिक
इत्शीत: ऐच्छिक
इत्सा_नासतना: अनैच्छिक
इत्साहीण: इच्छाहीन अकाम आकाङ्क्षाहीन निष्काम अनभिलाषा अनिच्छुक अनभिलाषी निस्पृही अनिच्छु निराकाङ्क्षी अभिलाषारहित
इत्सीत: इच्छित अभिलषित अभिलाषित अभीष्ट आकाङ्क्षित वाञ्छित इष्ट अपेक्षित अभिप्रेत मनोवाञ्छित वाञ्छनीय कमनीय अनुकाङ्क्षित अभिकाङ्क्षित अभिमत अभिवांछित अभिवाञ्छित अभीप्सित
इत्सुक: इच्छुक अनुकाङ्क्षी अभिलाषी आकांक्षी अभिलाषुक अभिलाषक इच्छालु
इत्सूक: इच्छापूर्ण अभिलाषापूर्ण कामनापूर्ण सकाम
इत्से_बगर: अनैच्छिक
इथियोपियायी: इथोपियाली
इबाडिल्लें: कुहिएको गलेको सडेको
इमानी: अद्रोही
इराकी: इराकी
इराणी: इरानी इरानेली इरानी इरानेली
इर्शेन_भरिल्लें: ईर्ष्यापूर्ण आरिसे द्वेषपूर्ण साविद्वेष सासूय विद्वेशपूर्ण वक्र
इल्लें: कम्ती अलिकति अल्प
इल्लेशें: अत्यल्प अलिकति छ्यास्स
इल्लोशें: सानो
इश्कोलाचें: स्कुली विद्यालयी विद्यालयीय
इश्टागत: मिलनसार मिल्दो
इश्टाबगरचो: मित्रहीन बन्धुरहित अबन्धु बन्धुरहित मित्ररहित बंधुहीन बन्धुहीन
इश्टाविरयतचो: मित्रहीन बन्धुरहित अबन्धु बन्धुरहित मित्ररहित बंधुहीन बन्धुहीन
इश्वर_बगरचें: अनीश्वर
इश्वरहीण: अनीश्वर
इश्वरी: ईश्वरीय ईश्वरी दैवी परमेश्वरी
इहलोकीक: इहलौकिक सांसारिक लौकिक
ईश्वरा_बगरचें: प्रभुहीन अनीश्वर ईश्वरहीन
ईश्वरी: देवदत्त
उंचल्या_कुळातलो: अभिजात अभिजात्य उच्च_वंशीय उच्च_कुलीन
उंचेलें: अग्लो उच्च
उकडिल्लें: उसिनेको
उकती: रहस्यहीन अचम्मको अगूढ
उकतें: खुला उघारो उदाङ्गो अगोपनीय अगोप्य प्रकट्य कथ्य प्रकाश्य प्रकट उजागर प्रस्फुटित प्रस्फुट खुल्ला मुक्त
उकतेपणीचें: अनावृत्त
उकतो: नाङ्गो नग्न निर्वस्त्र
उकत्या_पांयाचें: नाङ्गा_खुट्टे
उक्तें: अगुप्त अनिभृत
उखलपी: उत्तोलक
उखलिल्लें: उचालेको उत्तोलित
उगडास_नाशिल्लें: विस्मृत बिर्सिएको
उगडें: खुला उघारो उदाङ्गो
उचांबळ: उद्विग्न हताश_भएको डराएको आतुर अधीर कातर व्याकुल बेचैन विकल अधैर्य अधैर्यवान् अधैर्यवान अधैर्यवान् अभिभूत क्षुब्ध
उचांबळीत: चञ्चल चकचके अधीर
उचीत: नैतिकतापूर्ण नीतिपूर्ण नैतिक उचित सही उचित उपयुक्‍त ठिक शुद्ध_सही यथोचित यथायोग्य समुचित
उच्च: कनिष्ठा
उच्चारिल्लें: उच्चारित उच्चरित
उजळ: श्वेत सेतो शुक्ल तेजोमण्डित तेजपूर्ण कान्तिमान जाज्वल्यमान प्रकाशमान दिव्य चम्किलो
उजळणी: दोहोर्याइ पुनरुक्त
उजवाडायिल्लें: प्रकाशित
उजवें: दाहिने दायाँ
उजू: निष्कपट विश्‍वासी
उजो_पालोवपी: प्रशामक शमक शान्तिकर शामक आगो_निभाउने
उजोलायणें: दाहक दाहिक
उडनासपी: उडन_नसक्ने
उडयिल्लें: बर्बाद बिनष्ट नाश अधिक्षिप्त झरेको खसेको झरुवा
उडिया: उडिया उडिया ओडिया
उणे_पिरायेचें: अल्पायु स्वल्पायु अल्प_जीवी
उणें: अपर्याप्त अपूर्ण अपरिपूर्ण कम्ती अलिकति अल्प
उणें_उलोवपी: अल्पभाषी मितभाषी अल्पवादी
उणें_केल्लें: निलम्बित निलंबित पदच्युत बरखास्त बरख्वास्त अपदस्थ अनुलंबित अनुलम्बित
उण्या_आयुश्याचें: अल्पायु स्वल्पायु अल्प_जीवी
उतरांचें: शाब्दिक शब्द
उताणें: सिधा सीधा उत्तानो सोझो
उतावळें: हतारे
उतावळो: चञ्चल चकचके अधीर
उत्कृश्ठ: सर्वोत्तम सर्वश्रेष्ठ अन्यतम सर्वोत्कृष्ट
उत्तम: उत्तम उत्कृष्ट अनमोल श्रेष्ठ प्रशस्त
उत्तर_अमेरीकी: उत्तरी_अमरीकी उत्तरीअमेरिकी
उत्तरकाळीन: उत्तर_कालीन उत्त्रवर्ती
उत्तरदायी: उत्तरदायी उत्तरदायक जवाबदेह ज़िम्मेदार जिम्मेदार
उत्तरी: उत्तरी
उत्तीर्ण: उत्तीर्ण पास
उत्तेजक: उत्तेजक उत्तेजनाप्रद भडकाउ भडकदार
उत्पन्न: उत्पन्न उत्पादित पैदा-भएको
उत्पादक: उत्पादन_गर्ने उत्पादक
उत्पादीत_जाल्लें: उत्पन्न उत्पादित पैदा-भएको
उत्सर्जीत: त्यागिएको उत्सर्जित
उत्साहपूर्ण: उत्साहपूर्ण उमङ्गपूर्ण
उत्साहहीण: अनुत्सुक निरुत्सुक अनुत्क जिज्ञासाहीन अजिज्ञासु उत्सुक्ताहीन निरुत्सुक
उत्साही: जोशीलो जोशपूर्ण
उथळ: छिपछिपे
उदक_भरशिल्लें: पानी_हालेको पनिया
उदकांतली: पानीमा_उम्रिने जलीय जलज
उदकाचें: पानी_हालेको पनिया सजल
उदकाभरवण: जलमग्न प्लावित
उदकाळ: पानीमा_बस्ने जलीय पानी_हालेको पनिया सजल जलमय अपोमय
उदय_जाल्लो: उदित झुल्किएको
उदारें: सिधा सीधा उत्तानो सोझो
उदेंती: पूर्वी पूर्वीय
उदेल्लो: उदित झुल्किएको
उद्देगी: जावगरिलो मिहिनेती परिश्रमी_आलस्यहीन
उद्धट: चकचके चुलबुले उदण्ड ऊछृङ्खल
उद्धार_केल्लें: अनुद्धृत
उद्युक्त: अनर्जित नकमएको
उध्वस्त: नष्ट चौपट तहस-नहस ध्वस्त समाप्त बरबाद बर्बाद ध्वंसित अपध्वस्त विनष्ट निकंदन ध्वस्त बिग्रेको भत्केको नष्‍टभ्रष्‍ट
उन्नत: विकसित उन्नत प्रोन्नत सुविकसित अभ्युत्थित अभ्युदित
उन्नतीकारक: उन्नतिकारी उत्कर्षकारी उन्नायक उन्नतकारी
उपकारादीक: उपकारी उपकर्ता उपकर्त्ता उपकारक उपकार_कर्त्ता उपकार_कर्ता अनुग्राहक अनुग्राही
उपकारी: कृतज्ञ आभारी धन्यवादी उपकृत अनुगृहीत कृतार्थ कृतकृत्य
उपचारीक: अनुपलक्षित
उपद्रवी: उपद्र्याहा बदमाश छुचो
उपभोगी: उपभोग्य उपभोज्य
उपयुक्त: उचित उपयुक्‍त ठिक
उपयोगी: उपयोगी लाभदायक फाइदाकारी
उपरांतचें: परवर्ती अघिल्लो अगिल्लो
उपस्थीत: उपस्थित हाजिर विद्यमान प्रस्तुत
उपाट: अत्यधिक धेरै औधि प्रचुर अत्याधिक धेरै बहुत अधिक ज्यादा अतिशय अति अगाध अतीव बहुल अदम्य भरपूर सम्पूर्ण सकेसम्म भरिएको भरपूर
उपाड्यांत_घातिल्लें: ढलुवा
उपाधीत: अलङ्कृत अलंकृत उपाधित विभूषित
उपाशी: अनाहार
उपासगामी: व्रतगामी
उपासाचें: उपवासक उपवासी
उपेक्षा: उपेक्ष्य उपेक्षणीय
उपेक्षित: तिरस्कृत अनादृत अनादरित उपेक्षित
उपेक्षीत: उपेक्षित
उपेगाचें: लाभदायक लाभप्रद लाभकर लाभकारी लाभजनक गुणकारी उपयोगी हितकारी अर्थकर
उपेगी: योग्य उपयुक्‍त समर्थ सक्षम खाइलाग्दो उपयोगी लाभदायक फाइदाकारी
उपोश्णकटीबंधीय: उपोष्णकटिबन्धीय उपोष्णकटिबंधीय
उप्तादीत: उत्पन्न उत्पादित पैदा-भएको
उप्राशिल्लें: समागत सङ्गमित
उप्रासपी: परिणामी
उबारपी: उत्तोलक
उबारिल्लें: उचालेको उत्तोलित
उबें_केल्लें: निर्मित रचित विरचित सृष्ट कृत सर्जित सृजित संरचित पर्णीत प्रकृत प्रणीत
उभयचर: उभयचर जल-स्थलचर जलथली
उमथें: उल्टो अधोमुख
उमेदी: प्रसन्न खुसी खुश आनन्दित पुलकित हर्षित विह्वल आह्लादित प्रफुल्ल परितुष्ट प्रफुल्लित प्रफुलित उल्लसित उल्लासित उल्लासी आनन्दी विनोदित पुलकित तुष्ट प्रसन्नचित्त उत्साहपूर्ण उमङ्गपूर्ण
उमेदी_बगरचें: अनुत्सुक निरुत्सुक अनुत्क जिज्ञासाहीन अजिज्ञासु उत्सुक्ताहीन निरुत्सुक
उरफाटें: विपरीत उल्टो विरुद्ध वामावर्त देब्रेतिर_हुँदै_घुमेको
उरफाटो_चलपी: प्रतिगामी पश्चगामी पश्चगङ्ता
उरफाट्या_अर्थाचें: विलोम उल्टो विपरीत_विरुद्धार्थी
उरफाट्या_काळजाचो: निठुरी निर्मोही निर्मम अमोही
उरबेवंत: जोशीलो जोशपूर्ण
उरमट: अनम्य अनमनीय कठोर दृढ
उरिल्लें: अव्यतीत अगत अविगत उब्रेको बचेको बचेखुचेको रहल शेष बाँकी रोकिएको बन्द_भएको थामिएको परिशिष्ट अवशिष्ट
उरिल्लें_रीण: बकाया एरियार दातव्य दाय
उरुग्वेयी: उरुग्वेयन उरुग्वे-सम्बंधी
उर्बेभरीत: प्रोत्साहित उत्साहित प्रेरित
उर्मट: चकचके चुलबुले उदण्ड ऊछृङ्खल
उलट_सुलट: उल्टापाल्टा उलटपलट हेरफेर अदलीबदली
उलटें_सुलटें: उटपट्याङ फाल्टु नचाँहिदो अनावश्यक रद्दी
उलयतें: मुखरित मुखर
उलयिल्लें: उच्चारित उच्चरित
उल्लेखनीय: उल्लेखनीय उल्लेखयोग्य उल्लेख्य उल्लेखनीय उल्लेख_गर्ने_योग्‍य
उल्लेखीत: उल्लेखित कथित लिखित निर्देशित निर्दिष्ट
उशीर_जाल्लें: विलम्बित विलंबित
उश्टायिल्लें: खाएको भक्षित
उश्टें: जुठो उचछिष्ट
उश्ट्याचें: जुठो उचछिष्ट
उश्ण: तातो गर्मी उष्ण तातो न्यानो
ऊंच: अग्लो उच्च उचो उच्च अग्लो अल्को लामो
एक: एक १
एक_करोड: कडोर कोटी_१००००००० 10000000
एक_जेवणाचें: एक-छाके एकाहारी
एक_तृतियांश: तीनभाग
एकक: एकल
एकचारवादी: समन्वयवादी
एकचित्त: एकाग्रचित्त तन्मय स्थिरचित्त
एकट्याचें: एक_तर्फफो एकपक्षीय
एकठांय: एकत्रित एकट्ठा एकत्र जमा समग्रीकृत सङ्घटित सङ्गठित एकीकृत एकीकरण
एकतर्फी: एकतर्फी वान_वे एक_तर्फफो एकपक्षीय एकतर्फी एकपक्षको एकलकाटे
एकतायपूर्ण: एकतापूर्ण सौहार्दपूर्ण संगठित सङ्गठित
एकतिसावें: एक्काइसौँ
एकतीस: एकतीस ३१
एकत्र: एकत्रित एकट्ठा एकत्र जमा समग्रीकृत
एकत्रीत: एकतापूर्ण सौहार्दपूर्ण संगठित सङ्गठित एकत्रित एकट्ठा एकत्र जमा समग्रीकृत एकीकृत एकीकरण
एकदम: पुरै पूर्ण पक्का
एकदेशी: एकदेशी एकदेशीय
एकनिश्ठ: निष्ठावान अनन्य एकनिष्ठ
एकपिकी: एकफसला
एकभशेनचें: समानार्थक अनुगतार्थ
एकमत: एकमत एकराय
एकमताचें: अभिमत
एकमती: अभिमत
एकमुळी: एक्लो एक्लै
एकमुळें: अमिलनसार बाउँठे एकलकाटे
एकमुळो: पृथकचर
एकरुपी: प्रतिरूपी अनुरूपी समरूपी
एकलें: एक १
एकलें-दुकलें: एक_दुई एक्का_दुक्का
एकलेंच: एकमात्र एउटा_मात्र
एकल्याचें: एक_तर्फफो एकपक्षीय
एकवंशी: वंशीय
एकवटिल्लें: एकत्रित एकट्ठा एकत्र जमा समग्रीकृत
एकवटीत: सङ्घटित सङ्गठित
एकविसावें: एक्काइसौँ २१
एकवीस: एक्काइस २१
एकशें_एक: एक_सय_एक
एकसठ: एकसट्ठी एकसठ
एकसठावें: एकसट्ठीऔं
एकसारकें: समानार्थक अनुगतार्थ
एकसुरी: एक्लो एक्लै
एकसुरें: अमिलनसार बाउँठे एकलकाटे
एकसुरो: पृथकचर
एका_वर्साचें: एक_वर्षे
एकांत: निर्जन एकान्त सुनसान जनशून्य
एकांतहीण: एकान्तरहित सुनसानहीन एकान्तहीन
एकाग्र: केन्द्रित केन्द्रिभूत
एकाग्रताय: एकाग्रचित्त तन्मय स्थिरचित्त
एकाच_काळांतलें: सामयिक अवसरीय कालिक
एकाद्रें: एकाध
एकावडो: एकसरो
एकावन: एकाउन्न एकाउन
एकावनावें: एकाउन्नौं
एकासारकें: एकनासे समान तुल्य
एकुणअंयशीं: उनासी उन्यासी ७९
एकुणअंयश्यांवें: उनासीऔं
एकुणचाळिसावें: उनन्चालीसौँ
एकुणचाळीस: उनन्चालीस
एकुणणव्वद: उनासी
एकुणतिसावो: उनन्तीसौँ
एकुणतीस: उनन्तीस २९
एकुणपन्नास.: उनन्चास ४९
एकुणपन्नासावें: उनञ्चासौँ
एकुणसत्तर: उनन्सत्तरी ६९
एकुणसत्तरावें: उनन्सत्तरीऔं
एकुणसाठ: उनसट्ठी ५९
एकुणसाठावें: उन्साठीऔं उनन्साठीऔं
एकुणीस: उन्नाइस १९ उन्नाइसौँ १९_औं 19औं
एकुलगें: अमिलनसार बाउँठे एकलकाटे
एकुलतें: अमिलनसार बाउँठे एकलकाटे
एकुलयो: पृथकचर
एकूच: एकमात्र एउटा_मात्र
एकूलगी: एक्लो एक्लै
एकूलयी: एक्लो एक्लै
एके_वटेनचें: एकतर्फी एकपक्षको एकलकाटे
एकेचाळिसावें: एकचालीसौँ
एकेचाळीस: एकचालीस
एकोणअंयशीं: उनासी ७९
एक्यांयशीं: एकासी
एक्यांयश्यांवें: एकासीऔं
एक्याण्णव: एकानब्बे
एक्याण्णवावें: एकानब्बेऔं
एक्यात्तर: एकहत्तर
एक्यात्तरावें: एकहत्तरौं
एक्वादोरी: एक्वाडोरी
एण्टिगुवाचें: एन्टिगुआई
एण्टिगुवायी: एन्टिगुआई
एण्डोरी: एन्डोरी
एरिट्रियायी: एरिट्रियाई
एल_सल्वाडोराचें: एल_सल्वाडोरी सल्वाडोरी
एल_सल्वाडोरी: एल_सल्वाडोरी सल्वाडोरी
ऑफिसरा_भशेन: अफसरी
ऑफिसाचें: अफसरी
ऑस्ट्रियन: आस्ट्रियाई आस्ट्रिआई आस्ट्रियन
ऑस्ट्रेलियायी: अस्ट्रेलियाई
ओंपिल्लें: समर्पित
ओकारांती: ओकारान्त ओकारादि
ओगोत_जाल्लें: विलम्बित विलंबित
ओजस्वी: तेजस्वी ओजस्वी तेजवन्त तेजवान कान्तिवान्
ओडलायणें: आकर्षक मनोहर राम्रो सुन्दर मनोरम मनोहर सुन्दर
ओपेरासांव_केल्ले: प्रत्यारोपित प्रतिरोपित
ओबड_धोबड: खस्रो रूखो असमान असमतल
ओबडधोबड: असमतल असम अग्लो_होचो
ओमथें: उल्टो अधोमुख
ओरिया: उडिया ओडिया
ओलें: भिजेको
ओल्ताचें: मोडदार
कंगाल: अभाव-ग्रस्त अभावग्रस्त
कंजूस: महालोभी धेरै_लोभी लोभी कन्जुस कन्चुस
कंठओंठयो: कण्ठोष्ठ्य
कंठताळयें: कण्ठतालव्य
कंपमान: थर्किइरहेको कम्पित कम्पायमान
कंपीत: थर्किइरहेको कम्पित कम्पायमान
कंपुचियन: कम्बोडियाई कम्पुचियाई कम्बोडियन कम्पुचियन
कंबोडियन: कम्बोडियाई कम्पुचियाई कम्बोडियन कम्पुचियन
कंवळें: मसृण चिल्लो
कचेरीक: कार्यालयीय
कच्चें: काँचो नपाकेको काँचो काँचो अधकल्चो आधा_पाकेको
कट्टर: क्षतिग्रस्त
कट्टरवादी: मतान्ध कट्टरवादी कट्टरपन्थी
कट्ट्या_विणें: बोक्रो_नभएको कवचहीन आवरणहीन
कट्ट्याचें: कवचधारी कवचयुक्‍त आवरणयुक्‍त
कठीण: कठिन दुर्गम अगम्य अगम दुरूह दुर्गम्य अगत आगम अप्ठ्यारो कठिन सारो मुश्किल दुर्बोध्य अति_गूढ दुरूह गम्भीर अप्ठ्यारो जटिल गाह्रो कठिन विकट मुश्‍किल सारो अबुझ कठिन गाह्रो अप्ठयारो मुस्किल कडा कठोर साह्रो
कठोर: क्रूर निर्दय कठोर निर्दयी निष्ठुर नृशंस करुणाहीन दयारहित दयाहीन उग्र करुणाविहीन अदयालु असभ्य दुर्जन दुर्छे
कडक: तीक्ष्ण तीव्र कुशाग्र प्रखर तेज अकुण्ठ अकुंठित अकुन्ठित विषम कडा उग्र
कडयिल्लें: पाकेको पकाएको
कडेनचें: निकटस्थ छेउको निकटको समिपको निकटवर्ती समीपी सन्निकट समीपवर्ती समीपस्थ
कड्डणाचें: अन्नीय अनाजी
कणखर: चर्को तीव्र कडा धाकिलो धाके
कणीक: कनिका मोटो
कथनीय: भनिने कथनीय कथ्य वाच्य अभिभाष्य वक्तव्य
कदें: मोटो बलियो स्थुलकाय
कनवाळू: दयालु कृपालु दयावन
कनिश्ठ: साना_भाइ भाइ
कन्नड: कन्नड कन्नड कन्नड
कपटहीण: छद्महीन कपटहीन अछद्म
कपटी: कपटपूर्ण छलपूर्ण कपटमय छलमय छद्मपूर्ण धूर्ततापूर्ण कुटिल वक्र टेढा अरालटेढो बाङ्गो बाउँठो दुराशय कुविचारी आरिसे धोकाबाज बेइमानी_गर्ने धूर्त कपटी छली
कपडे_घाल्लें: परिधान_गरेका वस्त्राभूषित
कफल्लक: निर्धन गरीब दरिद्र
कबलातीचें: अनुबद्ध अनुबन्धित अनुबंधित
कमजोर: अबला
कमयिल्लें: अर्जित कमाएको
कमी: अपर्याप्त अपूर्ण अपरिपूर्ण कम्ती अलिकति अल्प
कमी_उलोवपी: अल्पभाषी मितभाषी अल्पवादी
कमोवपी: कमाऊ
कम्युनिस्ट: साम्यवादी समानतावादी कम्युनिस्ट साम्यवादी कम्युनिस्ट
कर_आशिल्लो: कराधीन करयुक्त
करंगळी: कान्छी_औंलो कनिष्ठ कान्छो कान्छी
करणारो: कर्त्ता कर्ता कर्तार
करपी: कर्त्ता कर्ता कर्तार
करमुक्त: करमुक्त करहीन कर_मुक्त अकर_शुल्क_मुक्त
करयुक्त: कराधीन करयुक्त
करहीण: करमुक्त करहीन
करामती: चमत्कारी करामाती
कराराचें: अनुबद्ध अनुबन्धित अनुबंधित
करूंक_नाशिल्लें: नगरिएको अकृत
करूंकनाशिल्लें: अकृत
कर्तो: कर्त्ता कर्ता कर्तार
कर्मकांडी: कर्मठ कर्मनिष्ठ कर्मी
कर्मनिश्ठ: कर्मनिष्ठ कर्मठ कर्मी
कर्‍या_भशेनचें: असिना
कलंकीत: लाञ्छित कलङ्कित कलुषित दागी बदनामी
कलम: कलमी कलम_काटेको
कलात्मक: कलापूर्ण कलात्मक कलामय
कलापूर्ण: कलापूर्ण कलात्मक कलामय
कलाहीण: कलाहीन अकलात्मक
कल्पनेंतलें: काल्पनिक कल्पित अवास्तविक अयथार्थ अनात्मक अप्रकृत अयथातथ अयाथार्थिक
कल्पनेभायलें: अपरिकल्पित
कल्पीत: कपोल_कल्पित मनगढन्त हावा कपोलकल्पित
कल्याणकारी: कल्याणकारी मङ्गलकारी कल्याणप्रद मङ्गलकारक मङ्गलदायक मङ्गलप्रद हितकारी हितकर हितकारक कल्याणमय अनुकूल
कळवळप: द्रवित द्रवीभूत दयार्द्र
कळवळ्यां_येवपी: रिरिहा
कळाव_जाल्लें: विलम्बित विलंबित
कवच_घाल्लें: कवचधारी कवची
कवचधारी: कवचधारी कवची
कवचाळ: कवचधारी कवचयुक्‍त आवरणयुक्‍त
कवर्गी: कवर्गीय
कव्हराचें: गाता_लगाएको गाता_भएको
कशाय_कशें: उल्टापाल्टा उलटपलट हेरफेर अदलीबदली
कश्टकरी: परिश्रमी मेहनती उद्यमी कर्मशील पुरूषार्थी
कश्टाची: दुखद दुखदायी दुखप्रद दुखमय दुखद दुखपूर्ण कष्टपूर्ण
कसरती: व्यायामी
कांटयारें: काँढे कण्टकयुक्त कंटकित
कांटे_नाशिल्लें: कण्टकहीन अकण्टक शूलहीन
कांटेहीण: कण्टकहीन अकण्टक शूलहीन
कांट्याबगरचें: कण्टकहीन अकण्टक शूलहीन
कांठा_वयलें: किनार तीर छेउ
कांठाचें: किनारा_भएको
कांतिमान: तेजोमण्डित तेजपूर्ण कान्तिमान जाज्वल्यमान प्रकाशमान दिव्य चम्किलो
कांतीमय: तेजस्वी ओजस्वी तेजवन्त तेजवान कान्तिवान्
कांद्या_कोराचें: बैजनी_रङको प्याजी
कांय: अनेक कैयौं विविध नाना एकाधिक अनेकानेक तमाम कम्ती अलिकति अल्प अलिकति केही थोरै
काकुटी: सहानुभूतिशील
कागदपत्री: दस्तावेजी
कागदी: कागजको
कागाळ_करपी: गुहारी
कागाळकार: गुहारी
काजराचें: वैवाहिक बिहे_सम्बन्धी
काजारी: विवाहित बिहे_भएको परिणीत
काटकसरी: अल्पव्ययी कमखर्ची
काटू: लोभी कन्जुस कन्चुस
काटूक: लोभी कन्जुस कन्चुस
काडपी: नाशक
काडिल्लें: निलम्बित निलंबित पदच्युत बरखास्त बरख्वास्त अपदस्थ अनुलंबित अनुलम्बित अछत
कातरिल्लें: छिनेको काटिएको टुक्रिएको
कात्र्यांचें: पेच_भएको पेचताल
कादंबरेचें: औपन्यासिक उपन्यास-सम्बन्धी
कादयेचे: हवालती
कानकातरो: कनकट्टा बुच्चे कानचिरा
कानकापो: कनकट्टा बुच्चे कानचिरा
कानडी: कन्नड कन्नड
कापरा_कोराचें: कपुरी कपुरे
कापराचें: कपुरे कपुरी कपुरी
कापसा_कोराचें: कपासे
कापसाळ: रुवोदार कपासदार
कापिल्लें: छिनेको काटिएको टुक्रिएको
कापीत: धेरैबुढो वृद्ध
कापूंक_नाशिल्लें: नकाटेको अनुच्छिन्न अखण्डित
काप्पी: धेरैबुढो वृद्ध
काफीर: काफिर
काबार: समाप्त सम्पूर्ण निष्पादित पूरा सम्पादित संपादित पूर्ण सम्पन्न संपन्न सम्पन्न ध्वस्त बिग्रेको भत्केको नष्‍टभ्रष्‍ट
काबीज: अधिग्रहीत अधिकृत अधिगत
काबुली: काबुली काबुली
कामचोर: अल्छी जाँगरहीन
कामनेचें: इच्छापूर्ण अभिलाषापूर्ण कामनापूर्ण सकाम इच्छित अभिलषित अभिलाषित अभीष्ट आकाङ्क्षित वाञ्छित इष्ट अपेक्षित अभिप्रेत मनोवाञ्छित वाञ्छनीय कमनीय अनुकाङ्क्षित अभिकाङ्क्षित अभिमत अभिवांछित अभिवाञ्छित अभीप्सित
कामवती: कामवती
कामसू: जावगरिलो मिहिनेती परिश्रमी_आलस्यहीन
कामहीण: कामहीन वासनाहीन निष्काम निर्मम
कामूक: कामवती
कायदेशीर: न्यायपूर्ण न्यायसङ्गत न्यायोचित
कायद्याचें: वैध कानूनी ऐन_अनुसार कानुनी
कायम: स्थायी स्थाइ
कायरोचें: काहिराइ
कारण_नासतना: बिनासित्ति अकारण
कारणा_बगर: बिनासित्ति अकारण
कारणां_करपी: ढर्रे स्वाङ_पार्ने
कारबारी: कर्मी कामकाजी काम-काजी कारबारी उद्योगी अभिक्रान्ती
कार्यकारी: स्थानापन्न अर्काको_ठाउँमा_आएको सट्टामा_आएको अर्काका_पदमा_सरुवा_भई_आएको
कार्यालयीन: कार्यालयीय
कालजयी: अमर मृत्यु_कालजयी चिरञ्जीवी
काल्पनीक: काल्पनिक कल्पित अवास्तविक अयथार्थ अनात्मक अप्रकृत अयथातथ अयाथार्थिक कपोल_कल्पित मनगढन्त हावा कपोलकल्पित अडकलबाज अनुमान
काळखी: अन्धकारपूर्ण अँध्यारो अंधकारपूर्ण अन्धेरा अन्धियारा अन्धकारपूर्ण तमोमय तमस्वी अप्रकाशित अप्रकाशमान
काळजाक_लागपी: भावपूर्ण मार्मिक भावनात्मक भावनापूर्ण भावात्मक मर्मस्पर्शी हृदयस्पर्शी
काळवाचक: कालवाचक कालवाची
काळींगकार: धनाढ्य धनी धनवान
काळीज_चिरपी: हृदय-विदारक मार्मिक मर्मभेदी मर्मघाती मर्मान्तिक
काळीज_पिंजपी: विदारक
काळें: कालो अध्याँरो कृष्ण श्याम
काळें_कुळकुळीत: कालो-डिङ्गर अति_श्याम गहिरो_कालो
काळो: अश्‍वेत कालो
काव्यात्मक: काव्यात्मक कवित्वपूर्ण रसात्मक
काशीचें: बनारसी
काश्मिरी: कश्मीरी कश्मीरी
कासादोर: सिकारी व्याधा सिकारी
कास्तिसांवाचें: दुर्बोध्य अति_गूढ दुरूह गम्भीर अप्ठ्यारो जटिल गाह्रो
किंकोत: उपेक्ष्य उपेक्षणीय
किक्के: कति
किजिली: कर्कशा रिसाहा उग्रा झगडालु चण्डी चण्डिका झगडालु खटपटे लडाकु कलहप्रिय कलहकारी कर्कश लडाइ झगडा मारामार काटाकाट इबी इख
किटकनाशक: कीटाणुनाशक
किडकिडीत: हड्डीछाला अस्थिमय दुब्लो सिकुटे खिनाउटे अति_क्षीणकाय दुब्लो लुते क्षीण
किडकिडें: कमजोर दुर्बल निम्छरो
किण्ण: सुनसान निस्तब्ध चकमन्न
कितले: कति
कितल्योश्योच: अनेक कैयौं विविध नाना एकाधिक अनेकानेक तमाम
किमती: महँगो मङ्गो दामी मूल्यवान
किरंगळी: कनिष्ठ कान्छो कान्छी
किरकोळ: खुद्रा_सामान फुटकर_सामान छिटपुट छुटपुट छिट-पुट छुट-पुट हल्का-फुल्का
किसमिसाचें: किसमिसे किसमिसी
कुकर्मी: अकीर्तिकर अपकीर्तिकर
कुकुलें: भुराभुरि केटाकेटी नानी शिशु बच्चा सानो मसृण चिल्लो सानो सानु
कुचकामी: विकल्पहीन उपायहीन निरुपाय विवश अनन्यगति अनन्यगतिक
कुचकुचीत: सघन घना गहन सङ्घात
कुच्छित्री: कुस्वभावी कुबुद्धि दुश्शील
कुटील: अबुझ
कुटुंबवितुश्टी: भँडुवा घर-फोडुवा घरभँडुवा
कुटुंबहीण: परिवारहीन कुटुम्बहीन
कुटुंबीक: पारिवारिक घरेलु पैत्रिक पुर्ख्यौली पुश्तैनी परिवारयुक्त कुटुम्बयुक्त
कुडके_जाल्लें: चकनाचुर
कुडीचें: सारीरिक दैहिक कायिक
कुडीचो: शरीरी अङ्गधारी अङ्गी तनुधारी सदेही सशरीरी शरीरधारी देहवान
कुड्डो: अन्धो नेत्रहीन
कुड्डो_विश्वासी: अन्धविश्वासी अन्ध-विश्वासी
कुड्डो_विस्वासू: मतान्ध कट्टरवादी कट्टरपन्थी
कुतां_काडपी: छिद्रान्वेषक छिद्रान्वेषी
कुतां_काडिनासपी: अछिद्रान्वेषक अछिद्रान्वेषी
कुपथ्य: नपच्ने कुपथ्य अपच्य कुपथ्य अपथ्य अहितकर
कुपां_नाशिल्लें: स्वच्छ मेघहीन निरभ्र अनभ्र मेघरहित अनाकाश अमेघ
कुपां_बगरचें: स्वच्छ मेघहीन निरभ्र अनभ्र मेघरहित अनाकाश अमेघ
कुपां_विरयत: स्वच्छ मेघहीन निरभ्र अनभ्र मेघरहित अनाकाश अमेघ
कुपांवीण: स्वच्छ मेघहीन निरभ्र अनभ्र मेघरहित अनाकाश अमेघ
कुपात्र: कुपात्र अपात्र अनधिकारी अभाजन
कुपोशीत: कुपोषित
कुप्रसिद्द: कुख्यात बदनाम दुर्नाम
कुरूप: कुरूप नराम्रो विरूप
कुळवंत: कुलीन घरानियाँ खानदानी
कुळीन: कुलीन घरानियाँ खानदानी
कुविख्यात: कुख्यात बदनाम दुर्नाम
कुशळ: सिपालु प्रवीण निपुण पारङ्गत दक्ष माहिर अभ्यस्त कुशल होशियार पक्का सिद्धहस्त शातिर पटु पका निष्णात परिपक्व कार्यकुशल विचक्षण अभिज्ञ अभ्यासी आप्त योग्य उपयुक्‍त समर्थ सक्षम खाइलाग्दो
कुशिल्ले: सडियल
कुशिल्लें: कुहिएको गलेको सडेको
कुशीक: च्युत बञ्चित अपगत
कुशीकचें: निकटस्थ छेउको निकटको समिपको निकटवर्ती समीपी सन्निकट समीपवर्ती समीपस्थ
कुशीचें: पल्लो छेउको
कुसकें: कुहिएको गलेको सडेको
कूट: अप्ठ्यारो कठिन सारो मुश्किल
कूडहीण: विदेह अशरीरी अकाय शरीरहीन अगात्र अतनु अदेह शरीरविहीन अपाङ्ग अपिण्डी पिण्डरहित
कूपाळू: दयालु कृपालु दयावन
कूळहीण: अकुलीन पानी_नचल्ने अछुत निम्न_वंशीय
कृतघ्न: कृतघ्न अकृतज्ञ
कृतज्ञ: कृतज्ञ आभारी धन्यवादी उपकृत अनुगृहीत
कृतार्थ: कृतार्थ कृतकृत्य
कृत्रीम: देखावटी नकली बनावटी बनौटी कृत्रिम अप्रकृत अयाथार्थिक
कृपापात्र: कृपापात्र दयापात्र
कृशोदरी: कृशोदरी तनुमध्या कटिहीना
कॅटेलनी: केटेलनी
कॅथोलीक: केथोलिक
कॅनेडीयन: कनेडियन कनाडाई
केंद्रीत: केन्द्रित केन्द्रिभूत
केनियायी: केन्यायी किनियाई
केल्लें: कृत निष्पन्न निष्पादित
केसाळ: रुवायुक्त
केस्तांवी: लडाइ झगडा मारामार काटाकाट
केस्ताळ: झगडालु खटपटे लडाकु कलहप्रिय कलहकारी कर्कश
कैदी: हवालती
कोंकणी: कोङ्कणी कोङ्कनी कोङ्कणी कोङ्कनी कोङ्कणी कोङ्कनी
कोंत्रायिल्ले: कुँदिएको खोपिएको
कोडू: टर्रो तितो तितो
कोडू_काजरो: धेरै_तितो अति_कटु धेरै_तितो अति_कटु
कोडू_वीख: धेरै_तितो अति_कटु
कोडूभाशी: अप्रियभाषी अप्रियवादी अप्रियंवद
कोणूच: कोही_पनि
कोनश्यांचें: कोणयुक्त कोणीय
कोनी: कोणयुक्त कोणीय
कोनीय: कोणयुक्त कोणीय
कोमल: नरम कमलो कोमल मसृण चिल्लो
कोमलांगिनी: कोमलाङ्गिनी कोमलांगना कोमलाङ्गी
कोमेल्ले: अङ्कुरित उम्रिएको
कोमोरोजी: कोमोरोजी कोमोरोसी
कोरांतिल्ले: कुँदिएको खोपिएको
कोरियन: कोरियाको कोरियन कोरियाई कोरियन
कोरियी: कोरियाको कोरियन कोरियाई कोरियन
कोरी: कोरा अप्रयुक्त अव्यवहृत
कोरें: सादा सेतो
कोलंबियी: कोलम्बी
कोलकाती: कोलकत्ते
कोसळिल्लें: भत्केको ढस्केको कोल्टिएको
कौमार्ययुक्त: कौमार्ययुक्त
क्युबी: क्युबाई क्युबन
क्रमहीण: क्रमहीन अक्रमिक अनियोजित विशृङ्खलित
क्रमा_बगरचें: क्रमहीन अक्रमिक अनियोजित विशृङ्खलित
क्रमान: क्रमिक अनुक्रमिक क्रमबद्ध विन्यस्त क्रमानुसार क्रमानुकूल शृङ्खलाबद्ध अनुपूर्व
क्रियाहीण: अक्रिय क्रियारहित क्रियाहीन
क्रिये_बगरचें: अक्रिय क्रियारहित क्रियाहीन
क्रिस्ती: केथोलिक
क्रुर: क्रूर निर्दय कठोर निर्दयी निष्ठुर नृशंस करुणाहीन दयारहित दयाहीन उग्र करुणाविहीन अदयालु
क्रूर: अत्याचारी अनाचारी आततायी बर्बर नृशंस अतिचारी अनीतिमान् उत्पीडक
क्रॅऑली: क्रिओल क्रियोल
क्रोएशियन: क्रोएसियाई क्रोएशिआई क्रोएशियन क्रोएसियाई क्रोएसिआई
क्षणजिवी: नश्वर अशाश्वत क्षणजीवी क्षयशील नाशवान भंगुर विनाशी अनित्य मेटिने नाशुक अनित
क्षणभंगूर: नश्वर अशाश्वत क्षणजीवी क्षयशील नाशवान भंगुर विनाशी अनित्य मेटिने नाशुक अनित
क्षमा: माफ माफी क्षमा छुट मिनाहा
क्षमायोग्य: क्षम्य क्षमा_योग्य मर्षणीय
क्षम्य: क्षम्य क्षमा_योग्य मर्षणीय
क्षय_रोगी: क्षयी
क्षीण: अति_क्षीणकाय दुब्लो लुते क्षीण
क्षुद्र: अकुलीन पानी_नचल्ने अछुत निम्न_वंशीय
क्षुद्र_कुळाचें: निम्न_कुलीन निम्न_वंशीय
क्षेपक: क्षेपक
क्षेपणक: क्षेपक
खंडक: खण्डक खण्डनकर्ता
खंडणीय: खण्डनीय खंडनीय भंजनीय काट्य खण्डनीय खंडनीय
खंडाचें: प्रायद्वीपीय
खंडी: महाद्वीपीय
खंडीय: प्रायद्वीपीय
खंतदिणी: दुखद दुखदायी दुखप्रद
खंती: हताश निराश खिन्न
खंतीची: दुखद दुखदायी दुखप्रद दुखमय दुखद दुखपूर्ण कष्टपूर्ण
खंबीर: दृढ़ अटल अडिग अविचल स्थिर कायम अडिग अनत अनमित
खंयचेंय_एक: एकाध
खटारी: थोत्रो पूरानो
खडकाळ: ढुङ्गेनी
खडतर: कठिन दुर्गम अगम्य अगम दुरूह दुर्गम्य अगत आगम
खडपाळ: ढुङ्गेनी
खडबडीत: असमतल असम अग्लो_होचो खस्रो रूखो असमान असमतल
खणपी: उत्खनक
खताळ: दाग_भएको दाग_लागेको धब्बा_लागेको
खतेवल्लें: दागी
खनीज: खनिज
खबर_आशिल्लें: थाहा ज्ञात विदित अवगत विज्ञात अवबुद्ध परिचित
खबर_नाशिल्लें: अज्ञात नजानेको अविदित अनवगत अपरिचित अपरिगत अनधिगत अनभिज्ञ अज्ञ
खबरेपत्र: दैनिक प्रत्येक_दिन
खर: अदम्य तीक्ष्ण तीव्र कुशाग्र प्रखर तेज अकुण्ठ अकुंठित अकुन्ठित विषम दरो बलियो कठरो सारो जोशीलो जोशपूर्ण चर्को तीव्र कडा असभ्य दुर्जन दुर्छे
खर_बुद्दीचें: तीक्ष्णबुद्धि तीखो_बुद्धि प्रखरबुद्धि
खरसाणीचे: प्रबल प्रचण्ड उत्कट उग्र तेज कडा
खरी: खारिएको असली शुद्ध राम्रो खोटहीन विशुद्ध वास्तविक यथार्थ साँचो सही असली वास्तव अकाल्पनिक अकल्पित प्रकृत प्राकृतिक
खरें: साँचो सत्य यथार्थ शुद्ध_सही
खरो: निष्कपट विश्‍वासी
खर्चीक: अपव्ययी खर्चिलो फिजुलखर्ची व्ययशील अतिव्ययी अति-व्ययी व्ययी
खळबळीत: सनसनीदार सनसनीखेज
खांदये_बगरचें: हाँगा_नभएको शाखाहीन शाखाविहीन
खांदये_विरयत: हाँगा_नभएको शाखाहीन शाखाविहीन
खांदी_नाशिल्लें: हाँगा_नभएको शाखाहीन शाखाविहीन
खांदो: शाखायुक्त डाले प्रशाखित
खांपें: सिपालु प्रवीण निपुण पारङ्गत दक्ष माहिर अभ्यस्त कुशल होशियार पक्का सिद्धहस्त शातिर पटु पका निष्णात परिपक्व कार्यकुशल विचक्षण अभिज्ञ अभ्यासी आप्त
खाकी: माटो_रङ खाकी खैरो
खाजगी: निजी आफ्नो स्वकीय स्वायत्त आत्म वैयक्तिक व्यक्तिगत निजी आफ्नो व्यक्तिगत
खाणा_बगरचें: निराहार अनाहार
खातेदार: खातेदार
खात्या_बगरचें: निर्विभाग
खात्रीचें: अनुमानित अनुमित
खादाड: पेटु खन्चुवा घिचासे घिचुवा भाते
खाद्य: खाद्य भोज्य आहार्य ग्राह्य भक्ष्य अशनीय
खानदानी: पैत्रिक पुर्ख्यौली पुश्तैनी
खापो: दिग्गज
खायलें: नगण्य यस्तो-उस्तो अगण्य अनुदात्त अधीनस्थ अधीन मातहत अधस्तन अमुख्य
खायल्या_कुळाचें: अकुलीन पानी_नचल्ने अछुत निम्न_वंशीय निम्न_कुलीन निम्न_वंशीय
खारट: नुनीलो
खारें: नुनीलो
खालचें: निम्न तल्लो
खालते_मानेचें: निहुरिनु घोसेमुन्टो
खाला_दिल्लें: निम्नलिखित
खाली: रिक्त खाली रित्तो शून्य
खाल्लें: पच हजम हडप
खावगें: पेटु खन्चुवा घिचासे घिचुवा भाते
खावपाचें: खाद्य भोज्य आहार्य ग्राह्य भक्ष्य अशनीय
खावपी: भक्षक भक्षी खादक
खाशेलें: विशिष्ट
खाश्या: सहोदर सहोदरा एकोदर सगर्भ सगर्भ्य
खाश्श्या: स्वजनीय आत्मजनीय
खास: विशिष्ट असामान्य असाधारण खास विशेष यस्तो-उस्तो जस्तो-त्यस्तो अपसामान्य स्पेसल विशेष खास खासा
खिसेकापो: बगलीमारा पाकेटमारा
खीणयाळें: नश्वर अशाश्वत क्षणजीवी क्षयशील नाशवान भंगुर विनाशी अनित्य मेटिने नाशुक अनित
खुटें: फिका खल्लो
खुळो: पागल पगला बौलाहा
खूब: अनेक कैयौं विविध नाना एकाधिक अनेकानेक तमाम धेरै बहुत अधिक ज्यादा अतिशय अति अगाध अतीव बहुल भरपूर सम्पूर्ण सकेसम्म भरिएको भरपूर निकै धेरै प्रशस्त मनग्गे प्रगाढ गम्भीर गहन
खूब_कोडू: धेरै_तितो अति_कटु
खूब_चड: अत्यधिक धेरै औधि प्रचुर अत्याधिक
खूब_व्हड: धेरै_ठुलो अति_विशाल विशालतम
खेंचर: नभचर नभश्‍चर अकासगामी
खेदहीण: शोकहीन अवसादहीन अशोक विशोक अखेद खेदरहित
खेदा_बगरचें: अखेद खेदरहित
खेरीज: अलग छुट्टै पृथक् फरक
खेळीमेळीचें: मिलनसार मिल्दो
खोजो: नामर्द नपुंसक पौरुषहीन पुरषत्वहीन वीर्यहीन अपौरुष अपुरुष शंड
खोटे: खोटो नकली
खोटें: टाँट असत्यवादी अनृतभाषी असत्यभाषी मिथ्याभाषी अन्यवादी मिथ्यावादी असत्य झूटो निराधार अप्रामाणिक तथ्यहीन आधारहीन सारहीन निर्मूल यथार्थहीन अनाधार आधाररहित
खोटो: दुराशय कुविचारी आरिसे
खोडपी: खण्डक खण्डनकर्ता
खोडून_काडपी: खण्डक खण्डनकर्ता
खोल: गहन गहिरो गहिरो
खोशये_बगरचें: असन्तोषजनक असन्तोषप्रद
खोशी: प्रसन्न खुसी खुश आनन्दित पुलकित हर्षित विह्वल आह्लादित प्रफुल्ल परितुष्ट प्रफुल्लित प्रफुलित उल्लसित उल्लासित उल्लासी आनन्दी विनोदित पुलकित तुष्ट प्रसन्नचित्त
खोस_दिना_अशें: असन्तोषजनक असन्तोषप्रद
खोस_दिवपी: सन्तोषप्रद सन्तोषजनक आनन्द
खोसदिणें: रमाइलो आनन्दप्रद आनन्दप्रद आनन्द-दायक आह्लादक सुखप्रद खुशनुमा प्रसन्नतादायक आनंददायक आनन्ददायक आनन्ददायी आनन्दकारी आनंदकारी आह्लादी अनंद अनन्द नंदक नन्दक रमन रमण सन्तोषप्रद सन्तोषजनक आनन्द
खोसयाळें: आनन्दपूर्ण आनन्दमय उल्लासपूर्ण सानन्द
ख्यास्तपात्र: दण्डको_योग्य दण्ड_पात्र दण्ड_पाउने
ख्यास्ती_बगरचें: अदण्डित अदण्ड
ख्यास्ती_विणें: अदण्डित अदण्ड
गंदीत: सुवासित अनुवासित
गच्च: सघन घना गहन सङ्घात
गच्च_वाडिल्लें: झाडी_भएको
गटखळ: दुष्कर दुःसाध्य दुःखसाध्य कष्‍टसाध्य
गडखळ: दुष्कर दुःसाध्य दुःखसाध्य कष्‍टसाध्य
गडद: चहकिलो चम्किलो टलकदार कढा चहक
गडबडें: हतारे
गडबडो: चञ्चल चकचके अधीर
गणतंत्री: प्रजातन्त्रीय प्रजातान्त्रिक जनतान्त्रिक
गणनीय: गणनीय गण्य
गण्य: गणनीय गण्य
गतिशील: द्रुतगामी तीव्रगामी
गतिहीण: स्थिर थिर दृढ अचल अविचल निश्चल गतिहीन अविचलित अटल
गतीचें: गतिशील गतिपूर्ण गतिमान चल चालू चलायमान अविराम अस्थिर अथिर अध्रुव संचारी सञ्चारी
गतीशील: गतिशील गतिपूर्ण गतिमान चल चालू चलायमान अविराम अस्थिर अथिर अध्रुव संचारी सञ्चारी
गतीहीण: रोकिएको बन्द_भएको थामिएको
गरगरीत_वाडिल्लें: झाडी_भएको
गरजू: खाँचो आवश्यक प्रयोज औचित्य अभाव अपेक्षी अपेक्षक
गरजे_भायर: अनावश्यक अनपेक्षित फाल्टु नचाँहिदो जथाभावी अवाञ्छनीय गैरजरूरी निष्प्रयोजन
गरजेचें: आवश्यक जरूरी अपेक्षित अपेक्ष्य अनिवार्य परमावश्यक जरूरी
गरजेवंत: खाँचो आवश्यक प्रयोज औचित्य अभाव अपेक्षी अपेक्षक
गरम: तातो गर्मी उष्ण तातो न्यानो तातो गरम
गराचें: गडीदार गिरीयुक्त
गरीब: निर्धन गरीब दरिद्र
गर्भस्थ: गर्भस्थ
गर्भीत: निहित गर्भित राखिएको स्थापित दिइएको सुम्पिएको हुलिएको कोचिएको रहेको गर्भस्थ
गर्वहीण: निरभिमानी अनभिमानी अभिमानरहित गर्वहीन दर्पहीन अदम्भी अदर्पी निरहङ्कारी अहङ्कारहीन दम्भहीन निरहङ्कर निरहङ्कृत सीधा अनमद अहङ्काररहित गर्वरहित मदशून्य अमानी अभिमानशून्य अमत्त घमण्डरहित गौरवहीन गरिमाहीन
गर्विश्ट: गर्विलो गर्वी अभिमानी अहङ्कारी घमण्डी
गवत_खावपी: तृणचर तृण-चर
गांजपी: गुञ्जित स्वरित
गांबियायी: गाम्बेली गाम्बिआई गाम्बियन
गांवटी: पालतु घरपाला घरेलु घरैया
गाड: कढा चहक घोर गहिरो
गाढ: बाक्लो
गादयेचें: गद्दादार गद्दी
गाबायी: गवोनी गबुन
गायब: अदृश्य अदृष्टिगोचर लोचनातीत अदृश्यमान विलीन अन्तर्हित
गार्फ: कलमी कलम_काटेको
गिड्डो: पुडके होचो
गिन्यानान_भरिल्लें: ज्ञानपूर्ण ज्ञानमय बोधपूर्ण चिन्मय
गिन्यानी: विद्वान् ज्ञानी प्राज्ञ पण्डित विज्ञ सिपालु प्रवीण ज्ञानी जान्ने
गिरेस्त: धनी धनवान धनाढ्य धनी धनवान
गुंथवणूकदार: निवेशक
गुंथिल्लें: जुटेको लागेको_कार्यरत
गुजराती: गुजराती गुजराती गुजराती
गुजराथी: गुजराती गुजराती
गुठल्यांचें: गुजुल्टिएक गुजुल्टो_परेको गुजमुजिएको
गुडहीण: रहस्यहीन अचम्मको अगूढ
गुणकारक: प्रभावशाली प्रभावकारी
गुणगुणपी: गुञ्जित
गुणयुक्त: गुणवत्तायुक्त राम्रो गतिलो गजबको गुणयुक्त गुणान्वित
गुणरहीत: गुणरहित गुणहीन अगुणी
गुणवंत: सद्‍गुणी गुणी गुणवन्त गुणवान गुणशाली
गुणवत्तायुक्त: गुणवत्तायुक्त राम्रो गतिलो गजबको गुणयुक्त गुणान्वित
गुणवत्ताहीण: गुणवत्ताहीन गुणवत्तारहित
गुणी: सद्‍गुणी गुणी गुणवन्त गुणवान गुणशाली
गुणेस्त: प्रतिभाशाली
गुन्यांवकार: अपराधी दोषी कसुरवार
गुन्यांवकारी: अपराघमूलक अपराधमूलक अपराधी अपराधशील आरोपी
गुन्यांवी: अपराधमूलक आरोपी
गुन्यावंकार: अपराधशील आपराधिक
गुपीत: गोपनीय अप्रकट्य गोप्य अपहरणीय अप्रकाश्य गुप्त अप्रत्यक्ष अप्रकाश अप्रकाशित अप्रकाशमान अप्रथित अभिगुप्त रहस्यपूर्ण रहस्यमय रहस्यात्मक गूढ निहित गर्भित राखिएको स्थापित दिइएको सुम्पिएको हुलिएको कोचिएको रहेको अधिगुप्त
गुप्त: गोपनीय अप्रकट्य गोप्य अपहरणीय अप्रकाश्य गुप्त अप्रत्यक्ष अप्रकाश अप्रकाशित अप्रकाशमान अप्रथित अभिगुप्त अधिगुप्त
गुप्तहेरी: जासुसी
गुयानी: गुवानी गुयानाई गुयनाई
गुलाबी: गुलाबी
गुलाम: बँधुवा
गुल्ल: तल्लीन अनुरत निमग्न लीन तन्मय मग्न मगन दत्तचित्त लिप्त रत निरत अनुरक्त अनुसंरक्त अभिनिविष्ट जुटेको लागेको_कार्यरत व्यस्त लगनशील बेफुर्सद
गुळगुळीत: चिल्लो चिप्लो
गूढ: गोपनीय अप्रकट्य गोप्य अपहरणीय अप्रकाश्य गुप्त अप्रत्यक्ष अप्रकाश अप्रकाशित अप्रकाशमान अप्रथित अभिगुप्त अप्ठ्यारो कठिन सारो मुश्किल रहस्यपूर्ण रहस्यमय रहस्यात्मक गूढ निहित गर्भित राखिएको स्थापित दिइएको सुम्पिएको हुलिएको कोचिएको रहेको
गेल्लें: कुर्की_भएको पठाइएको निबहुरा
गेल्लो: हिँडेका
गैरहजर: अनुपस्थित गैरहाजिर अविद्यमान अप्रस्तुत अप्राप्त
गॉटेमालाचें: गौटेमाली गौटेमालन गौटमालन
गॉटेमालायी: गौटेमाली गौटेमालन गौटमालन
गोठिल्लें: जमेको
गोड: गुलियो मिठो रमाइलो मधुर मन_पर्ने प्रिय राम्रो_लाग्ने
गोड_उलोवपी: प्रियभाषी प्रियवादी प्रियंवद
गोडभाशी: प्रियभाषी प्रियवादी प्रियंवद
गोड्यामुताचें: प्रमेही मधुमेही डायबिटिक चिनीरोग
गोरखपंथाचें: गोरखपन्थी
गोरखपंथी: गोरखपन्थी
गोरो: गोरो श्वेत
गोरो-गुलाबी: रातो-सेतो लाल_वर्ण
गोरो_धवो: गोरो श्वेत
गोल: गोलो वृत्ताकार गोलाकार बाटुलो गोलो डोलो डल्लो गोल
गौण: अप्रधान अप्रमुख आनुषङ्गिक गौण अमुख्य
गौरवपूर्ण: गौरवपूर्ण गौरवयुक्त गरिमापूर्ण गरिमायुक्त गौरवशाली गौरवमयी गौरवान्वित
गौरवशीळ: गौरवपूर्ण गौरवयुक्त गरिमापूर्ण गरिमायुक्त गौरवशाली गौरवमयी गौरवान्वित
ग्रस्त: पीडित ग्रस्त ग्रसित व्यथित
ग्रिनलॅण्डी: ग्रिनल्यान्डी ग्रोनल्यान्डी ग्रिनल्यान्डर ग्रोनल्यान्डर ग्रिनल्यान्डी ग्रोनल्यान्डी
ग्रीक: युनानी ग्रिक युनानी ग्रीक
ग्रेनॅडाचें: ग्रेनेडी ग्रेनाडियन
ग्रेनॅडी: ग्रेनेडी ग्रेनाडियन
घट: घनिष्ठ आत्मीय अन्तरङ्ग अन्तरंग गाढा अनन्य अभिन्न प्रगाढ अङ्गरङ्गी अन्तरंगी इष्ट अन्यतम दृढ़ अटल अडिग अविचल स्थिर कायम निडर अभय निर्भय निर्भीक बेडर भयहीन निर्भीत अपभय अपभीति निःशंक अपशंक अभीत अभीरु ठोस खँदिलो कडा उग्र दरो बलियो कठरो सारो लठेब्रो चिसो ठन्डा अचेत चेतना_नभएको होस_गुमेको सुद्धी_हराएको बेहोस
घट_काळजाचो: निठुरी निर्मोही निर्मम अमोही
घटमूट: बलियो दह्रो मोटो
घडपाचें: घटनीय घट्य
घडपी: घटनीय घट्य
घडयिल्लें: कपोल_कल्पित मनगढन्त हावा कपोलकल्पित निर्मित रचित विरचित सृष्ट कृत सर्जित सृजित संरचित पर्णीत प्रकृत प्रणीत
घडिल्लें: घटित घटेको भएको
घडूंक_नाशिल्लें: अघटित नघटेको
घन: ठोस खँदिलो
घमेंडखोर: घमण्डी अभिमानी सेखीवाला
घमेंडी: गर्विलो गर्वी अभिमानी अहङ्कारी घमण्डी अकडो
घरगुती: पारिवारिक घरेलु पालतु घरपाला घरेलु घरैया
घरभेदी: भँडुवा घर-फोडुवा घरभँडुवा
घरमोडें: भँडुवा घर-फोडुवा घरभँडुवा
घरहीण: आवासहीन आश्रयहीन गृहहीन गृहविहीन बेघर बेघरवार
घरावें: पारिवारिक घरेलु पालतु घरपाला घरेलु घरैया
घसरड: चिप्लो
घाई_करपी: हतारे
घाणयारें: मैलो फहोर अशुद्ध फोहोरी मैलाधैला
घाणीचें: दुर्गंधपूर्ण दुर्गंधयुक्त दुर्गंधित
घातक: हिंस्रक हिंसात्मक घातक बर्बर नृशंस
घातकी: हिंसक आततायी बर्बर घातक नृशंस धोकाबाज बेइमानी_गर्ने धूर्त कपटी छली
घातमारें: धोकाबाज बेइमानी_गर्ने धूर्त कपटी छली
घातिल्लें: अधिरोपित
घानायी: घानाली घानाई
घामाचें: स्वेदक प्रस्वेदित
घायाळ: घायल घाइते जख्मी जखमी आहत क्षत अभिप्रहत अभ्याहत
घार्मिक: धार्मिक धर्मशील धर्मी धर्मनिष्ठ
घालप: विलीन अदृश्य लुप्‍त
घालपा_सारकें: परिधानयोग्य
घाळ: असावधान लापरवाह हेलचेक्राइँ अचेत असजग अनचित अमनोयोगी
घुमपी: गुञ्जित स्वरित
घुवळी_वखदां: अफीमी
घुसपटिल्लें: उल्झिनु उल्झनु
घुसपलिल्लो: अढकिनु अल्झिनु फँस्नु
घुसपल्लें: उल्झिनु उल्झनु
घुस्पागोंदळाचें: दुर्बोध्य अति_गूढ दुरूह गम्भीर अप्ठ्यारो जटिल गाह्रो
घृणास्पद: घृणित घिनौलो कुत्सित वीभत्स बीभत्स जघन्य घृणास्पद अपकृष्ट
घृणीत: घृणित घिनौलो कुत्सित वीभत्स बीभत्स जघन्य घृणास्पद अपकृष्ट
घोडदळ: अश्‍वारोही
घोड्या_बगरचें: अश्वरहित अश्वविहीन
घोनें: मूर्ख अज्ञानी बुद्धु
घोळटें: बन्जारा घुमन्ते
घोळपी: घोलिने_खालको विलय_हुने_खालको
घोळोवप: विलीन अदृश्य लुप्‍त
घोशीत: घोषित
घोस्ताचें: मनपर्दो प्रिय रुचिकर अभीष्ट
चंचळ: विचलित हटेको चञ्चल चकचके अधीर अशान्त अशांत चंचल अस्थिरचित्त उत्कंठित उत्कण्ठित विचलित अस्थिर अनुपशांत अनेकांत अनेकान्त क्षुब्ध दृढमतहीन अन्यमनस्क
चंदेरी: चाँदनी जुनेली
चकचकपी: चम्किलो आलोकित उज्ज्वलित कान्तिमान ज्योतित दीप्त जगमग प्रकाशवान प्रदीप्त द्युतिमान्
चकचकीत: प्रकाशपूर्ण दीप्तिपूर्ण प्रकाशमान आलोकित ज्योतित उज्ज्वल उज्जवल सफा स्वच्छ चम्किलो चहकिलो चहकदार
चक्रम: मूर्ख अज्ञानी बुद्धु पागल पगला बौलाहा
चक्रवर्ती: चक्रवर्ती एकाधिपति सर्वेश्वर सर्वेश
चक्राचें: चक्कादार
चक्राचो: चक्रको_जस्तो
चक्री: चक्रको_जस्तो
चक्रीय: चक्रको_जस्तो
चड: अनेक कैयौं विविध नाना एकाधिक अनेकानेक तमाम धेरै बहुत अधिक ज्यादा अतिशय अति अगाध अतीव बहुल भारी भीषण घनघोर अत्याधिक निकै धेरै प्रशस्त मनग्गे प्रगाढ गम्भीर गहन
चड_कोडो: धेरै_तितो अति_कटु
चड_गरजेचें: अत्यावश्यक अति_आवश्यक अपरिहार्य
चड_रागीश्ट: अति_आविष्ट अत्युग्र
चडपा_सारक्या: चढदो
चडशे: धेरैजसो प्राय
चडांत_चड: अधिकतम सर्वाधिक सबैभन्दा_बढी धेरैजसो प्राय
चडाक्षरी: अनेकाक्षर
चडिल्लें: चढदो अधिरूढ
चतूर: फुर्तिलो छिटो जाँगरिलो चलाख चतुर बुद्धिमान
चपळ: चलाख चतुर बुद्धिमान
चमत्कारी: चमत्कारी चमत्कारपूर्ण चामत्कारिक तिलस्मी चमत्कारी करामाती
चरम: परम
चराचर: चराचर चलाचल चल_अचल
चरित्रवान: चरित्रवान सच्चरित्र
चरित्रहीण: पतिता दुश्चरित्रा दुश्चरिता दुराचारिणी शीलहीन
चलणुकेंत_नाशिल्लो: अप्रचलित अप्रचरित अव्यवहृत अप्रयुक्त आउटडेटेड आउट_आफ_डेट
चलपाचें: हिडने
चलपी: चालित परिचालित प्रचालित पदचर पदचारी पादचारी पैदल हिँड्दै_गरेको पदस्थ
चळवळें: विद्रोही क्रान्तिकारी
चवतिसावो: चौतीसौँ
चवतीस: चौतीस ३४
चवथें: चार चौथो ४ 4
चवदा: चौधौ १४औं 14_औं
चवद्यांयशीं: चौरासी
चवद्यांयश्यांवें: चौरासीऔं
चवद्याण्णव: चौरानब्बे
चवद्याण्णवावें: चौरानब्बेऔं
चवद्यात्तर: चौहत्तर
चवद्यात्तरावें: चौहत्तरौं
चवपन: चौवन चौवन्न
चवपनावें: चौवन्नौं
चवर्गी: चवर्गीय
चवसठ: चौसट्ठी
चवसठावें: चौंसट्ठीऔं
चवेचाळिसावें: चवालीसौँ
चवेचाळीस: चवालीस
चांदीचें: चाँदीको रजत
चांद्र: चान्द्र
चाकाचें: चक्कादार
चाकी: चक्कादार
चाटिल्लें: खाएको भक्षित
चाडी: चाडी चाडसम्बन्धी
चान्नी: चाँदनी जुनेली
चामटो: महालोभी धेरै_लोभी लोभी कन्जुस कन्चुस
चायनीस: चिनी
चार: चार ४ 4
चार_खावपी: तृणचर तृण-चर
चार_रंगी: चौरङ्गी
चारतर्फी: चौतर्फी
चारपट: चौगुणा चार_गुना
चारशेंवीस: छक्याउने
चारित्र्यवान: चरित्रवान सच्चरित्र
चारेक: गोडा_चारेक
चालंत: गतिशील गतिपूर्ण गतिमान चल चालू चलायमान अविराम अस्थिर अथिर अध्रुव संचारी सञ्चारी
चालक: चालक
चालाक: चलाख चतुर बुद्धिमान तिकडमबाज तिगडमबाज
चालू: गतिशील गतिपूर्ण गतिमान चल चालू चलायमान अविराम अस्थिर अथिर अध्रुव संचारी सञ्चारी चालित परिचालित प्रचालित कामुक विलासी विषयी भोगी कामचारी इन्द्रियलोलुप ज्वलन्त प्रज्वलित
चाळिशेक: गोडा_चालिसेक चालिस_जनाजति
चाळिसावें: चालीसौँ
चाळीस: चाल्लीस चालिस
चिंतनशील: मननशील चिन्तनशील विचारशील। अनुशीलित
चिंतपाचें: विचारणीय विचार्य चिन्तनीय चिंतनीय चिंत्य अनुशीलनीय विचारणीय लक्ष्य अभिलक्ष्य
चिंताहीण: अविचारणीय अचिन्तनीय अविचार्य
चिंतेबगरची: अविचारित अचिन्तित अचिंतित नसोचिएको
चिंतेस्त: चिन्तित चिंतित चिन्तायुक्त चिन्ताग्रस्त
चिकचिकीत: लयालो
चिकट: लयालो
चिकलाचें: हिले
चिकू: महालोभी धेरै_लोभी
चिकू_मारवाडी: लोभी कन्जुस कन्चुस
चिकें: कम्ती अलिकति अल्प
चिखलामेकळें: अपङ्किल पङ्करहित
चिड्डयिल्लें: दामित थिचिएका हेपिएका पिसिएका
चित्रांकीत: चित्राङ्कित
चित्रायिल्लें: चित्राङ्कित
चित्रीत: चित्राङ्कित छापिएको चित्रित
चिनी: चिनी चिनी
चिन्हीत: छापिएको चित्रित
चिपचिपीत: जलमय अपोमय
चिप्प_भिजील्लेंप: रगतपच्छे
चिरंजीव: अमर मृत्यु_कालजयी चिरञ्जीवी चिरञ्जीव चिरञ्जीवी चिरजीवी दीर्घजीवी दीर्घायु आयुष्मान चिरायु
चिरिल्लें: छिनेको काटिएको टुक्रिएको
चिलखता_वीण: कवचहीन
चिली: चिलियन
चुकिल्लें: अकृत
चुकीची: अनुचित खराब बेठिक
चुकीचें: अशुद्ध भूल गलत
चुकीचो_समज_जाल्लें: अध्यारोपित मिथ्यारोपित
चुरगळिल्ल्या: खुम्चिएको संकुचित निकुंचित निकुञ्चित
चेक: चेक चेक
चेतन: जिउँदो नमरेको जीवित प्राणवान् प्रण_भएको
चेतनायुक्त: चेतनायुक्त चेतन संज्ञायुक्त
चेपटें: च्याप्टो थ्याप्चो थेप्चो चेप्टो चेप्टे
चोंचरें: तोते तोते
चोंयवटेनचें: चौतर्फी
चोकपा_सारकें: चूषणीय चूष्य चूसनीय
चोपनावें: चौवन्नौं
चोवपन: चौवन चौवन्न
चोविसावें: चौबीसौँ
चोवीस: चौबीस २४
चौकस: जिज्ञासित जान्न_खोजिएको
चौकोनी: चारकुने चौकुने
चौपट: चौगुणा चार_गुना
चौरंगी: चौरङ्गी
छंदबद्ध: आबद्ध निबद्ध बद्ध बाँधिएको अमुक्त अनुबद्ध पाबन्द अपिबद्ध अपिनद्ध
छत्तिसावें: छत्तीसौँ
छत्तीस: छत्तीस
छाप्पन: छपन्न
छाप्पनावें: छपन्नौं
जंगली: वन्य जङ्गली आरण्य आरण्यक जङ्गली वन_भएको
जंतूनाशक: कीटाणुनाशक
जखमी: घायल घाइते जख्मी जखमी आहत क्षत अभिप्रहत अभ्याहत
जखमे_विरयतचें: चोट_नलागेको अचोट अप्रहत
जगजयी: विश्व_विजेता जगजयी दिग्विजयी विश्वविजयी
जगजाहीर: सर्वसंज्ञात सर्वज्ञात सर्वजनविदित
जड: भारी गरुङ्गो वजनदार
जडयिल्लें: जडेको
जननेंद्री: जननेन्द्रीय
जपानाचो: जापानी
जपानी: जापानी मिहिनती मिहेनती मेहेनती जापानी जापानको
जप्त: कुर्की_भएको
जबाबदार: अनुत्तरदायी उत्तरदायित्वहीन
जमनींतलें: भूमिगत भूमिको धर्तीको
जमा_करपी: जमाकर्ता जमा_कर्ता
जमैकी: जमैकी
जयी: सफल सिद्ध
जरतारी: जरतारी जरकशी जरकसी जरकस
जर्जर: मरणासन्न मुमूर्ष
जर्मन: जर्मन जर्मन
जलचर: जलचर जल-चर
जलस्थलचर: उभयचर जल-स्थलचर जलथली
जलहीण: निर्जल अजल जलहीन जलरहित
जल्म_घेतिल्लें: जन्मेको जन्मिएको उत्पन्न_भएको
जल्मजात: जन्मजात जन्मगत
जल्मल्लें: जन्मेको जन्मिएको उत्पन्न_भएको
जल्मसिद्ध: जन्मसिद्ध जन्मजात
जल्मा_सावन: जन्मजात जन्मगत
जल्मांध: जन्मान्ध जात्यन्ध
जल्माक_आयिल्लें: जन्मेको जन्मिएको उत्पन्न_भएको
जल्मीत: जन्मेको जन्मिएको उत्पन्न_भएको
जळयिल्लें: भुटेको
जळिल्लें: डढेको दग्ध पोलेको पिल्सिएको दुःख_पाएको सताइएको सन्तप्त
जळोवपी: दाहक दाहिक
जस्ताचें: जस्तसम्बन्धी जस्ताको
जांतव: जिउँदो
जांबियायी: जाम्बियाई
जागरूक: जागृत जाग्रत जाग्रत् अनिद्रित
जागृत: जागृत जाग्रत जाग्रत् अनिद्रित
जागें: जागृत जाग्रत जाग्रत् अनिद्रित
जाड: बाक्लो मोटो
जाणकार: अनुभवी जानकार परिपक्व खारिएको विद्वान् ज्ञानी प्राज्ञ पण्डित विज्ञ सर्वज्ञ सर्ववेत्ता सिपालु प्रवीण ज्ञानी जान्ने
जाणटी: बुढ़ी बूढ़ी वृद्धा वयोबृद्धा
जाणटें: वृद्ध बूढ़ो बुढ़ो वरिष्ठ बुजुर्ग वयोवृद्ध उम्रदराज
जाणपी: ज्ञेय ज्ञानगम्य बोधगम्य बोध्य ज्ञातव्य अभिमन्तव्य अभिमंतव्य ग्राह्य
जाणा_आशिल्लें: थाहा ज्ञात विदित अवगत विज्ञात अवबुद्ध परिचित
जाणा_जाल्लें: सिपालु प्रवीण ज्ञानी जान्ने
जाणाजाल्लें: थाहा ज्ञात विदित अवगत विज्ञात अवबुद्ध परिचित
जाती_भायलें: अन्यजातीय
जाती_भितरलें: सजातीय समवर्गीय सजाति स्वजातीय स्वजाति
जाती_विशींचें: जातीय
जातीचें: जातीय
जापसालदार: अनुत्तरदायी उत्तरदायित्वहीन उत्तरदायी उत्तरदायक जवाबदेह ज़िम्मेदार जिम्मेदार
जापे_बगर: अनुत्तरित
जाबाबदार: उत्तरदायी उत्तरदायक जवाबदेह ज़िम्मेदार जिम्मेदार
जाम: क्षमताहीन अक्षम अशक्त शक्तिहीन असमर्थ बेदम
जाम_जाल्लें: थाकेको थकित क्लान्त क्लांत परिश्रांत
जायत_सावन: जन्मजात जन्मगत
जायत्यो: अनेक कैयौं विविध नाना एकाधिक अनेकानेक तमाम
जाल्लें: कृत निष्पन्न निष्पादित घटित घटेको भएको
जाळयेचें: जालीदार
जाळीदार: जालीदार
जावन_गेल्लें: घटित घटेको भएको
जावायी: जावाई जावाई
जासुसी: जासुसी
जाहीर: अगोपनीय अगोप्य प्रकट्य कथ्य प्रकाश्य
जिक्के: जति जतिमात्रा
जिखिल्लें: जेय जय_योग्य जित्य
जिखिल्लो: विजेता विजयी
जिज्ञासू: जिज्ञासित जान्न_खोजिएको
जितके: जति जतिमात्रा
जितले: जति जतिमात्रा
जिती: ज्वलन्त प्रज्वलित
जितेंजागतें: जीवन्त जिउँदो
जितेंद्री: जितेन्द्रिय
जितो: जिउँदो नमरेको जीवित प्राणवान् प्रण_भएको चेतनायुक्त चेतन संज्ञायुक्त
जिद्दी: हठी जिद्धी जिद्दीवाल
जिल्ल्याचें: सम्भागीय मण्डलीय
जिवंत: जिउँदो नमरेको जीवित प्राणवान् प्रण_भएको जीवन्त जिउँदो
जिवनदान: जीवनदायी मृत्युमारक सञ्जीवनी संजीवनी अमृत्युकारी
जिवी: ज्वलन्त प्रज्वलित
जिवीत: जिउँदो नमरेको जीवित प्राणवान् प्रण_भएको
जिवें: जीवन्त जिउँदो
जिवो: जिउँदो नमरेको जीवित प्राणवान् प्रण_भएको चेतनायुक्त चेतन संज्ञायुक्त
जीण_वाडोवपी: भुटेको भुटेका
जीबमुळयीं: जिह्वामूलीय
जीर्ण: जीर्ण पुरानो थोत्रो भाँचिएको
जुंव्याचें: द्वीपी द्वीपीय
जुगारी: जुवाडी जुवारी
जुनी: थोत्रो पूरानो
जुनें: जीर्ण जर्जर
जुल्मी: अत्याचारी अनाचारी आततायी बर्बर नृशंस अतिचारी अनीतिमान् उत्पीडक
जुळें: जम्ल्याहा
जुवळीं: जम्ल्याहा जुम्ल्याहा
जुवळें: जम्ल्याहा
जुवान: तन्नेरी जवान युवा तरुण
जेझू_विशीं: ईसा_विषयक ईसाई मसीही
जेवणा_बगरचें: निराहार अनाहार
जेवपाचें: खाद्य भोज्य आहार्य ग्राह्य भक्ष्य अशनीय
जेश्ठ: दाजु अग्रज जेठा ज्येष्ठ ठुला
जैतवंत: जेय जय_योग्य जित्य सफल सिद्ध
जैतीवंत: विजेता विजयी
जैवीक: जैव जैविक
जोखप: छेडेको भेदगरेको
जोखिल्लें: जोख्‍नु तौलनु तौलिएको
जोडपी: कमाऊ
जोडपें: दाम्पत्य
जोडिल्लें: संलग्न सम्बद्ध अनुलग्न क्षेपक अर्जित कमाएको
जोडूंक_नाशिल्लें: असंयुक्‍त पृथक छुट्टै भिन्दै
ज्ञात: परिज्ञात प्रज्ञात विज्ञात संज्ञात
ज्ञानपूर्ण: ज्ञानपूर्ण ज्ञानमय बोधपूर्ण चिन्मय
ज्ञानमय: ज्ञानपूर्ण ज्ञानमय बोधपूर्ण चिन्मय
ज्ञानहीण: ज्ञानहीन अज्ञानपूर्ण
ज्ञेय: ज्ञेय ज्ञानगम्य बोधगम्य बोध्य ज्ञातव्य अभिमन्तव्य अभिमंतव्य ग्राह्य
ज्वलंत: ज्वलन्त प्रज्वलित
ज्वलनशील: ज्वलनशील
ज्वालामुखी: ज्वालामुखीको
झगझगीत: प्रकाशपूर्ण दीप्तिपूर्ण प्रकाशमान आलोकित ज्योतित
झगडपी: कर्कशा रिसाहा उग्रा झगडालु चण्डी चण्डिका
झगडाळ: कर्कशा रिसाहा उग्रा झगडालु चण्डी चण्डिका झगडालु खटपटे लडाकु कलहप्रिय कलहकारी कर्कश
झगडाळू: लडाइ झगडा मारामार काटाकाट
झगडूल: कर्कशा रिसाहा उग्रा झगडालु चण्डी चण्डिका
झगड्डाळ: इबी इख
झगड्याचें: विवादास्पद
झांकपी: प्रलापी कुरौटे अतिवक्ता
झिंबाबेयी: जिम्बाब्ली जिम्बाब्वेयाई
झिरझिरिल्ली: जीर्ण जर्जर
झिरझिरीत: पातल
झिरमिरीत: पातलो पात्लो
झिळींचें: झाडी_भएको
झुजपी: जुझारू डटने अपलायनशील
झुजारी: रणवीर युद्धवीर
झेंपें: मूर्ख अज्ञानी बुद्धु
झेताचो: अकडो
झेमें: मूर्ख अज्ञानी बुद्धु
झेमेड्डो: अनिद्रा जाग्राम
झेलांतलो: हिउँमा_बस्ने हिउँको
झेलाचें: बरफिलो ज्यादै_चिसो अति_ठन्डा बरफ_भएको
झोंपांचें: झाडी_भएको
टणक: दरो बलियो कठरो सारो
टवटवीत: आलो ताजा ताजा
टवर्गी: टवर्गीय
टायप_केल्लें: टङ्कित टाइप_गरिएको
टाळूं_येना: अवश्यम्भावी अटल तय अटलनीय अनिवार्य अबाध्य अमिट
टिकाकार: निन्दक अपवादक अपवादिक अपवादी आक्षेपी आक्षेपक अभिसन्धक
टिपक्यांचें: थोप्ले थोप्लादार
टोगोली: टोगोलिज
ट्युनिशियायी: ट्युनिसियाई
ट्युनीशी: ट्युनिसियाई ट्युनिसियन
ठगो: लफङ्गो फटाहा लुच्चा बदमास दुष्ट
ठिपक्यांचें: छिटदार
डच: डच डच
डाळंबा_कोराचें: अनारे
डेनमार्की: डेनमार्की डेनमार्की डेनिश
डोमिनिकाचें: डोमिनिकी डोमिनिकन
डोमिनिकी: डोमिनिकी डोमिनिकन
डोलत: हल्लिँदै डगमगाउँदै ढलपललिँदै
णव: नौ ९ 9
णवपट: नौ_गुना नौगुणा
णववें: नवौँ नवम
णवेक: गोडा_नौएक
णव्याण्णव: उनान्सय
णव्याण्णवावें: उनान्सय निरानब्बे
णव्वद: नब्बे
णव्वदावें: उनानब्बेऔं नब्बेऔं
तंजानियायी: तान्जानियायी
तंतूमय: रेसा_भएका रेसायुक्‍त
तंत्रांविशींचें: प्रविधि तकनीक_विषयक प्राविधिक
तंत्राबगरचें: गैर-प्रविधि प्रविधिहीन
तंत्रीक: प्रविधि तकनीक_विषयक प्राविधिक
तंदुरी: तन्दुरी
तकलेंतलें: काल्पनिक कल्पित अवास्तविक अयथार्थ अनात्मक अप्रकृत अयथातथ अयाथार्थिक
तकलेचें: दिमागी
तटवासी: तटवासी
तटस्थ: तटस्थ निरपेक्ष उदासीन पक्षपातरहित अपक्षपाती निर्पेक्ष अनपेक्ष
तडी_वयलें: किनार तीर छेउ
तड्डकी: टाँट असत्यवादी अनृतभाषी असत्यभाषी मिथ्याभाषी अन्यवादी मिथ्यावादी
तण_खावपी: तृणचर तृण-चर
तत्कालीक: तत्कालिक
तत्काळीन: तत्कालीन तत्कालिन तत्कालिक
तत्पर: तयार तत्पर उद्यत्
तत्पुरते: अस्थायी
तत्वज्ञानी: दार्शनिक तत्वज्ञानी
तथाकथीत: तथाकथित नाम_मात्रको
तथ्यपूर्ण: तथ्यपूर्ण तथ्यात्मक तथ्यपरक प्रामाणिक सारपूर्ण
तपाशिल्लें: अवलोकित दृष्टिगत विलोकित परीक्षित अनुभूत
तमीळ: तमिल तमिल तमिल
तयवानी: ताइवानी ताइवानीस फोर्मोसन
तयार: तयार तयार तत्पर उद्यत् रेडिमेड
तयार_करूंक_नाशिल्लें: अरचित अकृत नरचेको अनिर्मित
तयार_केल्लें: निर्मित रचित विरचित सृष्ट कृत सर्जित सृजित संरचित पर्णीत प्रकृत प्रणीत
तयार_जाल्लें: उत्पन्न उत्पादित पैदा-भएको
तरणें: तन्नेरी जवान युवा तरुण
तरबेज: प्रशिक्षित तालिमे
तरातरांचें: असङ्ख्य अनेक धेरै कैयौँ अनगन्ती बेगन्ती धेरै_थरी विभिन्न नाना
तरेकवार: असङ्ख्य अनेक धेरै कैयौँ अनगन्ती बेगन्ती धेरै_थरी विभिन्न नाना
तर्क_नाशिल्लें: तर्कहीन तर्करहित युक्तिहीन फाल्टु बिनाबित्थाको
तर्कपुर्ण: तर्कपूर्ण तर्कयुक्त तर्कसङ्गत युक्तिपूर्ण युक्तियुक्त
तर्कहीण: तर्कहीन तर्करहित युक्तिहीन फाल्टु बिनाबित्थाको तर्कातीत अतर्क्य तर्कागम्य अप्रतर्क्य
तर्का_बगरचें: तर्कातीत अतर्क्य तर्कागम्य अप्रतर्क्य
तर्काबगरचें: तर्कहीन तर्करहित युक्तिहीन फाल्टु बिनाबित्थाको
तर्र: मात्तिएको उन्मत्त उद्धत मदमत्त मदान्ध धुत धुत्त
तळा_बगरचें: पिँध_नभएको
तवर्गी: तवर्गीय
तशाक_तशें: हुबहु हु-ब-हु जस्ताको_त्यस्तै
तांकिवंत: महाबली शक्‍तिशाली
तांतया_आकाराचो: अण्डाकार
तांबडो: रातो लाल रोहित रातो-सेतो लाल_वर्ण
तांबशें: सिँदुरे_रङ
तांबूस: सिँदुरे_रङ
तांब्याचें: तामे तामे
ताकतीक_करपी: हतारे
ताचे_खेरीज: अतिरिक्‍त बाहेक
ताचे_बगर: अतिरिक्‍त बाहेक
ताचे_भायर: अतिरिक्‍त बाहेक
ताचे_शिवाय: अतिरिक्‍त बाहेक
ताजी: ज्वलन्त प्रज्वलित
ताजें: आलो साजी ताजा ताजा
ताजो: आलो ताजा
ताठ: अडिग अनत अनमित
तानेल्लें: तिर्खाएको प्यासा तिर्खा_लागेको
तापट: रिसाएको झोकिएको क्रुद्ध
तापिल्लें: तातो गरम
ताबूस: तामे
ताब्यांत: अधीन
तामीळ: तमिल तमिल तमिल
तारणहार: पालनकर्ता पालनहार
तारपी: पालनकर्ता पालनहार योजक
तारवटी: जहाजी
तारहीण: बेतार
तारे_बगरचें: बेतार
तार्कीक: तार्किक तत्त्‍ववेत्ता दार्शनिक नैयायिक तर्कगम्य तर्काधीन तर्कसङ्गत अध्याहृत
तार्‍याविणें: ताराविहीन ताराहीन
तालीक_केल्लें: प्रतिलिपित
ताळतंत्राबगरचें: असंयत
ताळो: शाखायुक्त डाले प्रशाखित
तिकतीकपी: चम्किलो आलोकित उज्ज्वलित कान्तिमान ज्योतित दीप्त जगमग प्रकाशवान प्रदीप्त द्युतिमान्
तिकोनी: तीन_कुना
तिक्कें: त्यत्रो त्यत्रो_औधी
तिक्ष्ण: तीक्ष्ण तीव्र कुशाग्र प्रखर तेज अकुण्ठ अकुंठित अकुन्ठित विषम
तितकें: त्यत्रो त्यत्रो_औधी
तितलें: त्यत्रो त्यत्रो_औधी
तितारी: तीनतारे
तिनेक: गोडा_तीनेक
तिप्पट: तीनगुणा तीन_गुणा
तिबेटी: तिब्बती तिब्बती तिब्बती
तिमाही: त्रैमासिक तीनमहिने
तिरंगी: त्रिरङ्ग तीनरङ्ग
तिरसट: तितो
तिरायत: पराई बिरानो परचक्री
तिरायताचें: पराइ परजनीय अरूको अन्य_को परकीय अर्काको
तिव्र: तीक्ष्ण तीव्र कुशाग्र प्रखर तेज अकुण्ठ अकुंठित अकुन्ठित विषम चर्को तीव्र कडा
तिसरें: तेस्रो तृतीय
तिसावें: तीसौँ
तीख: तितो
तीन: तीन त्रय ३
तीन_कोनशांचे: त्रिभुजी त्रिकोणी
तीन_कोनांचे: त्रिभुजी त्रिकोणी
तीन_तारी: तीनतारे
तीनतर्फी: तीनतर्फे
तीनपायी: तीनखुट्टे त्रिपद त्रिपाद
तीनमाही: त्रैमासिक तीनमहिने
तीनरंगी: त्रिरङ्ग तीनरङ्ग
तीस: तीस त्रिस
तुंबिल्लें: अप्रवाहित जमेको प्रवाहहीन स्थिर गतिहीन
तुंबिल्लो: बन्द थुनिएको रोकिएको
तुजें: तिम्रो तेरो
तुटकें: फुटेको थोत्रिएको
तुटकें-फुटकें: फुटेको थोत्रिएको
तुमचें: तपाईंको यहाँको हजुरको
तुमचें.: तिम्रो तेरो
तुर्कस्थानी: तुर्की तुर्क तुरकीस्थान_वासी
तुर्की: तुर्की तुर्की तुर्क तुरकीस्थान_वासी तुर्की
तुलनात्मक: तुलनात्मक
तुल्य: तुलनीय तुल्य
तुळात्मक: तुलनात्मक
तुळे_भायरें: असङ्ख्य अतुल अतुलित
तुस्ततोखणायेचें: प्रशंसित अभिनन्दित चर्चित
तुस्तेचें: अभिनन्दित अभिनंदित वंदित
तृणजिवी: तृणजीवी
तृतीय: तेस्रो तृतीय
तृप्त: तृप्त तुष्ट सन्तुष्ट संतुष्ट अघाएको
तेंगशेचें: अग्लो उच्च
तेजपूर्ण: तेजोमण्डित तेजपूर्ण कान्तिमान जाज्वल्यमान प्रकाशमान दिव्य चम्किलो
तेजस्वी: तेजोमण्डित तेजपूर्ण कान्तिमान जाज्वल्यमान प्रकाशमान दिव्य चम्किलो तेजस्वी ओजस्वी तेजवन्त तेजवान कान्तिवान्
तेजहीण: रगतहीन निस्तेज आभाहीन कांतिहीन ओजहीन प्रभाहीन बेरौनक अप्रभ प्रभारहित श्रीहत
तेजाबी: तेजाबी
तेत्तिसावो: तेत्तीसौँ
तेत्तीस: तेत्तीस
तेमकाचें: अग्लो उच्च
तेरा: तेइस
तेरावें: तेह्रौं १३_औं 13_औ
तेलकट: तेलिया स्निगध चिप्लो तेलिया तेल_भएको तेलिया चिप्लो चिल्लो स्निग्ध
तेलगू: तेलगु तेलेगु तेलुगु तेलगु तेलुगु तेलगु तेलुगु
तेलाचें: तेलिया चिप्लो चिल्लो स्निग्ध
तेलुगू: तेलगु तेलेगु तेलुगु तेलगु तेलुगु तेलगु तेलुगु
तेविसावें: तेइसौँ
तेवेचाळिसावें: त्रिचालीसौँ
तेवेचाळीस: त्रिचालीस
तैवानी: ताइवानी ताइवानीस फोर्मोसन
तोंकाचें: अग्लो उच्च तिखो
तोंकाळ: घोच्ने घोप्ने रोप्ने तिखो
तोंडपाठ: कण्ठस्थ मुखाग्र
तोंडा_वयलें: आसन्न सन्निकट छेउको नजिकको
तोंडी: मौखिक अन्तर्वार्ता
तोंप्पी: घोच्ने घोप्ने रोप्ने
तोखणायेचे: प्रशंसनीय स्तुत्य धन्य धन्न प्रशंस्य श्लाघ्य श्लाघनीय सराहनीय प्रशस्त अभिनन्दनीय अभिवन्दनीय
तोखणायेचें: अभिनन्दित अभिनंदित वंदित प्रशंसित अभिनन्दित चर्चित
तोडीचो: बराबर समान तुल्य
तोतरें: तोते तोते
तोलूंक_नाशिल्लें: नजोखेको नतौलिएको
त्या_काळा_वयलें: तत्कालिन तत्कालिक
त्या_काळाची: तत्कालीन
त्या_काळावयली: तत्कालीन
त्यागिल्लें: त्यागेको परित्यक्‍त त्यक्‍त
त्यागी: त्यागी सन्न्यासी वैरागी जोगी भिक्षु
त्याज्य: त्याज्य त्याजनीय परित्याज्य तजनीय हेय वर्ज्य
त्रस्त: उत्पीड़ित पीड़ित त्रसित प्रताडित पिटिएको चुटिएको
त्रासदिणी: दुखद दुखदायी दुखप्रद
त्रासाची: दुखमय दुखद दुखपूर्ण कष्टपूर्ण
त्रासिल्लो: उत्पीड़ित पीड़ित त्रसित
त्रासीक: दुखी पीड़ित व्यथित दुःखी आर्त दुखित
त्रिकोणाकार: त्रिभुजाकार
त्रिकोणी: त्रिभुजाकार तीन_कुना
त्रिकोनी: त्रिभुजी त्रिकोणी तीन_कुना
त्रिदोश: त्रिदोषज
त्रिपद: तीनखुट्टे त्रिपद त्रिपाद
त्रिबुनालीन: न्याय_विषयक अदालती न्यायिक
त्रेप्पन: त्रिपन्न त्रिपन ५३
त्रेप्पनावें: त्रिपन्नौं ५३औं
त्रेसठ: तिरसट्ठी त्रिसठ
त्रेसठावो: तिरसट्ठीऔं
त्र्यांयशीं: तिरासी
त्र्यांयश्यावें: तिरासीऔं
त्र्याण्णव: तिरानब्बे
त्र्याण्णवावें: तिरानब्बेऔं
त्र्यात्तर: त्रिहत्तर
त्र्यात्तरावें: त्रिहत्तरौं
थंड: सौम्य कोमल_स्वभावी सौम सौम्य सुशील सुजान अभिविनीत गम्भीर शान्त धीर चिसो शीतल ठण्डा अनुष्ण चिसो ठन्डा चिसो ठण्डा शीतल चिसो ठण्डा शान्त शीतल ठण्डा शान्तिपूर्ण लठेब्रो चिसो ठन्डा चिसो
थकपाचें: थकाइ
थकिल्लें: थाकेको थकित क्लान्त क्लांत परिश्रांत
थकूंक_नाशिल्लें: नथाक्ने अक्लान्त अक्लांत
थपकटें: समतल समथर च्याप्टो थ्याप्चो थेप्चो चेप्टो चेप्टे
थपथपिल्लें: लतपत रगतपच्छे
थपथपीत: जलमय अपोमय
थपथपीतप: रगतपच्छे
थरथरपी: धेरैबुढो वृद्ध
थरांचें: परतदार स्तरयुक्त स्तरित
थरावीक: निर्धारित सीमित नियत
थरिल्ली: निर्णीत निर्णय_गरिएको
थळावीक: स्थानीय आन्चलिक स्थानिक
थळीय: थलचर धरातली स्थलीय
थांबिल्ली: गतिहीन स्थिर अचल
थांबिल्लें: रोकिएको बन्द_भएको थामिएको
थायां_पडपी: दृश्यमान दृश्य दृष्टिगोचर चाक्षुष देखिने
थायी: थाई साइमिस सायमिस थाई साइमिस सायमिस थाई थाइल्यान्डी
थारनासतना: अनवरत लगातार निरन्तर
थारायिल्लें: निश्चित निर्धारित नियत नियमित ठिक निर्दिष्ट
थारायिल्ल्या: सीमित सीमाबद्ध सीमायुक्त
थारावीक: निश्‍चयात्मक पक्का
थिकाळ: दाग_भएको दाग_लागेको धब्बा_लागेको
थिरप्रतीज्ञ: दृढप्रतिज्ञ
थीर: अविचलित अडिग अविचल गम्भीर शान्त धीर दृढ़ अटल अडिग अविचल स्थिर कायम अडिग अनत अनमित अचल स्थावर अकम्पित अकम्पायमान कम्परहित अकम्प
थीर_चित्ताचो: स्थिरचित्त शान्त स्थिर प्रशान्त अचञ्चल प्रशान्त
थीरनिश्चयी: अध्यवसायित अध्यवसित
थोक: थोक मोठ
थोटें: लङ्गडो लंगडो खोरन्डो लङ्गडो लँगडो खँजाहा खोरन्डो
थोटो: लुलो-लङ्गडो
थोडे_भितर: संक्षिप्‍त
थोडें: कम्ती अलिकति अल्प अलिकति केही थोरै
थोडें_उलोवपी: अल्पभाषी मितभाषी अल्पवादी
दंग: व्यस्त लगनशील बेफुर्सद
दंगलखोर: हुल्याहा हुल्लडबाज
दंगेखोर: हुल्याहा हुल्लडबाज
दंडीत: दण्डित सजायप्राप्‍त
दकारांती: दकारान्त दकारादि
दक्षिणी: दक्षिणी दक्खिनी
दक्षिणे_वटेन: दक्षिणावर्त दक्षिणतिर
दक्षीण_अफ्रिकी: दक्षिण_अफ्रिकी दक्षिण_अफ्रिकासम्बन्धी
दक्षीण_अमेरिकी: दक्षिणीअमरीकी दक्षिणी_अमरीकी दक्षिणी-अमरीकी दक्षिणीअमेरिकी दक्षिणी_अमेरिकी दक्षिणी-अमेरिकी
दणकट: पोटिलो खँदिलो भरिलो मोटो दह्रो;
दणकेबाज: जोरदार
दत्तक: धर्मपुत्र
दयाळू: दयालु कृपालु दयावन
दयेस्त: दयालु कृपालु दयावन सहानुभूतिशील
दर: प्रत्येक सबै
दर_एक: प्रत्येक सबै
दरबारी: दरबारिया
दर्यायी: समुद्री
दर्शनशास्त्रीय: दर्शनशास्त्रीय दार्शनिक
दलीत: पददलित पदाक्रान्त दलित पाददलित थिचिएका कुल्चिएका पेलिएका हेपिएका दलित
दळडिरें: अभाव-ग्रस्त अभावग्रस्त
दळडिरो: निर्धन गरीब दरिद्र दलित
दळभद्री: अभाव-ग्रस्त अभावग्रस्त
दळिद्री: अभाव-ग्रस्त अभावग्रस्त
दळिद्रो: निर्धन गरीब दरिद्र
दस्तावेजी: दस्तावेजी
दांडगट: पोटिलो खँदिलो भरिलो मोटो दह्रो;
दांत_नाशिल्लो: अदन्त दन्तहीन दाँतहीन
दांतयाळी: दाँते दँतुर दंतुर दन्तुर
दांतयें: दन्त्य
दांतहीण: थोते
दांतोळी: दाँते दँतुर दंतुर दन्तुर
दांतोळें: दन्त्य
दांपत्य: दाम्पत्य
दाग_आशिल्लें: दागी
दागा_विरयत: बेदाग दागरहित अदाग अदागी
दागाळ: दाग_भएको दाग_लागेको धब्बा_लागेको
दागिल्लें: दागी
दाट: सघन घना गहन सङ्घात बाक्लो बाक्लो मोटो
दातयाळें: दाँते
दातरांचें: दाँते
दादलेपणाचें: पुरुष लोग्ने पुरुषको_जस्तो मर्दाना
दादलो: नर
दादल्यां_संबंदीं: पुरुष लोग्ने
दानशूर: दानी दाता दानशील
दानाचें: दानी दाता
दानित्सू: दानी दानशील उदार
दानित्सूक: दानी दानशील उदार
दानी: दानी दाता दानशील
दार्शनीक: दार्शनिक तत्वज्ञानी दर्शनशास्त्रीय दार्शनिक
दावकें: देब्रे बाम
दावखुरें: देब्रे बाम
दावें: देब्रे बायाँ बाउँ बाम
दास: बँधुवा
दिकाहीण: दिग्भ्रमित दिशाहीन
दिखावटी: देखावटी बनावटी बोक्रे बनौटी घोरेलको
दिग्गज: दिग्गज दिग्गज
दिनवाशी: कृतज्ञ आभारी धन्यवादी उपकृत अनुगृहीत
दिर्घतपी: दीर्घतपा
दिल्लें: उपलब्ध प्राप्त लब्ध अधिगत दिइएको प्रदत्त
दिवंक_नाशिल्ले: अदत्त अदत्ता
दिवंक_नाशिल्लें: अनावृत्त
दिवंगत: मरेको मृत
दिवाणी: दीवानी
दिवाळखोर: दिवालिया दीवालिया टाट_उल्टेको
दिव्य: परलौकिक अलौकिक परलोकिय दिव्यलोक आधिदैविक आमुष्मिक स्वर्गीय स्वर्गिक दिव्य वैकुन्ठीय दिव्य
दिशाहीण: दिग्भ्रमित दिशाहीन
दिश्टी_पडप: परिलक्षित देखाइएको निर्दिष्‍ट
दिश्टी_पडपी: दृश्यमान दृश्य दृष्टिगोचर चाक्षुष देखिने
दिसप: परिलक्षित देखाइएको निर्दिष्‍ट
दिसपी: दृश्यमान दृश्य दृष्टिगोचर चाक्षुष देखिने
दिसाळें: दैनिक प्रत्येक_दिन
दीर्घकालीन: दीर्घकाल चिरकाल
दुकळग्रस्त: सुक्खाग्रस्त खडेरीक्षेत्र अनावृष्टिक्षेत्र
दुकळपिडीत: सुक्खाग्रस्त खडेरीक्षेत्र अनावृष्टिक्षेत्र
दुकां_बगरचें: अनश्रु आँसुरहित
दुकुमेती: दस्तावेजी
दुखापती_बगरचे: अनाहत अक्षत क्षतिहीन अनुपहत
दुखावल्लें: घायल घाइते जख्मी जखमी आहत क्षत अभिप्रहत अभ्याहत
दुख्खदिणी: दुखद दुखदायी दुखप्रद
दुख्खहीण: शोकहीन अवसादहीन अशोक विशोक
दुख्खांती: दुखात्मक दुखान्त
दुख्खाची: दुखद दुखदायी दुखप्रद दुखमय दुखद दुखपूर्ण कष्टपूर्ण
दुख्खी: शोकपूर्ण शोकाकुल शोकग्रस्त दुखी पीड़ित व्यथित दुःखी आर्त दुखित
दुडवांकार: धनाढ्य धनी धनवान
दुतर्फी: दुईतर्फे दुईतर्फा
दुतोंडी: दुईमुखे दुइटा_मुख_भएको दुइमुखे दुइजिब्रे दुइमुखे
दुदाचें: _ले_बनिएको
दुदाचो: दुधेबालक दुधमुखे दूधखाने
दुदारू: दुधालु
दुदाळ: _ले_बनिएको
दुधारी: दोधारे
दुपटें: दुई_गुणा
दुबळी: अबला
दुबळें: कमजोर दुर्बल अशक्‍त दुब्लो लुते क्षीण
दुबळो: क्षमताहीन अक्षम अशक्त शक्तिहीन असमर्थ बेदम
दुबावा_बगरचो: असन्दिग्ध संदेहहीन असन्दिग्ध सन्देहहीन
दुबावा_विरयत: असन्दिग्ध संदेहहीन असन्दिग्ध सन्देहहीन दुविधाहीन दुबिधाहीन सन्देहहीन संशयहीन नि सन्देहहीन शङ्काहीन
दुबावी: शङ्कालु दोधारे संशयी सम्भ्रान्त
दुबावीत: आशङ्कित आशङ्कापूर्ण आशंकित आशंकापूर्ण दुविधाजनक दुबिधाजनक अनिश्चयात्मक भ्रामक संशयात्मक सन्दिग्ध संदिग्ध सन्देहास्पद संदेहास्पद सशङ्कित शङ्कित शङ्का आशङ्की सन्दिग्ध सन्देहपूर्ण सन्देहास्पद अनुयोज्य
दुभती: दुधालु
दुयेंती: रोगी बिमारी बिरामी पन्थे रुग्न
दुरंगी: दुई_रङ्गी
दुरदर्शिकायहीण: अदूरदर्शी अल्पदर्शी
दुरदर्शी: दूरदर्शी अग्रसोची दीर्घप्रज्ञ दीर्घदर्शी
दुरुस्त: राम्रो ठीकठाक‍ फिट
दुर्गूण: दुर्गुणी बैगुनी अगुणी अपगुणी
दुर्जन: दुष्ट दुर्जन अधम खल शठ हरामी पाजी अमति कुमति पामर अशील असज्जन असाधु असित
दुर्बोध: दुर्ग्राह्य दुर्ग्रह दुर्ग्राही दुर्ज्ञेय दुर्बोध
दुर्भागी: दुर्भाग्यशाली अभागी भाग्यहीन
दुर्मीळ: कठिन दुर्गम अगम्य अगम दुरूह दुर्गम्य अगत आगम
दुर्वेव्हारी: दुर्व्यवहारी
दुलपी: हल्लिने
दुशीत: दूषित दोषयुक्त ख़राब
दुश्काळग्रस्त: सुक्खाग्रस्त खडेरीक्षेत्र अनावृष्टिक्षेत्र
दुश्ट: दुष्ट दुर्जन अधम खल शठ हरामी पाजी अमति कुमति पामर अशील असज्जन असाधु असित दुरात्मा दुष्टचेता दुष्टात्मा दुष्टमति पापमति पापबुद्धि दुष्टचित्त
दुसरे_जातीचें: विजातीय परजातीय भिन्न_जातीय विजाति अर्को_जातिको
दुसरें: दोस्रो द्वितीय अघिल्लो अगिल्लो
दुसर्‍यांचेर_आदारून: परावलम्बी परावलम्बी आश्रित पराश्रयी पराश्रित परावलम्बित अनुजीवी
दुसर्‍याचें: पराइ परजनीय अरूको अन्य_को परकीय अर्काको
दुस्मानकेचो: सराप हाय
दुस्मानहीण: शत्रुहीन अजातशत्रु शत्रुविहीन अरिहीन अभूतशत्रु
दुस्मानी: शत्रुपूर्ण सशत्रु
दुस्वाशी: जुगुप्सु दुष्ट दुर्जन अधम खल शठ हरामी पाजी अमति कुमति पामर अशील असज्जन असाधु असित
दुस्वासी: द्वेषमूलक विरोधजन्य
दूझ: बाह्र १२
दूद_आटिल्लें: थनटुट्टु
दूद_पियेवपी: दुधेबालक दुधमुखे दूधखाने
दूर: दूर दूरवर्ती दूरस्थ
दृढ: दृढ़ अटल अडिग अविचल स्थिर कायम
दृश्टियुक्त: दृष्टियुक्त दृष्टिवान दृष्टिवंत
दृश्टिहीण: अन्धो नेत्रहीन
देंवणेचें: ओह्रालो
देंवतें: ओह्रालो
देंवयिल्लें: निलम्बित निलंबित पदच्युत बरखास्त बरख्वास्त अपदस्थ अनुलंबित अनुलम्बित
देखघेणे: आदर्श
देखणें: राम्रो सुन्दर
देगे_वयलें: किनार तीर छेउ
देगेचें: निकटस्थ छेउको निकटको समिपको निकटवर्ती समीपी सन्निकट समीपवर्ती समीपस्थ
देड: डेढ
देड_पटीचें: डेढगुना
देडीचें: डेढगुना
देण्याचें: देय दाय प्रदेय दातव्य
देवनिंदक: देवनिन्दक
देवा_बगरचें: अनीश्वर
देश_सोडिल्लो: देशत्यागेको
देशत्यागी: देशत्यागेको
देशभक्त: किनेको
देशी: देशीय देशी
देशी.: स्वदेशीय देशी देसी स्वदेशी देशीय देशज
दैववादी: भाग्यवादी प्रारब्धवादी दैववादी
दैवी: ईश्वरीय ईश्वरी दैवी परमेश्वरी देवत्य सुरत्य देवदत्त देवदत्त
दोंगराळ: पहाडी पर्वत-वासी पर्वत_वासी पर्वतीय पर्वती पहाडी पर्वतीय पर्वती
दोंगरी: पहाडी पर्वतीय पर्वती
दोट्टी: दोहोरो
दोट्टें: दुई_गुणा
दोतर्फी: दुईतर्फे दुईतर्फा
दोन: दुई
दोन_तोंडांचें: दुईमुखे दुइटा_मुख_भएको दुइमुखे दुइजिब्रे दुइमुखे
दोन_पटी: दुई_गुणा
दोन_हाताचें: दुइ_हाते
दोननाळी: दुई_नले
दोनरंगी: दुई_रङ्गी
दोनवर्सुकी: दुई_वर्षे द्विवर्षी
दोनांय_वटांतलें: दुइतर्फा दुइतिर दोतर्फा दोतर्फा
दोशमुक्त: रिहा आरोप_मुक्‍त
दोशी: अपराधी दोषी कसुरवार निन्दनीय निंदनीय निद्य निंदात्मक
द्रव: तरल द्रव
द्रवचलीत: द्रवचालित
द्रवीत: द्रवित द्रवीभूत
द्विवर्शी: दुई_वर्षे द्विवर्षी
धंदेकार: व्यवहार_कुशल व्यवहारी दुनियादार
धंद्याचें: व्यापारिक वाणिज्यिक व्यवसायिक
धडधाकट: पोटिलो खँदिलो भरिलो मोटो दह्रो; बलियो दह्रो मोटो
धडपडो: उपद्र्याहा बदमाश छुचो
धडाकेबाज: जोरदार
धनलाबाचें: धनदाता धनद धनदायी
धनवान: धनी धनवान
धनी: धनी धनवान धनाढ्य धनी धनवान
धन्य: कृतार्थ कृतकृत्य
धन्यवादी: कृतज्ञ आभारी धन्यवादी उपकृत अनुगृहीत
धरपी: धारी धारण_गर्ने ग्रहण_गर्ने
धर्म_मानपी: धर्मावलम्बी मतानुयायी धर्मानुयायी
धर्मकुड्डें: धर्मान्ध
धर्मच्यूत: धर्मच्युत धर्मभ्रष्ट धर्मपथभ्रष्ट नीतिभ्रष्ट
धर्मनिरपेक्ष: धर्मनिरपेक्ष
धर्मनिश्ट: धार्मिक धर्मशील धर्मी धर्मनिष्ठ
धर्मभिरु: धर्मभीरु
धर्मभ्रश्ट: धर्मच्युत धर्मभ्रष्ट धर्मपथभ्रष्ट नीतिभ्रष्ट
धर्मांध: धर्मान्ध
धर्मार्थ: धर्मार्थ धर्मका_निम्ति पुण्यका_लागि
धर्मालंबी: धर्मावलम्बी मतानुयायी धर्मानुयायी
धर्मावलंबी: धर्मावलम्बी मतानुयायी धर्मानुयायी
धर्मिक: धार्मिक धर्मशील धर्मी धर्मनिष्ठ
धर्मिश्ठ: धर्मावलम्बी मतानुयायी धर्मानुयायी
धर्मीक: धर्मावलम्बी मतानुयायी धर्मानुयायी धार्मिक धर्मीय
धवली: गौरी
धवें: श्वेत सेतो शुक्ल
धवो: गोरो श्वेत
धा: दस १० 10
धा_आनी_आठ: अठारौं १८_औ 18औं
धा_आनी_चार: चौधौ १४औं 14_औं
धा_आनी_पांच: पन्ध्रौँ १५_औं 15_औं
धा_पट: दसगुना दशगुणा दस_गुना दश_गुणा
धांपिल्लो: आच्छादित ढाकिएको आवृत्त आवृत अपिबद्ध अपिनद्ध अपिहित आच्छन्न
धांवडायिल्लें: निलम्बित निलंबित पदच्युत बरखास्त बरख्वास्त अपदस्थ अनुलंबित अनुलम्बित राजनीतिज्ञ राजनीतिशास्त्रज्ञ राजनीतिशास्त्रविद् राजनीतिशास्त्री राजनीति_शास्त्री
धांवपी: अभिद्रुत
धाएक: गोडा_दसेक दश_जनाजति
धाकटुलें: सानो
धाकटो: कान्छो कनिष्ठ
धाकलो: साना_भाइ भाइ
धाडशी: धैर्यशील धैर्यवान धीर साहसी हिम्मती बहादुर
धाडिल्लें: पठाउनु_भएको प्रेषित पठाइएको
धातूचें: धात्वीय धात्विक
धात्वीय: धात्वीय धात्विक
धादोस: तृप्त तुष्ट सन्तुष्ट संतुष्ट अघाएको
धार_आशिल्लें: धारिलो धार_भएको
धार_गेल्लें: भुत्ते बोधो नलाग्ने
धार_पडिल्लें: भुत्ते बोधो नलाग्ने
धारण_करपी: धारी धारण_गर्ने ग्रहण_गर्ने
धारदार: धारिलो धार_भएको तिखो धारिलो साह्रै_लाग्ने
धारावाहीक: धारावाहिक धारावाही
धारी: धारी धारण_गर्ने ग्रहण_गर्ने
धारेचें: धारिलो धार_भएको तिखो धारिलो साह्रै_लाग्ने
धार्मीक: धार्मिक धर्मीय
धावें: दस दश दसौँ दशौँ
धिमें: मन्द ढिलो सुस्त
धिराचें: अभयकर
धिरिश्ट: धैर्यशील धैर्यवान धीर
धीट: धैर्यशील धैर्यवान धीर साहसी हिम्मती बहादुर
धील: कमजोर लुलो शिथिल खुकुलो ढीला
धुंवराळ: धमिलो अस्पष्ट
धुक्याचें: धमिलो अस्पष्ट
धुल्लाचें: धुस्रोफुस्रो धूलधूसरित
धुळकट: धुस्रोफुस्रो धुस्रोफुस्रो धूलधूसरित
धुवंक_नाशिल्लें: नधोइएको
धैर्यहीण: धैर्यहीन
धोणुकार: धनुषाकार
धोदेल: मोटो बलियो स्थुलकाय
धोनयो: पेटु खन्चुवा घिचासे घिचुवा भाते
धोलत: हल्लिँदै डगमगाउँदै ढलपललिँदै
धोलपी: अनुमति_अदत्त अनुमति_अप्राप्त अस्वीकृत सम्मति_अदत्त हल्लिने डोलाउने डोलायमान
ध्यानमग्न: ध्यानमग्न ध्याननिष्ठ तपस्यारत
ध्यानहीन: ध्यानहीन अतल्लीन
ध्यानी: ध्यानमग्न ध्याननिष्ठ तपस्यारत
ध्यानेस्त: ध्यानमग्न ध्याननिष्ठ तपस्यारत
ध्वनीत: ध्वनित
न_फेडी_सारकें: अदेय अदाय
नकल_करपी: देखासिकी नक्कल अनुकृति
नकली: देखावटी नकली बनावटी बनौटी कृत्रिम अप्रकृत अयाथार्थिक देखासिकी नक्कल अनुकृति
नकसूद: नाजुक
नक्षत्रहीण: ताराविहीन ताराहीन
नक्षत्रांविणें: ताराविहीन ताराहीन
नक्षलवादी: नक्सलवादी नक्सली
नक्षली: नक्सलवादी नक्सली
नक्षिदार: नक्कासीदार
नखरेबाज: ढर्रे स्वाङे
नखशिखांत: नङदेखी_टुप्पीसम्म
नखेत्रांनी_भरिल्लें: तारायुक्त ताराङ्कित ताराले_भरिएको
नगरवासी: सहरी नगरवासी नगर_निवासी नगर-वासी नगर-निवासी नगरनिवासी नगरवासी शहराती नागर अग्राम्य
नगरी: सहरको नगरको
नगरेंतले: सहरी नगरवासी नगर_निवासी नगर-वासी नगर-निवासी नगरनिवासी नगरवासी शहराती नागर अग्राम्य
नग्न: नाङ्गो नग्न निर्वस्त्र
नजरबंद: नजरबन्द
नटयिल्लें: सुसज्जित
नटोवणी: सजाउने
नदर_आशिल्लो: दृष्टियुक्त दृष्टिवान दृष्टिवंत
नदरबंद: नजरबन्द
नदरेक_पडपी: दृश्यमान दृश्य दृष्टिगोचर चाक्षुष देखिने
नपियेवपा_सारकें: अपेय
नपुसक: नामर्द नपुंसक पौरुषहीन पुरषत्वहीन वीर्यहीन अपौरुष अपुरुष शंड
नमळायेचो: अप्रमाद अभ्रान्त
नमस्कार_करि_सारकें: वन्दनीय पुजनीय
नम्र: शान्त शीतल ठण्डा
नर: नर
नरभक्षक: नरभक्षी मनुष्यभक्षी मान्छेखाने
नरभक्षी: नरभक्षी मनुष्यभक्षी मान्छेखाने
नरम: सौम्य कोमल_स्वभावी सौम लचिलो लचकदार नम्य नमनीय विनम्य सुनम्य नरम कमलो कोमल
नवलकाणयेचें: औपन्यासिक उपन्यास-सम्बन्धी
नवलिकेचें: औपन्यासिक उपन्यास-सम्बन्धी
नवशिकें: सिकारू काँचो कच्चा नव_प्रशिक्षित नयाँ असिद्ध अनभ्यस्त अपक्व अपरिपक्क
नवशिक्षीत: सिकारू काँचो कच्चा नव_प्रशिक्षित नयाँ असिद्ध अनभ्यस्त अपक्व अपरिपक्क
नवीन: नयाँ नौलो नवीन हालैको
नवे: नयाँ नौलो नवीन हालैको
नवें: अपरिकल्पित
नवेंच_शिकिल्लें: सिकारू काँचो कच्चा नव_प्रशिक्षित नयाँ असिद्ध अनभ्यस्त अपक्व अपरिपक्क
नवो: आधुनिक अद्यतन आजको अर्वाचीन अधुनातन नया अप्राचीन अकालातीत अपूरातन अपूर्वकालीन नवीन अपूराण साम्प्रतिक
नशिलें: मत्त मस्त
नशीबवान: सौभाग्यशाली भाग्यवान भाग्यशाली
नशेचें: मत्त मस्त
नशेबाज: नशाबाज
नश्ट: नष्ट चौपट तहस-नहस ध्वस्त समाप्त बरबाद बर्बाद ध्वंसित अपध्वस्त विनष्ट निकंदन ध्वस्त बिग्रेको भत्केको नष्‍टभ्रष्‍ट
नश्टो: जुगुप्सु दुरात्मा दुष्टचेता दुष्टात्मा दुष्टमति पापमति पापबुद्धि दुष्टचित्त ईर्ष्यालु इखालु इबी इख
नश्वर: नश्वर अशाश्वत क्षणजीवी क्षयशील नाशवान भंगुर विनाशी अनित्य मेटिने नाशुक अनित
नसाय_करपी: ईर्ष्यालु इखालु
नसायहीण: ईर्ष्याहीन द्वेषहीन अद्वेषी आरिसहीन
नसायें: ईर्ष्यालु इखालु
नांगरणे_विरयत: बाँझो अजोत
नांगरूंक_नाशिल्लें: बाँझो अजोत
नांगेचें: डङ्किलो
नांमाबगरचें: बेनामी गुमनाम
नांवा_पुरतें: तथाकथित नाम_मात्रको
नांवाचें: तथाकथित नाम_मात्रको
नांवाजतो: प्रसिद्ध प्रख्यात ख्याति_प्राप्‍त
नांवादीक: प्रसिद्ध प्रख्यात ख्याति_प्राप्‍त
नाउमेदी: अनुत्सुक निरुत्सुक अनुत्क जिज्ञासाहीन अजिज्ञासु उत्सुक्ताहीन निरुत्सुक
नाकहीण: नाकहीन
नाका_जावपाचें: थकाइ
नाका_बगरचें: नाकहीन
नाकाजाल्लें: अनावश्यक अनपेक्षित फाल्टु नचाँहिदो जथाभावी अवाञ्छनीय गैरजरूरी निष्प्रयोजन
नाखटां_खायरें: नङटोके
नाखटां_खावपी: नङटोके
नाखूश: अप्रसन्न नाराज रुष्ट खिन्न अप्रतीत
नाखोशयेचें: असन्तोषजनक असन्तोषप्रद
नागडो: नाङ्गो नग्न निर्वस्त्र
नागोवणो: लफङ्गो फटाहा लुच्चा बदमास दुष्ट
नाजूक: कमजोर दुर्बल निम्छरो मसृण चिल्लो नाजुक
नाटकी: देखावटी नकली बनावटी बनौटी कृत्रिम अप्रकृत अयाथार्थिक नाटकीय नाटकीय
नाड: तिकडमबाज तिगडमबाज
नादमय: ध्वनित
नापसंतीचें: अप्रिय अप्रीतिकर नमिठो नचाहिँदो
नापास: अनुत्तीर्ण फेल
नापीक: बाँझो अनुर्वर
नामंजुर: अपारित अस्वीकृत नामञ्जुर
नामंजूर: अस्वीकृत नामंजूर सहमतिहीन सहमति_अप्राप्त अस्वीकृत नामञ्जुर खारेज
नामनेचे: विश्वविख्यात जगत_प्रसिद्ध विश्वप्रसिद्ध
नामनेचो: प्रसिद्ध प्रख्यात ख्याति_प्राप्‍त
नामर्द: नामर्द नपुंसक पौरुषहीन पुरषत्वहीन वीर्यहीन अपौरुष अपुरुष शंड
नामांकीत: नामङ्कित मनोनीत
नामिबियायी: नामिबियाई नामिबिया-सम्बन्धि
नायजिरियायी: नाइजेरियायी नाइजेरियाई नाइजेरेली
नारंगी: सुन्तले नारङ्गी
नालायक: अयोग्य अनुपयुक्त नालायक ना-लायक अनलायक अपारग अप्रभु अयथा अयुक्त अयुक्तरूप अयोग अकर्मण्य निकम्मा बेकार फालतू अकर्मा नालायक ना-लायक अनलायक_नालायक ना-लायक अकर्मण्य निकम्मा अयोग्य
नावडटें: मन_नपर्दो अप्रिय अनभीष्ठ अनभिमत अमनोनीत
नावडीचें: अप्रिय अप्रीतिकर नमिठो नचाहिँदो
नावाडगें: चकचके चञ्‍चल चुलबुले
नावाडगो: कुख्यात बदनाम दुर्नाम
नावेश: विलुप्त लुप्त गायब अदृश्य अदिष्ट अन्तर्हित अंतर्हित
नाशक: नाशक नाशी विनाशी विनाशक मार्ने ध्वंसकारी ध्वंसक विध्वंसक
नाशवंत: नश्वर अशाश्वत क्षणजीवी क्षयशील नाशवान भंगुर विनाशी अनित्य मेटिने नाशुक अनित
नाशिवंत: ध्वंसकारी ध्वंसक विध्वंसक
निंदक: निन्दक अपवादक अपवादिक अपवादी आक्षेपी आक्षेपक अभिसन्धक
निंदा_करपी: निन्दक अपवादक अपवादिक अपवादी आक्षेपी आक्षेपक अभिसन्धक
निंदात्मक: निन्दात्मक
निंदे_बगरचें: अनिन्दित कलङ्क_नलागेको निन्दारहित निष्कलङ्क
निंदे_विरयत: अनिन्दित कलङ्क_नलागेको निन्दारहित निष्कलङ्क
निंदेस्त: निन्दनीय निंदनीय निद्य निंदात्मक
निकारगुवायी: निकारगुआई
निखर्व: नील
निग्रही: संयत निग्रही अक्खड
निजामी: निजामी
नितळ: स्वच्छ मेघहीन निरभ्र अनभ्र मेघरहित अनाकाश अमेघ स्पष्ट प्रष्ट सफा छर्लङ्ग पवित्र शुद्ध निर्मल सफा
नितीक: वैध कानूनी ऐन_अनुसार विनयी नम्र
नितीकतायपूर्ण: नैतिकतापूर्ण नीतिपूर्ण नैतिक उचित सही
नितीपूर्ण: नैतिकतापूर्ण नीतिपूर्ण नैतिक उचित सही
नितीभायरें: अनीतिज्ञ
निद्रागत: निद्रामग्न सुतेको निद्रित निद्रागत स्वप्निल सुप्त सुप्तविग्रह सुप्तस्थ
निद्राहीण: अनिद्रा अनिँदो
निनावी: बेनामी गुमनाम
निपक्ष: तटस्थ निरपेक्ष उदासीन पक्षपातरहित अपक्षपाती निर्पेक्ष अनपेक्ष
निपूण: सिपालु प्रवीण निपुण पारङ्गत दक्ष माहिर अभ्यस्त कुशल होशियार पक्का सिद्धहस्त शातिर पटु पका निष्णात परिपक्व कार्यकुशल विचक्षण अभिज्ञ अभ्यासी आप्त योग्य उपयुक्‍त समर्थ सक्षम खाइलाग्दो
निबर: क्रूर निर्दय कठोर निर्दयी निष्ठुर नृशंस करुणाहीन दयारहित दयाहीन उग्र करुणाविहीन अदयालु निडर अभय निर्भय निर्भीक बेडर भयहीन निर्भीत अपभय अपभीति निःशंक अपशंक अभीत अभीरु कडा उग्र दरो बलियो कठरो सारो असभ्य दुर्जन दुर्छे निठुरी निर्मोही निर्मम अमोही
निमंत्रक: निमन्त्रक
निमंत्रण: निमन्त्रित आमनत्रित निम्त्याइएको बोलाइएको निम्तो_गरिएको
निमणें: अन्तिम
निमतां_करपी: ढर्रे स्वाङ_पार्ने
निमताळो: ढर्रे स्वाङ_पार्ने
निमसरकारी: अर्द्धसरकारी अर्धसरकारी अर्द्धशासकीय अर्धशासकीय
निमाणें: अन्तिम
निमाणो: कान्छो कनिष्ठ
निमाण्या: अन्तिम अंतिम आखिरी अन्त्य अंत्य
नियंत्रक: नियन्त्रक
नियंत्रीत: नियन्त्रित
नियमीत: नियमित नियमबद्ध
नियाळा_बगरचें: अनालोचित आलोचनाहीन
नियाळिल्लें: अवलोकित दृष्टिगत विलोकित
नियुक्तीत: नियुक्त तैनाथ नियोजित
निरंकूश: निरङ्कुश स्वेच्छाचारी अप्रतिबन्धित मनमोजी मनमौजी स्वच्छन्द अत्याचारी अन्यव्रत अप्रतिबद्ध अबद्ध
निरंहकारी: निरभिमानी अनभिमानी अभिमानरहित गर्वहीन दर्पहीन अदम्भी अदर्पी निरहङ्कारी अहङ्कारहीन दम्भहीन निरहङ्कर निरहङ्कृत सीधा अनमद अहङ्काररहित गर्वरहित मदशून्य अमानी अभिमानशून्य अमत्त घमण्डरहित
निरक्षर: अशिक्षित अनपढ निरक्षर
निरपराध: अदण्ड अदण्डनीय अदण्ड्य
निरपराधी: निर्दोष बेकसुर निरपराध निरपराधी अपराधहीन अदोष अनपराध अनपराधी
निरपेक्ष: निष्काम निरपेक्ष
निरपेक्षी: अनपेक्ष्य
निरभिमानी: निरभिमानी अनभिमानी अभिमानरहित गर्वहीन दर्पहीन अदम्भी अदर्पी निरहङ्कारी अहङ्कारहीन दम्भहीन निरहङ्कर निरहङ्कृत सीधा अनमद अहङ्काररहित गर्वरहित मदशून्य अमानी अभिमानशून्य अमत्त घमण्डरहित
निरर्थक: उटपट्याङ फाल्टु नचाँहिदो अनावश्यक रद्दी अर्थहीन निरर्थक
निरशेल्लें: लज्जित कुण्ठित
निराकार: निराकार अमूर्त निरङ्कार आकारविहीन अनवाय अनवय निरवयव अनाकार अपिरच्छन्न अमूर्त्त अमूर्त्ति अमूर्ति आकृतिहीन अमूर्तमान अमूर्तिमान अमूर्त्तिमान मूर्तिरहित अरूप अरूपक अशरीरी अशारीरिक
निरादार: निराधार
निराधार: असहाय निस्सहाय बेसहारा निराश्रित निराश्रय अनाश्रित आश्रयहीन अपाश्रय निरवलम्ब अवलम्बहीन अवलम्बनहीन  अनवस्थित अनाथ निरवलम्ब अनाश्रित निःसहाय निराधार अप्रामाणिक तथ्यहीन आधारहीन सारहीन निर्मूल यथार्थहीन अनाधार आधाररहित अधर पराश्रित पराश्रय पराधीन निराश्रित
निरावासीत: उजाडिएको सुनसान निर्जन
निराशादायी: निराशाजनक
निराशेवणेचें: निराशाजनक
निराश्रीत: निराश्रित अनाश्रित आश्रयहीन अपाश्रय निराश्रय
निराहार: निराहार अनाहार
निरीच्छ: अनिच्छा
निरुत्साही: अनुत्सुक निरुत्सुक अनुत्क जिज्ञासाहीन अजिज्ञासु उत्सुक्ताहीन निरुत्सुक
निरुपायी: अनुपाय उपायहीन विकल्पहीन
निरुपेगी: अनुपयोगी अनावश्यक उपयोगहीन निरर्थक व्यर्थ फालतू रद्दी अनर्थक
निरूपयोगी: विकल्पहीन उपायहीन निरुपाय विवश अनन्यगति अनन्यगतिक
निरोगी: स्वस्थ्य निरोगी
निर्जन: निर्जन एकान्त सुनसान जनशून्य
निर्जल: निर्जलीय जलविहीन निर्जला निर्जल
निर्जळ: निर्जल अजल जलहीन जलरहित
निर्जाप: अनुत्तरित
निर्जीव: निर्जीव निष्प्राण अजीवित जीवनहीन अजीव अप्राण अप्राणी जड अचैतन्य जडत्वयुक्त स्थूल अजैव भौतिक अचेतन चेतनारहित अजीव अनात्म आत्मारहित
निर्णय_जाल्ली: निर्णीत निर्णय_गरिएको
निर्णया_बगरचें: अनिर्णय बेनिधो अनिर्णित
निर्णायक: निर्णायक
निर्णीत: निर्णीत निर्णय_गरिएको
निर्दयी: क्रूर निर्दय कठोर निर्दयी निष्ठुर नृशंस करुणाहीन दयारहित दयाहीन उग्र करुणाविहीन अदयालु निठुरी निर्मोही निर्मम अमोही
निर्देशीत: निर्देशित निर्दिष्ट
निर्दोश: निर्दोष बेकसुर निरपराध निरपराधी अपराधहीन अदोष अनपराध अनपराधी
निर्बळ: क्षमताहीन अक्षम अशक्त शक्तिहीन असमर्थ बेदम कमजोर दुर्बल अशक्‍त
निर्बळा: अबला
निर्भय: निडर अभय निर्भय निर्भीक बेडर भयहीन निर्भीत अपभय अपभीति निःशंक अपशंक अभीत अभीरु
निर्भेळ: राम्रो शुद्ध चोखो असल पवित्र शुद्ध निर्मल सफा
निर्मळ: पवित्र शुद्ध निर्मल सफा
निर्माण_केल्लें: निर्मित रचित विरचित सृष्ट कृत सर्जित सृजित संरचित पर्णीत प्रकृत प्रणीत
निर्माणकर्तो: सृजनकर्ता सर्जक सृजक रचयिता स्रष्टा
निर्मातो: सृजनकर्ता सर्जक सृजक रचयिता स्रष्टा
निर्मिल्लें: निर्मित रचित विरचित सृष्ट कृत सर्जित सृजित संरचित पर्णीत प्रकृत प्रणीत
निर्मीत: निर्मित रचित विरचित सृष्ट कृत सर्जित सृजित संरचित पर्णीत प्रकृत प्रणीत
निर्यात: निर्यात_गरेको पठाएको
निर्यात_करपी: निर्यातक
निर्याती: निर्यातक
निर्लज्ज: निर्लज्ज लज्जाहीन छाडा निसङ्कोची निर्धक्क
निर्लोभी: निस्पृह निर्लोभ लोभहीन लालचहीन
निर्वासीत: शरणार्थी रेफ्युजी निष्कासित निर्वासित निष्काशित निकासित
निर्विकार: निर्विकार विकार_रहित
निर्विवाद: अकाट्य अखण्डनीय अखंडनीय अखंड्य अखण्ड्य निर्विवाद
निर्वेसनी: निर्व्यसनी अव्यसनी
निर्शेल्लें: उदास खिन्न म्लान अन्यमनस्क अन्यमन विरक्त अप्रसन्न अभितप्त
निर्शेवप: हताश निराश खिन्न
निलंबीत: निलम्बित निलंबित पदच्युत बरखास्त बरख्वास्त अपदस्थ अनुलंबित अनुलम्बित
निळसार: नीलो
निळें: नीलो
निवडक: चयनीय
निवडपा_सारकें: चयनीय
निवडिल्ली: नियुक्त तैनाथ नियोजित
निवडिल्लें: छानेको छुट्याएको पन्छाएको निर्वाचित चुनिएको
निवलकाणयेचें: औपन्यासिक उपन्यास-सम्बन्धी
निवळ: पवित्र शुद्ध निर्मल सफा उज्ज्वल उज्जवल सफा स्वच्छ
निवळावपी: नाशक
निवारक: निवारक रोक्‍ने हटाउने नाशक
निवृत्तीवेतना_विशींचें: आनुवृत्तिक
निवेदीत: निवेदित
निव्वळ: स्पष्ट प्रष्ट सफा छर्लङ्ग
निशस्त्र: शस्त्रहीन निहत्था निरस्त्र शस्त्रविहीन
निशाचर: निशाचर रात्रिचर
निशाणी__केल्ली: हस्ताक्षरित दस्तखती
निशाणे_बगर: अहस्ताक्षरित हस्ताक्षर_नगरिएको
निशाणे_विरयत: अहस्ताक्षरित हस्ताक्षर_नगरिएको
निशाद: निशाद
निशुल्क: निःशुल्क मुफ्त निशुल्क
निश्कपट: पवित्र शुद्ध निर्मल सफा
निश्कपटी: निष्कपट विश्‍वासी छद्महीन कपटहीन अछद्म
निश्क्रीय: निष्क्रिय असक्रिय सुप्‍त
निश्चींत: निश्चिन्त चिन्तारहित चिन्ताहीन चिन्तामुक्त
निश्चीत: अवश्यम्भावी अटल तय अटलनीय अनिवार्य अबाध्य अमिट निश्चित निर्धारित नियत नियमित ठिक निर्दिष्ट निश्‍चयात्मक पक्का
निश्टूर: क्रूर निर्दय कठोर निर्दयी निष्ठुर नृशंस करुणाहीन दयारहित दयाहीन उग्र करुणाविहीन अदयालु
निश्ठावान: निष्ठावान आस्थावान भक्ति_भावापन्न निष्ठावान
निश्ठाहीण: निष्ठाहीन
निश्पर्णी: पतछिन
निश्पाप: पवित्र शुद्ध निर्मल सफा पापहीन निष्पाप पापरहित निष्कलङ्क निर्दोष बेकसुर निरपराध निरपराधी अपराधहीन अदोष अनपराध अनपराधी
निश्प्राण: निर्जीव निष्प्राण अजीवित जीवनहीन अजीव अप्राण अप्राणी
निश्फळ: निष्फल असफल विफल व्यर्थ निरर्थक
निसंकोच: सन्देहहीन शङ्काहीन
निसंकोची: निसङ्कोची निर्धक्क
निसरटी_(निसट्टी): चिप्लो
निसुवार्थ: निस्वार्थ स्वार्थहीन
निस्तेज: म्लान न्याउरो न्यास्रो सत्वहीन निःसत्व
नीच: घटिया निकृष्ट नीच अधम क्षुद्र निकृष्टतम अधमाधम तुच्छातितुच्छ
नीच_कुळाचें: निम्न_कुलीन निम्न_वंशीय
नेटाचें: प्रबल प्रचण्ड उत्कट उग्र तेज कडा तुफानी
नेटाचो: अकडो
नेणटें: अवयस्क नाबालिग अल्पवयस्क अप्रौढ़ अप्राप्तयौवन
नेणार: अप्रवीण अनाडी अकुशल अदक्ष अनिपुण अधकचरा अनाप्त अनारी अनैपुण अपटु अपाटव अपात्र अविवेकी विवेकहीन अबोध अबुझ नावालक निरीह
नेत्याबगरचें: नेताविहिन अनायक नेतारहित
नेपाळी: नेपाली नेपाली नेपाली
नेम_पाळपी: नियमी नेमी नियम_पालक आत्मानुशासी
नेमणूक_केल्लें: अधिकृत
नेमा_प्रमाणें: विहित
नेमान: नियमित नियमबद्ध
नेमाळें: दैनिक प्रत्येक_दिन
नेमिल्लें: अधिकृत अधियुक्त पदस्थ
नेमी: नियमी नेमी नियम_पालक आत्मानुशासी
नेमीत: विहित
नैसर्गीक: प्राकृतिक नैसर्गिक प्राकृत अकृत्रिम प्रकृत
नॉर्वेयी: नर्वेजियन नर्वेजियन
न्याय_करपी: न्याय_कर्ता न्यायी
न्यायकरतो: न्याय_कर्ता न्यायी
न्यायालयीन: न्याय_विषयक अदालती न्यायिक
न्यायी: न्याय_कर्ता न्यायी
न्युझीलॅण्डी: न्युजिल्यान्डी
न्हयकारी: ऋणात्मक
न्हाण_घेतिल्लो: नुहाएको स्नात
न्हाल्लो: नुहाएको स्नात
न्हाविल्लो: नुहाएको स्नात
न्हिदखुरें: तन्द्रिल तन्द्रालु तन्द्रायुक्त
न्हिदखुरो: निदाएको निद्रालु निद्राग्रस्त अनिद्रा जाग्राम
न्हिदनाशिल्लो: अनिद्रा अनिँदो
न्हिदसुरें: तन्द्रिल तन्द्रालु तन्द्रायुक्त
न्हिदिल्लें: निद्रामग्न सुतेको निद्रित निद्रागत स्वप्निल सुप्त सुप्तविग्रह सुप्तस्थ
न्हिदेचें: स्वाप निद्राकोऔषधि
न्हिदेभायरें: उन्निद्र निद्रा_रहित
न्हिदेस्त: निदाएको निद्रालु निद्राग्रस्त अनिद्रा जाग्राम
न्हिद्राळू: निदाएको निद्रालु निद्राग्रस्त
न्हिद्रो: अनिद्रा जाग्राम
न्हीदमग्न: निद्रामग्न सुतेको निद्रित निद्रागत स्वप्निल सुप्त सुप्तविग्रह सुप्तस्थ
न्हेसनाशिल्लें: अधृत
न्हेसपा_सारकें: परिधानयोग्य
पंचतारी: पाँचतारे
पंचभुजांचें: पञ्चभुज पञ्चभुजा
पंचभुजी: पञ्चभुज पञ्चभुजा
पंचमासीक: पाँचमासे
पंचविसावें: पच्चीसौँ
पंचविसेक: गोडा_पचिसेक पचिस_जनाजति
पंचवीस: पच्चीस
पंचात्तरेक: गोडा_पचहत्तरेक पचहत्तर_जनाजति
पंचावन: पचपन्न
पंचावनावें: पचपन्नौं
पंचावनेक: गोडा_पचपनेक पचपन्न_वटाजति
पंचेचाळिसावें: पैंतालिसौं पैंताल्लीसौं ४५औं
पंचेचाळिसेक: गोडा_पैंतालीसेक पैतालिस_जनाजति
पंचेचाळीस: पैँतालीस ४५
पंच्यांयश्यावें: पचासीऔं
पंच्याण्णव: पन्चान्नब्बे ९५ 95
पंच्याण्णवावें: पन्चानब्बेऔं
पंच्यात्तर: भर्‍याङ लिस्नु खुड्किलो
पंच्यात्तरावें: पचहत्तरौं
पंच्यायशीं: पचासी ८५ 85
पंजाबी: पन्जाबी पन्जाबी पन्जाबी
पंडीत: बुद्धिमानी ज्ञानी प्राज्ञ समझदार दिमागदार दिमागी बुझक्की मेधावी विद्वान् ज्ञानी प्राज्ञ पण्डित विज्ञ
पंथ: साम्प्रदायिक
पंथीय: साम्प्रदायिक
पंदरा: पन्ध्र १५ पन्ध्रौँ १५_औं 15_औं
पंन्नासेक: गोडा_पचासेक पचास_जनाजति
पकदस्त: भारी गरुङ्गो वजनदार धाकिलो धाके
पक्कें: निश्‍चयात्मक पक्का
पक्षपाती: पक्षधर पक्षपाती समर्थक अनुमोदक पक्षपातपूर्ण भेदभावपूर्ण
पचकळ: प्रलापी कुरौटे अतिवक्ता
पचपचीत: लयालो
पचपी: सुपाच्य सहज_पाच्य हल्का पथ्य पाक्य पाकेको पाच्य
पचिल्लें: पचेको हजम_भएको
पच्छतापी: पश्चात्तापी
पच्छातापी: अनुतप्त
पठारी: पठारी
पडकें: भत्केको ढस्केको कोल्टिएको
पडमूर: कृतघ्न अकृतज्ञ
पडिल्लें: भत्केको ढस्केको कोल्टिएको उदास खिन्न म्लान अन्यमनस्क अन्यमन विरक्त अप्रसन्न अभितप्त
पड्डो: झिल्लीयुक्त झिल्लित
पड्ड्यांचें: पाल_भएको
पणसाचें: कटहरे
पथी: संयमी नियमी संयमशील
पदचारी: पदचर पदचारी पादचारी पैदल
पदव्युत्तर: स्नातकोत्तर पोस्ट्-ग्रेजुएट
पदव्युत्तरी: स्नातकीय
पद्यात्मक: पद्यात्मक छन्दात्मक छन्दोबद्ध छन्दबद्ध
पनवतीचो: अवनत अधोगत अधोपतित झरेको पतित अनुपतित अपकृष्ट अपभ्रंशित
पन्नास: पचास ५० 50
पन्नासावें: पचासौँ
पयलींचें: जीर्ण जर्जर
पयलें: पहिलो प्रथम
पयशेकार: धनाढ्य धनी धनवान
पयश्यांची: आर्थिक वित्तीय रुपिया
पयस: दूर दूरवर्ती दूरस्थ अछुतो अभोग
परकें: पराई बिरानो परचक्री
परक्याचें: पराइ परजनीय अरूको अन्य_को परकीय अर्काको
परजळपी: चम्किलो आलोकित उज्ज्वलित कान्तिमान ज्योतित दीप्त जगमग प्रकाशवान प्रदीप्त द्युतिमान्
परजळीत: प्रकाशपूर्ण दीप्तिपूर्ण प्रकाशमान आलोकित ज्योतित
परजातीचें: विजातीय परजातीय भिन्न_जातीय विजाति अर्को_जातिको
परजिवी: परजीवी पराआश्रित अन्यासक्त
परत_घेतिल्लो: बहाल पुनर्नियुक्त
परत_दिल्लो: बहाल पुनर्नियुक्त
परतुपाचें: आउने फर्किने
परतूंक_नाशिल्लें: अनावृत्त
परतें: विपरीत उल्टो विरुद्ध वामावर्त देब्रेतिर_हुँदै_घुमेको उल्टो अधोमुख
परतेचें: आउने फर्किने
परदेशी: विदेशी परदेशी परदेसी बिदेसी गैरमुल्की विलायती अन्यदेशीय अन्यराष्ट्रीय
परपंरावादी: परम्परावादी परम्परा_वादी परम्परा-वादी
परपोशी: अन्यपुष्ट
परम: परम
परमळीत: सुवासित अनुवासित
परमाणू: परमाणविक एटमी
परम्याकार: प्रमेही
परलोकी: परलौकिक अलौकिक परलोकिय दिव्यलोक आधिदैविक आमुष्मिक
परलोकीक: परलौकिक अलौकिक परलोकिय दिव्यलोक आधिदैविक आमुष्मिक
परवानगे_बगरचें: नअह्राइएको अनादिष्ट आदेशरहित
परवानगे_भायरें: अनाज्ञा
परसुवादीन: अध्यधीन अन्याधीन
पराक्रमी: वीर पराक्रमी
पराग्वेयी: पराग्वेयी पराग्वेयन
पराजीत: नहरुवा अनिर्जित
पराधीन: पराधीन गुलाम परतन्त्र अधीन अन्याधीन
परावलंबी: परावलम्बिनी परावलंबिनी आश्रिता पराश्रयिता परावलंबिन परावलम्बिन आश्रित अवलम्बित आलंबित अवलम्बित आलम्बित निर्भर आधारित अवलंबी अन्यासक्त
परासक्त: अन्यासक्त
परिचीत: थाहा ज्ञात विदित अवगत विज्ञात अवबुद्ध परिचित परिज्ञात प्रज्ञात विज्ञात संज्ञात
परिणामकारक: प्रभावशाली प्रभावकारी
परिणामी: परिणामी
परित्यागी: त्याज्य त्याजनीय परित्याज्य तजनीय हेय वर्ज्य
परिपक्व: अनुभवी जानकार परिपक्व खारिएको पाकेको परिपक्व अनुभवी कार्यकुशल प्रवीण प्रौढ
परिपूर्ण: परिपूर्ण भरिएको अभिपूर्ण पूर्ण
परिभाशीत: परिभाषित
परिवर्तनशील: परिवर्तनशील परिवर्तनीय परिवर्ती बदलिँदो
परिवर्तीत: परिवर्द्धित
परिवारांतलें: पारिवारिक घरेलु
परिवारीक: परिवारयुक्त कुटुम्बयुक्त
परिसिमीत: सीमित सीमाबद्ध सीमायुक्त
परोत्सुकी: अन्योत्सुक
परोपकारहीण: अनुपयोगी
परोपकारा_बगरचें: अनुपयोगी
परोपकारा_भायरें: अनुपयोगी
परोपकारी: परोपकारी परमार्थी परहितैषी परकाजी
पर्यायहीण: विकल्पहीन उपायहीन निरुपाय विवश अनन्यगति अनन्यगतिक
पर्यायी: वैकल्पिक विकल्पयुक्त विकल्पी ऐच्छिक पर्यायवाची पर्याय पर्यायवाचक समानार्थी समानार्थक
पर्शियन: इरानी इरानेली इरानी इरानेली
पळपी: पलायनशील अपक्रमी
पळपुटो: पलायनशील अपक्रमी
पळयिल्लें: अवलोकित दृष्टिगत विलोकित अभिज्ञात पूर्व_परिचित
पळोवंक_नाशिल्लें: अनवलोकित अदृष्ट
पवर्गी: पवर्गीय
पवित्र: पवित्र पावन पुण्य पुनीत शुद्ध
पसंतीचें: प्रिय प्यारो मन-पर्ने
पसरायिल्लें: प्रसारित
पसरिल्लें: विस्थापित स्थानच्युत छरिएको फिँजरिएको
पसून: जन्य सिर्जिएको उत्पन्न_भएको
पस्तिशेक: गोडा_पैँतिसेक पैँतिस_जनाजति
पस्तिसावें: पैतीसौँ
पस्तीस: पैँतीस ३५
पांखयाळें: प्वाँख_भएका
पांखां_आशिल्लें: प्वाँख_भएका
पांखां_बगरचें: पखेटाहीन पङ्खहीन पक्षरहित अपक्ष
पांगळो: लुलो-लङ्गडो
पांच: पाँच पाँचौँ पञ्च ५ 5
पांच_पटीचें: पाँचगुणा
पांचपट: पाँचगुणा
पांचमाही: पाँचमासे
पांचवें: पाँचौं पञ्चम
पांचेक: गोडा_पाँचेक
पांय_ओडपी: अपकर्षक
पांसठ: पैँसट्ठी ६५
पांसठावें: पैंसट्ठीऔं
पाकिस्तानी: पाकिस्तानी
पाखाट्यांविरयत: पखेटाहीन पङ्खहीन पक्षरहित अपक्ष
पाचक: सुपाच्य सहज_पाच्य हल्का पथ्य
पाचवें: हरियो
पाचवेंचार: हरियो-परियो हरियाली हरिया-परिया
पाचारिल्लें: सम्बोधित सम्बोध्य
पाझरप: द्रवित द्रवीभूत दयार्द्र
पाठ्य: पठनीय सुपाठ्य पाठ्य पठ्य अध्ययनीय अध्येतव्य अध्येय
पाड: मैलो फहोर अशुद्ध खराब रद्दी नजाती
पाड_जाल्लें: कुहिएको गलेको सडेको
पाडिल्लें: झरेको खसेको झरुवा
पाडे_बुद्धीचो: दुरात्मा दुष्टचेता दुष्टात्मा दुष्टमति पापमति पापबुद्धि दुष्टचित्त
पाडें: मैलो फहोर अशुद्ध
पाडो: जुगुप्सु दुरात्मा दुष्टचेता दुष्टात्मा दुष्टमति पापमति पापबुद्धि दुष्टचित्त
पाण: पानीमा_बस्ने जलीय
पाणिनी: पाणिनीय पाणिनिसम्बन्धी
पाणिनीचें: पाणिनीय पाणिनिसम्बन्धी
पातंजली: पातञ्जलीय पातञ्जल
पातयेवणें: विश्वासिलो विश्वसनीय विश्वासपात्र विश्वस्त विश्वासी पत्याउरो
पातळ: असघन अघन पानी_हालेको पनिया पातलो तरल द्रव गाढा पातलो पात्लो
पातळिल्लें: छरिएको फिँजरिएको व्यापी व्याप्‍त
पातशायी: राजाको बादशाही सुल्नानको
पात्र: सुपात्र सत्पात्र सत्पात्र राम्रो_पात्र योग्य उपयुक्‍त लायक
पादिसेर: अभाव-ग्रस्त अभावग्रस्त
पानबुडो: गोतालाउने डुबुल्की_मार्ने
पानाळ: पातभएका पाते पर्णी
पापनाशक: पापनाशक
पापहीण: पापहीन निष्पाप पापरहित निष्कलङ्क
पापी: पापी अधम अनाचारी पतित पातकी नीच पापकर्मी पापात्मा अधर्मी अधर्मिष्ट अधार्मिक म्लेच्छ अपकृष्ट कुमार्गी अपमार्गी अपाचारी दुष्ट दुरात्मा दुष्टचेता दुष्टात्मा दुष्टमति पापमति पापबुद्धि दुष्टचित्त
पापूय_नाशिल्लो: टुहुरो पितृहीन पितृविहीन पिताहीन पितविहीन अपितृ अपितृक
पारखुपी: दूरदर्शी अग्रसोची दीर्घप्रज्ञ दीर्घदर्शी
पारदर्शक: पारदर्शक पारदर्शी
पारदर्शी: पारदर्शक पारदर्शी
पारस्पारीक: पारस्परिक आपसी
पार्थीव: पार्थिव
पालक: पालनकर्ता पालनहार
पालविल्लें: चिसो ठण्डा
पाळपी: पालनकर्ता पालनहार
पाळिल्लें: पालतु घरपाला घरेलु घरैया
पाव: पाउ
पावयिल्लें: चुकता_गरिएको तिरिएको भुगतानकृत अभिदत्त
पावली_घालपी: हिँड्दै_गरेको पदस्थ
पावली_मारपी: हिँड्दै_गरेको पदस्थ
पावसा_विणें: नझर्ने
पावसा_विरयत: नझर्ने
पावसाळी: वर्षा_काल झरी वर्खा
पावसाळो: वर्षा
पाशाणी: सङ्गीन पत्थर_निर्मित
पाश्चात्य: पाश्‍चात्य पश्‍चिमी
पाश्च्यात्य: पश्‍चिमी पच्छिमी
पास: उत्तीर्ण पास पारित पास
पासठेक: गोडा_पैंसट्ठीएक पैसट्ठी_जनाजति
पिंजकें: च्यातिएको फाटेको जीर्ण
पिंजिल्लें: थोत्रो झुत्रो पुरानो फाटेको च्यातिएको फाटेको जीर्ण
पिकपी: धाने
पिकसावं: चिन्तित चिंतित चिन्तायुक्त चिन्ताग्रस्त
पिकांचें: फसलसम्बन्धी
पिकाळ: धाने
पिकिल्लें: पाकेको
पिकें: पाकेको
पिचो: पागल पगला बौलाहा
पिडिल्लें: प्रताडित पिटिएको चुटिएको
पिडिल्लो: उत्पीड़ित पीड़ित त्रसित
पिडीत: पीडित ग्रस्त ग्रसित व्यथित
पिडेस्त: रोगी बिमारी बिरामी पन्थे रुग्न दुखी पीड़ित व्यथित दुःखी आर्त दुखित
पितळीचें: पित्ले पितलको
पितूळचें: पित्ले पितलको
पितृहीण: टुहुरो पितृहीन पितृविहीन पिताहीन पितविहीन अपितृ अपितृक
पित्ताचें: पैत्तिक पैत्त
पिनिल्लें: च्यातिएको फाटेको जीर्ण
पियेनासपाचें: अपेय
पिशें: बौलाहा बहुला पागल बौलाही पागली
पिसांट: मूर्ख अज्ञानी बुद्धु
पिसाट: पागल पगला बौलाहा
पुजनीय: पूजनीय पूजा_गर्न_योग्य पुज्नुपर्ने उपासनीय उपास्य अर्चनीय पूज्य वन्दना_गर्न_योग्यवन्दनीय वन्द्य आराध्य आराधनीय स्तुत्य अभिवन्दनीय वरेण्य
पुजपा_सारकी: पूजनीय पूजा_गर्न_योग्य पुज्नुपर्ने उपासनीय उपास्य अर्चनीय पूज्य वन्दना_गर्न_योग्यवन्दनीय वन्द्य आराध्य आराधनीय स्तुत्य अभिवन्दनीय वरेण्य
पुज्य: पूजनीय पूजा_गर्न_योग्य पुज्नुपर्ने उपासनीय उपास्य अर्चनीय पूज्य वन्दना_गर्न_योग्यवन्दनीय वन्द्य आराध्य आराधनीय स्तुत्य अभिवन्दनीय वरेण्य
पुता_भशेन: छोरोजस्तो पुत्रतुल्य पुत्रवत
पुता_समान: छोरोजस्तो पुत्रतुल्य पुत्रवत
पुत्र_वत्सल: वत्सल स्नेही
पुनरावृत्तीचें: अनुवृत्ति आनुवृत्तिक
पुनरुक्त: पुनरुक्त पुनरावृत्त
पुनर्नियुक्ती: बहाल पुनर्नियुक्त
पुनर्वसणुकीत: पुन पुनर्वासित
पुनर्वासीत: पुन पुनर्वासित
पुरक: पूरक सम्पूरक
पुरवणीत: पूरक अनुपूरक
पुरस्कार_मेळिल्लो: पुरस्कृत
पुरस्कृत: पुरस्कृत
पुराय: पुरै पूर्ण पक्का सारा सबै पूरा सम्पूर्ण सम्पूर्ण जम्मै जम्मा सारा सबै समस्त सम्पूर्ण तमाम भरपूर सम्पूर्ण सकेसम्म
पुरुशी: पुरुष लोग्ने पुरुषको_जस्तो मर्दाना
पुरूश: नर
पुरो: पर्याप्त काफी यथेष्ट चाहिएजति मनग्य पर्याप्‍त प्रशस्त
पुरो_जाल्लें: थाकेको थकित क्लान्त क्लांत परिश्रांत
पुरो_जावपाचें: थकाइ
पुर्तगाली: पुर्तगाली
पुर्तुगेझ: पुर्तगाली
पुर्वापार: पैत्रिक पुर्ख्यौली पुश्तैनी
पुर्विल्लें: प्राचीन पूराकालीन पूरातन पुराना प्राक्कालीन आदिम प्राच्य आदिकालीन प्राचीन पुरानो पूर्व-कालीन
पुश्टीक: पौष्टिक पुष्टिकारक शक्तिवर्धक
पुसट: अस्पष्ट अप्रतीत धमिलो अस्पष्ट
पूर्ण: सारा सबै पूरा सम्पूर्ण सम्पूर्ण जम्मै जम्मा सारा सबै समस्त सम्पूर्ण तमाम
पूर्णप्रभावीत: अभिभूत ओतप्रोत ओत-प्रोत अभिपन्न अभिप्लुत
पूर्वकथित: पूर्वोक्त पूर्वकथित
पूर्वी: पूर्वी पूर्वीय
पृश्ठ: पछिल्लो पश्च पश्चस्थ
पृश्ठांकीत: पृष्ठाङ्कित
पेंवपी: पौडिने
पेज: प्रलापी कुरौटे अतिवक्ता
पेटयिल्लें: प्रज्वलित
पेटोवपी: दाहक दाहिक
पेय: पेय
पेरणेचें: रोपनीय
पेरपी: रोपाहार
पेरिल्लें: छरुवा रोपित
पेरूंक_नाशिल्लें: नरोपिएको
पेशीपुंजुल्याचें: अभिन्यास
पॉझिट्रॉन: धनात्मक
पोंग: कुँजो कुब्ज
पोकळ: खोक्रो ध्वान्द्रो
पोको: खोक्रो ध्वान्द्रो
पोजडें: अश्लील कामुकतापूर्ण
पोटयो: पेटु खन्चुवा घिचासे घिचुवा भाते
पोटसरें: घिस्रिने सरीसृप सर्पी
पोटाचें: पेटको पेटे उदरीय भुँडीको
पोब्र_फिदाल्ग: फक्कड
पोरणें: जीर्ण जर्जर प्राचीन पूराकालीन पूरातन पुराना प्राक्कालीन आदिम प्राच्य आदिकालीन प्राचीन पुरानो पूर्व-कालीन अतीत गत भूत व्यतीत बितेको गएको पछिल्लो पुरानो
पोल: खोक्रो ध्वान्द्रो
पोलिशी: पोलिस पोल्यान्डी पोलिस
पोलो: खोक्रो ध्वान्द्रो
पोशिल्लें: पालतु घरपाला घरेलु घरैया
पोशेगवाली: वस्त्रधारी वस्त्र-धारी
पोसकें: धर्मपुत्र
पोसपी: पालनकर्ता पालनहार
प्रकाशी: प्रकाशक द्योतक
प्रकाशीत: प्रकाशित प्रकाशित उज्यालो चहकिलो
प्रकाशीत_जावपाचीं: प्रकाशोन्मुख
प्रक्षेपीत: प्रक्षेपित प्रक्षिप्त
प्रखर: तीक्ष्ण तीव्र कुशाग्र प्रखर तेज अकुण्ठ अकुंठित अकुन्ठित विषम
प्रगट: प्रकट उजागर प्रस्फुटित प्रस्फुट
प्रगतिशील: विकसित उन्नत प्रोन्नत सुविकसित अभ्युत्थित अभ्युदित
प्रगती_केल्लो: प्रगत अग्रगत
प्रगतीकर्तो: प्रगति_गर्ने प्रगति_कर्ता अग्रगामी अग्रदर्शी
प्रचलीत: चालित परिचालित प्रचालित
प्रचारक: प्रचारक प्रचार_कर्ता
प्रचारीत: प्रचारित
प्रजातंत्री: प्रजातन्त्रीय प्रजातान्त्रिक जनतान्त्रिक
प्रजातंत्रीक: प्रजातान्त्रिक गणतान्त्रिक लोकतानत्रिक
प्रतिकारी: प्रतिकारी
प्रतिक्षीत: प्रतीक्षित पर्खिएको
प्रतिगामी: प्रतिगामी पश्चगामी पश्चगङ्ता
प्रतिद्वंद्वी: प्रतिद्वन्द्वी प्रतिस्पर्धी प्रतियोगी स्पर्धी
प्रतिध्वनीत: प्रतिध्वनित गुञ्जायमान
प्रतिपादीत: प्रतिपाद्य अभिधेय निचोड निष्कर्ष
प्रतिरुपी: प्रतिरूपी अनुरूपी समरूपी
प्रतिश्ठीत: प्रतिष्ठित अग्रगण्य इज्जतदार गणमान्य नामी सम्मानित मान्य माननीय गौरवान्वित सम्भ्रान्त संभ्रांत सम्ब्रांत अजीज अपचायित सुर्खरू विशिष्ट विशेष
प्रतिस्पर्धक: प्रतिद्वन्द्वी प्रतिस्पर्धी प्रतियोगी स्पर्धी
प्रतीसर्तक: प्रतिद्वन्द्वी प्रतिस्पर्धी प्रतियोगी स्पर्धी
प्रत्यक्ष: इन्द्रियगम्य इंद्रिय_गोचर गोचर इंद्रियग्राह्य इन्द्रियगोचर इंद्रियगोचर प्रत्यक्ष अपरोक्ष प्रत्यक्ष साक्षात् साक्षात
प्रत्येक: प्रत्येक सबै
प्रथम: पहिलो प्रथम
प्रदर्शनी: दर्शनीय प्रदर्शनीय
प्रदर्शीत: मञ्चन अभिमञ्चित प्रदर्शित प्रदर्शित देखाइएको प्रदर्शन_गरिएको
प्रदुशीत: दूषित दोषयुक्त ख़राब
प्रदेशीक: प्रान्तीय क्षेत्रीय_प्रादेशिक
प्रभावशाली: प्रभावशाल प्रभावशील
प्रभावी: प्रभावशाल प्रभावशील प्रभावशाली प्रभावकारी
प्रभावीत: प्रभावित
प्रमाणीक_वेव्हारी: सद्व्यवहारी
प्रमाणीत: सत्यापित प्रमाणित प्रमाणित प्रमाणीकृत प्रमाणिकरण सिद्ध प्रमाणित साबित
प्रमाणें: अनुकूल अनुसार अनुरूप मुताबिक समान तुल्य सदृश बराबर तदनुसार त्यस_अनुसार त्यस्तै_रूपले उसै_बमोजिम
प्रयत्नशील: प्रयत्नशील प्रयासशील प्रयासी प्रयत्नी प्रयत्नवान उद्यमी उद्यमशील उद्योगी
प्रयोजनार्थी: प्रयोजनार्थी प्रयोजनी
प्रवाहीत: धाराप्रवाह निरन्तर एकोहोरो
प्रवेशाचें: प्रवेश्य प्रवेशनीय
प्रवेशीत: प्रविष्ट आगत प्रवेशित अभिनिवेशित
प्रशंसक: प्रशंसक प्रशंसी
प्रशस्त: भव्य ठुलो सानदार विशाल
प्रशासनीक: प्रशासनिक
प्रशिक्षीत: प्रशिक्षित तालिमे
प्रसन्न: प्रसन्न खुसी खुश आनन्दित पुलकित हर्षित विह्वल आह्लादित प्रफुल्ल परितुष्ट प्रफुल्लित प्रफुलित उल्लसित उल्लासित उल्लासी आनन्दी विनोदित पुलकित तुष्ट
प्रसन्नचित्त: प्रसन्नचित्त
प्रसन्नमूख: प्रसन्नमुख प्रसन्नवदन
प्रसारीत: प्रसारित
प्रसिद्ध: प्रसिद्ध प्रख्यात ख्याति_प्राप्‍त विश्वविख्यात जगत_प्रसिद्ध विश्वप्रसिद्ध
प्रस्तावीत: प्रस्तावित
प्रस्तुतीकरणाचें: मञ्चनीय मंच्य प्रस्तुति_योग्य
प्रहारक: प्रहारी
प्रांतीय: प्रान्तीय क्षेत्रीय_प्रादेशिक
प्राकृतीक: प्राकृतिक नैसर्गिक प्राकृत अकृत्रिम प्रकृत
प्राचीन: प्राचीन पूराकालीन पूरातन पुराना प्राक्कालीन आदिम प्राच्य आदिकालीन
प्राज्ञी: विदुषी प्राज्ञी
प्राथमीक: प्रारम्भिक आरम्भिक आरंभिक प्राथमिक प्रारंभिक पूर्व
प्रादेशीक: प्रान्तीय क्षेत्रीय_प्रादेशिक
प्राधिकृत: प्राधिकृत
प्राप्त_केल्लें: उपलब्ध प्राप्त लब्ध अधिगत
प्रामाणीक: विश्वासिलो विश्वसनीय विश्वासपात्र विश्वस्त विश्वासी पत्याउरो तथ्यपूर्ण तथ्यात्मक तथ्यपरक प्रामाणिक सारपूर्ण निष्कपट विश्‍वासी शुद्ध_मन अनीच
प्रायोगीक: प्रायोगिक प्रयोगात्मक
प्रायोजीत: प्रायोजित
प्रारब्दवादी: भाग्यवादी प्रारब्धवादी दैववादी
प्रार्थनीय: प्रार्थनीय प्रार्थना_गर्न_योग्य याचनीय वन्दनीय
प्रासंगीक: प्रासङ्गिक प्रसङ्ग-सम्बन्धी
प्रीयभाशी: प्रियभाषी प्रियवादी प्रियंवद
प्रेमपूर्ण: अनगन्ती थुप्रो
प्रेममय: अनगन्ती थुप्रो
प्रेमासक्त: प्रेमासक्त अनुरक्त अनुरागी आसक्त लसपसिएको
प्रेरणा_दिवपी: प्रेरणादायक प्रेरणात्मक प्रेरणास्पद प्रेरणाजन्य
प्रेरणादायक: प्रेरणादायक प्रेरणात्मक प्रेरणास्पद प्रेरणाजन्य
प्रेरणास्पद: प्रेरणादायक प्रेरणात्मक प्रेरणास्पद प्रेरणाजन्य
प्रेरीत: प्रेरित
प्रेशीत: पठाउनु_भएको प्रेषित
प्रोत्साहीत: प्रोत्साहित उत्साहित
प्रौढ: परिपक्व अनुभवी कार्यकुशल प्रवीण प्रौढ
प्रौद्योगीक: प्रौद्योगिक
फकांडीं: मजाकी दिल्लगीबाज मजाकिया
फकिरी: अभाव-ग्रस्त अभावग्रस्त
फटकळ: मुखाले चोथाले थुतुने दुर्मुखा
फटकिरें: टाँट असत्यवादी अनृतभाषी असत्यभाषी मिथ्याभाषी अन्यवादी मिथ्यावादी असत्य झूटो
फटकीरपणाचें: असत्य झूटो
फटींग: टाँट असत्यवादी अनृतभाषी असत्यभाषी मिथ्याभाषी अन्यवादी मिथ्यावादी निराधार अप्रामाणिक तथ्यहीन आधारहीन सारहीन निर्मूल यथार्थहीन अनाधार आधाररहित छक्याउने असभ्य अभद्र अशिष्ट लफङ्गो फटाहा लुच्चा बदमास दुष्ट धोकाबाज बेइमानी_गर्ने धूर्त कपटी छली
फटीचें: असत्य झूटो कपोल_कल्पित मनगढन्त हावा कपोलकल्पित मिथ्या झुटो असत्य ढाँट झूट
फडफडीत: आलो ताजा ताजा
फळआहार: फलाहार
फळदिणें: फलदायक फलप्रद फलदायी
फळां_दिवपी: फल_भएको
फळां_नाशिल्ले: अफल फलहीन फलरहित फलविहीन_फल_नभएको निष्फल
फळां_लागपी: फल_भएको
फळां_लागिल्लें: फल_लागेका फल_भएका
फळांचें: फल_लागेका फल_भएका
फळादीक: सफल सिद्ध
फळादीक.: फलित सफल
फळार: फलाहार
फांकिल्लें: छरिएको फिँजरिएको
फांटो: शाखायुक्त डाले प्रशाखित
फांफार्रांव: धृष्ट उच्छृङ्खल ढीठ निडर उद्धत
फाकिवंत: प्रसिद्ध प्रख्यात ख्याति_प्राप्‍त
फाटलें: पछिल्लो पश्च पश्चस्थ परवर्ती पछिल्लो पछिको
फाटल्या: अतीत गत भूत व्यतीत बितेको गएको पछिल्लो पुरानो
फाटल्यान: अप्रत्यक्ष परोक्ष
फाटल्यान_चडिल्लें: अन्तिम शेष
फाटल्यान_बशिल्लो: पछिल्लो
फाटल्यान_लागपी: अनुप्रपन्न
फाटल्यानचें: अकथित नभनिएको अनुक्त नबताइएको नकहिएको
फाटी_उरिल्लें: अनुवृत्त
फाटी_पडिल्लें: अनुवृत्त
फाटीं_उरिल्लो: पछाडिएको प्रतिगत पश्चगत फिसौटो नजान्ने
फाटीं_सरनासपी: अपरावर्ती अपरावर्ती
फाटीकणो_मोडिल्लें: भग्नपृष्ठ
फाटीचें: खोटो नकली
फातराळ: ढुङ्गेनी
फाफडिल्लें: प्रसारित
फाफशिल्लें: छरिएको फिँजरिएको
फाम: होहल्ला अफवाही हल्ला
फामाद: प्रसिद्ध प्रख्यात ख्याति_प्राप्‍त सुप्रसिद्ध सुविख्यात सुख्यात अभिविख्यात अभिविश्रुत विश्वविख्यात जगत_प्रसिद्ध विश्वप्रसिद्ध
फायद्याचें: लाभदायक लाभप्रद लाभकर लाभकारी लाभजनक गुणकारी उपयोगी हितकारी अर्थकर
फाराविल्लो: अढकिनु अल्झिनु फँस्नु
फारीक_करिनासपा_सारकें: अदेय अदाय
फारीक_केल्लें: चुकता_गरिएको तिरिएको भुगतानकृत
फारीक_ना_करी_सारकें: अदेय अदाय
फालतू: उटपट्याङ फाल्टु नचाँहिदो अनावश्यक रद्दी अनुपयोगी अनावश्यक उपयोगहीन निरर्थक व्यर्थ फालतू रद्दी अनर्थक घटिया निकृष्ट नीच अधम क्षुद्र अनावश्यक अनपेक्षित फाल्टु नचाँहिदो जथाभावी अवाञ्छनीय गैरजरूरी निष्प्रयोजन अर्थहीन निरर्थक
फाल्याचें: अन्येद्युक
फाळीक_लागिल्लो: मरणासन्न मुमूर्ष
फावोशी: समुचित
फावोशें: अनुकूल अनुसार अनुरूप मुताबिक उचित उपयुक्‍त ठिक उचित समुचित उपयुक्त ठिक सही योग्य उपयुक्‍त लायक अनुकूल अनुकूलित मानवीय मानवोचित
फिकें: रङ्गहीन फुस्रो
फिटफिटें: कमजोर दुर्बल निम्छरो
फिन: बुद्धिमानी ज्ञानी प्राज्ञ समझदार दिमागदार दिमागी बुझक्की मेधावी
फिनलॅण्डी: फिनल्यान्डी फिनिस फिनल्यान्डी
फिरकेचें: पेच_भएको पेचताल
फिलिपियन: फिलिपिनी फिलिपिनो
फिशाल: योग्य उपयुक्‍त समर्थ सक्षम खाइलाग्दो बुद्धिमानी ज्ञानी प्राज्ञ समझदार दिमागदार दिमागी बुझक्की मेधावी
फिशाळ: सिपालु प्रवीण ज्ञानी जान्ने
फीट: साँगुरो छोटो फिट ठीक फिट
फुकट: निःशुल्क मुफ्त निशुल्क
फुटकें: फुटेको थोत्रिएको
फुटीर: एकताहीन असङ्गठित सङ्गठनहीन छरपटिएको भताभुङ्ग_भएको अलगाउवादी
फुटें: फिका खल्लो
फुडलें: अघिल्लो अगिल्लो
फुडलो: अघिल्लो अग्र अग्रवर्ती अग्रिम पूर्व सामुन्नेको सामुको अग्रगामी पुरोगामी पूर्वगामी
फुडल्या: आउँदो आगामी भावी आउनेवाला आइन्दा
फुडाराचें: आगामी भविष्य_कालीन सम्भावित भविष्णु भाविता भावी भव्य अगत्तर भवितव्य अनागत
फुडारी_नाशिल्लें: नेताविहिन अनायक नेतारहित
फुडारीहीण: नेताविहिन अनायक नेतारहित
फुलां_बगरचें: पुष्पहीन अपुष्पित पुष्परहित अपुष्प कुसुमरहित
फुलांनी_भरिल्लें: पुष्पित कुसुमित पुष्पयुक्त प्रफुल्ल
फुलिल्लें: पुष्पित फुलेको कुसुमित खिला प्रफुल्लित प्रफुलित स्मित विकसित
फुलूंक_नाशिल्लें: अपुष्पित अविकसित मुकुलित अस्मित
फॅल: अनुत्तीर्ण फेल
फेडिनासपा_सारकें: अदेय अदाय
फोराचें: गाता_लगाएको गाता_भएको
फोर्त: दरो बलियो कठरो सारो
फोलगी: अपव्ययी खर्चालु फिजुलखर्ची
फोल्गी: अपव्ययी खर्चिलो फिजुलखर्ची व्ययशील अतिव्ययी अति-व्ययी व्ययी
फौजदारी: फौजदारी
फौजी: फौजी
फ्राक: कमजोर दुर्बल अशक्‍त
फ्रान्स_गुवानी: फ्रेन्च_गुआनी फ्रेन्च_गुआनाई
फ्रान्सी: फ्रान्सेली फ्रान्सिसी फ्रेन्च
फ्रेंच: फ्रान्सेली फ्रान्सीसी फ्रेन्च फ्रान्सेली फ्रान्सिसी फ्रेन्च
फ्रेन्च: फ्रान्सेली फ्रान्सीसी फ्रेन्च फ्रान्सेली फ्रान्सिसी फ्रेन्च
बंगाली: बङ्गाली बङ्गाली बङ्गाली
बंजारा: बन्जारा घुमन्ते
बंडखोर: विद्रोही क्रान्तिकारी
बंद: बन्द थुनिएको रोकिएको बन्द
बंद_केल्लें: रोकिएको बन्द_भएको थामिएको
बंदखणीचे: हवालती
बंदनमुक्त: अनवरत निरन्तरको लगातारको बारम्बारको
बंदनहीण: अनवरत निरन्तरको लगातारको बारम्बारको
बंदना_बगरचो: अनवरत निरन्तरको लगातारको बारम्बारको
बकासूर: पेटु खन्चुवा घिचासे घिचुवा भाते
बकें: दुब्लो सिकुटे खिनाउटे अति_क्षीणकाय
बचत_केल्लें: धृत निभृत
बडतर्फ: अछत
बडबडे: बिरेनुन कालो_नुन पादे_नुन
बडबडें: बकबके
बडबडेचें: उटपट्याङ फाल्टु नचाँहिदो अनावश्यक रद्दी
बडबडो: प्रलापी कुरौटे अतिवक्ता
बडीची: पैत्रिक पुर्ख्यौली पुश्तैनी
बडीचें: आनुवंशिक वंशागत वंशानुक्रमिक पैतृक आनुवांशिक अनुवांशिक पुर्ख्यौली
बत्तिसावें: बत्तीसौँ
बत्तीस: बत्तीस
बदनामिकारक: निन्दात्मक
बदलनासपी: अपरिवर्तनीय अपरिवर्तनशील
बदलपी: परिवर्तनशील परिवर्तनीय परिवर्ती बदलिँदो
बदली_केल्लो: सरुवा स्थानान्तरित
बदिस्त: आबद्ध निबद्ध बद्ध बाँधिएको अमुक्त अनुबद्ध पाबन्द अपिबद्ध अपिनद्ध
बद्‍दल: विषयक सम्बन्धीय सम्बन्धी अनुषंगी अन्वयी अबाध
बनारसी: बनारसी
बनावट: देखावटी बनावटी बोक्रे बनौटी घोरेलको देखावटी नकली बनावटी बनौटी कृत्रिम अप्रकृत अयाथार्थिक कपोल_कल्पित मनगढन्त हावा कपोलकल्पित
बरयल्लो: लिखित लिपिबद्ध अङ्कित लेखिएको
बरयिल्लें: लेखाकृत अभिलिखित लेखाङ्कित
बरी: उत्तम उत्कृष्ट अनमोल श्रेष्ठ प्रशस्त भारी
बरुंडी: बुरेन्डी
बरें: राम्रो सही_मान्छे गतिलो श्लील श्रील चिकित्स्य साध्य स्वादिष्ट मिठो स्वादिष्ठ राम्रो दिव्य प्रतिभाशाली
बरें_जायना__अशें: असाध्य अचिकित्स्य चिकित्सातीत दुस्साध्य दुःसाध्य
बरें_मागपी: हितैषी शुभचिन्तक शुभाकाङ्क्षी
बरो: सज्जन भद्र भलादमी सुजन शीलवान सद्गुणी सुप्रतीक
बरोबर: उचित समुचित उपयुक्त ठिक सही शुद्ध_सही
बरोवन_दवरपा_सारकें: उल्लेखनीय उल्लेख_गर्ने_योग्‍य
बर्फाळ: बरफिलो ज्यादै_चिसो अति_ठन्डा बरफ_भएको हिउँमा_बस्ने हिउँको
बर्मी: बर्मी बर्मे म्यानमारी बर्मी म्यानमारी बर्मेली बर्मी म्यानमारी
बर्‍या_कुळाचें: कुलीन घरानियाँ खानदानी
बर्‍या_घराण्यांतलें: कुलीन घरानियाँ खानदानी
बलात्कारी: बलात्कारी बलात्कार_कर्ता
बल्गेरी: बुल्गारियाई बुलगारियाई
बल्ल: मोटो बलियो स्थुलकाय
बळकट: पोटिलो खँदिलो भरिलो मोटो दह्रो;
बळजबरी_करपी: बलात्कारी बलात्कार_कर्ता
बळिश्ट: दरो बलियो कठरो सारो पोटिलो खँदिलो भरिलो मोटो दह्रो; महाबली शक्‍तिशाली
बशिल्लें: आसीन विराजमान बसेका उपविष्ट चढेको बसेको
बसयिल्लें: जडेको
बहामयी: बहमाई बहमी
बहिर्दृश्टी: बहिर्मुखी बहिर्भिमुखी
बहिर्मूख: बहिर्मुखी बहिर्भिमुखी
बहिश्कृत: राजनीतिज्ञ राजनीतिशास्त्रज्ञ राजनीतिशास्त्रविद् राजनीतिशास्त्री राजनीति_शास्त्री बहिष्कृत खारिज
बांदिल्लें: निर्मित रचित विरचित सृष्ट कृत सर्जित सृजित संरचित पर्णीत प्रकृत प्रणीत
बाकी: बकाया एरियार दातव्य दाय
बाकीचें: उब्रेको बचेको बचेखुचेको रहल शेष बाँकी
बागवल्लें: अवनमित नमित निहुरिएको नत
बागविल्लें: अभिनम्र
बात्तर: बहत्तर ७२
बाद: अकर्मण्य निकम्मा बेकार फालतू अकर्मा नालायक ना-लायक अनलायक_नालायक ना-लायक
बादीत: क्षतिग्रस्त
बाधक: अवरोधक अवरोधी बाधक अनुरोधक अनुरोधी
बापायचें: पैतृक पैत्रिक
बाबरी: बाबरी
बारबॅडोसी: बारबेडोसी
बारा: बाह्र १२
बारावें: बाह्रौं १२_औं 12_औं
बारीक: दुब्लो सिकुटे खिनाउटे अति_क्षीणकाय मिही मसिनो दुब्लो लुते क्षीण सानो सानु
बारीक-सारीक: छिटपुट छुटपुट छिट-पुट छुट-पुट हल्का-फुल्का
बारीकसाणीचें: सूक्ष्मदर्शी
बारीकसाणेचो.: महालोभी धेरै_लोभी
बावगल्लें: अभिनम्र
बावनावें: बाउन्नौं
बाविल्लें: रगतहीन निस्तेज आभाहीन कांतिहीन ओजहीन प्रभाहीन बेरौनक अप्रभ प्रभारहित श्रीहत म्लान न्याउरो न्यास्रो उदास खिन्न म्लान अन्यमनस्क अन्यमन विरक्त अप्रसन्न अभितप्त ओइलाएका ओइलाएको
बाशें: बासी पुरानो
बाश्पीत: आसवित आसुत
बासठावें: बैसट्ठीऔं
बाह्य: बाह्य बहिरङ्ग बाहिरी
बिंधास्त: मस्त मत्त चिन्तामुक्त जवान पट्ठो आनन्दित हर्षित
बिकट: विपरीत प्रतिकूल खिलाफ कठिन विकट मुश्‍किल सारो
बिनकांटयारें: कण्टकहीन अकण्टक शूलहीन
बिनखात्याचें: निर्विभाग
बिनचूक: अचूक अमोघ नचुक्ने भुल_नगर्ने विफल_नहुने
बिनपांयाचो: पाउहीन पादहीन पयरहीन गोडाहीन खुट्टा_नभएका
बिनपावशी: नझर्ने
बिनराखीव: अनारक्षित
बिनविरोध: निर्विरोध
बियां_बगर: निर्वीज बीजरहित
बियां_विरयत: निर्वीज बीजरहित
बिहारी: बिहारी बिहारी
बी: आदि इत्यादि
बीन: आदि इत्यादि
बीन_विखारी: विषहीन
बीनज्वाळाग्राही: अदाहक
बीनतारी: बेतार
बीनपगारी: अवैतनिक बेतन_रहित
बीनविरोध: अप्रतिघात
बुडा_विरयत: पिँध_नभएको
बुडिल्लें: जलमग्न प्लावित
बुडिल्लो: अस्तगत अस्त डुब्दो
बुदवंत: बुद्धिजीवी बुद्धिमानी ज्ञानी प्राज्ञ समझदार दिमागदार दिमागी बुझक्की मेधावी विद्वान् ज्ञानी प्राज्ञ पण्डित विज्ञ
बुद्दिजिवी: बुद्धिजीवी
बुरशें: मैलो फहोर अशुद्ध अश्लील कामुकतापूर्ण फोहोरी मैलाधैला
बुराक_नाशिल्लें: दुलो_नभएको प्वाल_नपरेको छिद्रहीन
बुराकाची: छिद्रयुक्त रन्ध्रयुक्त रन्ध्रयुक्त सछिद्र दुलोयुक्त
बुलेट_प्रूफ: बुलेट_प्रुफ
बे: दुई
बेकार: उद्यमहीन पुरुषार्थहीन अपरिश्रमी अनुद्यमी अप्रयत्‍न अप्रयास अयत्‍न यत्‍नरहित उद्योगहीन अकर्मण्य निकम्मा बेकार फालतू अकर्मा नालायक ना-लायक अनलायक_नालायक ना-लायक खाली अव्यस्त बेरोजगार बेइलमी जीविकाहीन अनियोजित नलगाइएको
बेकारलवडी: अकर्मण्य निकम्मा बेकार फालतू अकर्मा नालायक ना-लायक अनलायक_नालायक ना-लायक
बेगडी: देखावटी बनावटी बोक्रे बनौटी घोरेलको देखावटी नकली बनावटी बनौटी कृत्रिम अप्रकृत अयाथार्थिक
बेघर: आवासयुक्त गृहयुक्त आवासिक घरबारयुक्त घरबारी आवासहीन आश्रयहीन गृहहीन गृहविहीन बेघर बेघरवार
बेचाळिसावें: बयालीसौँ
बेचाळीस: बयालीस
बेचैन: उद्विग्न हताश_भएको डराएको
बेजार: अप्रसन्न नाराज रुष्ट खिन्न अप्रतीत हताश निराश खिन्न
बेजोड: बेजोड अजोड़
बेदाग: बेदाग दागरहित अदाग अदागी
बेधडक: निसङ्कोची निर्धक्क
बेनाळ: दुई_नले
बेनिनी: बेनिनी
बेनुल्ल: परजीवी पराआश्रित
बेपरवा: उपेक्ष्य उपेक्षणीय
बेपरवाय: बेपरवाह बेपरवा बिन्दास अचिन्त
बेफिकीर: मस्त मत्त चिन्तामुक्त जवान पट्ठो आनन्दित हर्षित
बेबदड: रक्स्याहा जँड्याहा मात्तिएको उन्मत्त उद्धत मदमत्त मदान्ध धुत धुत्त
बेबदो: नशाबाज रक्स्याहा जँड्याहा रक्स्याहा जँड्याहा मात्तिएको उन्मत्त उद्धत मदमत्त मदान्ध धुत धुत्त
बेमुदत: अवधिहीन
बेयमान: कृतघ्न अकृतज्ञ
बेलगाम: बेलगाम
बेलरसी: बेलरसी बेलरसी
बेलिजी: बेलिजी बेलिजियन
बेल्जियन: बेल्जियमी बेल्जियन
बेल्जियमी: बेल्जियमी बेल्जियन बेल्जियमी
बेवारशी: टुहुरो अनाथ यतीम लावारिस
बेशुद्ध: बेहोस मूर्च्छित मूर्छित अचेत चेतनाहीन चेतनाशुन्य अचेतन चेतनारहित ज्ञानशून्य संज्ञाशून्य संज्ञाहीन निश्चेष्ट अचेष्ट अचैतन्य लठेब्रो चिसो ठन्डा
बेसावध: असावधान लापरवाह हेलचेक्राइँ अचेत असजग अनचित अमनोयोगी
बेसूर: बेसुरिलो स्वरहीन
बोंडें: मूर्ख अज्ञानी बुद्धु
बोटी_वयलें: जहाजी
बोडकीं: पतछिन
बोडकें: ठुटे मुडुले
बोडको: पातहीन पत्रहीन निपात
बोत्सवानी: बोत्स्वानी
बोधपूर्ण: ज्ञानपूर्ण ज्ञानमय बोधपूर्ण चिन्मय
बोधहीण: अबोध्य अनबोध्य अबोधगम्य अबोधनीय
बोध्य: बोध्य बोधगम्य अक्लिष्ट सजिलो सरल सुगम सुबोध
बोलकें: मुखरित मुखर वाक्पटु
बोलिवियाचें: बोलिवियाली बोलिवियाई बोलिविआई
बोलिवियायी: बोलिवियाली बोलिवियाई बोलिविआई
बोसनियन: बोसनियाई बोसनियाई
बौद्ध_धर्मावलंबी: बौद्ध_धर्मावलम्बी बौद्ध
ब्यांयशीं: बयासी
ब्यांयश्यांवें: बयासीऔं
ब्याण्णवावें: बयानब्बेऔं
ब्यात्तरावें: बहत्तरौं
ब्रह्मांडांतलें: ब्रह्माण्डीय अनन्तलोकीय अनन्त_विश्वीय
ब्राजीली: ब्राजेली ब्राज़ील-सम्बन्धी
ब्रिटीश: ब्रिटिस अङ्ग्रेजी
भंगुर: भङ्गुर नाशवान
भंयकर: प्रचण्ड डरलाग्दो भयानक विकट रौद्र_रूप भारी भीषण घनघोर अत्याधिक
भक्तिपूर्ण: भक्‍तिपूर्ण
भक्षक: भक्षक भक्षी खादक
भक्ष्य: खाद्य भोज्य आहार्य ग्राह्य भक्ष्य अशनीय
भटकें: घुमक्कड घुमन्ते पर्यटनप्रिय यायावर घुम्ने भ्रमणशील भ्रमणीय अतिचारी अध्वगामी गश्ती भ्रमणप्रेमी भ्रमण-प्रेमी
भडक: उत्तेजक उत्तेजनाप्रद भडकाउ भडकदार चहकिलो चम्किलो टलकदार
भड्डो: कनिका मोटो
भयभीत: भयपूर्ण आतङ्कपूर्ण
भयरो: बहिरो बैह्रो बधिर
भयांकृत: क्रूर निर्दय कठोर निर्दयी निष्ठुर नृशंस करुणाहीन दयारहित दयाहीन उग्र करुणाविहीन अदयालु प्रचण्ड डरलाग्दो भयानक विकट रौद्र_रूप
भयानक: आक्रामक आक्रामकतापूर्ण अभिधावक प्रचण्ड डरलाग्दो भयानक विकट रौद्र_रूप
भरड: कनिका मोटो
भरतकाम: बुनेको
भरदस्त: भारी गरुङ्गो वजनदार
भरपूर: अत्यधिक धेरै औधि प्रचुर अत्याधिक धेरै बहुत अधिक ज्यादा अतिशय अति अगाध अतीव बहुल भरपूर सम्पूर्ण सकेसम्म भरिएको भरपूर
भरिल्लें: परिपूर्ण भरिएको अभिपूर्ण पूर्ण चुकता_गरिएको तिरिएको भुगतानकृत भरिएको भरि लतपत
भलायकेक_बरें: स्वास्थ्यप्रद आरोग्यप्रद निरोगकर
भलायकेवंत: स्वस्थ्य निरोगी
भलें: राम्रो सही_मान्छे गतिलो
भव्य: महाकाय अतिकाय बृहत्काय विशालकाय भीमकाय विकराल धेरै_ठुलो अति_विशाल विशालतम भव्य ठुलो सानदार विशाल
भशेन: समान तुल्य सदृश बराबर जस्तो तदनुरूप दुरूस्तै
भश्टी_जायनाशिल्ली: अरजस्वला अनार्तवा
भश्टें: रजस्वला ऋतुमती रजवती पुष्पवती
भांगरा_पसून_तयार_केल्ली: स्वर्ण_निर्मित सुन
भांगराची: स्वर्ण_निर्मित सुन
भांगराळें: सुनौलो स्वर्णिम हिरण्मय हैम सुवर्णीय सुवर्ण स्वर्ण सुनौला स्वर्णिम
भाग्यशाली: सौभाग्यशाली भाग्यवान भाग्यशाली
भाजिल्लें: भुटेका डढेको दग्ध पोलेको पिल्सिएको दुःख_पाएको सताइएको सन्तप्त
भाट: प्रशंसक प्रशंसी
भाटाबेंसाचे: साम्पत्तिक सम्पत्तिसम्बन्धी धनमालको
भाड्याच्यो: सशुल्क
भाद्रपदांतलें: भदौरे
भाद्रपदाचें: भदौरे
भाद्रपदी: भदौरे
भाद्रपदीं: भदौरे
भायर_आशिल्लें: रजस्वला ऋतुमती रजवती पुष्पवती
भायर_जाल्लें: रजस्वला ऋतुमती रजवती पुष्पवती
भायर_धाडिल्लें: निर्यात_गरेको पठाएको
भायर_सरिल्लें: निस्केको
भायराविल्लें: राजनीतिज्ञ राजनीतिशास्त्रज्ञ राजनीतिशास्त्रविद् राजनीतिशास्त्री राजनीति_शास्त्री
भायरी: विरेचक जुलाफ_गराउने
भायरें: बहिष्कृत खारिज
भायरो: बेदखल अधिकारच्युत
भायलें: बाह्य बहिरङ्ग बाहिरी पराई बिरानो परचक्री बाहिरी बाहिरको
भायलो: विदेशी परदेशी परदेसी बिदेसी गैरमुल्की विलायती अन्यदेशीय अन्यराष्ट्रीय
भायल्याचें: पराइ परजनीय अरूको अन्य_को परकीय अर्काको
भारतीय: भारतीय हिन्दुस्थानी
भाळावपी: मोहनी मोहिनी
भावपूर्ण: भावपूर्ण मार्मिक भावनात्मक भावनापूर्ण भावात्मक मर्मस्पर्शी हृदयस्पर्शी
भाविल्लें: प्रिय प्यारो मन-पर्ने
भावी: आउँदो आगामी भावी आउनेवाला आइन्दा
भावीक: भक्‍तिपूर्ण
भाशांतरकार: अनुवादक भाषान्तरकार उल्थाकार अनुवादी
भाशांतरीत: अनूदित अनुवादित अनुदित भाषांतरित भाषान्तरित
भाशातंर_करपी: अनुवादक भाषान्तरकार उल्थाकार अनुवादी
भाशीक: भाषिक
भाशेचें: भाषिक
भिकाड्डो: महालोभी धेरै_लोभी
भिकुड्डो: काँतर कायर काथर डरछेरुवा भीरु साहसहीन नामर्द हुपहारा पानीमरुवा पानीआन्द्रे
भिजूड: काँतर कायर काथर डरछेरुवा भीरु साहसहीन नामर्द हुपहारा पानीमरुवा पानीआन्द्रे
भिडेस्त: लजालु लज्जाशील सङ्कोची सङ्कोच_मान्ने लाज_मान्ने
भितर_पावूंक_नाशिल्लो: अप्रविष्ट नपसेको
भितरले: आन्तरिक भित्री अन्तः अन्तरङ्ग अन्तर्वर्ती अंतर्वर्ती आंतरिक अन्तः अन्तरंग अन्तरित
भितरलें: भित्री अन्तरीय
भित्रो: काँतर कायर काथर डरछेरुवा भीरु साहसहीन नामर्द हुपहारा पानीमरुवा पानीआन्द्रे
भियेल्लो: आतङ्कित त्रस्त सन्त्रस्त
भिरांकूळ: भयपूर्ण आतङ्कपूर्ण आक्रामक आक्रामकतापूर्ण अभिधावक प्रचण्ड डरलाग्दो भयानक विकट रौद्र_रूप
भिवकुरो: काँतर कायर काथर डरछेरुवा भीरु साहसहीन नामर्द हुपहारा पानीमरुवा पानीआन्द्रे
भुंयगत: अन्तरावासी भित्रे भित्र_बस्ने भूमिगत
भुंयचर: थलचर स्थलबासी
भुंयेंतलें: भूमिगत
भुकेल्लो: भोको भोकाएको
भुकेस्त: भोको भोकाएको घिचुवा खन्चुवा घिचासे पेटु
भुगोलीक: भौगोलिक भू-गोलीय भूगोलीय
भुतकाळ: अतीत गत भूत व्यतीत बितेको गएको पछिल्लो पुरानो
भुतकाळीन: बितेको भूतकालीन अतीत_कालीन पूर्व_कालीन भूत_कालीन
भुताचें: भूत_विषयक
भुताटकेचें: भूत_विषयक
भुतानी: भुटानी भुटानी भुटानी
भुमीगत: भूमिगत
भुरगें: अवयस्क नाबालिग अल्पवयस्क अप्रौढ़ अप्राप्तयौवन
भुरगेंपणाचें: नानीहरूको_जस्तो
भुरग्यांचें: बचकना बचकाना
भुरळ_घालपी: मोहनी मोहिनी
भुलयणें: सम्मोहनपूर्ण आकर्षक मनोहर राम्रो सुन्दर
भुलोवपी: आकर्षक मनोहर राम्रो सुन्दर मोहनी मोहिनी
भुसभुशीत: बुरबुरे
भुसारी: रासने राशनी
भेड्डो: बहिरो बैह्रो बधिर
भेदक: प्वाल_पार्ने भेदक वेधक भेदकारी छेड्ने चिर्ने
भेदनीय: वेध्य भेद्य वेधनीय भेदनीय
भेदपी: प्वाल_पार्ने भेदक वेधक भेदकारी छेड्ने चिर्ने
भेदभाव_करपी: भेदक छेड्ने प्वाल_पार्ने चिर्ने निर्धारक
भेदभावपूर्ण: पक्षपातपूर्ण भेदभावपूर्ण
भेदिल्ले: भेदकारी
भेदीत: भेदकारी
भेद्य: वेध्य भेद्य वेधनीय भेदनीय
भेरो: बहिरो बैह्रो बधिर
भेळशिल्लें: सडे-पडेको
भेळशेल्लें: बासी पुरानो
भेसळीचें: अशुद्ध मिलावट मिसिएको अपमिश्रित
भोंवपी: घुमक्कड घुमन्ते पर्यटनप्रिय यायावर घुम्ने भ्रमणशील भ्रमणीय अतिचारी अध्वगामी गश्ती भ्रमणप्रेमी भ्रमण-प्रेमी
भोगसणी: माफ माफी क्षमा छुट मिनाहा
भोगिल्लो: भुक्तभोगी भोगी
भोगी: कामुक विलासी विषयी भोगी कामचारी इन्द्रियलोलुप
भोळें: सहज_विश्वासी सहज_विश्वासशील
भोळो: सौम्य कोमल_स्वभावी सौम सोझो सीधा सरल सीधा-सादा
भोवअक्षरी: अनेकार्थी नानार्थक नानार्थी अनेकार्थक
भोवअर्थी: अनेकार्थी अनेकार्थक अनेकार्थ
भोवगुणी: योग्य उपयुक्‍त समर्थ सक्षम खाइलाग्दो
भोवमानीत: सत्कृत सत्कार_गरिएको
भोवमानेस्त: आदरणीय सम्माननीय समादरणीय सम्मान्य मान्य माननीय
भोववर्शी: बहुवर्षीय बहुवर्षी
भोवसंख्य: कानुनी कानुनन विधानतः
भोवसंख्या: बहुसङ्ख्यक बहुसङ्ख्य
भ्रमिश्ट: बौलाहा बहुला पागल भ्रममा भ्रान्त
भ्रमीत: भ्रममा भ्रान्त
भ्रश्ट: भ्रष्ट पतित दूषित
भ्रश्टाचारी: भ्रष्टाचारी
मंगलकारी: कल्याणकारी मङ्गलकारी कल्याणप्रद मङ्गलकारक मङ्गलदायक मङ्गलप्रद हितकारी हितकर हितकारक कल्याणमय अनुकूल
मंचनीय: मञ्चनीय मंच्य प्रस्तुति_योग्य
मंचीत: मञ्चन अभिमञ्चित
मंजूर: स्वीकृत अनुमति_प्राप्त अनुमतिप्राप्त
मंत्र_मारिल्लें.: अभिमन्त्रित
मंत्रीत: अभिमन्त्रित
मंद: मन्द बिस्तारो मन्थर मन्द मंद अप्रबल निस्तेज कुण्ठित कुंठित सानो मसिनो मन्द ढिलो सुस्त चिसो
मंदबुद्दी: मन्दमति मन्दबुद्धि
मंदमती: मन्दमति मन्दबुद्धि
मंदावपी: अपटु
मकदुनियायी: मकदुनियाई मेसीडोनियाई मकदुनियाई मेसिडोनियाई
मखमली: मखमली
मग्न: जुटेको लागेको_कार्यरत व्यस्त लगनशील बेफुर्सद
मचमचीत: स्वादिष्ट मिठो स्वादिष्ठ राम्रो
मजती: सहयोगी मदतगार सहायक
मजबूत: दरो बलियो कठरो सारो
मजेशीर: रोचक रमाइलो मजाको रङ्गीन मजाकी दिल्लगीबाज मजाकिया
मडगास्करी: मडगास्करी
मडील्लें: बनाएको आकार_दिइएको
मढयिल्लें: जडेको
मणिपुरी: मणिपुरी मणिपुरी
मणिपूरी: मणिपुरी
मताधिकारी: मताधिकारी भोटाधिकारी
मतींतलें: काल्पनिक कल्पित अवास्तविक अयथार्थ अनात्मक अप्रकृत अयथातथ अयाथार्थिक
मदलो: माइलो
मदल्या_आकाराचें: मझौलो
मदेवर्ती: मध्यवर्ती मध्यस्थित मध्य मध्यम अन्तरिम
मधूर: मसृण चिल्लो
मध्यम_आकाराचें: मझौलो
मध्यवर्ती: मध्यवर्ती मध्यस्थित मध्य मध्यम
मध्यस्ते_भायरें: अननुसन्धेय हस्तक्षेपयोग्य
मन_भुलोवपी: हृदयग्राही सुन्दर रुचिकर
मननशील: मननशील चिन्तनशील विचारशील।
मनभुलयणी: रमणीय रम्य रमणीक
मनभुलयणें: हृदयग्राही सुन्दर रुचिकर अधिश्री
मनमानी: मनमौजी अलमस्त
मनरिजवणेचें: मनोरञ्जक मनोरञ्जनपूर्ण आनन्दप्रद आमोद-प्रमोदपूर्ण
मनशाक_सोबता: मानवीय मानवोचित
मनाक_भुरळ_घालपी: हृदयग्राही सुन्दर रुचिकर
मनायेचें: मना मना_गरिएको निषिद्ध वर्जित प्रतिबन्धित प्रतिबंधित निषेधित वर्ज्य व्याहत
मनीस_निर्मीत: मानवकृत मानव-रचित मानव-कृत मानवनिर्मित मानव-निर्मित मानव_निर्मित कृत्रिम
मनीसचलीत: मानव_चालित
मनीसपण: राम्रो सही_मान्छे गतिलो
मनीसपणाचें: मानवीय पौरुषेय मानुषिक मानवी
मनोगत: मनोगत मनोद्भव
मनोविज्ञानीक: मनोविज्ञान मनोविज्ञानी
मरणा_उपरांत: मरणोत्तर मरिसकेपछि मृत्यु_पछि
मरणा_धडेर_आशिल्लो: मरणासन्न मुमूर्ष
मरणाक_तेंकिल्लो: मरणासन्न मुमूर्ष
मरणादीक: मृत्युकारी अन्तकारी जीवनहर मरणकारक मृत्युकर
मरतकच: मरणोत्तर मरिसकेपछि मृत्यु_पछि
मराठी: मराठी महाराष्ट्री मराठी मराठी
मर्दानी: पुरुषको_जस्तो मर्दाना
मर्मज्ञ: मर्मज्ञ मार्मिक
मर्यादीत: मितव्ययी निर्धारित सीमित नियत सीमित सीमाबद्ध सीमायुक्त मर्यादित संयत
मल्ल्याळम: मलयाली मलयाली मलयालम मलयाली
मल्ल्याळी: मलयाली मलयाली मलयालम मलयाली
मळकें: मैलो फहोर अशुद्ध
मळबभेदी: गगनभेदी आकाशभेदी
मळबस्पर्शी: गगनचुम्बी गगनभेदी अकासभेदी
मळबाक_तेंकपी: गगनचुम्बी गगनभेदी अकासभेदी
मशागत: पोषित सम्वर्धित पुष्ट सम्बर्द्धित
मस्तें: चकचके चञ्‍चल चुलबुले
महत्वाकांक्षी: महत्त्वाकाङ्क्षी उच्चाकाङ्क्षी महत्त्वाकांक्षी उच्चाकांक्षी
महान: महान ठुला श्रेष्ठ
महाराष्ट्री: मराठी महाराष्ट्री
महाराष्ट्रीयन: मराठी महाराष्ट्री
महाविद्यालयीम: महाविद्यालयीय
मांडिल्लें: अभिदिष्ट प्रतिपाद्य अभिधेय निचोड निष्कर्ष
माखिल्लें: लतपत
मागणें_केल्लें: फर्माइसी
मागनासपी: अयाचक अयाची
मागलें: पछिल्लो पश्च पश्चस्थ
मागारिल्लें: अनुवृत्त
मागिल्लें: फर्माइसी अनुरुद्ध याचित अभियाचित अभ्यर्थित
मागीरचें: परवर्ती
माघाचें: माघे
माजी: भूतपूर्व पूर्व अयथापूर्व
माणकुलें: भुराभुरि केटाकेटी नानी शिशु बच्चा मसृण चिल्लो सानो सानु
मातयेकोराचो: माटो_रङ खाकी खैरो
मातयेभरवण: नष्ट चौपट तहस-नहस ध्वस्त समाप्त बरबाद बर्बाद ध्वंसित अपध्वस्त विनष्ट निकंदन ध्वस्त बिग्रेको भत्केको नष्‍टभ्रष्‍ट धराशायी
मातसो: अत्यल्प अलिकति छ्यास्स
मातिल्लें: झाडी_भएको
मातृहीण: मातृहीन माताहीन मातृविहीन माताविहीन अमातृक
मादक: मत्त मस्त
मादी: पोथी
माध्यमीक: माध्यमिक
माननीय: आदरणीया सम्माननीया माननीया मान्या समादरणीया
मानपी: अनुयायी अनुगामी
मानवल्लें: प्रिय प्यारो मन-पर्ने
मानवी: मानवीय पौरुषेय मानुषिक मानवी
मानवीकृत: मानवीकृत
मानसीक: मानसिक मनः दिमागी
मानादीक: आदरणीया सम्माननीया माननीया मान्या समादरणीया आदरणीय सम्माननीय समादरणीय सम्मान्य मान्य माननीय अभिनन्दनीय अधीष्ट
मानिल्लें: अनिषिद्ध अप्रतिबन्धित अप्रतिबंधित अवर्जित निषेधहीन अटोक अप्रतिसिद्ध अबाध
मानेस्त: अभिनन्दनीय
मान्य: अनिषिद्ध अप्रतिबन्धित अप्रतिबंधित अवर्जित निषेधहीन अटोक अप्रतिसिद्ध अबाध स्वीकृत मान्य अनुमोदित पारित पास सहमत एकमत
मान्य_केल्ली: स्वीकृत मन्जुर सहमति_प्राप्त अभ्युपगत
मापनीय: मापनीय नापनीय
मापिल्लें: जोख्‍नु तौलनु तौलिएको
मापूंक_नाशिल्लें: अमापित अपरिमापित अपरिमित नमापिएको नजोखिएको
माफ: माफ माफी क्षमा छुट मिनाहा
माफ_करी_सारकी: क्षम्य क्षमा_योग्य मर्षणीय
माफी-बगरचो: अक्षम्य क्षमाशून्य
मामे: माइज्यू_सासू
माया_नाशिल्लो: निठुरी निर्मोही निर्मम अमोही
मायेस्त: स्नेही दयालु
मारक: मार्ने मारक घातक मारक मार्ने विनाशकर्ता
मारपाक_योग्य: वध्य मार्न_लायक मार्नुपर्ने
मारपी: मारक घातक प्रहारी
मारवाडी: मारवाडी मारवाडी
मारी_सारकें: वध्य मार्न_लायक मार्नुपर्ने
मार्मीक: मर्मज्ञ मार्मिक
मालकीचे: अधीनस्थ
मालकीचें: अधिकृत
मालक्रियाद: चकचके चञ्‍चल चुलबुले
माळेचें: धारावाहिक धारावाही
मावळिल्लो: अस्तगत अस्त डुब्दो
मावशे: सानिमाको_छोरो_भाइ
मावस: सानिमाको_छोरो_भाइ
मासहीण: दुब्लो लुते क्षीण
मासाहारी: मांसाहारी मांसभक्षी
मासीक: मासिक महिनावारी
मिटना__अशें: अमिट नमेटिने
मित्रत्व: मिलनसार मिल्दो
मिथ्या: मिथ्या झुटो असत्य ढाँट झूट
मिरीमिरी: सिमसिमे
मिळमीळीत: दृढमतहीन
मिशनरी: मिसनरी
मिश्कील: हँस्यौली विनोदी ठट्यौली मजाकी दिल्लगीबाज मजाकिया
मिश्र: मिश्र मिश्रित सम्मिश्रित
मिस्तुराद: अशुद्ध मिलावट मिसिएको अपमिश्रित मिश्र मिश्रित सम्मिश्रित
मीर्गाचें: वर्षा_काल झरी वर्खा
मुंजी: संस्कृत
मुंबयकार: बम्बेली मुम्बेली बम्बइया मुम्बइया
मुंबयचें: बम्बेली बम्बइया मुम्बइया
मुक्कामाचें: गन्तव्य
मुक्त: स्वतन्त्र स्वाधीन आजाद अनन्याश्रित अनधीन अनिर्बन्ध उन्मुक्‍त खुला मुक्‍त स्वतन्त्र स्वच्छन्द स्वतन्त्र स्वाधीन
मुक्तकंठ: मुक्‍तकण्ठ निःसङ्कोच
मुखार_धाडिल्लें: अग्रप्रेषित अग्रसारित
मुखार_येवपी: आउँदो आगामी भावी आउनेवाला आइन्दा
मुखारचो: अघिल्लो अग्र अग्रवर्ती अग्रिम पूर्व सामुन्नेको सामुको
मुखावयलो: अघिल्लो अग्र अग्रवर्ती अग्रिम पूर्व सामुन्नेको सामुको अग्रगामी पुरोगामी पूर्वगामी
मुखेल: मुख्य प्रधान मूल मूल खास मुख्य प्रमुख प्रधान
मुखेली: प्रधान अग्रगण्य प्रमुख मुख्य वरिष्ठ श्रेष्ठ अगुआ मुखिया अग्रणी
मुख्यः2: मुख्य प्रधान मूल
मुद्रांकीत: मुद्राङ्कित मुद्रित
मुद्रीत: मुद्राङ्कित मुद्रित
मुनेल्लें: भुत्ते बोधो नलाग्ने
मुमुर्खें: नबोल्ने
मुल्यवान: बहुमूल्य मूल्यवान अमूल्य अनमोल दामी
मुळाचें: जरादार
मुळावें: प्रारम्भिक आरम्भिक आरंभिक प्राथमिक प्रारंभिक पूर्व
मूठ_आशिल्लें: मूठदार मूँठदार हत्थेदार दस्तेदार
मूर्ख: मूर्ख अज्ञानी बुद्धु
मूर्त: साकार आकारयुक्त आकारवान मूर्तिमान मूर्तिमान् साक्षात् साक्षात
मूळ: मौलिक स्वकृत स्वरचित मूल अननुकृत
मृत: मरेको मृत
मृदू: नरम कमलो कोमल
मेंगें: मन्द ढिलो सुस्त
मेकळी: स्वच्छन्द स्वतन्त्र स्वाधीन
मेकळें: अगुप्त अनिभृत स्वतन्त्र स्वाधीन आजाद अनन्याश्रित अनधीन अनिर्बन्ध रिक्त खाली रित्तो शून्य खाली अव्यस्त
मेकळो: उन्मुक्‍त खुला मुक्‍त स्वतन्त्र
मेकळ्या_ताळ्याचें: मुक्‍तकण्ठ निःसङ्कोच
मेक्सिकन: मेक्सिकेली
मेघहीण: स्वच्छ मेघहीन निरभ्र अनभ्र मेघरहित अनाकाश अमेघ
मेजकेंच: मर्यादित संयत
मेजपा_योग्य: गणनीय गण्य
मेजपा_सारकें: अङ्कनीय
मेजिनाशिल्लें: अतुल्य अतुलनीय
मेजिल्लें: गणित अनुगणित
मेजी_सारक्यो: गणनीय गण्य
मेजूंक_नाशिल्लें: अनगन्ती अगणित
मेणा_सारकें: मैनका मैनले_बनेका
मेणाचें: मैन मइन
मेणाभशेनचें: मैनका मैनले_बनेका
मेले_उपरांत: मरणोत्तर मरिसकेपछि मृत्यु_पछि
मेल्लें: मृत ठुटे मुडुले सुकेको सुक्खा मृत हत मुर्दा
मेल्लो: मरेको मृत
मेळनाशिल्लें: अनुपलब्ध अप्राप्य अलभ्य अनधिगम्य अनमिलता अप्राप्त अमिल दुर्ग्राह्य दुर्ग्रह दुर्ग्राही
मेळयिल्लें: अर्जित कमाएको
मेळविरयत: बेमेल अनमेल अजोड अमेल
मेळिल्लें: बरामद
मेळोवन_दिल्लें: उपलब्ध प्राप्त लब्ध अधिगत
मेळोवप: विलीन अदृश्य लुप्‍त
मैदानी: पठारी
मॉरिटानियायी: माउरिटोनी
मॉरेशीयी: मारिसेलीली मारिसससम्बन्धी
मोखप: छेडेको भेदगरेको
मोगभरीत: अनगन्ती थुप्रो
मोगाचें: प्यारो प्रिय अनुरञ्जक
मोगाळ: स्नेही दयालु अनुरञ्जित अनुलिप्त अभिरञ्जित
मोगासक्त: प्रेमासक्त अनुरक्त अनुरागी आसक्त लसपसिएको
मोटें: दाजु अग्रज जेठा ज्येष्ठ ठुला
मोटो: मोटो बलियो स्थुलकाय
मोडकी: थोत्रो पूरानो
मोडकें: फुटेको थोत्रिएको जीर्ण पुरानो थोत्रो भाँचिएको
मोडको: पुडके होचो
मोडण: बाङ्गोटिङ्गो बाङ्गो वक्र
मोडणाचें: घुमाउरो बाङ्गो-टिङ्गो घुमेको मोडदार
मोडपा_सारकें: उल्लङ्घनीय अतिक्रमणीय
मोडवो: पुडके होचो
मोडिल्लें: भत्केको ढस्केको कोल्टिएको जीर्ण पुरानो थोत्रो भाँचिएको उल्लङ्घित
मोडूं_नजो_अशें: अनतिक्रमणीय
मोडूं_येत_अशें: भञ्जनशील भाँच्न_सकिने भञ्जनीय बिगार्ने भत्काउने तोडफोड_नाश विध्वंस
मोनें: अपुष्पित अविकसित मुकुलित अस्मित वाचारुद्ध अवाक
मोनो: लाटो ग्वागे अबोला
मोफत: निःशुल्क मुफ्त निशुल्क
मोरेक्की: मोरक्कली
मोलादीक: बहुमूल्य मूल्यवान अमूल्य अनमोल दामी अमूल्य अनमोल अमोल अमोलक मूल्यातीत
मोल्डोवायी: मोल्डोवाई मोलडोवाई मोल्डोवाई मोलडोवाई
मोव: सौम्य कोमल_स्वभावी सौम लचिलो लचकदार नम्य नमनीय विनम्य सुनम्य नरम कमलो कोमल कमजोर दुर्बल निम्छरो
मोसमाभायरो: बेमौसमी
मोसमी: मौसमी
मोहक: सम्मोहनपूर्ण मनोरम मनोहर सुन्दर
मोहीत: आसक्त मुग्ध मोहित मोहित मुग्ध
मौखीक: उच्चारित उच्चरित
म्यानमारी: बर्मी म्यानमारी बर्मेली बर्मी म्यानमारी
म्हगेलो.: आफ्नो निजी
म्हजो: आफ्नो निजी
म्हत्व_नाशिल्लें: महत्त्वहीन
म्हत्वकांक्षा_नाशिल्लें: अमहत्वाकाङ्क्षी
म्हत्वपूर्ण: महत्त्वपूर्ण महत्त्वपूर्ण बहूमूल्य अहम ठुलो अर्थपूर्ण
म्हत्वहीण: महत्त्वहीन
म्हत्वाचें: महत्त्वपूर्ण महत्त्वपूर्ण बहूमूल्य अहम ठुलो अर्थपूर्ण
म्हयनाळें: मासिक महिनावारी मासिक महिनाको
म्हयन्याचें: रजस्वला ऋतुमती रजवती पुष्पवती एक_महिने
म्हातारी: बुढ़ी बूढ़ी वृद्धा वयोबृद्धा
म्हातारें: वृद्ध बूढ़ो बुढ़ो वरिष्ठ बुजुर्ग वयोवृद्ध उम्रदराज
म्हान: महान ठुला श्रेष्ठ
म्हानगरीय: महान्गरीय
म्हापद्म: पद्म
म्हापापी: महापापी पापाधम महानीच पापिष्ठ पातकी पापी
म्हाबळादीक: महाबली शक्‍तिशाली
म्हामुर्ख: महामुर्ख बुद्धिहीन
म्हारग: बहुमूल्य मूल्यवान अमूल्य अनमोल दामी महँगो मङ्गो दामी मूल्यवान
म्हालम्हातारी: बुढ़ी बूढ़ी वृद्धा वयोबृद्धा
म्हालम्हातारें: वृद्ध बूढ़ो बुढ़ो वरिष्ठ बुजुर्ग वयोवृद्ध उम्रदराज
म्हालवाहक: भरिया भारवाहक भारी_बोक्ने
म्हावराक: मांसाहारी मांसभक्षी
म्हाविद्यालयीन: महाविद्यालयीय
म्हावीर: महावीर_महाबीर
म्हेळें: अशोधित अपरिशोधित अशुद्ध असंशोधित मैलो फहोर अशुद्ध फोहोरी मैलाधैला
म्होंवाळ: गुलियो मिठो रमाइलो मधुर मन_पर्ने प्रिय राम्रो_लाग्ने
म्होंवाळ_उलोवपी: प्रियभाषी प्रियवादी प्रियंवद
म्होवल्याचें: गडीदार गिरीयुक्त
यंत्रचलीत: यन्त्र_चालित यान्त्रिक स्वचालित यंत्र-संचालित
यत्नशील: प्रयत्नशील प्रयासशील प्रयासी प्रयत्नी प्रयत्नवान उद्यमी उद्यमशील उद्योगी
यशस्वी: विजेता विजयी
यहुदी: यहुदी हिब्रु इब्रानी इबरानी
याचक: प्रार्थी निवेदक अभ्यर्थी प्रार्थना_कर्ता
याद__नाशिल्लें: विस्मृत बिर्सिएको
याद_उरपा_सारकी: स्मरणीय अविस्मरणीय
यानहीण: यानहीन वाहनहीन अयान
यानाचेर_चडिल्लें: यान_आरूढ़ यानारूढ़
यानारूड: यान_आरूढ़ यानारूढ़
युक्रेनी: युक्रेनी युक्रेनी
युगांडी: युगान्डी
युगोस्लावियन: युगोस्लावियाई
युनानी: युनानी ग्रिक युनानी ग्रीक
युरेशियायी: युरेसियाई
येतें_वतें: दुइतर्फा दुइतिर दोतर्फा दोतर्फा
येवंक_नाशिल्लें: अप्राप्त
येवंक_नाशिल्लो: अनागत अप्राप्त नआएको
येवजल्लें: कल्पित अनुकल्पित
येवजिल्लें: ऐच्छिक
येवपी: आगामी भविष्य_कालीन सम्भावित भविष्णु भाविता भावी भव्य अगत्तर भवितव्य अनागत
येवरोपी: युरोपीय युरोपेली युरोपियन
येशस्वी: सफल सिद्ध
योग्य: योग्य उपयुक्‍त समर्थ सक्षम खाइलाग्दो अनुकूल अनुसार अनुरूप मुताबिक निश्चित निर्धारित नियत नियमित ठिक निर्दिष्ट सुपात्र सत्पात्र सत्पात्र राम्रो_पात्र उचित उपयुक्‍त ठिक वैध कानूनी ऐन_अनुसार समुचित उचित समुचित उपयुक्त ठिक सही शुद्ध_सही ठीक उचित सठीक अनुकूल अनुकूलित मानवीय मानवोचित यथोचित यथायोग्य समुचित मुखतोड मुखभरिको
योग्य_वेळार: सामयिक समयोचित समयानुकूल अवसरानुकूल अवसरोचित कालोचित
योजक: योजक संयोजक संयोगी
योद्धो: रणवीर युद्धवीर
रंगकुड्डेपण: वर्णान्ध वर्णान्धताले_पीडित
रंगहीण: रङ्गहीन
रंगांचो: रङ्गीबिरङ्गी रङ्गीचङ्गी रङ्गारङ्ग
रंगीत: रङ्गारङ्ग रङ्गीबिरङ्गी रङ्गबिरङ्ग रङ्गीचङ्गी रङ्गीन रङ्गीचङ्गी
रकाद_दिवपी: सन्देशवाहक सन्देश_वाहक अभिज्ञापक
रक्तपिपासू: डरलाग्दा
रक्तबंबाळ: रगताम्मे रक्ताम्मे रक्तरञ्जित
रक्तरंजीत: रगताम्मे रक्ताम्मे रक्तरञ्जित
रक्तहीण: रक्तहीन रुधिरहीन
रक्ताचें: खुनी खुनी
रक्षक: रक्षक रक्षा_कर्ता अभिरक्षक रक्षी वार्डन परिरक्षक
रगत_नाशिल्लें: रक्तहीन रुधिरहीन
रगत_पियेवपी: डरलाग्दा
रचणार: सृजनकर्ता सर्जक सृजक रचयिता स्रष्टा
रचनात्मक: रचनात्मक सृजनात्मक
रचिल्लें: काल्पनिक कल्पित अवास्तविक अयथार्थ अनात्मक अप्रकृत अयथातथ अयाथार्थिक निर्मित रचित विरचित सृष्ट कृत सर्जित सृजित संरचित पर्णीत प्रकृत प्रणीत
रचूंक_नाशिल्लें: अरचित अकृत नरचेको अनिर्मित
रडकुरें: रुन्चे रुन्चे
रडयें: रुन्चे
रडवें: रुन्चे
रणवीर: रणवीर युद्धवीर
रणशूर: रणवीर युद्धवीर
रमणीय: रमणीय रम्य रमणीक
रम्य: रमणीय रम्य रमणीक राम्रो सुन्दर
रवांडायी: रवान्डी रवान्डाई
रवांडी: रवान्डी रवान्डाई
रवो: कनिका मोटो
रशियन: रूसी
रशीयन: रूसी रशियन
रसहीण: रसहीन बेरस सुखा शुष्क नीरस
रसात्मक: काव्यात्मक कवित्वपूर्ण रसात्मक
रसाळ: रसिलो रसपूर्ण सरस रसवन्त रसवान
रसीक: रसिक
रस्तो_मेजपी: हल्लिने
रहस्य: रहस्यपूर्ण रहस्यमय रहस्यात्मक गूढ
रहस्यहीण: रहस्यहीन अचम्मको अगूढ
रांदनी_वयलें: अधिश्रित
राखण_नाशिल्लें: बाँझो
राखीव: आरक्षित व्याससिद्ध
राखीवतेबगरचें: अनारक्षित
राखूंक_नाशिल्लें: बाँझो
रागिश्ट: रिसाएको झोकिएको क्रुद्ध
राजकारणाचे: राजनैतिक राजनीतिक राजनीति_विषयक राजनयिक
राजकारणी: राजनैतिक राजनीतिक राजनीति_विषयक राजनयिक
राजकी: राजकीय राज्य_विषयको
राजद्रोही: राजद्रोही
राजनितीक: राजनैतिक राजनीतिक राजनीति_विषयक राजनयिक
राजपत्रीत: राजपत्रित
राजस्थानी: राजस्थानी
राजाहीण: अराजक राजाहीन अराज
राज्य: शासित प्रशासित
राज्य_पांवड्या_वयलें: प्रान्तीय क्षेत्रीय_प्रादेशिक
राज्यस्तरीय: प्रान्तीय क्षेत्रीय_प्रादेशिक
राज्या_विशींचें: राजकीय राज्य_विषयको
रातकुड्डें: निशान्ध रतन्धो
रातचर: निशाचर रात्रिचर
रातांधळें: निशान्ध रतन्धो
रानटी: वन्य जङ्गली आरण्य आरण्यक जङ्गली वन्य बनैया जङ्गली वन_भएको
रानवटी: वन्य जङ्गली आरण्य आरण्यक जङ्गली वन्य बनैया जङ्गली वन_भएको
राबित्याचें: आवासित अध्युष्ट औपनिवेशिक उपनिवेशिक
रामबाण: गुणकारी रामवाण रामबाण राम-बाण
रावपी: आवासित अध्युष्ट
राष्ट्रभक्त: किनेको
राष्ट्रीय: अन्तर्देशीय देशान्तर्गत राष्ट्रीय
रासायनीक: रासायनिक रसायनिक
रिकामी: रिक्त खाली रित्तो शून्य
रिकामें: खाली अव्यस्त सादा सेतो
रिकॉर्डर: रेकर्डर
रिणमुक्त: ऋणमुक्‍त
रिणा_बगरचो: ऋणहीन अनृणी अनृण
रिणाविरयत: ऋणहीन अनृणी अनृण
रितसर: सुव्यवस्थित सुविन्यस्त सुप्रबन्धित
रीणकार: ऋणी कर्जदार ऋणकर्ता
रीतसर: व्यवस्थित प्रबन्धित विन्यस्त ठिक
रुंद: फराक चौडा विस्तीर्ण
रुखाळ: लखरुखा
रुखावळीचें: लखरुखा
रुचीक: स्वादयुक्त चाखिलो मिठो स्वादपूर्ण
रुचीचें: स्वादयुक्त चाखिलो मिठो स्वादपूर्ण रुचिकर मनपर्दो
रुजवणेक_घातिल्लें: रोपित
रुजवणेचें: रोपनीय
रुढिवादी: रूढिवादी
रुपवती: रूपवती राम्री रूपसी रूपमयी
रुपांतरीत: रूपान्तरित
रुपेरी: चाँदीको रजत
रुप्याचें: चाँदीको रजत
रुमानियन: रुमानियाई रोमानियाई रोमानियम रुमानियन
रुमानी: रुमानियाई रोमानियाई रोमानियम रुमानियन रुमानियाई रोमानियाई
रुसी: रूसी रशियन रूसी
रूक्ष: सुक्खा सुकेको
रूच_नाशिल्लें: स्वादहीन बेस्वाद नीरस फीका अस्वादिष्ट अनास्वाद खल्लो नमिठो
रूचीक: स्वादिष्ट मिठो स्वादिष्ठ राम्रो
रूप_नाशिल्लें: कुरूप नराम्रो विरूप
रॅकॉर्डर: रेकर्डर
रेंवटाळ: बालुवा_भएको मरुभूमि
रेबट: दलदले थलथले धापिलो
रेब्याचें: हिले
रेशमी: रेसमी रेसमी सिल्की
रोगाणू_जीव: रोगकारक रोगजनक
रोगी: रोगी बिमारी बिरामी पन्थे रुग्न
रोमांचक: रोमाञ्चकारी रोमाञ्चक
रोमांचकारी: रोमाञ्चकारी रोमाञ्चक
रोमांचीत: रोमान्चित रोमान्चित खुसी पुलकित
रोवपा_सारकें: रोपणीय रोप्ने_योग्य रोप्य
रोवपी: रोपाहार
रोवूंक_नाशिल्लें: नरोपिएको
रोसाळ: रसभएको रसिलो झोलभएको
लंगडें: लङ्गडो लंगडो खोरन्डो लङ्गडो लँगडो खँजाहा खोरन्डो
लंगडो: तिघ्रा ऊरुज लुलो-लङ्गडो
लकलकीत: प्रकाशपूर्ण दीप्तिपूर्ण प्रकाशमान आलोकित ज्योतित उज्ज्वल उज्जवल सफा स्वच्छ
लक्षवेदी: लक्ष्यवेधी लक्ष्यानुगामी
लक्षा_वसून_पयस: लक्ष्यच्युत लक्ष्य_विमुख
लक्समबर्गाचें: लक्समबर्गी
लक्समबर्गी: लक्समबर्गी लक्समबर्गी
लग्न_जाल्लें: विवाहित बिहे_भएको परिणीत
लग्नाचें: वैवाहिक बिहे_सम्बन्धी
लज_नाशिल्लो: निर्लज्ज लज्जाहीन छाडा
लजेची: लाजमर्दो लज्जाजनक लज्जाजन्य लज्जाप्रद
लजेस्त: लजालु लज्जाशील सङ्कोची सङ्कोच_मान्ने लाज_मान्ने
लज्जीत: लज्जित
लटकें: असत्य झूटो निराधार अप्रामाणिक तथ्यहीन आधारहीन सारहीन निर्मूल यथार्थहीन अनाधार आधाररहित देखावटी बनावटी बोक्रे बनौटी घोरेलको मिथ्या झुटो असत्य ढाँट झूट
लटको: लफङ्गो फटाहा लुच्चा बदमास दुष्ट
लडकें: खोटो नकली
लडायेचीं: लडाकु जङ्गी
लडावू: लडाकु जङ्गी
लढाऊ: रणवीर युद्धवीर
लवंडपी: हल्लिने
लवचीक: लचिलो लचकदार नम्य नमनीय विनम्य सुनम्य
लश्करी: सैन्य सेना
लस्करी: सैन्य सेना
लांडें: पखेटाहीन पङ्खहीन पक्षरहित अपक्ष
लांब: लामो टाढा लामो ठुलो
लांब-रुंद: लामो टाढा
लांबोडी: अग्लो अल्को लामो
लाओ: लाओ लाओ लाओसियन
लाओशियन: लाओ लाओसियन
लाखांनीं: लाखौ
लाखावें: लाखौं
लागचें: निकटस्थ छेउको निकटको समिपको निकटवर्ती समीपी सन्निकट समीपवर्ती समीपस्थ
लागशिल्लें: पल्लो छेउको
लागींचे: आसन्न सन्निकट छेउको नजिकको
लागींचें: निकटस्थ छेउको निकटको समिपको निकटवर्ती समीपी सन्निकट समीपवर्ती समीपस्थ
लागू: लागु
लाचार: विकल्पहीन उपायहीन निरुपाय विवश अनन्यगति अनन्यगतिक विवश बाध्य लाचार
लाजरें: लजालु लज्जाशील
लाडाचें: प्यारो प्रिय
लातवियायी: लातवियाई लातवियन लातवियाई लातवियन
लाथाळ: लात्ते
लाबदिणें: लाभदायक लाभप्रद लाभकर लाभकारी लाभजनक गुणकारी उपयोगी हितकारी अर्थकर फलदायक फलप्रद फलदायी
लाभहीण: लाभहीन अलाभप्रद लाभरहित
लाभार्थी: लाभान्वित लाभ_प्राप्तकर्ता
लायक: योग्य उपयुक्‍त लायक
लायिल्लें: लागु
लाल: रातो लाल रोहित
लाशिल्लें: डढेको दग्ध पोलेको पिल्सिएको दुःख_पाएको सताइएको सन्तप्त
लाशें_आशिल्लें: दागी
लाशें_पडिल्लो: दाग_भएको दाग_लागेको धब्बा_लागेको
लाशेल्लें: दागी
लाशेल्लो: दाग_भएको दाग_लागेको धब्बा_लागेको
लिंगीक: लैङ्गिक लिङ्गीय
लिकलिकीत: चम्किलो चहकिलो चहकदार
लिकलीकपी: चम्किलो आलोकित उज्ज्वलित कान्तिमान ज्योतित दीप्त जगमग प्रकाशवान प्रदीप्त द्युतिमान्
लिखीत: लिखित लिपिबद्ध अङ्कित लेखिएको लेखाकृत अभिलिखित लेखाङ्कित
लिथुनियायी: लिथुनियाई लिथुनियाई
लिपयिल्लें: अधिगुप्त
लिबियायी: लिबियायी लिबियाई लिबियन
लिबेरियायी: लिबेरियाली लिबेरियाई लिबेरिआई लिबेरिया-सम्बन्धी
लुकसाणग्रस्त: अपहेलित
लुकसाणदिणें: हानिकारक क्षतिकारी हानिकर हानिप्रद अनर्थकारी क्षतिकर
लुकसाणाचें: क्षतिग्रस्त
लुकसाणीचें: हानिकारक क्षतिकारी हानिकर हानिप्रद अनर्थकारी क्षतिकर
लुकसाणीचो: लाभहीन अलाभप्रद लाभरहित
लुडबें: तोते तोते
लुप्त: विलुप्त लुप्त गायब अदृश्य अदिष्ट अन्तर्हित अंतर्हित
लुळोपांगळो: विकलाङ्ग अपाहिज अंगहीन अपंग अपाहज निपंग
लेंवाळ: रुवायुक्त
लेथोसी: लेसोथी लेसोथो-सम्बन्धी
लेव: फुस्रो
लेव_हळडुवें: वासन्ती बसन्ती
लैंगीक: लैङ्गिक लिङ्गीय
लोककल्याणकारी: लोकोपकारी लोक_हितैषी
लोकतंत्रीक: प्रजातान्त्रिक गणतान्त्रिक लोकतानत्रिक
लोकशायी: प्रजातान्त्रिक गणतान्त्रिक लोकतानत्रिक
लोकशायेचें: प्रजातन्त्रीय प्रजातान्त्रिक जनतान्त्रिक
लोकाचें: पराइ परजनीय अरूको अन्य_को परकीय अर्काको
लोकोपयोगी: जनोपयोगी लोकोपयोगी सर्वभोग्य
लोकोपेगी: जनोपयोगी लोकोपयोगी सर्वभोग्य
लोखंडाचें: फलामे
लोखंडी: फलामे
लोटांगण_घालपी: अनुशयी
लोणयाचें: मखानको
लोभी: स्वार्थी मतलबी स्वार्थपर तनपोषक अपस्वार्थी अपरता स्वार्थपरायण स्वादे चखुवा
लोळकें: मैलो फहोर अशुद्ध
लोळिल्लें: मैलो फहोर अशुद्ध
ल्हव: हलुको हलुङ्गो हल्का
ल्हव_ल्हव: मन्द बिस्तारो मन्थर
ल्हवपीक: सानो मसिनो
ल्हान: साना_भाइ भाइ नावालक निरीह कान्छो कनिष्ठ सानो सानु
ल्हान-सान: छिटपुट छुटपुट छिट-पुट छुट-पुट हल्का-फुल्का
ल्हानशें: सानो
ल्हेंवेल्लें: खाएको भक्षित
वंदनीय: वन्दनीय पुजनीय
वंशावळीचें: आनुवंशिक वंशागत वंशानुक्रमिक पैतृक आनुवांशिक अनुवांशिक पुर्ख्यौली
वक्र: कुगठित कुडौल बान्की_नपरेको
वचनबद्ध: वचनबद्ध
वजन_काडिल्लें: जोख्‍नु तौलनु
वजन_केल्लें: जोख्‍नु तौलनु
वजनदार: भारी गरुङ्गो वजनदार
वट्ट: सम्पूर्ण जम्मै जम्मा सारा सबै समस्त सम्पूर्ण तमाम
वडावळीचे: न्यग्रोधिक
वणखल्लें: अधिशायित
वत्सल: वत्सल स्नेही
वनस्पतीहीण: वनस्पतिहीन शस्यहीन
वयर_आयिल्लो: उदित झुल्किएको
वयरसकयल: असमतल असम अग्लो_होचो
वयले: उचो उच्च
वयलें: अग्लो उच्च बाहिरी बाहिरको
वयल्या_कुळांतलो: अभिजात अभिजात्य उच्च_वंशीय उच्च_कुलीन
वयल्यावयलें: देखावटी बनावटी बोक्रे बनौटी घोरेलको
वयस्क: वयस्क प्रौढ बालिग
वरिश्ठ: वृद्ध बूढ़ो बुढ़ो वरिष्ठ बुजुर्ग वयोवृद्ध उम्रदराज कनिष्ठा
वरी: जस्तो
वर्ग: समकक्ष समतुल्य एक_समान तुल्य सदृश्य समान
वर्जिल्लें: त्यागेको परित्यक्‍त त्यक्‍त
वर्जीत: मना मना_गरिएको निषिद्ध वर्जित प्रतिबन्धित प्रतिबंधित निषेधित वर्ज्य व्याहत
वर्ज्य: मना मना_गरिएको निषिद्ध वर्जित प्रतिबन्धित प्रतिबंधित निषेधित वर्ज्य व्याहत
वर्णना_बगरचें: अवर्णनीय अवर्ण्य
वर्णनीय: वर्णनीय कथनीय वर्ण्य अभिधेय
वर्तमान: वर्तमान अभूत हाल
वर्तमान_काळ: वर्तमानकालीन सामयिक आधुनिक वर्तमान हाल
वर्तमानपत्राचें: अखबारी समाचरपत्रीय
वर्तमानपत्री: अखबारी समाचरपत्रीय
वर्सुकी: एक_वर्षे
वर्सुकें: वार्षिक प्रतिवर्ष वर्षेनी
वलें: भिजेको
वळखीचें: थाहा ज्ञात विदित अवगत विज्ञात अवबुद्ध परिचित परिज्ञात प्रज्ञात विज्ञात संज्ञात अभिज्ञात पूर्व_परिचित
वळखीचो: परिचित चिनेजानेको जानपहिचान_भएको परिचय_भएको
वळखुपा_सारकें: अभिज्ञ अभिज्ञेय
वळणाचें: घुमाउरो बाङ्गो-टिङ्गो घुमेको मोडदार
वळेरेंत: क्रमिक अनुक्रमिक क्रमबद्ध विन्यस्त क्रमानुसार क्रमानुकूल शृङ्खलाबद्ध अनुपूर्व
वशिल्लें: आवासित अध्युष्ट
वशीकरण: वशीकरण बसीकर
वसणुकेचें: औपनिवेशिक उपनिवेशिक
वसतीघरवासी: छात्रावासी होस्टलवासी
वसाड: उजाडिएको सुनसान निर्जन बाँझो अनुर्वर
वसुलेचें: अनुप्राप्त
वस्तुनिश्ठ: वस्तुनिष्ठ
वांकडें: टेढो तेर्छो बाङ्गो तितो निहुरिएको नत
वांकडो: बाङ्गोटिङ्गो बाङ्गो वक्र
वांकडो-तिकडो: बाङ्गोटिङ्गो बाङ्गो वक्र
वांकड्या_तोंडाचें: बाङ्गोमुखे
वांकिल्लें: निहुरिएको नत
वांगडें: कुगठित कुडौल बान्की_नपरेको
वाकडें: अवनमित नमित बाङ्गो टेढोमेढो बाङ्गोटिङ्गो
वाकिल्लें: अभिनम्र
वाक्चतूर: वाक्पटु
वाचपा_योग्य: पठनीय पाठ्य पठ्य
वाचपा_सारकें: पठनीय पाठ्य पठ्य
वाचपायोग्य: पठनीय सुपाठ्य पाठ्य पठ्य अध्ययनीय अध्येतव्य अध्येय
वाचयिल्लें: धृत निभृत
वाचाळ: बिरेनुन कालो_नुन पादे_नुन
वाचिल्लें: अधीत
वाचिल्लो: पढेको
वाचीक: पठनीय सुपाठ्य पाठ्य पठ्य अध्ययनीय अध्येतव्य अध्येय
वाच्यनीय: पठनीय पाठ्य पठ्य
वाट_पळोवपी: प्रतीक्षित पर्खिएको प्रतीक्षक पर्खने
वाटकुळें: गोलो वृत्ताकार गोलाकार बाटुलो गोलो डोलो डल्लो गोल
वाटायिल्लें: धृत निभृत
वाडयिल्ली: परिवर्द्धित
वाडयिल्लें: विस्तारित विस्तृत अभिवृद्ध
वाडिल्लें: वृद्धियुक्त अधिरूढ
वाडोवपी: वर्धक वर्धयिता वर्द्धक वृद्धिकर वृद्धिकारी पोषक संवर्द्धक संवर्धक
वातानुकुलक: वातानुकुलक
वातानुकुलीत: वातानुकूलित
वादग्रस्त: विवादास्पद विवादित विवादास्पद विवादग्रस्त
वादा_बगर: निर्विवाद
वादाचें: विवादास्पद विवादित विवादास्पद विवादग्रस्त
वादास्पद: विवादास्पद
वान्शे_विरयत: निष्काम निरपेक्ष
वापराचें: उपयोगी लाभदायक फाइदाकारी
वापरिल्लें: प्रयुक्त व्यवहृत उपभुक्त
वाफेचें: आसवित आसुत
वायट: दुराशय कुविचारी आरिसे मैलो फहोर अशुद्ध घटिया निकृष्ट नीच अधम क्षुद्र निकृष्टतम अधमाधम तुच्छातितुच्छ विपरीत प्रतिकूल खिलाफ नराम्रो खराब निकृष्ट अनुचित धोकाबाज बेइमानी_गर्ने धूर्त कपटी छली खराब रद्दी नजाती
वायट_उलोवपी: अप्रियभाषी अप्रियवादी अप्रियंवद
वायट_करपी: दुष्कर्मी अकृत्यकारी अपकर्मी खल अकर्मी
वायट_गूण: दुर्गुणी बैगुनी अगुणी अपगुणी
वायट_मार्गान_मेळयिल्लें: पच हजम हडप
वायट_वेव्हारी: दुर्व्यवहारी
वायट_सभावाचो: कुस्वभावी कुबुद्धि दुश्शील
वायटकार: रोगी बिमारी बिरामी पन्थे रुग्न
वारें_घोळपी: हावा_आउने हावा_चल्ने
वावडी: होहल्ला अफवाही हल्ला
वासनाहीण: कामहीन वासनाहीन निष्काम निर्मम
वास्तवीक: वास्तविक यथार्थ साँचो सही असली वास्तव अकाल्पनिक अकल्पित प्रकृत प्राकृतिक
वास्तुशिल्पीय: वास्तुशिल्पीय
वाहक: वाहिका वाहिनी वाही वाहक बोक्ने चालक
विंगडविंगड: असङ्ख्य अनेक धेरै कैयौँ अनगन्ती बेगन्ती धेरै_थरी विभिन्न नाना
विकत_हाडिल्लें: किनेको
विकतें_घेतिल्लें: किनेको
विकल्पी: वैकल्पिक विकल्पयुक्त विकल्पी ऐच्छिक
विकसीत: प्रगत अग्रगत विकसित उन्नत प्रोन्नत सुविकसित अभ्युत्थित अभ्युदित
विकासकर्तो: प्रगति_गर्ने प्रगति_कर्ता अग्रगामी अग्रदर्शी
विकासशील: प्रगतिशील उन्नतशील विकासशील उन्नतिशील उत्थानशील अभ्युत्थायी
विकिल्लें: विक्रीत बेचिएको विक्रीत
विक्रमी: पराक्रमी वीर विक्रमी
विक्राळ: प्रचण्ड डरलाग्दो भयानक विकट रौद्र_रूप
विखंडी: खण्डक
विखा_बगर: विषहीन
विखारी: विषालु विषधर
विखाळ: विषालु विषधर
विख्यात: विश्वविख्यात जगत_प्रसिद्ध विश्वप्रसिद्ध
विचलीत: अशान्त अशांत चंचल अस्थिरचित्त उत्कंठित उत्कण्ठित विचलित अस्थिर अनुपशांत अनेकांत अनेकान्त क्षुब्ध
विचार_करपाचें: विचारणीय विचार्य चिन्तनीय चिंतनीय चिंत्य अनुशीलनीय विचारणीय लक्ष्य अभिलक्ष्य
विचार_केल्लें: विचारित विमर्शित अनुचिन्तित विचिन्तित चिन्तित अनुचिंतित विचिंतित चिंतित
विचार_जाल्लें: विचारित विमर्शित अनुचिन्तित विचिन्तित चिन्तित अनुचिंतित विचिंतित चिंतित
विचारवंत: विचारशील विचारवान मननशील दीर्घदर्शी
विचारशील: विचारशील विचारवान मननशील दीर्घदर्शी अनुशीलित
विचारशुन्य: विचारहीन सतही हल्का
विचारहीण: विचारहीन सतही हल्का
विचारी: विचारणीय विचार्य चिन्तनीय चिंतनीय चिंत्य अनुशीलनीय विचारणीय लक्ष्य अभिलक्ष्य
विचारीक: विचारपूर्ण विचारात्मक युक्तिपूर्ण विचारशील विचारवान मननशील दीर्घदर्शी वैचारिक विचार_विषयको
विचित्र: अस्वाभाविक अप्राकृतिक अनैसर्गिक अप्राकृत अप्रकृत अनौठो विचित्र विलक्षण विस्मयकारी विस्मयजनक कुतुहलजनक जिज्ञासाजनक अद्भुत अनागत
विजयी: सफल सिद्ध
विजातीय: विजातीय परजातीय भिन्न_जातीय विजाति अर्को_जातिको
विजेवरी: चट्याङ
विज्ञानीक: वैज्ञानिक
वितरायिल्लें: प्रसारित
वितळिल्लें: पाकेको पकाएको
विदुशी: विघ्नकारी
विदेशी: विदेशी परदेशी परदेसी बिदेसी गैरमुल्की विलायती अन्यदेशीय अन्यराष्ट्रीय
विद्यालयीन: स्कुली विद्यालयी विद्यालयीय
विद्रूप: कुरूप नराम्रो विरूप बाङ्गोमुखे
विद्वाटें: अनर्थकारी अनर्थबुद्धि
विद्वान: विद्वान् ज्ञानी प्राज्ञ पण्डित विज्ञ
विधिचें: वैध कानूनी ऐन_अनुसार
विधीलिखीत: प्रारब्धाधीन नियति_अधीन पूर्व_निश्चित विधिवश
विध्वंशी: ध्वंसकारी ध्वंसक विध्वंसक
विनम्र: विनम्र नम्र विनयी
विनयशील: विनयी नम्र
विनयी: निष्कपट विश्‍वासी
विनाकारण: बिनासित्ति अकारण
विनाशक: नाशक नाशी विनाशी विनाशक
विनाशी: नाशक नाशी विनाशी विनाशक
विनोदी: हँस्यौली विनोदी ठट्यौली हास्यपूर्ण हास्यप्रद हास्यजनक
विपक्षी: विपक्षीय प्रतिपक्षीय विपक्षधर
विपक्षीय: विपक्षीय प्रतिपक्षीय विपक्षधर
विभागणी: विभाजित विभक्त अलग
विभागी: विभागीय
विभुशीत: अलङ्कृत अलंकृत उपाधित विभूषित अलङ्कृत अलंकृत आभूषित भूषित सज्जित विभूषित अलंकारिक अलंकारपूर्ण अभिलमंडित अभिलमण्डित
विमूख: लक्ष्यच्युत लक्ष्य_विमुख
विरक्त: विरक्त विमुख बैरागी वैरागी विरागी सन्यासी सन्यासी सन्नासी रागहीन
विरगळपी: घोलिने_खालको विलय_हुने_खालको
विरनाशें: नघोलिने
विरनासपी: नघोलिने
विरपी: गल्ने_खालको गलनशील
विरळ: असघन अघन
विरुद्ध: विपरीत उल्टो विरुद्ध
विरुध्दार्थी: विलोम उल्टो विपरीत_विरुद्धार्थी
विरोधा_बगरचें: अप्रतिघात
विरोधा_बवगरचें: निर्विरोध
विरोधा_विणें: निर्विरोध
विरोधी: विरोधात्मक विरोधी विरोधक
विरोधी_अर्थी: विलोम उल्टो विपरीत_विरुद्धार्थी
विरोधी_पक्ष: विरोधी विपक्षी प्रतिपक्षी
विरोधीत: अपकृत
विलक्षण: विचित्र विलक्षण विस्मयकारी विस्मयजनक कुतुहलजनक जिज्ञासाजनक अद्भुत अनागत
विलासी: कामुक विलासी विषयी भोगी कामचारी इन्द्रियलोलुप
विवश: विवश बाध्य लाचार
विवादास्पद: विवादास्पद
विवाहीत: विवाहित बिहे_भएको परिणीत
विवीध: अनेक कैयौं विविध नाना एकाधिक अनेकानेक तमाम
विवेकी: विवेकी विवेकवान विवेकशील
विशयाच्यो: वस्तुपरक विषयपरक विषयात्मक
विशारी: विषालु विषधर
विशाळ: धेरै_ठुलो अति_विशाल विशालतम भव्य ठुलो सानदार विशाल
विशाळकाय: महाकाय अतिकाय बृहत्काय विशालकाय भीमकाय विकराल
विशीं: विषयक सम्बन्धीय सम्बन्धी अनुषंगी अन्वयी अबाध
विशुववृत्ती: विषुवतीय
विशेक: गोडा_बीसेक
विशेश: विशिष्ट विशेष खास खासा
विश्वविजेतो: विश्व_विजेता जगजयी दिग्विजयी विश्वविजयी
विश्वव्यापी: विश्वव्यापी विश्वव्याप्त
विश्वासी: विश्वासी भरोसी विश्वास_कर्ता विश्वासशील विश्वास_गर्ने पत्यारिलो
विश्वीक: सार्वभौमिक सार्वभौम सार्वजनीन
विसंगत: अनुचित खराब बेठिक
विसरपी: बिर्सुवी
विसरभोळें: बिर्सुवी
विसरभोळो: स्मृतिहीन
विसराळू: बिर्सुवी स्मृतिहीन
विसरिल्लें: विस्मृत बिर्सिएको
विसावो: बीसौं
विस्कळ: असघन अघन
विस्कळीत: अव्यवस्थित व्यवस्थाहीन लथालिङ्ग छरप्रस्ट विस्थापित स्थानच्युत छरिएको छ्यान्नब्यान्न छरपुष्ट
विस्तारीत: विस्तृत लामो विस्तारित विस्तृत अभिवृद्ध
विस्तीर्ण: व्यापक परिव्यापक
विस्थापीत: विस्थापित स्थानच्युत
विस्वासघातकी: धोकाबाज बेइमानी_गर्ने धूर्त कपटी छली
विस्वासू: विश्वासिलो विश्वसनीय विश्वासपात्र विश्वस्त विश्वासी पत्याउरो
विहीत: विहित
वीज.: विद्युत
वीर: वीर बहादुर सुरो पराक्रमी पुरूषार्थी पौरखी वीर पराक्रमी
वीस: बीस 20
वेंचपा_सारकें: चयनीय
वेंचिल्ली: नियुक्त तैनाथ नियोजित
वेंचिल्लें: छानेको छुट्याएको पन्छाएको निर्वाचित चुनिएको मनोनीत रोजिएक चुनिएको छानिएको
वेंचून_काडिल्लें: मनोनीत रोजिएक चुनिएको छानिएको
वेगळी: अस्वाभाविक अप्राकृतिक अनैसर्गिक अप्राकृत अप्रकृत अनौठो अछुतो अभोग
वेगळे: अलग छुट्टै पृथक् फरक
वेगळें: विपरीत उल्टो विरुद्ध असंयुक्‍त पृथक छुट्टै भिन्दै
वेगळेंवेगळें: असङ्ख्य अनेक धेरै कैयौँ अनगन्ती बेगन्ती धेरै_थरी विभिन्न नाना
वेगवान: द्रुतगामी तीव्रगामी
वेगवेगळें: असङ्ख्य अनेक धेरै कैयौँ अनगन्ती बेगन्ती धेरै_थरी विभिन्न नाना
वेगहीण: गतिहीन स्थिर अचल
वेगाचे: प्रबल प्रचण्ड उत्कट उग्र तेज कडा
वेगाचें: गतिशील गतिपूर्ण गतिमान चल चालू चलायमान अविराम अस्थिर अथिर अध्रुव संचारी सञ्चारी तुफानी त्वरित शीघ्रगामी छिटो_हिँड्ने वेगवान् फुर्तिलो त्वरित
वेतना_विणें: अवैतनिक बेतन_रहित
वेदांचें: वैदिक वेदीय
वेदीक: वैदिक वेदीय
वेधप: छेडेको भेदगरेको
वेनिजुएला: भेनिजुएलाई
वेपाराचें: व्यापारिक वाणिज्यिक व्यवसायिक
वेपारीक: व्यापारिक वाणिज्यिक व्यवसायिक
वेर्थ: निष्फल असफल विफल व्यर्थ निरर्थक
वेळ_पाळपी: समय_पालक
वेळ_पाळिनासपी: समय_अपालक
वेळार: सामयिक समयोचित समयानुकूल अवसरानुकूल अवसरोचित कालोचित
वेवसायाचें: व्यापारिक वाणिज्यिक व्यवसायिक
वेवसायीक: व्यापारिक वाणिज्यिक व्यवसायिक
वेवस्थीत: व्यवस्थित प्रबन्धित विन्यस्त ठिक सुव्यवस्थित सुविन्यस्त सुप्रबन्धित नियमित नियमबद्ध ठीक उचित सठीक निरापद आपत्तिरहित निर्विघ्न सुरक्षित
वेव्हारी: व्यवहार_कुशल व्यवहारी दुनियादार
वेश्टिल्लो: आच्छादित ढाकिएको आवृत्त आवृत अपिबद्ध अपिनद्ध अपिहित आच्छन्न
वैचारीक: विचारपूर्ण विचारात्मक युक्तिपूर्ण विचारशील विचारवान मननशील दीर्घदर्शी वैचारिक विचार_विषयको
वैभवशाली: धनाढ्य धनी धनवान
वैयक्तीक: वैयक्तिक व्यक्तिगत निजी आफ्नो व्यक्तिगत
वैरपणाचो: सराप हाय
वैरी: शत्रुपूर्ण सशत्रु
वैश्वीक: सार्वभौमिक सार्वभौम सार्वजनीन
वोल्ताचें: घुमाउरो बाङ्गो-टिङ्गो घुमेको
व्यक्त: प्रकट उजागर प्रस्फुटित प्रस्फुट
व्यक्तीगत: वैयक्तिक व्यक्तिगत निजी आफ्नो व्यक्तिगत
व्यभिचारी: व्यभिचारी कामुक दुश्चरित
व्यर्ज: वर्जनीय छोड्न_योग्य त्याज्य
व्यर्थ: निष्फल असफल विफल व्यर्थ निरर्थक
व्यस्त: व्यस्त लगनशील बेफुर्सद
व्याकूळ: आतुर अधीर कातर व्याकुल बेचैन विकल अधैर्य अधैर्यवान् अधैर्यवान अधैर्यवान् अभिभूत क्षुब्ध
व्याख्या_केल्ल्यो: परिभाषित
व्यापक: व्यापक परिव्यापक
व्याप्त: व्यापी व्याप्‍त
व्यायामी: व्यायामी
व्रतगामी: व्रतगामी
व्हगडायिल्लें: बर्बाद बिनष्ट नाश
व्हड: महान ठुला श्रेष्ठ लामो टाढा दाजु अग्रज जेठा ज्येष्ठ ठुला भव्य ठुलो सानदार विशाल
व्हड_आंकडो: बहुसङ्ख्यक बहुसङ्ख्य
व्हड_कानाचें: बडकाने ठुलकाने
व्हड_नाकाचें: नाके
व्हडली: भारी
व्हडलें: दाजु अग्रज जेठा ज्येष्ठ ठुला
व्हरपी: वाहक बोक्ने
व्हांवतें: प्रवाहित बग्दो प्रवाहशील प्रवाहमय गतिशील गतिमान प्रवाही परिष्यन्दी धाराप्रवाह निरन्तर एकोहोरो
व्हांवपी: प्रवाहित बग्दो प्रवाहशील प्रवाहमय गतिशील गतिमान प्रवाही परिष्यन्दी
शंकू: शङ्ख
शंखाचो: शाङ्खिक
शंखाच्यो: शाङ्खिक
शंग्रह_करी_सारक्यो: सङ्ग्रहणीय सङ्ग्रहम_गर्ने_योग्य
शंढ: नामर्द नपुंसक पौरुषहीन पुरषत्वहीन वीर्यहीन अपौरुष अपुरुष शंड
शंबर: सय सयकडा १००
शंबरावें: सयौं १००औं
शंबरेक: गोडा_सयेक यस_जनाजति
शक्तीहीण: कमजोर दुर्बल अशक्‍त
शक्य: सम्भव संभव संभावनीय संभावित संभाव्य सम्भव सम्भावनीय सम्भावित सम्भाव्य
शतायुशी: अतिजीवी अतिजीवित
शतायू: अतिजीवी अतिजीवित
शत्रुहीण: शत्रुहीन अजातशत्रु शत्रुविहीन अरिहीन अभूतशत्रु
शब्दाचें: शाब्दिक शब्द
शरण_आयिल्लो: शरणागत
शरणागत: शरणागत
शरणार्थी: शरणार्थी रेफ्युजी
शरीरहीण: विदेह अशरीरी अकाय शरीरहीन अगात्र अतनु अदेह शरीरविहीन अपाङ्ग अपिण्डी पिण्डरहित
शर्मेची: लाजमर्दो लज्जाजनक लज्जाजन्य लज्जाप्रद
शस्त्रधारी: सशस्त्र शस्त्रधारी हतियारबन्द सशस्त्र
शस्त्रहीन: शस्त्रहीन निहत्था निरस्त्र
शांत: सौम्य कोमल_स्वभावी सौम सौम्य सुशील सुजान अभिविनीत गम्भीर शान्त धीर शान्त शांत प्रशान्त निरुद्विग्न अविकल अव्याकुल प्रशांत निभृत अनाकुल अव्यग्र विश्रब्ध स्थिरचित्त शान्त स्थिर प्रशान्त अचञ्चल प्रशान्त अक्रोधी क्रोधहीन शान्त शीतल ठण्डा अविकल व्याकुलतारहित अप्रमाद अभ्रान्त
शांती_आवडपी: शान्तिप्रिय
शांतीपूर्ण: शान्तिपूर्ण
शांतीप्रीय: शान्तिप्रिय
शांयशीं: छयासी
शांयश्यावें: छयासीऔं
शाकभक्ष्यी: शाकाहारी घाँस_खाने
शाकाहारी: शाकाहारी घाँस_खाने
शाखा: शाखायुक्त डाले प्रशाखित
शाणो: दूरदर्शी अग्रसोची दीर्घप्रज्ञ दीर्घदर्शी
शाण्णव: छयानब्बे
शाण्णवावें: छयानब्बेऔं
शात्तर: छहत्तर
शात्तरावें: छयहत्तरौं
शापोती: धृष्ट उच्छृङ्खल ढीठ निडर उद्धत
शाब्दीक: शाब्दिक शब्द
शारांतले: सहरी नगरवासी नगर_निवासी नगर-वासी नगर-निवासी नगरनिवासी नगरवासी शहराती नागर अग्राम्य
शारिरीक: शरीरी अङ्गधारी अङ्गी तनुधारी सदेही सशरीरी शरीरधारी देहवान सारीरिक दैहिक कायिक
शारी: सहरी नगरवासी नगर_निवासी नगर-वासी नगर-निवासी नगरनिवासी नगरवासी शहराती नागर अग्राम्य सहरको नगरको महान्गरीय
शाळचें: स्कुली विद्यालयी विद्यालयीय
शाश्वत: अमर अक्षय अनश्वर शाश्वत अक्षुण्ण अक्षुण अनष्ट अविनाशी अविनासी अक्षय्य अच्युत अभङ्ग अनाश अनाश्य अनाशवान अभङ्गुर अखय अक्षुण्य शाश्वत नित्य अविनाशी सनातन चिरस्थायी चिरस्था‍इ चिर-स्थायी चिर-स्थाइ अविनासी कालातीत अकाल अखीन अच्युत अनंत अनन्त अनाशी अयोनि अरिष्ट
शासकी: अधिशासी प्रशासनिक
शासन: शासित प्रशासित
शास्त्रविरूद्ध: शास्त्रविरुद्ध शास्त्र-विरुद्ध
शास्त्रीय: शास्त्रीय
शास्वत: अमिट नमेटिने
शाही: शाही
शिंगां_नाशिल्लें: सिङहीन मुंडा शृंगहीन विशृंग मुडुलो
शिंगाबगरचें: सिङहीन मुंडा शृंगहीन विशृंग मुडुलो
शिंपडिल्लें: छरिएको फिँजरिएको प्रसारित
शिंयाळें: शीतकालीन शिशिर_ऋतु
शिंविल्लें: अनुस्यूत
शिकपी: अध्यायी अध्ययनशील
शिकयिल्लें: अध्यापित
शिकारी: सिकारी व्याधा सिकारी
शिकिल्लें: शिक्षित साक्षर प्राज्ञ पढे-लेखेको सुशिक्षित
शिक्षणीक: शैक्षिक तालिमी इलमी
शिक्षीत: शिक्षित साक्षर प्राज्ञ पढे-लेखेको
शिजपी: गल्ने_खालको गलनशील
शिटूक: दूरदर्शी अग्रसोची दीर्घप्रज्ञ दीर्घदर्शी फुर्तिलो छिटो जाँगरिलो हाजिरजवाफ प्रत्युत्पन्नमति
शिटूक.: चलाख चतुर बुद्धिमान
शिडशिडीत: दुब्लो सिकुटे खिनाउटे
शितळ: चिसो शीतल ठण्डा अनुष्ण चिसो ठन्डा शान्त शीतल ठण्डा शान्तिपूर्ण
शिफारशीत: अनुशंसित
शिमा_रक्षक: सीमा_रक्षक सीमापाल
शिमांकीत: सीमाङ्कित
शिमीत: ससीम परिसीमित सीमित निर्धारित सीमित नियत मर्यादित संयत
शिरंगार: सजाउने
शिल्लक: बकाया एरियार दातव्य दाय उब्रेको बचेको बचेखुचेको रहल शेष बाँकी
शिवराक: निरामिष अनामिष शाकाहारी घाँस_खाने
शिश्ट: सभ्य भद्र सुशील शिष्ट
शिश्टाचारी: सुसंस्कृत
शिस्त_नाशिल्लो: असंयमी अतिग्रही
शिस्तवार: अनुशासित
शिस्तीची: अनुशासनिक
शिस्तीचें: अनुशासन अनुशासित
शींगां_आशिल्लें: सिङयुक्त सीङ्गदार विषाणी शृंगयुक्त शृंगी सींगी
शीत: शीतल चिसो ठण्डा
शीत_जेवपी: भाते
शीम_रक्षक: सीमा_रक्षक सीमापाल
शीलवान: सच्चरित्रा चरित्रवती शीलवती सदाचारिणी साध्वी
शुद्ध: राम्रो शुद्ध चोखो असल पवित्र शुद्ध निर्मल सफा खारिएको असली शुद्ध राम्रो खोटहीन विशुद्ध
शुभ_चिंतक.: हितैषी शुभचिन्तक शुभाकाङ्क्षी
शुल्लक: छिटपुट छुटपुट छिट-पुट छुट-पुट हल्का-फुल्का
शूर: वीर बहादुर सुरो पराक्रमी पुरूषार्थी पौरखी वीर पराक्रमी
शेंकड्यांनी: सयौँ सयकडौँ
शेचाळीस: छयालीस
शेजारचें: पल्लो छेउको
शेण_मेळयिल्लें: गोबरे गोबरी गोब्रे
शेणलेलो: भड्केको मार्गच्युत
शेणाचें: गोबरे गोबरी गोब्रे गोबरे
शेणिल्लो: भड्केको मार्गच्युत
शेपडी_आशिल्लें: पुच्छर_भएको
शेपडीहीण: पुच्छरहीन
शेपडे_बगरचें: पुच्छरहीन
शेपडे_विरयत: पुच्छरहीन
शेपडेचें: पुच्छर_भएको
शेळें: बासी पुरानो
शेष: बकाया एरियार दातव्य दाय
शोकहीण: शोकहीन अवसादहीन अशोक विशोक
शोकांती: दुखात्मक दुखान्त
शोकी: सौखिन सोखी सोखिन
शोकीन: सौखिन सोखी सोखिन
शोधीत: शोधित
श्रद्धाळू: श्रद्धालु
श्रीमंत: धनाढ्य धनी धनवान
श्रुंगारीत: वेशित भूषित सज्जित
श्रेयदिणें: उत्तम उचित श्रेष्ठ
श्रेयस्कर: उत्तम उचित श्रेष्ठ
श्रेष्ठ: महान ठुला श्रेष्ठ
स: छ ६
स_पटींनी: छगुना छगुणा छःगुणा
संकलीत: सङ्ग्रहित सञ्चित सङ्गृहीत सङ्कलित सङ्हृत उपचित
संकल्पीत: सङ्कल्पित
संकुचीत: सङ्कुचित अनुदार
संकोची: सङ्कोची सङ्कोच_मान्ने लाज_मान्ने
संगणकाचें: कम्प्युको सङ्गणकीय
संगणकी: कम्प्युको सङ्गणकीय
संगणकीकरणी: कम्प्युटरीकृत कम्प्युटरीकृत
संग्रहणीय: सङ्ग्रहणीय सङ्ग्रहम_गर्ने_योग्य
संग्रहीत: सङ्ग्रहित सञ्चित सङ्गृहीत सङ्कलित सङ्हृत उपचित
संघटनेचें: सङ्घीय
संघटीत: सङ्घटित सङ्गठित
संघीय: सङ्घीय
संतुळीत: सन्तुलित
संतुश्टी: तोषक
संथ: अटल अचल
संदिसादू: अवसरवादी
संदेश_दिवपी: सन्देशवाहक सन्देश_वाहक अभिज्ञापक
संदेशवाहक: सन्देशवाहक सन्देश_वाहक अभिज्ञापक
संपत्तीक: साम्पत्तिक सम्पत्तिसम्बन्धी धनमालको
संपादनीय: सम्पादनीय सम्पादनको_योग्य
संप्रदाय: साम्प्रदायिक
संप्रदायीक: साम्प्रदायिक
संबंद_दवरिनासपी: सम्बन्धहीन
संबंदीं: विषयक सम्बन्धीय सम्बन्धी अनुषंगी अन्वयी अबाध
संबंदीत: सम्बन्धित सम्बद्ध संबंधित
संबोधक: सम्बोधक
संभव: सम्भव संभव संभावनीय संभावित संभाव्य सम्भव सम्भावनीय सम्भावित सम्भाव्य
संभोग_घेवपी: सम्भोगी
संभोगी: सम्भोगी
संयमी: संयमी नियमी संयमशील संयत निग्रही
संयमीत: संयमित संयमित
संयोगी: योजक संयोजक संयोगी
संयोजक: योजक संयोजक संयोगी
संवसार_जिखपी: विश्व_विजेता जगजयी दिग्विजयी विश्वविजयी
संवसारीक: इहलौकिक सांसारिक लौकिक विश्वव्यापी विश्वव्याप्त
संविधानीक: संवैधानिक वैधानिक
संशयी: सन्दिग्ध संदिग्ध सन्देहास्पद संदेहास्पद शङ्कालु दोधारे संशयी सम्भ्रान्त
संशोदक: शोधकर्ता अनुसन्धान_कर्ता
संशोधक: आविष्कारक आविष्कर्त्ता प्रकाशक आविष्कार्ता अविष्कारकर्त्ता अविष्कारकर्ता
संसर्गजन्य: सङक्रामक सञ्चारी
संसर्गीक: सङक्रामक सञ्चारी
संस्कृत: संस्कृत
संस्कृतीक.: सांस्कृतिक संस्कृति-सम्बन्धी
सकयल_दिल्लें: निम्नलिखित
सकयलें: निम्न तल्लो
सकयल्ल्या__कुळाचें: निम्न_कुलीन निम्न_वंशीय
सकलें: नगण्य यस्तो-उस्तो अगण्य अनुदात्त
सकारात्मक: सकारात्मक स्वीकारात्मक
सक्तीचें: अनिवार्य परमावश्यक जरूरी
सक्षम: सक्षम क्षमतावान सामर्थ्यवान क्षमताशाली सामर्थी सशक्त
सख्खें: सहोदर सहोदरा एकोदर सगर्भ सगर्भ्य
सख्खो: स्वजनीय आत्मजनीय
सगली: जम्मा सारा सबै समस्त सम्पूर्ण तमाम
सगलें: सारा सबै पूरा सम्पूर्ण
सगल्या_गुणांनी_भरिल्लो: सर्वगुण_सम्पन्न सर्वगुणी
सगल्यांक_खबर_आशिल्लें: सर्वसंज्ञात सर्वज्ञात सर्वजनविदित
सच्चरित्री: सच्चरित्रा चरित्रवती शीलवती सदाचारिणी साध्वी
सजयिल्लें: सुसज्जित
सजावट: सजाउने
सजिल्लें: वेशित भूषित सज्जित
सजीव: जीवन्त जिउँदो
सज्जन: सज्जन भद्र भलादमी सुजन शीलवान सद्गुणी सुप्रतीक
सटीक: ठीक उचित सठीक
सडसडीत: स्वस्थ्य निरोगी
सडीक: ठीक उचित सठीक
सडेतोड: मुखतोड मुखभरिको
सत: साँचो सत्य यथार्थ
सत_उलोवपी: सत्यवादी सत्यवान
सतत: अनवरत लगातार निरन्तर
सतरा: सत्र सत्रह सप्तदश १७ 17 सत्रौं १७औं 17औं
सतर्क: फुर्तिलो छिटो जाँगरिलो
सतर्क.???????????: सचेत सावधान सतर्क
सतायिल्लें: प्रताडित पिटिएको चुटिएको
सत्कर्मी: सत्कर्मी सत्कर्मा सुकर्मी
सत्तर: सत्तर
सत्तरावें: सत्तरीऔं
सत्तरेक: गोडा_सत्तरीएक सत्तरी_जनाजति
सत्ता: शासित प्रशासित
सत्ताधारी: सत्तारूढ सत्ताधारी सत्तारुढ
सत्तावन: सन्ताउन सन्ताउन्न ५७
सत्तावनावें: सन्ताउन्नौं
सत्तावीस: सत्ताइस २७
सत्ते_खाला: अधीन
सत्ते_तळा: अधीन
सत्तेचाळिसावें: सतचालीसौँ
सत्तेचाळीस: सैँतालीस ४७
सत्त्याण्णवावें: सन्तानब्बे सन्त्तानब्बेऔं
सत्त्यात्तरावें: सतहत्तरौं
सत्यनिश्ठ: सत्यनिष्ठ सत्यव्रत सत्यवती
सत्यभाशी: सत्यवादी सत्यवान
सत्यवादिनी: सत्यवादिनी सत्यभाषिणी
सत्यवादी: सत्यवादी सत्यवान सत्यनिष्ठ सत्यव्रत सत्यवती
सत्यांयश्यावें: सतासीऔं
सदळ: कमजोर लुलो शिथिल खुकुलो ढीला खुकुलो ढीला खुकुलो ढीला
सदां__खातीरचें: अमिट नमेटिने
सदाचरणी: सच्चरित्रा चरित्रवती शीलवती सदाचारिणी साध्वी
सदाचारी: शुद्ध_मन
सद्चरित्री: सच्चरित्रा चरित्रवती शीलवती सदाचारिणी साध्वी
सद्वेव्हारी: सद्व्यवहारी
सनसनाटी: सनसनीदार सनसनीखेज
सनातन: शाश्वत नित्य अविनाशी सनातन चिरस्थायी चिरस्था‍इ चिर-स्थायी चिर-स्थाइ अविनासी कालातीत अकाल अखीन अच्युत अनंत अनन्त अनाशी अयोनि अरिष्ट
सपाट: समतल समथर सोझो सीधा
सप्तकाचें: साप्ताहिक
सभावीक: स्वाभाविक स्वभावगत
सभ्य: सभ्य भद्र सुशील शिष्ट
सम: समान तुल्य सदृश बराबर जस्तो
समकालीन: सामयिक अवसरीय कालिक समसामयिक
समगुणी: अनुगुण
समजिकायचें: सामञ्जस्यपूर्ण मेलपूर्ण
समजूंक_नाशिल्लें: नबुझेका
समजूतदार: विवेकी विवेकवान विवेकशील
समजूतदारपणाचें: सामञ्जस्यपूर्ण मेलपूर्ण
समदर्शी: समदर्शी
समन्वयीत: समन्वित
समरुपी: प्रतिरूपी अनुरूपी समरूपी
समर्थीत: समर्थित अनुमोदित
समर्पीत: समर्पित
समा: उचित समुचित उपयुक्त ठिक सही
समांतर: समानान्तर समान्तर
समाजवादी: समाजवादी
समाजीक: सामाजिक
समाधान: हर्षित
समाधानकारी: तोषयितव्य
समाधानी: समाधानित सुल्झिएको हल_भएको टुङ्गिएको समाधान्य समाधेय हर्षित तोषणिक
समान: जस्तो समानान्तर समान्तर तदनुरूप दुरूस्तै समानार्थक अनुगतार्थ
समान_गूण_आशिल्लो: अनुगुण
समानार्थी: पर्यायवाची पर्याय पर्यायवाचक समानार्थी समानार्थक
समाप्त: समाप्त सम्पूर्ण निष्पादित पूरा सम्पादित संपादित पूर्ण सम्पन्न संपन्न सम्पन्न
समाही: छ_महिने अर्ध_वार्षिक षटमासिक
समिक्षे_बगरचें: अनालोचित आलोचनाहीन
समुद्री: समुद्री समुद्री समुद्रीय
समृद्धिदिणें: समृद्धिप्रद ऐश्वर्यप्रद समृद्धिदायक ऐश्वर्यप्रदायक
समेटाचें: अनुबद्ध अनुबन्धित अनुबंधित
समेस्त: जम्मा सारा सबै समस्त सम्पूर्ण तमाम
सम्राट: चक्रवर्ती एकाधिपति सर्वेश्वर सर्वेश
सय__केल्ली: हस्ताक्षरित दस्तखती
सयल: खुकुलो ढीला
सरकटें: घिस्रिने सरीसृप सर्पी
सरकारमान्य: प्राधिकृत
सरकारी: अधिशासी प्रशासनिक
सरपटें: घिस्रिने सरीसृप सर्पी
सरबियन: सरबियाई सर्बियाई
सरळ: सजिलो सरल सहज स्वाभाविक सहज प्राकृतिक प्राकृत नैसर्गिक अकृत्रिम प्रकृत बोध्य बोधगम्य अक्लिष्ट सजिलो सरल सुगम सुबोध सोझो सीधा सरल सीधा-सादा सुविधाजनक सुविधापूर्ण सजिलो सुनिवार्य सोझो सीधा सुगम सुगम्य स्पष्ट प्रस्ट छर्लङ्ग छ्याङ्ग
सरळमार्गी: सुपथ सुहाउँदो उचित
सरसादारण: सर्वसामान्य सर्व_सामान्य सर्वसाधारण सर्व_साधारण
सरसामान्य: सर्वसामान्य सर्व_सामान्य सर्वसामान्य सर्व_सामान्य सर्वसाधारण सर्व_साधारण
सरींचें: निकटस्थ छेउको निकटको समिपको निकटवर्ती समीपी सन्निकट समीपवर्ती समीपस्थ
सर्गींचें: स्वर्गीय स्वर्गिक दिव्य वैकुन्ठीय
सर्गेस्त: मरेको मृत
सर्जनशीळ: रचनात्मक सृजनात्मक
सर्वगुणी: सर्वगुण_सम्पन्न सर्वगुणी
सर्वगूणसंपन्न: सर्वगुण_सम्पन्न सर्वगुणी
सर्वज्ञ: सर्वज्ञ सर्ववेत्ता
सर्वज्ञानी: सर्वज्ञ सर्ववेत्ता
सर्वमान्य: सर्वमान्य
सर्ववेदीक: सार्ववैदिक
सर्वव्यापी: सर्वव्यापी सर्वव्यापक सर्वव्याप्‍त विश्वव्यापी दिग्व्यापी
सर्वशक्तीमान: सर्वशक्‍तिमान सर्वशक्‍तिशाली
सर्वशक्तीशाली: सर्वशक्‍तिमान सर्वशक्‍तिशाली
सर्वश्रेश्ट: उत्तम उत्कृष्ट अनमोल श्रेष्ठ प्रशस्त
सर्वसादारण: सर्वसामान्य सर्व_सामान्य सर्वसाधारण सर्व_साधारण
सर्वसामान्य: सर्वसामान्य सर्व_सामान्य सर्वसामान्य सर्व_सामान्य सर्वसाधारण सर्व_साधारण
सर्वांगीण: सर्वाङ्गीन
सर्वोच्च: उच्च माथिल्लो
सर्वोत्कृश्ठ: सर्वोत्तम सर्वश्रेष्ठ अन्यतम सर्वोत्कृष्ट
सर्वोत्तम: सर्वोत्तम सर्वश्रेष्ठ अन्यतम सर्वोत्कृष्ट
सल्तनती: राजाको बादशाही सुल्नानको
सवकाश: मन्द बिस्तारो मन्थर
सवकास: मन्द बिस्तारो मन्थर
सवती: सौतेलो सौता_तिरको सौतेलो
सवाय: सस्तो कममूल्य सवा सस्तो सस्ता
सवायशीण: सधवा सधुवा
सवार: चढेको बसेको
सविसावें: छब्बीसौँ
सवें: छैठौं छ_नम्बर षष्टम
सव्वा: सवा
सव्वीस: छब्बीस
सशस्त्र: सशस्त्र शस्त्रधारी
सश्रम: सश्रम
सस्तन: जरायुज गर्भज पिंडज पिण्डज स्तनपायी योनिज
सहज: सजिलो सरल सहज स्वाभाविक सहज प्राकृतिक प्राकृत नैसर्गिक अकृत्रिम प्रकृत सुविधाजनक सुविधापूर्ण सजिलो सुनिवार्य
सहप्रवासी: सहयात्री सहगामी
सहमत: सहमत एकमत
सहयात्री: सहयात्री सहगामी
सहयोगी: सहयोगी मदतगार सहायक
सांकेतीक: साङ्केतिक
सांगपा_सारकी: भनिने कथनीय कथ्य वाच्य अभिभाष्य वक्तव्य
सांगि_सारकी: भनिने कथनीय कथ्य वाच्य अभिभाष्य वक्तव्य
सांगिल्लें: निवेदित उल्लेखित कथित लिखित प्रतिपाद्य अभिधेय निचोड निष्कर्ष
सांगिल्ल्या: उक्‍त भनिएको बताइएको वर्णन_गरिएको
सांगिल्ल्यो: प्रचारित
सांगूंक_नाशिल्लें: अकथनीय अकथ्य
सांचिल्लें: अप्रवाहित जमेको प्रवाहहीन स्थिर गतिहीन
सांच्यांत_घातिल्लें: ढलुवा
सांठयिल्लें: धृत निभृत
सांठिल्लें: अप्रवाहित जमेको प्रवाहहीन स्थिर गतिहीन
सांबाळपी: पालनकर्ता पालनहार योजक
सांमंतकाळीन: सामन्तकालीन
सांसठ: छयसट्ठी
सांसठावें: छैसट्ठीऔं
साकरीचें: शक्करी शकरी
साक्षर: शिक्षित साक्षर प्राज्ञ पढे-लेखेको
साक्षात: साकार आकारयुक्त आकारवान मूर्तिमान मूर्तिमान् साक्षात् साक्षात प्रत्यक्ष साक्षात् साक्षात
सागरी: समुद्री
साठ: साठी ६०
साठावें: साठीऔं
साठेक: गोडा_साठीएक साठी_जनाजति
साडे: साढे
साडे_तीन: साढे_तीन
सात.: सात ७ 7
सातपटीचें: सातगुना
सातवें: सातौँ सात
सातसठ: सतसट्ठी
सातसठावें: सतसट्ठीऔं
सातेक: गोडा_सातेक
सातोळ्याचें: साप्ताहिक
सात्तिसावें: सैँतीसौँ
सात्तीस: सैँतीस
सादरीकरणाचें: मञ्चनीय मंच्य प्रस्तुति_योग्य
सादरीत: मञ्चन अभिमञ्चित
सादारण: नगण्य यस्तो-उस्तो अगण्य अनुदात्त सामान्य आम साधारण कामचलाउ अविशिष्ट निरपवाद सर्वसामान्य सर्व_सामान्य सामान्य साधारण सादा सरल छिटपुट छुटपुट छिट-पुट छुट-पुट हल्का-फुल्का
सादूर: सचेत सावधान सतर्क
सादें: नगण्य यस्तो-उस्तो अगण्य अनुदात्त सुविधाजनक सुविधापूर्ण सजिलो सादा सेतो सामान्य साधारण सादा सरल सादा
सादें.: सोझो सीधा
सादो: सोझो सीधा सरल सीधा-सादा
साधनयुक्त: साधन_सम्पन्न साधनपूर्ण साधनयुक्त
साधनसंपन्न: साधन_सम्पन्न साधनपूर्ण साधनयुक्त
साधनहीण: साधनहीन साधनविहीन साधन_नभएको
साधनां_नाशिल्लें: साधनहीन साधनविहीन साधन_नभएको
साधवी: सच्चरित्रा चरित्रवती शीलवती सदाचारिणी साध्वी
साध्य: चिकित्स्य साध्य
सान: नावालक निरीह सानो सानु
सानुलें: भुराभुरि केटाकेटी नानी शिशु बच्चा सानो सानो सानु
सापेक्ष: आपेक्षिक सापेक्ष
साफ: स्पष्ट प्रष्ट सफा छर्लङ्ग
सामकें_गरजेचें: अत्यावश्यक अति_आवश्यक अपरिहार्य
सामको: पुरै पूर्ण पक्का
सामको_उणो: अत्यल्प अलिकति छ्यास्स
सामान्य: सामान्य आम साधारण कामचलाउ अविशिष्ट सामूहिक आम सार्वजनिक सामुदायिक सामान्य सर्वजनीन निरपवाद सामान्य साधारण सादा सरल
सामुहीक: सामूहिक आम सार्वजनिक सामुदायिक सामान्य सर्वजनीन
साम्यवादी: साम्यवादी समानतावादी कम्युनिस्ट साम्यवादी कम्युनिस्ट
सायप्रसी: साइप्रसी
सारकें: समान तुल्य सदृश बराबर एकनासे समान तुल्य सुव्यवस्थित सुविन्यस्त सुप्रबन्धित समानान्तर समान्तर उचित समुचित उपयुक्त ठिक सही शुद्ध_सही
सारको: पुरै पूर्ण पक्का जस्तो
सारहीण: निस्सार निसार साररहित सारहीन निस्सार खोखला निसार साररहित
सार्थ: अन्वर्थ
सार्वभौमीक: सार्वभौमिक सार्वभौम सार्वदेशिक सर्वदेशीय सार्वजनी
साव: सभ्य भद्र सुशील शिष्ट निष्कपट विश्‍वासी अनीच
सावत्र: सौतेलो सौता_तिरको सौतेलो
सावध: सचेत सावधान सतर्क
सावधी: सावधि अवधियुक्त सावधिक
सावळेचें: छायाँ_भएको ओझेल_परेको
सावळो: अश्‍वेत कालो
सासणा_खातीरचें: अमिट नमेटिने
सास्टांग_नमस्कार_करपी: अनुशयी
साहित्यीक: साहित्यिक
सिंधी: सिन्धी सिन्धी सिन्धवासी सैन्धव सिन्धव
सिंहली: सिंहली श्रीलङ्काई सिंहली सिंहल सिंहली
सिएरा_लियोनी: सिएरा_लिओनी
सिद्ध: सिद्ध प्रमाणित साबित
सिद्धांतीक: सैद्धान्तिक सिद्धान्तको सिद्धान्तसम्बन्धी।
सिनेगली: सिनेगली सिनेगलीस
सुंदर: राम्रो सुन्दर सुचारु मनोरम मनोहर सुन्दर रूपवती राम्री रूपसी रूपमयी
सुंदर_अक्षरवळणाचो: असल बेस राम्रो
सुकडें: दुब्लो सिकुटे खिनाउटे अति_क्षीणकाय
सुकप: विहीव शून्य
सुकिल्लें: ठुटे मुडुले सुकेको सुक्खा ओइलाएका
सुकें: दुब्लो सिकुटे खिनाउटे सुक्खा सुकेको सुकेको सुक्खा
सुक्षीम: सूक्ष्मतम अति_सूक्ष्म मिही मसिनो
सुक्षीमदर्शी: सूक्ष्मदर्शी
सुक्ष्म: सूक्ष्मतम अति_सूक्ष्म
सुख: सुखी सुखमय आनन्दी मङ्गलमय
सुखदिणी: सुखद सुखदायक सुखकारी सुखदायी सुखप्रद
सुखांतीक: सुखात्मक सुखान्त
सुखाची: सुखद सुखदायक सुखकारी सुखदायी सुखप्रद
सुखात्मक: सुखात्मक सुखान्त
सुखाळ: सुखद सुखदायक सुखकारी सुखदायी सुखप्रद
सुखी: सुखी सुखमय आनन्दी मङ्गलमय
सुग्राही: सुग्राही
सुग्र्याह: सुग्राह्य
सुचरित्री: सच्चरित्रा चरित्रवती शीलवती सदाचारिणी साध्वी
सुचिल्लें: कल्पित अनुकल्पित
सुचीत: सूचित ज्ञापित अभिदिष्ट
सुझ्य: फोहोरी मैलाधैला
सुटनासपी: अबुझ
सुटसुटीत: सुडौल सुगठित बान्की_परेको
सुटिल्लो: हिँडेका
सुडानी: सुडानी सुडान-सम्बन्धी
सुती: सुती
सुदरपा_सारकें: अनुशासित अनुशासनीय
सुदारिल्लो: प्रगत अग्रगत
सुदारीत: प्रगत अग्रगत परिष्कृत परिमार्जित संस्कृत
सुनयनी: सुनयन ललितलोचन सुलोचन सुनेत्र
सुनिश्चीत: सुनिश्‍चित सुनिर्धारित
सुनेत्री: सुनयन ललितलोचन सुलोचन सुनेत्र
सुन्न: लठेब्रो चिसो ठन्डा अचेत चेतना_नभएको होस_गुमेको सुद्धी_हराएको बेहोस
सुपाच्य: सुपाच्य सहज_पाच्य हल्का पथ्य
सुपुल्लें: सानो सानु
सुप्त: निष्क्रिय असक्रिय सुप्‍त
सुप्रसिद्ध: सुप्रसिद्ध सुविख्यात सुख्यात अभिविख्यात अभिविश्रुत
सुबेज: धृष्ट उच्छृङ्खल ढीठ निडर उद्धत मुखाले चोथाले थुतुने दुर्मुखा
सुरक्षीत: रक्षित संरक्षित सुरक्षित निरापद सुरक्षित निरापद रक्षात्मक निरापद आपत्तिरहित निर्विघ्न सुरक्षित निरापद आपत्तिरहित निर्विघ्न सुरक्षित
सुरवातीचें: प्रारम्भिक आरम्भिक आरंभिक प्राथमिक प्रारंभिक पूर्व
सुरांटो: रक्स्याहा जँड्याहा
सुरांडो: रक्स्याहा जँड्याहा रक्स्याहा जँड्याहा रक्स्याहा जँड्याहा
सुरिनामी: सुरीनामी सुरीनामीस
सुरू_आशिल्लें: चालित परिचालित प्रचालित
सुलक्षण: सुलक्षण सुलक्षन सुलक्ष सुलच्छन
सुलतानी: राजाको बादशाही सुल्नानको
सुलभ: गम्य गमनीय सजिलो सरल सहज सुलभ सुप्राप्य सुलब्ध सहज_प्राप्य
सुलिखीत: स्पष्ट_लेखिएको
सुळसुळीत: चिल्लो चिप्लो
सुवर्णी: सुनौला
सुवादाचें: स्वादयुक्त चाखिलो मिठो स्वादपूर्ण
सुवादीक: स्वादयुक्त चाखिलो मिठो स्वादपूर्ण स्वादिष्ट मिठो स्वादिष्ठ राम्रो
सुवादीन: समर्पित
सुवार्था_बगर: निस्वार्थ स्वार्थहीन
सुवार्थी: स्वार्थी मतलबी स्वार्थपर तनपोषक अपस्वार्थी अपरता स्वार्थपरायण
सुवासीत: सुवासित अनुवासित
सुशिक्षीत: शिक्षित साक्षर प्राज्ञ पढे-लेखेको सुशिक्षित
सुशील: चरित्रवान सच्चरित्र
सुशेगाद: अल्छी सुस्त ढिलो
सुसंस्कृत: सुसंस्कृत
सुसेगाद: शान्त शांत प्रशान्त निरुद्विग्न अविकल अव्याकुल प्रशांत निभृत अनाकुल अव्यग्र विश्रब्ध मन्द ढिलो सुस्त
सुस्त: अल्छी सुस्त ढिलो मन्द ढिलो सुस्त
सूखदिणें: रमाइलो आनन्दप्रद आनन्दप्रद आनन्द-दायक आह्लादक सुखप्रद खुशनुमा प्रसन्नतादायक आनंददायक आनन्ददायक आनन्ददायी आनन्दकारी आनंदकारी आह्लादी अनंद अनन्द नंदक नन्दक रमन रमण
सूरहीण: बेसुरिलो स्वरहीन
सूर्यवंशी: सूर्यवंशी सूर्यवंशीय
सृजक: सृजनकर्ता सर्जक सृजक रचयिता स्रष्टा
सृजनकर्तो: सृजनकर्ता सर्जक सृजक रचयिता स्रष्टा
सृजनात्मक: रचनात्मक सृजनात्मक
सॅटिनाचें: अतलसी अतलसी
सेगीत: अनवरत लगातार निरन्तर
सेवक: सेवी सेवक सेवी
सेवनाचें: सेवनीय सेव्य सेवित
सेवा_करपी: स्याहारसुसार हेरचाह
सेवाभावी: सेवक सेवी
सेवी: सेवी
सेवीत: सेवित सेव्य
सेशिल्जी: सेसिल्सी सेसिल्जी
सैनिकी: सैन्य सेना फौजी फौजदारी
सैन्य: सैन्य सेना
सैन्या_बगरचें: सेनारहित अदल
सैन्या_विरयत: सेनारहित अदल
सैमीक: प्राकृतिक नैसर्गिक प्राकृत अकृत्रिम प्रकृत स्वाभाविक सहज प्राकृतिक प्राकृत नैसर्गिक अकृत्रिम प्रकृत
सैल: कमजोर लुलो शिथिल खुकुलो ढीला खुकुलो ढीला
सोंपूंक_नाशिल्लें: अधुरो बाँकी शेष असमाप्त अनिष्पादित असम्पादित अपूर्ण असम्पन्न असिद्ध अनिष्पन्न
सोंपे: सुलभ सुप्राप्य सुलब्ध सहज_प्राप्य
सोंपें: गम्य गमनीय बोध्य बोधगम्य अक्लिष्ट सजिलो सरल सुगम सुबोध सुविधाजनक सुविधापूर्ण सजिलो सुनिवार्य
सोंपेपणाचें: सुविधाजनक सुविधापूर्ण सजिलो
सोंपो: सजिलो सरल सहज
सोकिल्लें: सोसित
सोकून_घेतिल्लें: सोसित
सोडिल्लें: त्यागेको परित्यक्‍त त्यक्‍त पठाइएको
सोडोवंक_जायना_अशें: अबुझ
सोद_घेय_सारकें: अनुसन्धेय
सोदक: शोधकर्ता अनुसन्धान_कर्ता
सोदर्यात्मक: सौन्दर्यात्मक_सौन्दर्यपरक सौन्दर्य_बोधक
सोदिल्लें: शोधित
सोप्पाचें: समाप्य समापनीय
सोबीत: राम्रो सुन्दर सुचारु मनोरम मनोहर सुन्दर रूपवती राम्री रूपसी रूपमयी दिव्य
सोमाली: सोमाली सोमालिया-सम्बन्धी
सोरेकार: रक्स्याहा जँड्याहा
सोर्‍याकार: रक्स्याहा जँड्याहा
सोलिल्लीं: बोक्रो_नभएको कवचहीन आवरणहीन
सोलिल्लें: ताछेको तासिएको छोडाएको
सोलूंक_नाशिल्लें: नताछिएको
सोळा: सोह्र सोर
सोळावें: सोह्रौं १६औं 16औं
सोशीक: सह्य सहनीय सहनक्षम
सौम्य: सौम्य कोमल_स्वभावी सौम
स्कॅण्डिनेवियी: स्केन्डिनेवियाई
स्टोनियायी: स्टोनियाई स्टोनियाई
स्तन्य: स्तनीय स्तन्य
स्तुतीपाठक: प्रशंसक प्रशंसी
स्त्री: पोथी
स्थगीत: स्थगित रोकिएको
स्थानीक: स्थानीय आन्चलिक स्थानिक
स्थापणूक_करी_सारकें: स्थापनीय स्थाप्य संस्थापनीय
स्थापी_सारकें: स्थापनीय स्थाप्य संस्थापनीय
स्थापीत: संस्थापित अधिष्ठित अधिष्ठापित स्थापित
स्थायी: स्थायी स्थायी स्थाइ
स्थायीक: आवासित अध्युष्ट
स्थावर: अचल गतिहीन स्थावर अग अगतिक अचर अचल स्थावर
स्थीर: गतिहीन स्थिर अचल अचल गतिहीन स्थावर अग अगतिक अचर स्थिर थिर दृढ अचल अविचल निश्चल गतिहीन अविचलित अटल अचल स्थावर अकम्पित अकम्पायमान कम्परहित अकम्प
स्थूल: मोटो बलियो स्थुलकाय
स्नेही: स्नेही दयालु
स्पटिकी: बिल्लौरी
स्पर्श_करी_सारकें: स्पृश्‍य स्पर्श_गर्न_योग्य छुन_सकिने छुवाछूत_चल्ने
स्पर्श_करूंक_नाशिल्लें: नछोइएको नछोएको अस्पर्शित
स्पश्ट: स्पष्ट प्रष्ट सफा छर्लङ्ग स्पष्ट प्रस्ट छर्लङ्ग छ्याङ्ग
स्पृश्य: स्पृश्‍य स्पर्श_गर्न_योग्य छुन_सकिने छुवाछूत_चल्ने
स्पॅनीश: स्पेनी स्पेनिस स्पेनी स्पेनिया
स्फटिका_भशेन: बिल्लौरी
स्फटिकाचें: बिल्लौरी बिल्लौरी
स्फूर्तहीण: स्फूर्तिहीन अस्फूर्त उत्साहहीन अनुत्साही निरुत्साह हतोत्साहित निरुत्साहित
स्फोटक: विस्फोटक विस्फोटकारी
स्मरणीय: स्मरणीय अविस्मरणीय
स्मृतीहीण: स्मृतिहीन
स्लोवाकी: स्लोवाकी स्लोवाकी
स्लोवेनियाचें: स्लोवेनियाई
स्लोवेनियायी: स्लोवेनियाई स्लोवेनियाई
स्वखोसयेचें: स्वेच्छार्थ
स्वगत: मनोगत मनोद्भव
स्वजातीय: सजातीय समवर्गीय सजाति स्वजातीय स्वजाति
स्वतंत्र: स्वतन्त्र स्वाधीन आजाद अनन्याश्रित अनधीन अनिर्बन्ध स्वच्छन्द स्वतन्त्र स्वाधीन
स्वता_कमयिल्लें: स्वार्जित स्वोपार्जित स्वयधिगत स्वयमर्जित
स्वता_जोडिल्लें: स्वार्जित स्वोपार्जित स्वयधिगत स्वयमर्जित
स्वता_मेळयिल्लें: स्वार्जित स्वोपार्जित स्वयधिगत स्वयमर्जित
स्वताचें: निजी आफ्नो स्वकीय स्वायत्त आत्म
स्वदेशी: स्वदेशीय देशी देसी स्वदेशी देशीय देशज
स्वनिर्भर: आत्मनिर्भर स्वनिर्भर
स्वपक्षी: स्वपक्षीय अपना स्वपक्षी
स्वप्रशंसी: आत्मप्रशंसक
स्वभावीक: स्वाभाविक स्वभावगत
स्वराचें: स्वरित
स्वराळ: स्वरित
स्वर्णीम: स्वर्ण सुनौला स्वर्णिम
स्वशिक्षीत: स्वशिक्षित
स्वाजी: स्वाजि
स्वाभावीक: स्वाभाविक सहज प्राकृतिक प्राकृत नैसर्गिक अकृत्रिम प्रकृत
स्वाभिमानहीण: स्वाभिमानहीन अस्वाभिमानी
स्वायत्त: स्वायत्त
स्वावलंबी: स्वावलम्बिनी स्वावलंबिनी आत्मावलम्बिनी आत्मावलंबिनी स्वावलम्बी आत्मावलम्बी आत्मनिर्भर स्वनिर्भर
स्वाहिली: स्वाहिली स्वाहिली किस्वाहिली
स्विकारिल्ली: स्वीकृत मन्जुर सहमति_प्राप्त अभ्युपगत स्वीकृत मान्य अनुमोदित
स्विकारिल्लें: अङ्गीकृत स्वकृत परिग्रहीत गृहीत स्वीकृत स्वाङ्गीकृत अभ्युपगत
स्विकारूंक_नाशिल्लें: अस्वीकृत नामंजूर सहमतिहीन सहमति_अप्राप्त
स्विकृत: स्वीकृत अनुमति_दत्त अनुमति_प्रदत्त स्वीकृत मान्य अनुमोदित
स्विडीश: स्विडिस स्विडिस
स्वित्झरलॅण्डी: स्विट्जरल्यान्डी
हक्क_आशिल्लो: अधिकारी अधिकार_प्राप्त अधिकारयुक्त अधिकारिक हकदार अधिकारक
हक्काचें: अधीनस्थ
हजर: उपस्थित हाजिर विद्यमान प्रस्तुत
हजरजबाबी: हाजिरजवाफ प्रत्युत्पन्नमति
हजार: हजार
हजारांनी: हजारौँ
हजारावें: हजारौं
हजारेक: हजारजति हजार_जनाजति
हट्टी: दुराग्रही हठी जिद्धी जिद्दीवाल
हडपिल्लें: कुर्की_भएको पच हजम हडप
हमाली: भरिया भारवाहक भारी_बोक्ने
हयकारी: सकारात्मक स्वीकारात्मक
हरवें: काँचो नपाकेको काँचो अधकल्चो आधा_पाकेको
हरामी: साह्रै_दुष्ट हरामी दुर्जन
हलकें: सानो मसिनो फुस्रो
हलको: हलुको हलुङ्गो हल्का
हळडुवें: पहेँलो पीत
हळू: सानो मसिनो
हळू_हळू: मन्द बिस्तारो मन्थर
हवादार: हावा_आउने हावा_चल्ने
हसतमूख: प्रसन्नमुख प्रसन्नवदन
हस्तलिखीत: हस्तलिखित हातले_लेखेका
हस्तांतरीत: हस्तान्तरित
हस्तीदंती: गजदन्ती हातीको_दाँत
हांडेकार: धनाढ्य धनी धनवान
हांशाक_म्हारग: हास्य
हांशाचें: हास्य
हांसपी: हाँसेको हाँसिरहेको हँसिलो
हांसमूख: हँसिलो हँसैया
हांसयाळें: हाँसेको हाँसिरहेको हँसिलो
हांसरें: हँसिलो हँसैया
हांसोवपी: हास्यपूर्ण हास्यप्रद हास्यजनक
हाडकुळें: हड्डीछाला अस्थिमय दुब्लो सिकुटे खिनाउटे अति_क्षीणकाय
हाडांचें: अस्थिमय अस्थिनिर्मित अस्थि_निर्मित
हातबरपाचें: हस्तलिखित हातले_लेखेका
हाता_खालचें: अधीनस्थ अधीन मातहत अधस्तन अमुख्य
हारिल्लो: पछाडिएको प्रतिगत पश्चगत पराजित परास्त अपध्वस्त
हालत: हल्लिँदै डगमगाउँदै ढलपललिँदै
हालपी: अनुमति_अदत्त अनुमति_अप्राप्त अस्वीकृत सम्मति_अदत्त
हावरट: लोभी लालची चुइयाँ कन्जुस स्वादे चखुवा
हावरें: लोभी लालची चुइयाँ कन्जुस
हावेसाचें: इच्छापूर्ण अभिलाषापूर्ण कामनापूर्ण सकाम इच्छित अभिलषित अभिलाषित अभीष्ट आकाङ्क्षित वाञ्छित इष्ट अपेक्षित अभिप्रेत मनोवाञ्छित वाञ्छनीय कमनीय अनुकाङ्क्षित अभिकाङ्क्षित अभिमत अभिवांछित अभिवाञ्छित अभीप्सित
हासयाळें: हँसिलो हँसैया
हास्य: हास्य
हिंदी: हिन्दी
हिंदुस्थानी: भारतीय हिन्दुस्थानी
हिंसक: हिंसक आततायी बर्बर घातक नृशंस हिंस्रक हिंसात्मक घातक बर्बर नृशंस
हिजडो: नामर्द नपुंसक पौरुषहीन पुरषत्वहीन वीर्यहीन अपौरुष अपुरुष शंड
हितकारी: कल्याणकारी मङ्गलकारी कल्याणप्रद मङ्गलकारक मङ्गलदायक मङ्गलप्रद हितकारी हितकर हितकारक कल्याणमय अनुकूल
हिमटो: लोभी कन्जुस कन्चुस
हिवाळी: शीतकालीन शिशिर_ऋतु
हिसबा_भायलें: अनगन्ती बेहिसाब थुप्रो औधि धेरै निक्कै निकै पर्जापखान
हीणपणाचें: निकृष्टतम अधमाधम तुच्छातितुच्छ
हीम: हिउँमा_बस्ने हिउँको
हुंपूंक_जायनाशिल्लो: अपारगम्य अगम्य अपार दुस्तर दुष्पार्य अगम
हुंवारग्रस्त: बाढग्रस्त बाढपीडित बाढ-पीडित बाढ_पीडित
हुंवारान_पिडेस्त: बाढ-पीडित बाढ_पीडित
हुनहुनीत: तातो गरम
हुबेहुब: हुबहु हु-ब-हु जस्ताको_त्यस्तै
हुमटपी: उत्खाता
हुमटायिल्लें: उत्खात
हुलपल्लें: डढेको दग्ध पोलेको पिल्सिएको दुःख_पाएको सताइएको सन्तप्त
हुलपावपी: दाहक दाहिक
हुल्लडबाज: हुल्याहा हुल्लडबाज
हुशार: योग्य उपयुक्‍त समर्थ सक्षम खाइलाग्दो बुद्धिमानी ज्ञानी प्राज्ञ समझदार दिमागदार दिमागी बुझक्की मेधावी फुर्तिलो छिटो जाँगरिलो चलाख चतुर बुद्धिमान
हुसक्यामेकळें: निश्शङ्क अनाशङ्कित आशङ्काहीन संशयहीन निश्शंक अनाशंकित आशंकाहीन
हुसक्यामेकळो: निश्चिन्त चिन्तारहित चिन्ताहीन चिन्तामुक्त
हुस्को: चिन्तित चिंतित चिन्तायुक्त चिन्ताग्रस्त
हून: तातो गर्मी उष्ण तातो न्यानो तातो गरम
हॅटीचें: हैती हैती-सम्बन्धी
हॅटीयी: हैती हैती-सम्बन्धी
हे_तरेचें: त्यस्तो
हे_भशेचें: त्यस्तो
हे_सारकें: त्यस्तो
हेच_तरेन: यस्तै_खालको यसकै_जस्तो
हेच_भशेन: यस्तै_खालको यसकै_जस्तो
हेडगें: घुमक्कड घुमन्ते पर्यटनप्रिय यायावर घुम्ने भ्रमणशील भ्रमणीय अतिचारी अध्वगामी गश्ती भ्रमणप्रेमी भ्रमण-प्रेमी बन्जारा घुमन्ते
हेर: अरू अर्को अन्य अर्को इतर अर्कै पराई बिरानो परचक्री
हेर_कोराचें: अन्यवर्ण
हेर_रंगाचें: अन्यवर्ण
हेरगिरीचें: जासुसी
हेरवर्णी: अन्यवर्ण
हेरांचें: अन्यत्र
हैदराबादी: हैदराबादी
हॉडुरसी: हाँडुरसी होन्डुरसी
होंवरेंत_रावपी: गुहावासी कन्दरावासी
