abandon: स्थान_त्यागना स्थान_खाली_करना स्थान_छोड़ना
abduct: अपहरण_करना हरण_करना हरना अगवा_करना हर_लेना किडनैप_करना
abide: बसना डेरा_डालना अपमान_सहना बरदाश्त_करना जहर_का_घूंट_पीना
abound: बहुत_होना प्रचुर_होना
abrade: माँजना मलना मँजाई_करना मांजना
absorb: अवशोषित_करना खींचना चूसना सोखना पीना ईचना ईंचना ऐंचना
abuse: गाली_देना गाली_बकना अपशब्द_कहना गरियाना
abut: सीमा_पर_होना सरहद_पर_होना किनारे_पर_होना
accept: स्वीकारना स्वीकार_करना लेना ग्रहण_करना पाना प्राप्त_करना अपनाना स्वीकारना स्वीकार_करना चुनना अपना_बनाना अंगीकार_करना अपना_लेना अख़्तियार_करना अख्तियार_करना सकारना
accommodate: ठहराना टिकाना रुकवाना
account: खींचना खीचना ईचना ईंचना ऐंचना
accumulate: जोड़ना जमा_करना जुटाना संचित_करना इकट्ठा_करना एकत्रित_करना एकत्र_करना संग्रह_करना संग्रहना संजोना सँजोना जमना एकत्र_होना जमा_होना एकत्रित_होना जुटना गोलियाना इकट्ठा_होना अगटना जुड़ना घुमड़ना
accustom: अभ्यस्त_होना
ache: टूटना ललचना ललकना लालसा_करना लहकना टीसना करकना कसकना चसकना चिलकना टहकना डबकना चबकना ठनकना
acknowledge: मानना
acquaint: परिचय_कराना
acquire: मिलना हाथ_लगना हाथ_आना प्राप्त_होना हासिल_होना सीखना
acquit: बरी_करना अपराध_मुक्त_करना दोष_मुक्त_करना रिहा_करना छोड़ना
act: व्यवहार_करना बर्ताव_करना करना पेश_आना आचरण_करना आचरना काम_करना असर_करना असर_डालना
addict: पड़ना
addle: गड़बड़ाना अटपटाना
address: संबोधित_करना सम्बोधित_करना संबोधन_करना सम्बोधन_करना कहना पुकारना बोलना बुलाना
adhere: सटना चिपकना जुड़ना जुटना चिपकना सटना
adjoin: सीमा_पर_होना सरहद_पर_होना किनारे_पर_होना छुआना छुलाना छुवाना स्पर्श_कराना परसाना
adjudicate: निपटाना सुलझाना निबटाना फरियाना समाधान_करना निपटा_लेना सुलझा_लेना निबटा_लेना फरिया_लेना समाधान_कर_लेना
adjure: निवेदन_करना विनती_करना विनय_करना प्रार्थना_करना अनुनय_करना दुआ_करना अनुरोध_करना अनुराधना अपील_करना
adjust: चढ़ाना
administer: बाँटना वितरित_करना वितरण_करना बांटना
admit: अपनाना स्वीकारना स्वीकार_करना चुनना अपना_बनाना अंगीकार_करना अपना_लेना अख़्तियार_करना अख्तियार_करना सकारना
admonish: चेतावनी_देना चेताना चिताना सावधान_करना आगाह_करना ख़बरदार_करना जताना
adolesce: जवान_होना युवा_होना
adopt: गोद_लेना दत्तक_लेना
adorn: सजाना सँवारना अलंकृत_करना सज्जित_करना सँजोना संजोना शोभान्वित_होना शोभित_होना शोभना फबना शोभायमान_होना
advance: बढ़ाना तेज_करना तेज़_करना तीव्र_करना जीतना विजय_पाना विजयी_होना हराना पराजित_करना परास्त_करना शिकस्त_देना पछाड़ना मात_देना जीत_दर्ज_करना जीत_लेना कामयाब_होना उन्नत_होना उन्नति_करना उभरना विकास_करना बढ़ना फलना फलना-फूलना चमकना पदोन्नति_करना पदोन्नति_देना भाव_बढ़ना भाव_चढ़ना भाव_आसमान_छूना दाम_बढ़ना दाम_आसमान_छूना महँगा_होना चढ़ना तेजी_आना तेज़ी_आना
advert: उल्लेख_करना जिक्र_करना ज़िक्र_करना
advise: परामर्श_देना सलाह_देना राय_देना
affect: प्रभावित_करना प्रभाव_डालना असर_डालना छाप_छोड़ना असर_करना रंग_जमाना रंगना छाना
affiance: रोकना
affirm: कसम_खाना सौगंध_खाना सौगन्ध_खाना कसम_लेना सौगंध_लेना सौगन्ध_लेना
afford: खुलना
affright: डराना भयभीत_करना डरवाना डरपाना
affront: अपमानित_करना अपमान_करना अनादर_करना निरादर_करना निदरना पगड़ी_उछालना तिरस्कार_करना तिरस्कृत_करना अनरना अपमानना अवहेलना_करना अवमानना_करना
age: बुढ़ाना वृद्ध_होना
aggrieve: उदास_होना अनमनाना
agitate: उकसाना चढ़ाना भड़काना उभाड़ना उभारना उसकाना उकतारना उगसाना उचटाना लड़ना लड़ाई_करना सरकना खिसकना खसकना हटना टसकना हिलना डिगना अपसवना डगना डुलाना हिलाना डोलाना विलोड़ना हिलाना
aid: सहायता_करना मदद_करना सहयोग_करना हाथ_देना हाथ_थामना हाथ_बढ़ाना हाथ_बँटाना
aim: प्रयोजन_होना मतलब_होना निशाना_साधना निशाना_बाँधना
alight: उतरना अवरोहना अवतरण_करना
allay: बुझना
allot: बाँटना वितरित_करना वितरण_करना बांटना
allow: स्वीकृति_देना सहमति_देना सकारना स्वीकार_करना स्वीकारना मंजूरी_देना हाँ_करना ठप्पा_लगाना मुहर_लगाना मोहर_लगाना हरी_झंडी_देना हरी_झंडी_दिखाना अलग_रखना अलग_रक्षित_करना पृथक_रक्षित_करना अलग_निकालना पृथक_निकालना
alter: बनाना कर_देना करना बना_देना परिवर्तित_करना बदलना बदलाव_आना परिवर्तित_होना परिवर्तन_आना बदल_जाना तब्दील_होना
altercate: लड़ना झगड़ना झगड़ा_करना लड़ाई_करना तकरार_करना उलझना कलह_करना किचकिच_करना अखड़ाना अपड़ाना अरुझाना अलुझना
amass: जमना एकत्र_होना जमा_होना एकत्रित_होना जुटना गोलियाना इकट्ठा_होना अगटना जुड़ना घुमड़ना जोड़ना जमा_करना जुटाना संचित_करना इकट्ठा_करना एकत्रित_करना एकत्र_करना संग्रह_करना संग्रहना संजोना सँजोना
amaze: आश्चर्यचकित_होना भौचक्का_होना अकबकाना हकबकाना
ambuscade: घात_लगाना घतियाना घात_में_बैठना ताक_में_बैठना ताक_में_रहना मौक़ा_ढूढना
ambush: घात_लगाना घतियाना घात_में_बैठना ताक_में_बैठना ताक_में_रहना मौक़ा_ढूढना
ameliorate: बढ़ाना विकसित_करना उन्नत_करना बिकसाना ऊंचा_उठाना ऊँचा_उठाना सुधरना
amend: बढ़ाना विकसित_करना उन्नत_करना बिकसाना ऊंचा_उठाना ऊँचा_उठाना
amuse: बहलना
anathemise: कोसना
anathemize: कोसना
anchor: लंगर_डाला_होना बँधा_होना
anger: गुस्सा_दिलाना क्रोध_दिलाना क्रुद्ध_करना क्रोधित_करना भड़काना तड़काना क्रुद्ध_होना क्रोधित_होना गुस्साना गुस्सा_करना गरम_होना क्रोध_करना तमकना तमना बमकना बिगड़ना उखड़ना उखरना उबलना कुपित_होना तड़कना भड़कना उत्तेजित_होना आमरखना भौंहें_चढ़ाना भौंहें_तानना त्योरी_चढ़ाना उबल_पड़ना
angle: झुकना नवना
anguish: दुखाना
animate: प्रेरित_करना
answer: उत्तर_देना उत्तर_बताना जवाब_देना
anticipate: संभावना_होना सकना
apparel: पहनाना डालना
appeal: फ़रियाद_करना गुहारना गुहार_करना दुहाई_देना अपील_करना
appear: प्रकट_होना उतराना उठना खड़ा_होना
appease: मनाना मनुहारना मान_मनुहार_करना
apply: अनवाँसना लिपना आलेपित_होना
appraise: मूल्यांकन_करना मूल्य_लगाना
apprehend: समझना पकड़ना बंदी_बनाना बंदी_बना_लेना क़ैद_करना कैद_करना गिरफ्तार_करना गिरफ़्तार_करना पकड़ना पकड़_लेना गिरफ़्त_में_लेना गिरफ्त_में_लेना हिरासत_में_लेना अरेस्ट_करना
appropriate: अलग_रखना अलग_रक्षित_करना पृथक_रक्षित_करना अलग_निकालना पृथक_निकालना
approximate: भाँपना ताड़ना लखना भांपना भापना
argue: वितंडा_करना दलीलबाज़ी_करना बाल_की_खाल_निकालना
argufy: लड़ना झगड़ना झगड़ा_करना लड़ाई_करना तकरार_करना उलझना कलह_करना किचकिच_करना अखड़ाना अपड़ाना अरुझाना अलुझना
arise: पैदा_होना उत्पन्न_होना उठना आना
arouse: जागना जगना उठना आँख_खोलना सोकर_उठना जगाना साधना साधन_करना जगाना सचेत_करना
arrange: निर्धारित_करना नियत_करना सुनिश्चित_करना निश्चित_करना ठहराना तय_करना कायम_करना मंचन_करना
arrest: बंदी_बनाना बंदी_बना_लेना क़ैद_करना कैद_करना गिरफ्तार_करना गिरफ़्तार_करना पकड़ना पकड़_लेना गिरफ़्त_में_लेना गिरफ्त_में_लेना हिरासत_में_लेना अरेस्ट_करना
arrive_at: आना पहुँचना पहुंचना पधारना अवना आगमना
ascend: चढ़ना उठना
ask: देखना पूछना पूँछना पूछताछ_करना माँग_होना
asperse: चुग़ली_करना चुग़ली_खाना चुगली_करना चुगली_लगाना चुगली_खाना लगाना_बुझाना चुगली_जड़ना
asphyxiate: दम_घुटना साँस_अटकना साँस_रुँधना श्वासावरोध_होना
assert: कसम_खाना सौगंध_खाना सौगन्ध_खाना कसम_लेना सौगंध_लेना सौगन्ध_लेना
assess: मूल्यांकन_करना मूल्य_लगाना
assist: सहायता_करना मदद_करना सहयोग_करना हाथ_देना हाथ_थामना हाथ_बढ़ाना हाथ_बँटाना सेना सेवा_करना अवराधना
assoil: बरी_करना अपराध_मुक्त_करना दोष_मुक्त_करना रिहा_करना छोड़ना
assuage: मनाना मनुहारना मान_मनुहार_करना बुझना
assure: कहना बोलना वचन_देना वादा_करना ज़बान_देना करार_करना क़रार_करना क़रार_देना करार_देना
astonish: आश्चर्यचकित_होना भौचक्का_होना अकबकाना हकबकाना
astound: आश्चर्यचकित_होना भौचक्का_होना अकबकाना हकबकाना
attach: संलग्न_करना जोड़ना संबद्ध_करना
attain: पहुँचना पहुंचना आना पहुँचना पहुंचना पधारना अवना आगमना
attend: सेना सेवा_करना अवराधना
attend_to: सेना सेवा_करना अवराधना
attract: आकर्षित_करना खींचना लुभाना आकृष्ट_करना आकर्षना
auction: नीलाम_करना
auction_off: नीलाम_करना
auctioneer: नीलाम_करना
audit: जाँचना जाँच_करना जांचना जांच_करना
avenge: प्रतिशोध_लेना बदला_चुकाना हिसाब_बराबर_करना क़सर_निकालना
aver: कसम_खाना सौगंध_खाना सौगन्ध_खाना कसम_लेना सौगंध_लेना सौगन्ध_लेना
avow: कसम_खाना सौगंध_खाना सौगन्ध_खाना कसम_लेना सौगंध_लेना सौगन्ध_लेना
await: टपना
awake: जागना जगना उठना आँख_खोलना सोकर_उठना
awaken: जगाना सचेत_करना जागना जगना उठना आँख_खोलना सोकर_उठना
award: सम्मान_देना सम्मानित_करना
baa: मिमियाना मेमियाना मेंकना में_में_करना
back_away: पीछे_हटना
back_out: पीछे_हटना
back_up: अवरुद्ध_होना फँसना फंसना बाधा_पड़ना रुँधना रुंधना बंद_होना
badger: छेड़ना छेड़छाड़_करना छेड़खानी_करना
bag: हड़पना कब्ज़ा_करना हथियाना गटकना पचाना पचा_लेना हज़म_करना हजम_करना हज्म_करना खाना डकारना कब्ज़ा_जमाना कब्ज़ा_जमा_लेना
bait: उघटना उकटना उगटना
balk: अड़ना अँड़ियाना अड़ियाना हठ_करना जिदियाना ज़िदियाना जिद_करना ज़िद_करना टेकना अरना
ball_over: सकपकाना चकपकाना भौंचक्का_होना भौचक्का_होना चौंकना उछकना उझकना
bandage: मढ़ना
bang: सटाना
bank: विश्वास_करना ठीक_मान_लेना पतियाना भरोसा_करना यकीन_करना पतिआना पतीजना
bankrupt: दिवालिया_बनाना दिवाला_निकालना दिवालिया_करना
banquet: भोज_देना दावत_देना
bar: बंद_कराना बन्द_कराना ब्लॉक_कराना ब्लॉक_करा_देना ब्लाक_कराना ब्लाक_करा_देना
bare: नंगियाना नंगा_करना उघाड़ना उघारना
barf: उगलना उगिलना उग्रहना
bark: भौंकना भूँकना भों-भों_करना भौं-भौं_करना भूँ-भूँ_करना
barricade: बंद_कराना बन्द_कराना ब्लॉक_कराना ब्लॉक_करा_देना ब्लाक_कराना ब्लाक_करा_देना
bask: आनंद_लेना आनन्द_लेना मजा_लेना लुत्फ_लेना लुत्फ़_लेना लुत्फ_उठाना लुत्फ़_उठाना आनंद_उठाना आनन्द_उठाना मौज_करना मस्ती_करना मौज-मस्ती_करना मौज_मस्ती_करना
baste: कूटना कुटाई_करना तागना
bath: निमज्जन_करना अवगाहना
bathe: नहाना स्नान_करना अन्हाना निमज्जन_करना अवगाहना
batter: कूटना कुटाई_करना
baulk: अड़ना अँड़ियाना अड़ियाना हठ_करना जिदियाना ज़िदियाना जिद_करना ज़िद_करना टेकना अरना
bawl_out: धिक्कारना फटकारना लानत-मलामत_करना
be: लगना आक्रमण_होना हमला_होना निभाना अदा_करना जीना जीवित_रहना जीवन_यापन_करना जीवन_बिताना गुजर-बसर_करना पड़ना
be_adrift: चलना
be_after: इरादा_होना विचार_होना
be_born: जन्म_लेना जनमना जन्मना पैदा_होना प्रसूत_होना आना
be_intimate: सटाना
be_sick: उगलना उगिलना उग्रहना
beam: चमकना जगमगाना झलझलाना दमकना जगजगाना झलकना
bear: पैदा_करना जन्म_देना जन्माना जनना उत्पन्न_करना जनमाना अपमान_सहना बरदाश्त_करना जहर_का_घूंट_पीना होना
bear_in_mind: ध्यान_में_रखना याद_रखना स्मरण_रखना
bear_on: बनाए_रखना जीवित_रखना जिंदा_रखना जिन्दा_रखना बरक़रार_रखना बरकरार_रखना
beat: मारना पीटना प्रहार_करना ठोंकना ठोकना पिटाई_करना धुनना धुनाई_करना ताड़ना लगाना रसीद_करना हनन_करना पीटना फेंटना लहरना लहराना फहरना उड़ना फरफराना
beat_up: मारना पीटना प्रहार_करना ठोंकना ठोकना पिटाई_करना धुनना धुनाई_करना ताड़ना लगाना रसीद_करना हनन_करना
beautify: शोभान्वित_होना शोभित_होना शोभना फबना शोभायमान_होना सजाना सँवारना अलंकृत_करना सज्जित_करना सँजोना संजोना
becharm: मोहना मोहित_करना रिझाना लुभाना मोह_लेना
become: बनना तैयार_होना खिलना जँचना जमना फबना खुलना अच्छा_लगना शोभना शोभित_होना उगना
bed: बिस्तर_देना सटाना
bedamn: कोसना
bedazzle: चौंधियाना
bedevil: भ्रमित_होना चकित_होना अक़ल_चकराना भ्रम_होना चकराना
beetle: लटकना
befool: उल्लू_बनाना बनाना
befuddle: भ्रमित_होना चकित_होना अक़ल_चकराना भ्रम_होना चकराना
beg: भीख_माँगना भिक्षा_माँगना
begin: उठाना चलाना छेड़ना आरम्भ_करना आरंभ_करना शुरू_करना निकालना छिड़ना ठनना शुरू_होना आरंभ_होना प्रारंभ_होना आरम्भ_होना प्रारम्भ_होना उठाना आना
begrime: मचाना गंदा_करना मलिन_करना
beguile: मोहना मोहित_करना रिझाना लुभाना मोह_लेना
behave: व्यवहार_करना बर्ताव_करना करना पेश_आना आचरण_करना आचरना
belch: डकारना
beleaguer: छेड़ना छेड़छाड़_करना छेड़खानी_करना
believe: समझना मानना
bellow: गरजना दहाड़ना
bemire: मचाना गंदा_करना मलिन_करना
bend: नवाना झुकाना
benefit: फलना फल_देना
benumb: सोना
bequeath: वसीयत_करना
berate: धिक्कारना फटकारना लानत-मलामत_करना
beseech: निवेदन_करना विनती_करना विनय_करना प्रार्थना_करना अनुनय_करना दुआ_करना अनुरोध_करना अनुराधना अपील_करना
beset: सताना उत्पीड़ित_करना ताड़ना प्रताड़ना तपाना कष्ट_देना दुखी_करना दुःखी_करना पीड़ा_देना पेरना परेशान_करना तंग_करना तंङ्ग_करना नाक_में_दम_करना पीड़ित_करना अप्रसन्न_करना हैरान_करना नींद_हराम_करना नींद_उड़ाना उँगली_करना उंगली_करना अरूरना अर्दना अवडेरना अवसेरना
beshrew: कोसना
besmirch: चुग़ली_करना चुग़ली_खाना चुगली_करना चुगली_लगाना चुगली_खाना लगाना_बुझाना चुगली_जड़ना
bespeak: माँगना मांगना अर्थना हाथ_फैलाना आगे_हाथ_फैलाना
besprinkle: सींचना छिड़कना
bestride: चढ़ना सवार_होना बैठना आरोहित_होना अरोहना सवारी_करना
betray: बहलना बहकना फुसलना
betroth: रोकना
better: बढ़ाना विकसित_करना उन्नत_करना बिकसाना ऊंचा_उठाना ऊँचा_उठाना सुधरना
bewitch: मोहना मोहित_करना रिझाना लुभाना मोह_लेना
bid: देना प्रदान_करना शुभकामना_देना निवेदन_करना विनती_करना विनय_करना प्रार्थना_करना अनुनय_करना दुआ_करना अनुरोध_करना अनुराधना अपील_करना
bide: बसना डेरा_डालना
bind: चिपकना सटना मढ़ना मढ़ना बँधना बंधना
binge: अघाना अफराना
birr: घरघराना घर्रघराना घड़घड़ना घुरघुराना घुर्रघुराना
birth: पैदा_करना जन्म_देना जन्माना जनना उत्पन्न_करना जनमाना
bite: काटना परपराना डसना डँसना काटना
blab: बकवास_करना बकना बकबक_करना बकबकाना प्रलाप_करना
blabber: बकवास_करना बकना बकबक_करना बकबकाना प्रलाप_करना
black_market: अवैध_सौदा_करना अवैधानिक_सौदा_करना गैरकानूनी_सौदा_करना ग़ैरकानूनी_सौदा_करना
blackguard: उपहास_करना खिल्ली_उड़ाना मज़ाक_उड़ाना हँसी_उड़ाना गाली_देना गाली_बकना अपशब्द_कहना गरियाना
blame: मढ़ना लगाना थोपना ठेलना ढकेलना मढ़_देना
blank_out: भूलना भूल_जाना विस्मरण_करना बिसारना बिसरना विस्मृत_करना
blarney: फुसलाना बहलाना बहकाना बरगलाना बर्गलाना
blat: मिमियाना मेमियाना मेंकना में_में_करना
blate: मिमियाना मेमियाना मेंकना में_में_करना
blaze: दहकना धधकना धकधकाना लहकना
bleat: मिमियाना मेमियाना मेंकना में_में_करना
blend: मिलना अमेजना
bless: आशीर्वाद_देना दुआ_देना आशीष_देना असीसना अभिमंत्रण_करना अभिमंत्रित_करना
blink: मीचना
block: बंद_कराना बन्द_कराना ब्लॉक_कराना ब्लॉक_करा_देना ब्लाक_कराना ब्लाक_करा_देना रहना रह_जाना अड़ाना अराना भूलना भूल_जाना विस्मरण_करना बिसारना बिसरना विस्मृत_करना
block_off: बंद_कराना बन्द_कराना ब्लॉक_कराना ब्लॉक_करा_देना ब्लाक_कराना ब्लाक_करा_देना
block_up: बंद_कराना बन्द_कराना ब्लॉक_कराना ब्लॉक_करा_देना ब्लाक_कराना ब्लाक_करा_देना
blockade: बंद_कराना बन्द_कराना ब्लॉक_कराना ब्लॉक_करा_देना ब्लाक_कराना ब्लाक_करा_देना
bloom: खिलना फूलना चिटकना चटकना फूटना प्रस्फुटित_होना विकसित_होना बिकसना लगना
blossom: खिलना फूलना चिटकना चटकना फूटना प्रस्फुटित_होना विकसित_होना बिकसना लगना
blow: फूँकना फूंकना सनसनाना छिनकना छिरकना सिनकना चलना झोंकना फूँकना फूंकना फूँकना फूंकना शेखी_बघारना बघारना डींग_हाँकना डींग_मारना
blow_out: बुझाना बुताना
blow_out_of_the_water: सकपकाना चकपकाना भौंचक्का_होना भौचक्का_होना चौंकना उछकना उझकना
blow_up: फोड़ना छोड़ना फुलाना
blub: पिनपिनाना
blubber: पिनपिनाना
blunt: सोना
blush: लज्जित_होना शर्मिन्दा_होना लजाना शरमाना शर्माना झेंपना झेंप_जाना
bluster: शेखी_बघारना बघारना डींग_हाँकना डींग_मारना
boast: शेखी_बघारना बघारना डींग_हाँकना डींग_मारना दिखाना
bob: पूँछ_काटना
bob_up: उठना आना
boggle: ठिठकना ठक_रह_जाना स्तम्भित_होना
boil: उबलना खौलना उखलना उबालना खौलाना
boil_down: गढ़ाना गाढ़ा_करना
bolster: बढ़ाना साथ_देना सहारा_देना
bolster_up: बढ़ाना साथ_देना सहारा_देना
bolt: भक्षण_करना भखना भकोसना
bomb: अनुत्तीर्ण_होना फेल_होना
bombilate: गूँजना गुँजना गुंजारना गूंजना गुंजना गुनगुनाना
bombinate: गूँजना गुँजना गुंजारना गूंजना गुंजना गुनगुनाना
bond: चिपकना सटना मिलाना
bonk: सटाना
book: आरक्षित_करना रोकना
boost: बढ़ाना तेज_करना तेज़_करना तीव्र_करना
boot_out: निकालना बहिराना बहरियाना निर्गत_करना बाहर_का_रास्ता_दिखाना बाहर_करना
booze: नशाना नसाना
border: सीमा_निर्धारित_करना सीमा_निश्चित_करना किनारी_बनाना बार्डर_बनाना सीमा_पर_होना सरहद_पर_होना किनारे_पर_होना
bore: छेदना छेद_करना बेधना भेदना सालना छालना
borrow: उधार_लेना
bosom: गले_लगाना गले_मिलना आलिंगन_करना आलिङ्गन_करना चिपटाना लिपटाना अँकवारना अँकोरना अंकवारना अंकोरना अंग_लगाना अरसना-परसना आलिंगना आलिङ्गना
bother: झंझट_में_डालना अवडेरना
bound: कूदना सीमा_निर्धारित_करना सीमा_निश्चित_करना
bourgeon: अंकुर_निकलना अँखुआना जमना अँकुरना अंकुरना अंकुर_फूटना अंकुरित_होना उकसना उकिसना
bowl: लुढ़कना ढुलकना ढुलना ढनमनाना
brace: जगाना साधना साधन_करना
brag: शेखी_बघारना बघारना डींग_हाँकना डींग_मारना
brandish: घुमाना नचाना
bray: रेंकना जाँतना जातना जांतना
break: तोड़ना समाप्त_करना खत्म_करना फटना फूटना तोड़ना फोड़ना तोड़_देना फोड़_देना भग्न_करना टोरना तोरना भंग_करना फूटना खुलना उघड़ना उघरना उघढ़ना भांडा_फूटना भंडा_फूटना पर्दाफ़ाश_होना परदाफ़ाश_होना परदाफाश_होना पर्दाफाश_होना बेनक़ाब_होना बेनकाब_होना रहस्योद्घाटन_होना लीक_होना टूटना अलग_होना दिवालिया_बनाना दिवाला_निकालना दिवालिया_करना ढहना गिरना गिर_पड़ना फूटना भग्न_होना टुकड़े_करना तोड़ना तोरना तड़कना चिटकना चटकना चनकना तिड़कना चुरकना टूटना
break_away: टूटना उढ़रना भगना भागना
break_loose: फ़रार_होना फरार_होना भागना ग़ायब_होना चंपत_होना रफ़ू_चक्कर_होना रफू_चक्कर_होना पलायन_करना चम्पत_होना चम्पत_हो_जाना चंपत_हो_जाना काफूर_होना काफ़ूर_होना काफूर_हो_जाना काफ़ूर_हो_जाना अपावर्तन
break_off: टुकड़े_करना तोड़ना तोरना तोड़ना टोरना तोरना
break_open: फटना
break_up: अलग_होना घोलना घोरना मिलाना मिश्रित_करना सम्मिश्रित_करना टूटना
break_wind: पादना पाद_छोड़ना
breathe: साँस_लेना सांस_लेना श्वसन_करना श्वास_लेना श्वासोच्छवास_करना सुस्ताना आराम_करना विश्राम_करना थकान_उतारना थकान_मिटाना दम_भरना आराम_फरमाना कमर_सीधी_करना कमर_खोलना
bribe: चटाना खिलाना घूस_देना रिश्वत_देना ज़ेब_गर्म_करना जेब_गर्म_करना ज़ेब_गरम_करना जेब_गरम_करना
bring: लाना ले_आना आनना पहुँचाना पहुंचाना करना
bring_back: लौटाना फेरना वापस_करना पलटाना फिराना
bring_down: उतारना अवतारना कटौती_करना
bring_forth: उत्पादन_करना उत्पन्न_करना पैदा_करना अवतारना उतपाना
bring_home_the_bacon: भरण-पोषण_करना
bring_out: खोलना उघाड़ना उघारना भांडा_फोड़ना भंडा_फोड़ना परदाफ़ाश_करना पर्दाफ़ाश_करना परदाफाश_करना पर्दाफाश_करना बेनक़ाब_करना बेनकाब_करना पर्दा_उठाना परदा_उठाना पर्दा_खोलना परदा_खेलना पर्दा_हटाना परदा_हटाना पोल_खोलना पोल-पट्टी_खोलना रहस्योद्घाटन_करना निकलना प्रकाशित_होना खुलना उघड़ना उघरना उघढ़ना भांडा_फूटना भंडा_फूटना पर्दाफ़ाश_होना परदाफ़ाश_होना परदाफाश_होना पर्दाफाश_होना बेनक़ाब_होना बेनकाब_होना रहस्योद्घाटन_होना लीक_होना
bring_through: उबरना उद्धार_पाना निस्तार_पाना मुक्त_होना
bring_together: मिलाना
bring_up: पालना परवरिश_करना पालन-पोषण_करना पालन_करना पोषना पालना-पोषना उठाना उल्लेख_करना जिक्र_करना ज़िक्र_करना
brood: रूठना मुँह_फुलाना रुष्ट_होना रिसाना रूसना फूलना अनखना अनसाना अनखाना अनैसना सेना
brook: अपमान_सहना बरदाश्त_करना जहर_का_घूंट_पीना
broom: बुहारना झाड़ू_देना झाड़ू_लगाना बहारना
browbeat: धमकाना धमकी_देना हड़काना
browse: चरना
bruise: चुभना खटकना बुरा_लगना अप्रिय_लगना कूटना कुटाई_करना
brush: झाड़ना
brush_aside: निरस्त_करना रद्द_करना निरस्त_कर_देना रद्द_कर_देना ख़ारिज_करना खारिज_करना ख़ारिज_कर_देना खारिज_कर_देना
brush_off: निरस्त_करना रद्द_करना निरस्त_कर_देना रद्द_कर_देना ख़ारिज_करना खारिज_करना ख़ारिज_कर_देना खारिज_कर_देना
bubble: खदबदाना खदफदाना डकारना
buckle_under: अधीन_होना अधीनना आधीन_होना
bud: कलियाना कली_निकलना
budge: सरकना खिसकना खसकना हटना टसकना हिलना डिगना अपसवना डगना
bug: छेड़ना छेड़छाड़_करना छेड़खानी_करना
bug_out: उभरना उभड़ना उकसना उकिसना उझकना
build: उठना बनना तैयार_होना बनवाना तैयार_करवाना निर्माण_करवाना गठना
bulge: उभरना उभड़ना उकसना उकिसना उझकना
bulge_out: उभरना उभड़ना उकसना उकिसना उझकना
bully: धमकाना धमकी_देना हड़काना
bumble: तुतलाना तुतराना तोतलाना
bump: टकराना भिड़ाना
bump_off: मारना हत्या_करना प्राण_लेना जान_लेना मौत_के_घाट_उतारना हत_करना उड़ाना हनना वध_करना कत्ल_करना प्राण_निकालना जान_निकालना संहारना हनन_करना अरदना मौत_की_नींद_सुलाना जान_से_मारना खून_करना ख़ून_करना मार_डालना ठिकाने_लगाना ठिकाने_पहुँचाना
bunch: बाँधना बांधना पिंड_बनाना पिंडित_करना
bunch_up: बाँधना बांधना पिंड_बनाना पिंडित_करना
bunco: ठगना ऐंठना झटकना मूड़ना मूँड़ना लूटना झाड़ना मूसना
bundle: बाँधना बांधना पिंड_बनाना पिंडित_करना
bunk: उढ़रना भगना भागना
bunk_off: छुट्टी_मारना छुट्टी_पर_रहना छुट्टी_मनाना
burden: गरुआना लादना
burgeon_forth: अंकुर_निकलना अँखुआना जमना अँकुरना अंकुरना अंकुर_फूटना अंकुरित_होना उकसना उकिसना
burn: परपराना अगियाना अगिआना दागना दाग़ना आँकना आंकना चिलचिलाना आग_लगना
burp: डकारना
burst: फूटना फूटना
burst_out: फूटना फटना
burthen: गरुआना
bury: दबाना गाड़ना दबा_देना गाड़_देना
bushel: मरम्मत_करना ठीक_करना दुरुस्त_करना बनाना
bushwhack: घात_लगाना घतियाना घात_में_बैठना ताक_में_बैठना ताक_में_रहना मौक़ा_ढूढना
buss: चूमना चुंबन_लेना चुम्मा_लेना चुंबना
bust: फाड़ना चीरना बिदराना फूटना भग्न_होना
busy: लगना जुटना लिपटना व्यस्त_रहना लगा_रहना
butt: सीमा_पर_होना सरहद_पर_होना किनारे_पर_होना
butt_against: सीमा_पर_होना सरहद_पर_होना किनारे_पर_होना
butt_on: सीमा_पर_होना सरहद_पर_होना किनारे_पर_होना
butterfly: नख़रे_दिखाना चोचले_करना नाज़_नख़रा_करना बनना
buy: चटाना खिलाना घूस_देना रिश्वत_देना ज़ेब_गर्म_करना जेब_गर्म_करना ज़ेब_गरम_करना जेब_गरम_करना
buy_the_farm: मरना मर_जाना परलोक_सिधारना गुजरना गुज़रना दम_तोड़ना चल_बसना मौत_होना अलविदा_कहना लुढ़कना ढेर_होना प्राण_त्यागना प्राण_निकलना जान_जाना जान_चली_जाना
buzz: गूँजना गुँजना गुंजारना गूंजना गुंजना गुनगुनाना
ca-ca: हगना झाड़ा_फिरना पाखाना_करना पाख़ाना_करना टट्टी_करना मलत्याग_करना दिशा_मैदान_करना दिशा_मैदान_जाना करना
cajole: फुसलाना बहलाना बहकाना बरगलाना बर्गलाना
call: नाम_देना नाम_रखना नामित_करना चिल्लाना चिंघाड़ना बँकारना भौंकना कहना पुकारना बोलना बुलाना
call_back: याद_होना स्मरण_होना जुबान_पर_होना
call_down: धिक्कारना फटकारना लानत-मलामत_करना
call_for: माँगना मांगना अर्थना हाथ_फैलाना आगे_हाथ_फैलाना माँग_होना निमंत्रित_करना निमंत्रण_देना आमंत्रित_करना बुलाना निमन्त्रित_करना निमन्त्रण_देना निमंत्रना निमन्त्रना न्योतना नेवतना नेउतना न्यौता_देना तलब_करना अमातना
call_on_the_carpet: धिक्कारना फटकारना लानत-मलामत_करना
call_out: चिल्लवाना चिलवाना पुकारना पुकार_लगाना आवाज़_देना आवाज_देना
call_up: याद_होना स्मरण_होना जुबान_पर_होना
calm: बुझाना ठंडा_करना शांत_करना पटाना शांत_होना शान्त_होना
calm_down: पटाना शांत_होना शान्त_होना बुझाना ठंडा_करना शांत_करना
calumniate: चुग़ली_करना चुग़ली_खाना चुगली_करना चुगली_लगाना चुगली_खाना लगाना_बुझाना चुगली_जड़ना
camouflage: छद्मावरण_से_छिपाना रूप_बदलना
campaign: लड़ना लड़ाई_करना
can: निकालना बाहर_करना
captivate: मोहना मोहित_करना रिझाना लुभाना मोह_लेना
capture: मोहना मोहित_करना रिझाना लुभाना मोह_लेना धर_दबोचना
card: धुनना धुनकना पींजना
care: इच्छा_होना चाहना मन_होना अभिलाषा_होना अभिलाखना बाँछना आखना सँभलना संभलना सम्हलना पड़ना चिन्ता_होना
careen: डगमगाना लड़खड़ाना डगडोलना अलुटना डगना उखटना
cark: घबराना घबड़ाना बेचैन_होना व्याकुल_होना अकुलाना बिकलाना बेकलाना उकताना
carry: ढोना वहन_करना भावाभिव्यक्ति_करना अभिव्यंजना_करना भावाभिव्यक्त_करना भाव_अभिव्यक्त_करना ढोना वहन_करना होना
carry_on: बनाए_रखना जीवित_रखना जिंदा_रखना जिन्दा_रखना बरक़रार_रखना बरकरार_रखना
carry_through: उबरना उद्धार_पाना निस्तार_पाना मुक्त_होना
carve: तराशना
carve_up: अधियाना आधा_करना
cash: चेक_भुनाना चेक_भुनवाना
cash_in: चेक_भुनाना चेक_भुनवाना
cash_in_one's_chips: मरना मर_जाना परलोक_सिधारना गुजरना गुज़रना दम_तोड़ना चल_बसना मौत_होना अलविदा_कहना लुढ़कना ढेर_होना प्राण_त्यागना प्राण_निकलना जान_जाना जान_चली_जाना
cast: भटकना ख़ाक_छानना भरमना ढालना उगलना उगिलना उग्रहना
cast_aside: फेंकना थ्रो_करना
cast_away: फेंकना थ्रो_करना
cast_down: हतोत्साहित_होना बुझना ठंडा_पड़ना
cast_out: फेंकना थ्रो_करना
castrate: बधियाना बधिया_करना बधिया_बनाना
cat: उगलना उगिलना उग्रहना
catch: पकड़ना धर_दबोचना पकड़ना देखना मोहना मोहित_करना रिझाना लुभाना मोह_लेना
catch_fire: जलना सुलगना दग्ध_होना दहना सिलगना अगियाना अगिआना
catch_one's_breath: सुस्ताना आराम_करना विश्राम_करना थकान_उतारना थकान_मिटाना दम_भरना आराम_फरमाना कमर_सीधी_करना कमर_खोलना
catch_some_z's: सोना
catch_up: पकड़ना
cause: कारण_होना
cauterise: दागना दाग़ना आँकना आंकना
cauterize: दागना दाग़ना आँकना आंकना
cave_in: ढहना गिरना गिर_पड़ना
cavort: उछल-कूद_करना कूद-फाँद_करना कूदफाँद_करना
cease: छोड़ना छोड़_देना अलविदा_कहना छूटना छूट_जाना
cede: घुटने_टेकना हथियार_डालना हार_मानना झुकना नवना हाथ_खड़े_करना सौंपना छोड़ना सुपुर्द_करना हवाले_करना सौंप_देना छोड़_देना सुपुर्द_कर_देना हवाले_कर_देना
celebrate: उत्सव_मनाना मनाना
center: ध्यान_देना ध्यान_केंद्रित_करना ध्यान_केन्द्रित_करना गौर_करना ग़ौर_करना
centre: ध्यान_देना ध्यान_केंद्रित_करना ध्यान_केन्द्रित_करना गौर_करना ग़ौर_करना
cerebrate: सोचना विचारना विचार_करना देखना सोंचना अनुसंधानना अनुसन्धानना अवगतना
chafe: खीजना झुँझलाना खिजलाना खिजना कुढ़ना
chaffer: बात_करना बातचीत_करना बतियाना वार्तालाप_करना बोलना-बतियाना बोलना बोलना_बतियाना
challenge: चुनौती_देना ललकारना
change: बनाना कर_देना करना बना_देना परिवर्तित_करना बदलना बदलाव_आना परिवर्तित_होना परिवर्तन_आना बदल_जाना तब्दील_होना बदलवाना बदली_कराना बदलना बदल_देना
change_by_reversal: उलटना पलटना
change_state: घुमाना घुमा_देना मोड़ना मोड़_देना
chap: तड़कना दरकना चिटकना चटकना तिड़कना चुरकना अरकना
characterise: विशेषता_होना
characterize: विशेषता_होना
charge: उकसाना चढ़ाना भड़काना उभाड़ना उभारना उसकाना उकतारना उगसाना उचटाना लादना मढ़ना लगाना थोपना ठेलना ढकेलना मढ़_देना
charge_up: उकसाना चढ़ाना भड़काना उभाड़ना उभारना उसकाना उकतारना उगसाना उचटाना
charm: मोहना मोहित_करना रिझाना लुभाना मोह_लेना
charter: किराए_पर_लेना भाड़े_पर_लेना करना
chase: दौड़ाना भगाना
chase_after: दौड़ाना भगाना
chase_away: भगाना
chat: बात_करना बातचीत_करना बतियाना वार्तालाप_करना बोलना-बतियाना बोलना बोलना_बतियाना
chat_up: नख़रे_दिखाना चोचले_करना नाज़_नख़रा_करना बनना
chatter: किटकिटाना कटकटाना कचकचाना किचकिचाना बात_करना बातचीत_करना बतियाना वार्तालाप_करना बोलना-बतियाना बोलना बोलना_बतियाना बकवास_करना बकना बकबक_करना बकबकाना प्रलाप_करना
cheat: ठगाना लुटाना मुड़ाना मुँड़ाना
check: सँभालना संभालना सम्हालना जँचना जाँचा_जाना तड़कना चिटकना चटकना चनकना तिड़कना चुरकना
check_out: जँचना जाँचा_जाना
cheep: कलरव_करना चहकना चहचहाना
cheer: प्रसन्न_होना खुश_होना हर्षित_होना हर्षना आनंदना आनन्दना हुलसना आहलाना हरखना
cheer_up: प्रसन्न_होना खुश_होना हर्षित_होना हर्षना आनंदना आनन्दना हुलसना आहलाना हरखना
chevvy: सताना उत्पीड़ित_करना ताड़ना प्रताड़ना तपाना कष्ट_देना दुखी_करना दुःखी_करना पीड़ा_देना पेरना परेशान_करना तंग_करना तंङ्ग_करना नाक_में_दम_करना पीड़ित_करना अप्रसन्न_करना हैरान_करना नींद_हराम_करना नींद_उड़ाना उँगली_करना उंगली_करना अरूरना अर्दना अवडेरना अवसेरना
chevy: सताना उत्पीड़ित_करना ताड़ना प्रताड़ना तपाना कष्ट_देना दुखी_करना दुःखी_करना पीड़ा_देना पेरना परेशान_करना तंग_करना तंङ्ग_करना नाक_में_दम_करना पीड़ित_करना अप्रसन्न_करना हैरान_करना नींद_हराम_करना नींद_उड़ाना उँगली_करना उंगली_करना अरूरना अर्दना अवडेरना अवसेरना
chew: चबाना
chew_out: धिक्कारना फटकारना लानत-मलामत_करना
chew_the_fat: बात_करना बातचीत_करना बतियाना वार्तालाप_करना बोलना-बतियाना बोलना बोलना_बतियाना
chew_up: धिक्कारना फटकारना लानत-मलामत_करना
chide: धिक्कारना फटकारना लानत-मलामत_करना
chill: ठंडाना ठंडा_होना
chill_out: पटाना शांत_होना शान्त_होना
chink: टनटनाना
chip: तोड़ना टोरना तोरना
chirk_up: प्रसन्न_होना खुश_होना हर्षित_होना हर्षना आनंदना आनन्दना हुलसना आहलाना हरखना
chirp: कलरव_करना चहकना चहचहाना
chirrup: कलरव_करना चहकना चहचहाना
chisel: ठगाना लुटाना मुड़ाना मुँड़ाना
chitchat: बात_करना बातचीत_करना बतियाना वार्तालाप_करना बोलना-बतियाना बोलना बोलना_बतियाना
chitter: चहकना चहचहाना उमगना
chivvy: सताना उत्पीड़ित_करना ताड़ना प्रताड़ना तपाना कष्ट_देना दुखी_करना दुःखी_करना पीड़ा_देना पेरना परेशान_करना तंग_करना तंङ्ग_करना नाक_में_दम_करना पीड़ित_करना अप्रसन्न_करना हैरान_करना नींद_हराम_करना नींद_उड़ाना उँगली_करना उंगली_करना अरूरना अर्दना अवडेरना अवसेरना
chivy: सताना उत्पीड़ित_करना ताड़ना प्रताड़ना तपाना कष्ट_देना दुखी_करना दुःखी_करना पीड़ा_देना पेरना परेशान_करना तंग_करना तंङ्ग_करना नाक_में_दम_करना पीड़ित_करना अप्रसन्न_करना हैरान_करना नींद_हराम_करना नींद_उड़ाना उँगली_करना उंगली_करना अरूरना अर्दना अवडेरना अवसेरना
choke: अवरुद्ध_होना फँसना फंसना बाधा_पड़ना रुँधना रुंधना बंद_होना मरना मर_जाना परलोक_सिधारना गुजरना गुज़रना दम_तोड़ना चल_बसना मौत_होना अलविदा_कहना लुढ़कना ढेर_होना प्राण_त्यागना प्राण_निकलना जान_जाना जान_चली_जाना
choke_off: अवरुद्ध_होना फँसना फंसना बाधा_पड़ना रुँधना रुंधना बंद_होना
choose: छाँटना बीनना चुनना अलगाना छांटना बराना बाँछना उछाँटना
chop_off: छाँटना छाँट_देना
chuck: उगलना उगिलना उग्रहना
chuck_out: फेंकना थ्रो_करना निकालना बहिराना बहरियाना निर्गत_करना बाहर_का_रास्ता_दिखाना बाहर_करना
churn: मथना महना बिलोना मंथन_करना बिलोड़ना गाहना विलोड़ना विलोना अवगाहना आलोड़ना
circle: मंडराना मडराना मँडराना मंडलाना मँडलाना चक्कर_काटना
circulate: उड़ाना फैलाना
circumscribe: रोक_लगाना पाबंदी_लगाना पाबन्दी_लगाना रोक_लगा_देना पाबंदी_लगा_देना पाबन्दी_लगा_देना बंदिश_लगाना बन्दिश_लगाना निषेध_करना प्रतिबंध_लगाना प्रतिबंधित_करना प्रतिबन्ध_लगाना प्रतिबन्धित_करना बैन_लगाना
circumvent: टालमटोल_करना टरकाना टालना आज_कल_करना
cite: उल्लेख_करना जिक्र_करना ज़िक्र_करना
clack: बकवास_करना बकना बकबक_करना बकबकाना प्रलाप_करना
clapperclaw: गाली_देना गाली_बकना अपशब्द_कहना गरियाना
claver: बात_करना बातचीत_करना बतियाना वार्तालाप_करना बोलना-बतियाना बोलना बोलना_बतियाना
claw: नखियाना
clean: छुड़ाना छोड़ाना निकालना
clean_up: सुव्यवस्थित_करना सुविन्यस्त_करना सुप्रबंधित_करना
clear: फरियाना शुद्ध_लाभ_होना शुद्ध_बचत_होना शुद्ध_आय_होना शुद्ध_आमदनी_होना निवल_आय_होना निवल_लाभ_होना शुद्ध_लाभ_कमाना शुद्ध_बचत_करना शुद्ध_आय_करना शुद्ध_आमदनी_करना निवल_आय_करना निवल_लाभ_करना बरी_करना अपराध_मुक्त_करना दोष_मुक्त_करना रिहा_करना छोड़ना
cleave: सटना चिपकना जुड़ना जुटना
clench: जकड़ना
click: किटकिटाना कटकटाना कचकचाना किचकिचाना
climb_down: उतरना अवरोहना अवतरण_करना
climb_on: चढ़ना सवार_होना बैठना आरोहित_होना अरोहना सवारी_करना
climb_up: चढ़ना
clinch: जकड़ना
cling: सटना चिपकना जुड़ना जुटना
clink: टनटनाना
clip: छाँटना
clobber: कूटना कुटाई_करना
clock: समय_मापना समयावधि_मापना काल_मापना
clog: अवरुद्ध_होना फँसना फंसना बाधा_पड़ना रुँधना रुंधना बंद_होना
clog_up: अवरुद्ध_होना फँसना फंसना बाधा_पड़ना रुँधना रुंधना बंद_होना
close: बंद_करना बन्द_करना मूँदना बंद_करना बन्द_करना निपटना खतम_होना खत्म_होना ख़त्म_होना ख़तम_होना समाप्त_होना अंत_होना निबटना
close_down: बंद_करना बन्द_करना
close_up: बंद_करना बन्द_करना अड़ाना अराना
clothe: पहनाना डालना
clump: बाँधना बांधना पिंड_बनाना पिंडित_करना
cluster: बाँधना बांधना पिंड_बनाना पिंडित_करना
coalesce: मिलना अमेजना
coax: फुसलाना बहलाना बहकाना बरगलाना बर्गलाना
cock: इतराना चमकना अँगराना इठलाना झमकना टमकना मटकना अँठलाना अंठलाना
cockle: गींजना
cod: उघटना उकटना उगटना
coggle: ठुमकना ठुनकना थिरकना
cogitate: सोचना विचारना विचार_करना देखना सोंचना अनुसंधानना अनुसन्धानना अवगतना
cognise: जानना ज्ञान_होना ज्ञात_होना मालूम_होना पता_चलना अभिज्ञ_होना परिचित_होना रूबरू_होना आना अवकलना
cognize: जानना ज्ञान_होना ज्ञात_होना मालूम_होना पता_चलना अभिज्ञ_होना परिचित_होना रूबरू_होना आना अवकलना
cohere: सटना चिपकना जुड़ना जुटना
coincide: एक_साथ_होना साथ-साथ_होना
collapse: ढहना गिरना गिर_पड़ना
collar: बंदी_बनाना बंदी_बना_लेना क़ैद_करना कैद_करना गिरफ्तार_करना गिरफ़्तार_करना पकड़ना पकड़_लेना गिरफ़्त_में_लेना गिरफ्त_में_लेना हिरासत_में_लेना अरेस्ट_करना
collect: जोड़ना जमा_करना जुटाना संचित_करना इकट्ठा_करना एकत्रित_करना एकत्र_करना संग्रह_करना संग्रहना संजोना सँजोना एकत्रित_करना इकट्ठा_करना बटोरना समेटना अंजोरना अँजोरना
collide_with: टकराना भिड़ना भिड़ंत_होना टक्कर_खाना लड़ना
colly: मचाना गंदा_करना मलिन_करना
color: रंगना रँगना रंगना रँगना
color_in: रंगना रँगना
colorise: रंगना रँगना
colorize: रंगना रँगना
colour: रंगना रँगना रंगना रँगना
colour_in: रंगना रँगना
colourise: रंगना रँगना
colourize: रंगना रँगना
combine: मिलना मिल_जाना संबद्ध_होना एक_होना एक_हो_जाना मिलना अमेजना
combust: जलना सुलगना दग्ध_होना दहना सिलगना अगियाना अगिआना
come: आना आना पहुँचना पहुंचना मिलना सूझना
come_about: चरितार्थ_होना घटना ठीक_उतरना
come_alive: जागना जगना उठना आँख_खोलना सोकर_उठना
come_along: उन्नत_होना उन्नति_करना उभरना विकास_करना बढ़ना फलना फलना-फूलना चमकना
come_apart: फटना फूटना
come_back: लौटना वापस_आना आना
come_forth: निकलना निर्गत_होना प्रादुर्भूत_होना
come_in: प्रवेश_करना अंदर_आना दाख़िल_होना प्रविष्ट_होना आना घुसना पैठना ढुकना हलना पहुँचना पहुंचना मिलना मिलना पाना प्राप्त_होना
come_on: आना उन्नत_होना उन्नति_करना उभरना विकास_करना बढ़ना फलना फलना-फूलना चमकना
come_out: आना निकलना निर्गत_होना प्रादुर्भूत_होना झड़ना गिरना मिलना पाना प्राप्त_होना उभरना उभड़ना उकसना उकिसना उझकना
come_through: बचना उबरना बच_जाना उबर_जाना
come_to_mind: उठना
come_up: उतराना उठना आना उठना
comfort: सांत्वना_देना समझाना ढाढ़स_बँधाना तसल्ली_देना दिलासा_देना
commence: उठाना चलाना छेड़ना आरम्भ_करना आरंभ_करना शुरू_करना निकालना उठाना
commingle: मिलना अमेजना
comminute: जाँतना जातना जांतना
commit: समर्पित_करना देना लगाना निवेश_करना
commove: उकसाना चढ़ाना भड़काना उभाड़ना उभारना उसकाना उकतारना उगसाना उचटाना हिलाना
commute: बदलवाना बदली_कराना
compass: समझना पकड़ना
compensate: क्षतिपूर्ति_करना नुकसान_भरना नुक़सान_भरना भरपाई_करना
compete: प्रतियोगिता_करना होड़_लगाना प्रतिस्पर्धा_करना भिड़ना लड़ना मुक़ाबला_करना मुक़ाबिला_करना मुकाबला_करना मुकाबिला_करना बहसना
compile: जोड़ना जमा_करना जुटाना संचित_करना इकट्ठा_करना एकत्रित_करना एकत्र_करना संग्रह_करना संग्रहना संजोना सँजोना
complement: पूर्ण_बनाना उत्तम_बनाना
complete: चुकना
compose: संगीत_की_रचना_करना संगीत_रचना रचना लिखना
comprehend: समझना पकड़ना
comprise: बना_होना
con: ठगना ऐंठना झटकना मूड़ना मूँड़ना लूटना झाड़ना मूसना
conceal: छिपाना छुपाना लुकाना
concede: घुटने_टेकना हथियार_डालना हार_मानना झुकना नवना हाथ_खड़े_करना
conceive: समझना
conceive_of: मानना मान_लेना कल्पना_करना फर्ज़_करना फर्ज_करना अवरेवना कयास_लगाना
concentrate: ध्यान_देना ध्यान_केंद्रित_करना ध्यान_केन्द्रित_करना गौर_करना ग़ौर_करना गढ़ाना गाढ़ा_करना
concern: पड़ना
conciliate: मनाना मनुहारना मान_मनुहार_करना
conclude: निपटना निबटना निपटना खतम_होना खत्म_होना ख़त्म_होना ख़तम_होना समाप्त_होना अंत_होना निबटना
concur: एक_साथ_होना साथ-साथ_होना
confab: बात_करना बातचीत_करना बतियाना वार्तालाप_करना बोलना-बतियाना बोलना बोलना_बतियाना
confabulate: बात_करना बातचीत_करना बतियाना वार्तालाप_करना बोलना-बतियाना बोलना बोलना_बतियाना
confine: रोक_लगाना पाबंदी_लगाना पाबन्दी_लगाना रोक_लगा_देना पाबंदी_लगा_देना पाबन्दी_लगा_देना बंदिश_लगाना बन्दिश_लगाना निषेध_करना प्रतिबंध_लगाना प्रतिबंधित_करना प्रतिबन्ध_लगाना प्रतिबन्धित_करना बैन_लगाना
conflagrate: जलना सुलगना दग्ध_होना दहना सिलगना अगियाना अगिआना
conflate: मिलना अमेजना
conform: अनुकूल_होना मुआफिक_होना
confound: भ्रमित_होना चकित_होना अक़ल_चकराना भ्रम_होना चकराना
confront: टक्कर_लेना मुक़ाबला_करना मुकाबला_करना सामना_करना मुक़ाबिला_करना मुकाबिला_करना प्रस्तुत_करना पेश_करना
confuse: भ्रमित_होना चकित_होना अक़ल_चकराना भ्रम_होना चकराना
congest: अवरुद्ध_होना फँसना फंसना बाधा_पड़ना रुँधना रुंधना बंद_होना
conglomerate: जमना एकत्र_होना जमा_होना एकत्रित_होना जुटना गोलियाना इकट्ठा_होना अगटना जुड़ना घुमड़ना
conjoin: मिलना विवाह_करना शादी_करना ब्याहना बियाहना ब्याह_करना हाथ_थामना हाथ_धरना हाथ_पकड़ना
conjure: निवेदन_करना विनती_करना विनय_करना प्रार्थना_करना अनुनय_करना दुआ_करना अनुरोध_करना अनुराधना अपील_करना
conk: मरना मर_जाना परलोक_सिधारना गुजरना गुज़रना दम_तोड़ना चल_बसना मौत_होना अलविदा_कहना लुढ़कना ढेर_होना प्राण_त्यागना प्राण_निकलना जान_जाना जान_चली_जाना
connect: जोड़ना लगाना सटाना जुड़ना लगना जुटना संयुक्त_होना संलग्न_होना संबंध_होना संबद्ध_होना भिड़ना जोड़ना
conquer: दबाना हावी_होना
consecrate: समर्पित_करना देना मानना मन्नत_करना अभिमंत्रण_करना अभिमंत्रित_करना
conserve: सँभालना संभालना सुरक्षित_रखना सम्हालना
consider: लेना ले_लेना समझना मानना
consist: बना_होना
console: सांत्वना_देना समझाना ढाढ़स_बँधाना तसल्ली_देना दिलासा_देना
constitute: स्थापित_करना अधिष्ठित_करना अधिष्ठापित_करना
construct: उठना बनना तैयार_होना
consume: उड़ाना लुटाना खपना लगना उठना खर्च_होना
contact: छुआना छुलाना छुवाना स्पर्श_कराना परसाना
contain: होना सँभालना संभालना सम्हालना समाना आना भरना अटना पुराना अँटना अंटना अमाना अमावना आटना आपूरना
contend: वितंडा_करना दलीलबाज़ी_करना बाल_की_खाल_निकालना प्रतियोगिता_करना होड़_लगाना प्रतिस्पर्धा_करना भिड़ना लड़ना मुक़ाबला_करना मुक़ाबिला_करना मुकाबला_करना मुकाबिला_करना बहसना प्रतिद्वंद्विता_करना लड़ना
continue: चलने_देना बनाए_रखना जीवित_रखना जिंदा_रखना जिन्दा_रखना बरक़रार_रखना बरकरार_रखना बढ़ना आगे_बढ़ना रुकना ठहरना रहना रुक_जाना
contract: सिकुड़ना
contrive: आविष्कार_करना ईज़ाद_करना ईजाद_करना आविष्कृत_करना निकालना
control: सँभालना संभालना सम्हालना
convert: परिवर्तन_करना बदलना बदल_देना बदलवाना बदली_कराना समझाना
convey: भावाभिव्यक्ति_करना अभिव्यंजना_करना भावाभिव्यक्त_करना भाव_अभिव्यक्त_करना लाना ले_आना आनना
convince: समझाना
cook: भोजन_पकाना भोजन_बनाना रसोई_बनाना पकाना खाना_बनाना खाना_पकाना राँधना रांधना रींधना
cool: ठंडाना ठंडा_होना
cool_down: ठंडाना ठंडा_होना
cool_it: पटाना शांत_होना शान्त_होना
cool_off: पटाना शांत_होना शान्त_होना
coordinate: सजाना लगाना व्यवस्थित_करना जमाना
cop: चुराना चोरी_करना हाथ_मारना चुरा_लेना उड़ाना उड़ा_लेना मूसना टीपना अपहरना बंदी_बनाना बंदी_बना_लेना क़ैद_करना कैद_करना गिरफ्तार_करना गिरफ़्तार_करना पकड़ना पकड़_लेना गिरफ़्त_में_लेना गिरफ्त_में_लेना हिरासत_में_लेना अरेस्ट_करना
copulate: जोड़ा_खाना टपना
copy: टीपना नक़ल_करना नकल_करना अनुकरण_करना अनुसरना अनुहरना अनुहारना उतारना प्रतिरूप_बनाना नकल_करना नक़ल_करना
coquet: नख़रे_दिखाना चोचले_करना नाज़_नख़रा_करना बनना
coquette: नख़रे_दिखाना चोचले_करना नाज़_नख़रा_करना बनना
correct: चढ़ाना
correspond: बराबर_होना समतुल्य_होना समान_होना
corrupt: बिगाड़ना खराब_करना ख़राब_करना चटाना खिलाना घूस_देना रिश्वत_देना ज़ेब_गर्म_करना जेब_गर्म_करना ज़ेब_गरम_करना जेब_गरम_करना
cost: पड़ना पड़ना
costume: पोशाक_से_सुसज्जित_करना कस्टयूम_करना
cough: ठाँसना
cough_out: खखारना खँखारना
cough_up: खखारना खँखारना
counsel: परामर्श_देना सलाह_देना राय_देना
count: गिनना गिनती_करना संख्या_जानना
couple: जोड़ा_खाना टपना
course: बहना निकलना
cover: ढँकना ढाँकना ढाँपना तोपना ढकना ढाकना ढपना काटना छिपाना छुपाना गोपन_रखना गुप्त_रखना काम_करना सेना
cover_up: छिपाना छुपाना गोपन_रखना गुप्त_रखना
cozen: छलना धोखा_देना चकमा_देना छल_करना आँखों_में_धूल_झोंकना आंखों_में_धूल_झोंकना झोंकना
crack: तड़कना चिटकना चटकना चनकना तिड़कना चुरकना
crackle: कड़कड़ाना चुरचुराना
cram: ठूसना ठूँसना ठाँसना ठूंसना ठांसना ठेसना ठेंसना
cranch: चुरमुराना
crap: हगना झाड़ा_फिरना पाखाना_करना पाख़ाना_करना टट्टी_करना मलत्याग_करना दिशा_मैदान_करना दिशा_मैदान_जाना करना
crape: ऐंठना बल_खाना
craunch: चुरमुराना
crawfish: पीछे_हटना
crawfish_out: पीछे_हटना
crawl: बिलबिलाना किलबिलाना
creak: मचकना मचमचाना
cream_off: चुनवाना चुनाना छँटवाना छंटवाना
crease: सिकुड़ना बल_पड़ना सलवट_पड़ना सिलवट_पड़ना सल_पड़ना
create: करना कारण_होना सृष्टि_करना सृजन_करना रचना_करना सिरजना बनाना तैयार_करना निर्माण_करना रचना निर्माना खड़ा_कर_लेना खड़ा_करना विकसित_करना डिज़ाइन_करना
creep: बिलबिलाना किलबिलाना खिसकना सटकना खिसक_जाना सटक_जाना चलता_बनना सटक_लेना किड़कना
crepitate: कड़कड़ाना
crimp: समेटना ऐंठना बल_खाना
crimson: लज्जित_होना शर्मिन्दा_होना लजाना शरमाना शर्माना झेंपना झेंप_जाना
crinkle: सिकुड़ना बल_पड़ना सलवट_पड़ना सिलवट_पड़ना सल_पड़ना
crisp: सिंकना सेंकाना सिंकाना सिकना सिकाना
crispen: सिंकना सेंकाना सिंकाना सिकना सिकाना
criticise: निंदा_करना उँगली_उठाना थू_थू_करना बुरा_कहना बुराई_करना उंगली_उठाना अंगुली_उठाना
criticize: निंदा_करना उँगली_उठाना थू_थू_करना बुरा_कहना बुराई_करना उंगली_उठाना अंगुली_उठाना
croak: मरना मर_जाना परलोक_सिधारना गुजरना गुज़रना दम_तोड़ना चल_बसना मौत_होना अलविदा_कहना लुढ़कना ढेर_होना प्राण_त्यागना प्राण_निकलना जान_जाना जान_चली_जाना टर्रटर्राना टरटराना टर्राना टर्र-टर्र_करना टर्र_टर्र_करना भुनभुनाना
cronk: टर्रटर्राना टरटराना टर्राना टर्र-टर्र_करना टर्र_टर्र_करना
crop: कृषि_योग्य_बनाना खेती_योग्य_बनाना चराना चरना
crop_up: धमक_पड़ना आ_टपकना सहसा_आना आ_धमकना अचानक_आना टपक_पड़ना आ_पहुँचना
cross: काटना
crow: किलकारी_मारना किलकारना किलकिलाना
crumble: चुरचुराना
crumple: गींजना सिकुड़ना बल_पड़ना सलवट_पड़ना सिलवट_पड़ना सल_पड़ना
crunch: चुरचुराना चुरमुराना जाँतना जातना जांतना
crusade: लड़ना लड़ाई_करना
crush: दबाना पेरना कुचलना कुचलाना पिसना कचकना
cry: चिल्लाना चिंघाड़ना बँकारना भौंकना रोना रुदन_करना आँसू_बहाना क्रंदन_करना चिल्लवाना चिलवाना
cry_out: चिल्लवाना चिलवाना
cultivate: कृषि_योग्य_बनाना खेती_योग्य_बनाना
cumulate: जमना एकत्र_होना जमा_होना एकत्रित_होना जुटना गोलियाना इकट्ठा_होना अगटना जुड़ना घुमड़ना
curb: सँभालना संभालना सम्हालना दबाना हावी_होना
curl: लपेटना
curse: कोसना
cut: कटौती_करना कटना काटना बुझाना उपेक्षा_करना उपेक्षित_करना कन्नी_काटना काटना
cut_across: काटना
cut_back: कटौती_करना
cut_down: कटौती_करना गिराना
cut_off: छाँटना छाँट_देना रेताना कटना तोड़ना टोरना तोरना
cut_out: रेताना कटना
cut_through: काटना
dab: थपथपाना थपकाना थपकी_देना
dally: खेलना खिलवाड़_करना नख़रे_दिखाना चोचले_करना नाज़_नख़रा_करना बनना
damage: बिगाड़ना खराब_करना ख़राब_करना
damn: कोसना
dance: नाचना नृत्य_करना निर्जना नितना ठुमकना थिरकना नाचना
dandle: लाड़_करना लाड_करना लाड़ना दुलार_करना दुलारना प्यार_करना लाड़-प्यार_करना
dangle: लटकना झूलना झुलाना
dart: मँडराना मडराना मँडलाना मंडराना मंडलाना
dash: डरवाना
date: अभिसारना अभिसरना दिनांकित_करना दिनांक_निर्धारित_करना तारीख_नियत_करना मिलना डेट_करना
daub: लिपवाना
daunt: डरवाना
dawdle: पिछड़ना पीछे_छूटना पीछे_होना पछड़ना पीछे_रहना पीछे_रह_जाना
daydream: दिवास्वप्न_देखना
daze: चौंधियाना
dazzle: चौंधियाना
deal: लेना ले_लेना बाँटना वितरित_करना वितरण_करना बांटना सँभलना संभलना सम्हलना
deal_out: बाँटना वितरित_करना वितरण_करना बांटना
debate: वितंडा_करना दलीलबाज़ी_करना बाल_की_खाल_निकालना
debilitate: सुखाना
decant: पसाना
decay: सड़ना
decease: मरना मर_जाना परलोक_सिधारना गुजरना गुज़रना दम_तोड़ना चल_बसना मौत_होना अलविदा_कहना लुढ़कना ढेर_होना प्राण_त्यागना प्राण_निकलना जान_जाना जान_चली_जाना
deceive: छलना धोखा_देना चकमा_देना छल_करना आँखों_में_धूल_झोंकना आंखों_में_धूल_झोंकना बहलना बहकना फुसलना
decide: निर्णय_लेना फैसला_लेना सोच_लेना फ़ैसला_करना निश्चय_करना तय_करना तै_करना निपटाना सुलझाना निबटाना फरियाना समाधान_करना निपटा_लेना सुलझा_लेना निबटा_लेना फरिया_लेना समाधान_कर_लेना
deck: शोभान्वित_होना शोभित_होना शोभना फबना शोभायमान_होना
declare_oneself: विवाह_प्रस्ताव_रखना
decline: पतन_होना मना_करना ना_कहना
decorate: सजाना सँवारना अलंकृत_करना सज्जित_करना सँजोना संजोना शोभान्वित_होना शोभित_होना शोभना फबना शोभायमान_होना
decrease: कम_होना घटना ह्रास_होना गिरना क्षीण_होना नरम_पड़ना कमी_आना
dedicate: समर्पित_करना देना
deduct: घटाना घटान_करना
deem: रखना
deep-fry: छनना
defame: चुग़ली_करना चुग़ली_खाना चुगली_करना चुगली_लगाना चुगली_खाना लगाना_बुझाना चुगली_जड़ना
defeat: पछाड़ना मात_देना पराजित_करना परास्त_करना हराना शिकस्त_देना ढेर_करना धूल_चटाना
defecate: हगना झाड़ा_फिरना पाखाना_करना पाख़ाना_करना टट्टी_करना मलत्याग_करना दिशा_मैदान_करना दिशा_मैदान_जाना करना
defer: टालना स्थगित_करना टरना मुलतवी_करना सस्पेन्ड_करना सस्पेंड_करना
deform: नवाना झुकाना
defraud: ठगना ऐंठना झटकना मूड़ना मूँड़ना लूटना झाड़ना मूसना
degenerate: डूबना नष्ट_होना चौपट_होना बहना बिलाना बैठना बरबाद_होना बर्बाद_होना
deject: हतोत्साहित_होना बुझना ठंडा_पड़ना
delay: विलंब_होना देर_होना अबेर_होना सँभलना संभलना सम्हलना टिकना सहारा_लेना अवलंबना अवलम्बना उढ़कना उढ़ुकना
delight: सुखद_लगना अच्छा_लगना नीक_लगना सुहाना
delineate: खींचना खीचना ईचना ईंचना ऐंचना वर्णन_करना बताना बयान_करना बखानना
deliver: भाषण_देना बोलना वक्तव्य_देना पहुँचाना छोड़ना पहुंचाना सौंपना छोड़ना सुपुर्द_करना हवाले_करना सौंप_देना छोड़_देना सुपुर्द_कर_देना हवाले_कर_देना पैदा_करना जन्म_देना जन्माना जनना उत्पन्न_करना जनमाना
delude: छलना धोखा_देना चकमा_देना छल_करना आँखों_में_धूल_झोंकना आंखों_में_धूल_झोंकना
demand: माँग_होना
demasculinise: बधियाना बधिया_करना बधिया_बनाना
demasculinize: बधियाना बधिया_करना बधिया_बनाना
demo: दिखाना दिखलाना प्रदर्शित_करना शो_करना
demolish: ढाहना ढाना
demonstrate: दिखाना दिखलाना प्रदर्शित_करना शो_करना प्रदर्शन_करना
demoralise: हतोत्साहित_होना बुझना ठंडा_पड़ना
demoralize: हतोत्साहित_होना बुझना ठंडा_पड़ना
denigrate: चुग़ली_करना चुग़ली_खाना चुगली_करना चुगली_लगाना चुगली_खाना लगाना_बुझाना चुगली_जड़ना
denudate: नंगियाना नंगा_करना उघाड़ना उघारना
denude: नंगियाना नंगा_करना उघाड़ना उघारना
depart: प्रस्थान_करना रवाना_होना जाना चलना गमन_करना निकलना अभिसारना अभिसरना रुख_करना भटकना रास्ता_भूलना प्रस्थान_करना रवाना_होना खुलना छूटना चलना निकलना निकलना अलग_होना पृथक_होना हटना टूटना फूटना अरगाना
depend: निर्भर_होना आश्रित_होना अवलंबित_होना निर्भर_करना निर्भर_रहना
deplete: खपना लगना उठना खर्च_होना
depress: हतोत्साहित_होना बुझना ठंडा_पड़ना
derive: पाना प्राप्त_करना मिलना
describe: खींचना खीचना ईचना ईंचना ऐंचना खींचना खीचना ईचना ईंचना ऐंचना
desire: इच्छा_करना कामना_करना अहकना इच्छना इच्छा_रखना ईछना ईठना
despoil: लूटना अपहरना मूसना
destroy: उजाड़ना उजाड़_देना नष्ट_करना ख़ाक_करना नाश_करना मिटाना चौपट_करना ध्वस्त_करना उदासना उखाड़ना उखेड़ना उखारना उखेरना उजारना उज्जारना उछीनना उड़ासना उत्पाटना क्षय_करना नाश_करना अपहरना
destruct: उजाड़ना उजाड़_देना नष्ट_करना ख़ाक_करना नाश_करना मिटाना चौपट_करना ध्वस्त_करना उदासना उखाड़ना उखेड़ना उखारना उखेरना उजारना उज्जारना उछीनना उड़ासना उत्पाटना
detain: सँभलना संभलना सम्हलना टिकना सहारा_लेना अवलंबना अवलम्बना उढ़कना उढ़ुकना
deteriorate: डूबना नष्ट_होना चौपट_होना बहना बिलाना बैठना बरबाद_होना बर्बाद_होना
determine: निर्णय_लेना फैसला_लेना सोच_लेना फ़ैसला_करना निश्चय_करना तय_करना तै_करना
detest: घृणा_करना नफ़रत_करना नफरत_करना
detonate: फोड़ना छोड़ना
develop: निकलना आविष्कृत_करना पैदा_होना उत्पन्न_होना प्रशिक्षित_करना प्रशिक्षण_देना योग्य_बनाना
deviate: भटकना रास्ता_भूलना
devise: आविष्कार_करना ईज़ाद_करना ईजाद_करना आविष्कृत_करना निकालना
devolve: डूबना नष्ट_होना चौपट_होना बहना बिलाना बैठना बरबाद_होना बर्बाद_होना
devote: समर्पित_करना देना रखना समर्पित_करना
devour: उड़ाना
dictate: लिखवाना लिखाना
diddle: ठगना ऐंठना झटकना मूड़ना मूँड़ना लूटना झाड़ना मूसना
die: मरना मर_जाना परलोक_सिधारना गुजरना गुज़रना दम_तोड़ना चल_बसना मौत_होना अलविदा_कहना लुढ़कना ढेर_होना प्राण_त्यागना प्राण_निकलना जान_जाना जान_चली_जाना मरना आसक्त_होना रीझना मोहित_होना मरना ढलना फ़िदा_होना फिदा_होना लुढ़कना अनुरागना मरना ढेर_होना मरना
die_hard: चलना प्रचलित_होना जारी_होना
die_off: विलुप्त_होना अदृश्य_होना लुप्त_होना ग़ायब_होना मिटना काफूर_होना काफ़ूर_होना काफूर_हो_जाना काफ़ूर_हो_जाना
die_out: विलुप्त_होना अदृश्य_होना लुप्त_होना ग़ायब_होना मिटना काफूर_होना काफ़ूर_होना काफूर_हो_जाना काफ़ूर_हो_जाना
differ: असहमत_होना असहमति_जताना
differentiate: अंतर_करना अन्तर_करना फर्क_करना फर्क_बताना भेद_करना फ़र्क़_करना फ़र्क़_बताना फरक_करना फरक_बताना फ़रक़_करना फ़रक़_बताना
dig: खुदना खनना जोतना रगड़ना खोदना खुदाई_करना खनना घोंपना घुसेड़ना घुसाना भोंकना भौंकना पेलना धँसाना समझना पकड़ना
dig_out: खुदना खनना
digest: पचाना हजम_करना हज़म_करना हज्म_करना अपमान_सहना बरदाश्त_करना जहर_का_घूंट_पीना पचना हज़म_होना हजम_होना हज्म_होना
dilate: व्याख्या_करना समझाना अर्थ_समझाना अरथाना अर्थाना
diminish: कम_होना घटना ह्रास_होना गिरना क्षीण_होना नरम_पड़ना कमी_आना
dip: डुबाना बोरना डुबोना बूड़ाना
direct: निशाना_साधना निशाना_बाँधना
dirty: मचाना गंदा_करना मलिन_करना
disagree: असहमत_होना असहमति_जताना
disallow: रोकना मना_करना अवारना
disappear: उड़ना गायब_होना छू-मंतर_होना उड़न-छू_होना छूमंतर_होना उड़नछू_होना काफ़ूर_होना काफूर_होना उड़_जाना गायब_हो_जाना छू-मंतर_हो_जाना उड़न-छू_हो_जाना छूमंतर_हो_जाना उड़नछू_हो_जाना काफ़ूर_हो_जाना काफूर_हो_जाना खोना गायब_होना गुमना गुम_होना
discard: फेंकना थ्रो_करना
discharge: मुक्त_करना स्वतंत्र_करना छूटना चलना बरी_करना अपराध_मुक्त_करना दोष_मुक्त_करना रिहा_करना छोड़ना दागना दाग़ना
disclose: खुलना उघड़ना उघरना उघढ़ना भांडा_फूटना भंडा_फूटना पर्दाफ़ाश_होना परदाफ़ाश_होना परदाफाश_होना पर्दाफाश_होना बेनक़ाब_होना बेनकाब_होना रहस्योद्घाटन_होना लीक_होना
discombobulate: भ्रमित_होना चकित_होना अक़ल_चकराना भ्रम_होना चकराना
discommode: झंझट_में_डालना अवडेरना
discontinue: छोड़ना छोड़_देना अलविदा_कहना
discount: निरस्त_करना रद्द_करना निरस्त_कर_देना रद्द_कर_देना ख़ारिज_करना खारिज_करना ख़ारिज_कर_देना खारिज_कर_देना
discourage: चेतावनी_देना चेताना चिताना सावधान_करना आगाह_करना ख़बरदार_करना जताना
discover: खोज_करना पता_लगाना ढूँढ_निकालना खोज_निकालना आविष्कार_करना ढूंढ_निकालना डिस्कवर्ड खुलना उघड़ना उघरना उघढ़ना भांडा_फूटना भंडा_फूटना पर्दाफ़ाश_होना परदाफ़ाश_होना परदाफाश_होना पर्दाफाश_होना बेनक़ाब_होना बेनकाब_होना रहस्योद्घाटन_होना लीक_होना
discuss: वाद_विवाद_करना तर्क_वितर्क_करना तर्क_करना विवाद_करना बहस_करना बहसना
disdain: ठुकराना
disembarrass: छुड़ाना छोड़ाना
disencumber: सुलझना समाधान_होना उत्तर_निकलना हल_निकलना
disentangle: सुलझना समाधान_होना उत्तर_निकलना हल_निकलना
disgorge: उगलना उगिलना उग्रहना
dish_out: बाँटना वितरित_करना वितरण_करना बांटना
disinvest: उतारना खोलना निकालना
disk: हेंगाना
dislodge: हटाना उड़ाना निकालना हटा_देना उड़ा_देना दूर_करना अलग_करना मिटाना डिलीट अहुटाना हटाना करना
dismay: हतोत्साहित_होना बुझना ठंडा_पड़ना
dismiss: निरस्त_करना रद्द_करना निरस्त_कर_देना रद्द_कर_देना ख़ारिज_करना खारिज_करना ख़ारिज_कर_देना खारिज_कर_देना निकालना बाहर_करना
disoblige: झंझट_में_डालना अवडेरना
disorder: घबराना घबड़ाना बेचैन_होना व्याकुल_होना अकुलाना बिकलाना बेकलाना उकताना
dispatch: मारना हत्या_करना प्राण_लेना जान_लेना मौत_के_घाट_उतारना हत_करना उड़ाना हनना वध_करना कत्ल_करना प्राण_निकालना जान_निकालना संहारना हनन_करना अरदना मौत_की_नींद_सुलाना जान_से_मारना खून_करना ख़ून_करना मार_डालना ठिकाने_लगाना ठिकाने_पहुँचाना
dispel: भगाना
dispense: बाँटना वितरित_करना वितरण_करना बांटना
disperse: बिखेरना छितराना बिखराना उलछना विथराना
dispirit: हतोत्साहित_होना बुझना ठंडा_पड़ना
displace: उखाड़ना उखेड़ना उखारना उखेरना उखाड़_फेंकना हटवाना हटवा_देना
display: दिखाना दिखलाना
displease: नाराज़_होना ख़फ़ा_होना नाराज_होना खफा_होना अप्रसन्न_होना खिसियाना उग्र_होना
disport: बहलना उछल-कूद_करना कूद-फाँद_करना कूदफाँद_करना
dispose: फेंकना थ्रो_करना
dispute: लड़ना झगड़ना झगड़ा_करना लड़ाई_करना तकरार_करना उलझना कलह_करना किचकिच_करना अखड़ाना अपड़ाना अरुझाना अलुझना
disquiet: घबराना घबड़ाना बेचैन_होना व्याकुल_होना अकुलाना बिकलाना बेकलाना उकताना
disregard: उपेक्षा_करना उपेक्षित_करना कन्नी_काटना निरस्त_करना रद्द_करना निरस्त_कर_देना रद्द_कर_देना ख़ारिज_करना खारिज_करना ख़ारिज_कर_देना खारिज_कर_देना छोड़_देना ध्यान_न_देना नजरअंदाज_करना नजरंदाज_करना
disrupt: टोकना बोलना
diss: अपमानित_करना अपमान_करना अनादर_करना निरादर_करना निदरना पगड़ी_उछालना तिरस्कार_करना तिरस्कृत_करना अनरना अपमानना अवहेलना_करना अवमानना_करना
dissent: असहमत_होना असहमति_जताना
dissever: अधियाना आधा_करना
dissipate: अपव्यय_करना फिजूलखर्च_करना फिज़ूलख़र्च_करना पैसा_उड़ाना पैसा_बहाना पैसा_फूँकना
dissolve: घोलना घोरना मिलाना मिश्रित_करना सम्मिश्रित_करना घुलना टूटना
distend: फूलना
distil: चुआना आसवन_करना
distill: शोधन_करना परिष्कार_करना चुआना आसवन_करना
distinguish: अंतर_करना अन्तर_करना फर्क_करना फर्क_बताना भेद_करना फ़र्क़_करना फ़र्क़_बताना फरक_करना फरक_बताना फ़रक़_करना फ़रक़_बताना
distort: झुठलाना बटना ऐंठना पूरना भाँजना बँटना
distract: घबराना घबड़ाना बेचैन_होना व्याकुल_होना अकुलाना बिकलाना बेकलाना उकताना
distress: व्यथित_होना
distribute: बाँटना वितरित_करना वितरण_करना बांटना फैलाना बढ़ाना प्रसारित_करना विस्तृत_करना प्रसार_करना विस्तार_करना
disturb: हिलाना
disunite: अलग_करना अलगाना बिलगाना वियुक्त_करना विलगाना विलग_करना बगलियाना उचेलना
diverge: भटकना रास्ता_भूलना
divert: दूसरी_ओर_ले_जाना विपरीत_दिशा_में_ले_जाना दूसरी_ओर_भेजना विपरीत_दिशा_में_भेजना डाइवर्ट_करना बहलना
divest: उतारना खोलना निकालना
divide: अधियाना आधा_करना बँटना बटना अलग_करना अलगाना बिलगाना वियुक्त_करना विलगाना विलग_करना बगलियाना उचेलना
divorce: तलाक़_देना विवाह_विच्छेद_करना
divulge: खुलना उघड़ना उघरना उघढ़ना भांडा_फूटना भंडा_फूटना पर्दाफ़ाश_होना परदाफ़ाश_होना परदाफाश_होना पर्दाफाश_होना बेनक़ाब_होना बेनकाब_होना रहस्योद्घाटन_होना लीक_होना
do: करना निपटाना संपादित_करना सम्पादित_करना करना कारण_होना व्यवहार_करना बर्ताव_करना करना पेश_आना आचरण_करना आचरना
do_by: बरतना
do_it: सटाना
do_work: नौकरी_करना काम_करना
dock: पूँछ_काटना
doctor: मरम्मत_करना ठीक_करना दुरुस्त_करना बनाना
dodder: ठुमकना ठुनकना थिरकना
dodge: टालमटोल_करना टरकाना टालना आज_कल_करना
dog: दौड़ाना भगाना
dole_out: बाँटना वितरित_करना वितरण_करना बांटना
domiciliate: जगह_देना घर_देना
dominate: प्रबल_होना वर्चस्व_होना प्रधानता_होना शासन_होना अधिक_होना
donate: दान_करना देना दान_देना
dot: बिखेरना छितराना बिखराना उलछना विथराना
douse: बढ़ाना डुबाना बोरना डुबोना बूड़ाना
down: उड़ाना
download: डाउनलोड_करना
doze: ऊँघना ऊँघाना ऊंघना ऊंघाना उँघना उँघाना उंघना उंघाना झपकी_लेना
drag: घसीटना घसीटना
drag_in: घसीटना
drain: चुसना सुखाना
drape: ओढ़ना
draw: खींचना खीचना खींचना खीचना ईचना ईंचना ऐंचना निकालना काढ़ना अवशोषित_करना खींचना चूसना सोखना पीना ईचना ईंचना ऐंचना आकर्षित_करना खींचना लुभाना आकृष्ट_करना आकर्षना गूथना गूँथना गूंथना पिरोना पिरोहना पोहना नाधना नाँधना
draw_a_blank: भूलना भूल_जाना विस्मरण_करना बिसारना बिसरना विस्मृत_करना
draw_in: आकर्षित_करना खींचना लुभाना आकृष्ट_करना आकर्षना
draw_out: खींचना चूसना खीचना
draw_together: मिलाना
dread: डरना भयभीत_होना डर_जाना अपडरना डरपना सँकाना
dress: पहनाना डालना
dress_down: धिक्कारना फटकारना लानत-मलामत_करना
dribble: टपकाना चुआना
drift: चलना भटकना रास्ता_भूलना भटकना ख़ाक_छानना भरमना
drill: छेदना छेद_करना बेधना भेदना सालना छालना साधना
drink: पीना पान_करना नशाना नसाना पीना चढ़ाना
drip: टपकना चूना गिरना टप_टप_करना
drive: चलाना
drive_away: भगाना
drive_off: भगाना
drive_out: भगाना
drone: भिनभिनाना भिनकना
droop: दबना धँसना
drop: गिराना गिरा_देना गिराना लटकना झूलना छूटना छूट_जाना रहना रह_जाना डूबना नष्ट_होना चौपट_होना बहना बिलाना बैठना बरबाद_होना बर्बाद_होना जनना ब्याना बियाना जन्माना जनमाना जन्म_देना पैदा_करना उत्पन्न_करना अवतारना
drop_dead: मरना मर_जाना परलोक_सिधारना गुजरना गुज़रना दम_तोड़ना चल_बसना मौत_होना अलविदा_कहना लुढ़कना ढेर_होना प्राण_त्यागना प्राण_निकलना जान_जाना जान_चली_जाना
drown: तल्लीन_होना खोना डूबना डूब_जाना आत्मविस्मृत_होना ध्यानावस्थित_होना ध्यानमग्न_होना भावलीन_होना अवगाहना डूब_मरना
drowse: ऊँघना ऊँघाना ऊंघना ऊंघाना उँघना उँघाना उंघना उंघाना झपकी_लेना
drudge: जोतना रगड़ना
drum: डुगडुगाना
dry: सुखाना झुरवाना सूखना रसहीन_होना
dry_out: सूखना रसहीन_होना सुखाना झुरवाना
duck: टालमटोल_करना टरकाना टालना आज_कल_करना
dull: सोना
dunk: डुबाना बोरना डुबोना बूड़ाना
dust: झाड़ना झटकना झटकारना बिखेरना छितराना बिखराना उलछना विथराना
dwell: रहना निवास_करना
dye: रँगवाना रँगाना रंगाना रंगवाना रङ्गाना रङ्गवाना
earmark: अलग_रखना अलग_रक्षित_करना पृथक_रक्षित_करना अलग_निकालना पृथक_निकालना
earn: कमाना अर्जित_करना अर्जन_करना
eat: खाना अहारना खाना जीमना भोजन_करना आरोगना अरोगना खपना लगना उठना खर्च_होना खाना
eat_on: खाना
eat_up: खपना लगना उठना खर्च_होना
eavesdrop: अनकना
ebb: उतरना भठियाना भटियाना
ebb_away: उतरना भठियाना भटियाना
ebb_down: उतरना भठियाना भटियाना
ebb_off: उतरना भठियाना भटियाना
ebb_out: उतरना भठियाना भटियाना
echo: गूँजना प्रतिध्वनित_होना प्रतिनोदित_होना
eclipse: ग्रहण_लगना ग्रास_लगना
economise: बचाना बचत_करना
economize: बचाना बचत_करना
edge: किनारी_बनाना बार्डर_बनाना सीमा_पर_होना सरहद_पर_होना किनारे_पर_होना
educate: प्रशिक्षित_करना प्रशिक्षण_देना योग्य_बनाना
eff: सटाना
efface: मिटाना
egress: निकलना निर्गत_होना प्रादुर्भूत_होना
eject: निकालना बहिराना बहरियाना निर्गत_करना बाहर_का_रास्ता_दिखाना बाहर_करना
elaborate: व्याख्या_करना समझाना अर्थ_समझाना अरथाना अर्थाना
elate: बहकना
elect: चुनना निर्वाचित_करना चुनाव_करना
elevate: पदोन्नति_करना पदोन्नति_देना उठाना
elongate: तनवाना
elope: भागना भाग_जाना
elude: टालमटोल_करना टरकाना टालना आज_कल_करना
emasculate: बधियाना बधिया_करना बधिया_बनाना
embed: गाड़ना
embellish: शोभान्वित_होना शोभित_होना शोभना फबना शोभायमान_होना सजाना सँवारना अलंकृत_करना सज्जित_करना सँजोना संजोना
emblazon: रंगना रँगना
embody: निभाना अदा_करना
embrace: गले_लगाना गले_मिलना आलिंगन_करना आलिङ्गन_करना चिपटाना लिपटाना अँकवारना अँकोरना अंकवारना अंकोरना अंग_लगाना अरसना-परसना आलिंगना आलिङ्गना
embroil: घसीटना
emerge: निकलना निर्गत_होना प्रादुर्भूत_होना
emit: बोलना आवाज_करना
employ: अनवाँसना
empty: खलियाना खाली_करना स्थान_त्यागना स्थान_खाली_करना स्थान_छोड़ना
enamor: मोहना मोहित_करना रिझाना लुभाना मोह_लेना
enamour: मोहना मोहित_करना रिझाना लुभाना मोह_लेना
enchant: मोहना मोहित_करना रिझाना लुभाना मोह_लेना
encircle: मंडराना मडराना मँडराना मंडलाना मँडलाना चक्कर_काटना
enclose: पूरी_तरह_से_ढँकना पूरी_तरह_से_ढाँकना
enclothe: पहनाना डालना
end: छूटना छूट_जाना खत्म_करना खतम_करना समाप्त_करना पूरा_करना पूरा_कर_लेना पूर्ण_करना तय_करना तै_करना दूर_करना हटाना ठिकाने_लगाना
endanger: खतरे_में_डालना दाँव_पर_रखना
endeavor: प्रयत्न_करना प्रयास_करना कोशिश_करना उद्यम_करना उद्योग_करना यत्न_करना चेष्टा_करना यतन_करना
endeavour: प्रयत्न_करना प्रयास_करना कोशिश_करना उद्यम_करना उद्योग_करना यत्न_करना चेष्टा_करना यतन_करना
endure: अपमान_सहना बरदाश्त_करना जहर_का_घूंट_पीना टिकना चलना ठहरना रहना रहना रह_जाना चलना प्रचलित_होना जारी_होना
energise: जगाना साधना साधन_करना
energize: जगाना साधना साधन_करना
enfeeble: सुखाना
enfold: पूरी_तरह_से_ढँकना पूरी_तरह_से_ढाँकना
engage: डटना भिड़ना जुटना रोकना करना
englut: अघाना अफराना
engorge: अघाना अफराना
engraft: गाड़ना
enjoin: कहना बोलना फ़रमाना फरमाना आज्ञा_करना आज्ञा_देना आदेश_देना हुक्म_देना ऑर्डर_देना आर्डर_देना
enjoy: आनंद_लेना आनन्द_लेना मजा_लेना लुत्फ_लेना लुत्फ़_लेना लुत्फ_उठाना लुत्फ़_उठाना आनंद_उठाना आनन्द_उठाना मौज_करना मस्ती_करना मौज-मस्ती_करना मौज_मस्ती_करना
enlarge: व्याख्या_करना समझाना अर्थ_समझाना अरथाना अर्थाना
enliven: प्रेरित_करना
enquire: देखना छानबीन_करना जाँच-पड़ताल_करना अन्वेषण_करना तहक़ीकात_करना तफ़्तीश_करना तहकीकात_करना तफ्तीश_करना तफतीश_करना अवगाहना
ensconce: जमना बैठना
ensnare: फाँदना फँसाना फांदना फंसाना
entangle: गुथना गुँथना
enter: प्रवेश_करना अंदर_आना दाख़िल_होना प्रविष्ट_होना आना घुसना पैठना ढुकना हलना भाग_लेना हिस्सा_लेना सम्मिलित_होना शामिल_होना शिरकत_करना चढ़वाना टँकवाना दर्ज_कराना
entice: ललचाना लालच_देना लुब्ध_करना लुभाना
entrance: मोहना मोहित_करना रिझाना लुभाना मोह_लेना
entrap: फाँदना फँसाना फांदना फंसाना
entreat: निवेदन_करना विनती_करना विनय_करना प्रार्थना_करना अनुनय_करना दुआ_करना अनुरोध_करना अनुराधना अपील_करना
enumerate: गिनना गिनती_करना संख्या_जानना
envelop: पूरी_तरह_से_ढँकना पूरी_तरह_से_ढाँकना
environ: मंडराना मडराना मँडराना मंडलाना मँडलाना चक्कर_काटना
envisage: मानना मान_लेना कल्पना_करना फर्ज़_करना फर्ज_करना अवरेवना कयास_लगाना
envy: जलना ईर्ष्या_करना द्वेष_करना डाह_करना कुढ़ना
enwrap: पूरी_तरह_से_ढँकना पूरी_तरह_से_ढाँकना
equal: पाना
erase: मिटाना मिटाना
err: भूल_करना गलती_करना अपराध_करना कुसूर_करना कसूर_करना ज़ुर्म_करना जुर्म_करना गुनाह_करना भटकना रास्ता_भूलना
eruct: डकारना
erupt: फटना जलना सुलगना दग्ध_होना दहना सिलगना अगियाना अगिआना फूटना निकलना फूटना फलना
escape: फ़रार_होना फरार_होना भागना ग़ायब_होना चंपत_होना रफ़ू_चक्कर_होना रफू_चक्कर_होना पलायन_करना चम्पत_होना चम्पत_हो_जाना चंपत_हो_जाना काफूर_होना काफ़ूर_होना काफूर_हो_जाना काफ़ूर_हो_जाना अपावर्तन बच_निकलना उढ़रना भगना भागना
eschew: बचना
espouse: विवाह_करना शादी_करना ब्याहना बियाहना ब्याह_करना हाथ_थामना हाथ_धरना हाथ_पकड़ना
essay: परखना जाँचना जाँच_करना परीक्षण_करना टेस्ट_करना जांचना जांच_करना
establish: चलाना स्थापित_करना अधिष्ठित_करना अधिष्ठापित_करना
esteem: सम्मान_करना आदर_करना आदरना
estimate: भाँपना ताड़ना लखना भांपना भापना
evade: टालमटोल_करना टरकाना टालना आज_कल_करना
evaluate: मूल्यांकन_करना मूल्य_लगाना
evaporate: जलाना वाष्पित_करना जलना वाष्पित_होना
evince: जताना जतलाना जनाना
exalt: प्रेरित_करना
examine: समीक्षा_करना परखना जाँचना जाँच_करना परीक्षण_करना टेस्ट_करना जांचना जांच_करना
excavate: खोदना खुदाई_करना खनना
except: छोड़ना
exchange: बदलवाना बदली_कराना
excite: उकसवाना चढ़वाना भड़कवाना उभड़वाना उसकवाना उकसाना चढ़ाना भड़काना उभाड़ना उभारना उसकाना उकतारना उगसाना उचटाना
exclaim: चिल्लवाना चिलवाना
exclude: छोड़ना निकालना बहिराना बहरियाना निर्गत_करना बाहर_का_रास्ता_दिखाना बाहर_करना
excogitate: आविष्कार_करना ईज़ाद_करना ईजाद_करना आविष्कृत_करना निकालना
exculpate: बरी_करना अपराध_मुक्त_करना दोष_मुक्त_करना रिहा_करना छोड़ना
execute: चलाना चालित_करना चालू_करना गत्वरित_करना
exercise: कसरत_कराना व्यायाम_कराना अभ्यास_कराना कसरत_करवाना व्यायाम_करवाना अभ्यास_करवाना साधना
exhaust: खपना लगना उठना खर्च_होना
exhibit: दिखाना दिखलाना दिखाना दिखलाना प्रदर्शित_करना शो_करना
exit: मरना मर_जाना परलोक_सिधारना गुजरना गुज़रना दम_तोड़ना चल_बसना मौत_होना अलविदा_कहना लुढ़कना ढेर_होना प्राण_त्यागना प्राण_निकलना जान_जाना जान_चली_जाना
exonerate: बरी_करना अपराध_मुक्त_करना दोष_मुक्त_करना रिहा_करना छोड़ना
expand: प्रसारित_होना फैलना व्याख्या_करना समझाना अर्थ_समझाना अरथाना अर्थाना
expatiate: व्याख्या_करना समझाना अर्थ_समझाना अरथाना अर्थाना
expect: संभावना_होना सकना टपना
expectorate: खखारना खँखारना
expel: निकालना बहिराना बहरियाना निर्गत_करना बाहर_का_रास्ता_दिखाना बाहर_करना खदेड़ना भगाना खदेड़_देना भगा_देना
experience: भोगना पाना भुगतना जानना समझना बूझना अवगाहना
expire: मरना मर_जाना परलोक_सिधारना गुजरना गुज़रना दम_तोड़ना चल_बसना मौत_होना अलविदा_कहना लुढ़कना ढेर_होना प्राण_त्यागना प्राण_निकलना जान_जाना जान_चली_जाना
explain: समझाना बूझाना बुझाना बताना बतलाना अवगारना
explode: फोड़ना छोड़ना फूटना
exploit: चूसना चूसना निचोड़ना
expose: खुलना उघड़ना उघरना उघढ़ना भांडा_फूटना भंडा_फूटना पर्दाफ़ाश_होना परदाफ़ाश_होना परदाफाश_होना पर्दाफाश_होना बेनक़ाब_होना बेनकाब_होना रहस्योद्घाटन_होना लीक_होना दिखाना दिखलाना
exposit: व्याख्या_करना समझाना अर्थ_समझाना अरथाना अर्थाना
expound: व्याख्या_करना समझाना अर्थ_समझाना अरथाना अर्थाना
express: जताना जतलाना जनाना अभिव्यक्त_करना प्रकट_करना अभिव्यक्ति_करना व्यक्त_करना रखना जाहिर_करना उजागर_करना प्रगटाना उगसारना उजियाना बताना बतलाना भावाभिव्यक्ति_करना अभिव्यंजना_करना भावाभिव्यक्त_करना भाव_अभिव्यक्त_करना
express_joy: हँसना
express_mirth: हँसना
extend: दौड़ना चलना जाना देना अँगड़ाना अँगड़ाई_लेना अंगड़ाना अंगड़ाई_लेना
extinguish: बुझाना बुताना
extort: ऐंठना
extract: खींचना चूसना खीचना चुआना आसवन_करना
extricate: सुलझना समाधान_होना उत्तर_निकलना हल_निकलना
exuberate: खुशी_से_नाचना खुशी_से_उछलना खुशी_से_फूलना फूला_न_समाना अत्यानंदित_होना अत्यधिक_प्रसन्न_होना खुशी_से_पागल_होना
exudate: पसीजना
exude: पसीजना
exult: खुशी_से_नाचना खुशी_से_उछलना खुशी_से_फूलना फूला_न_समाना अत्यानंदित_होना अत्यधिक_प्रसन्न_होना खुशी_से_पागल_होना
face: टक्कर_लेना मुक़ाबला_करना मुकाबला_करना सामना_करना मुक़ाबिला_करना मुकाबिला_करना रुख_होना रुख़_होना प्रस्तुत_करना पेश_करना
fade: उड़ना उड़_जाना फीका_पड़ना निकलना उतरना मुरझाना कुम्हलाना म्लान_होना मुर्झाना उतरना
fag: जोतना रगड़ना थकना हारना
fag_out: थकना हारना
fail: हारना असफल_होना नाकाम_होना विफल_होना अनुत्तीर्ण_होना फेल_होना
fall: गिरना आना कम_होना घटना ह्रास_होना गिरना क्षीण_होना नरम_पड़ना कमी_आना अरराना गिरना गिर_पड़ना
fall_apart: फूटना भग्न_होना चुरचुराना फटना फूटना
fall_back: पिछड़ना पीछे_छूटना पीछे_होना पछड़ना पीछे_रहना पीछे_रह_जाना
fall_behind: पिछड़ना पीछे_छूटना पीछे_होना पछड़ना पीछे_रहना पीछे_रह_जाना
fall_down: अरराना
fall_in: ढहना गिरना गिर_पड़ना
fall_out: झड़ना गिरना चरितार्थ_होना घटना ठीक_उतरना
falsify: झुठलाना
falter: तुतलाना तुतराना तोतलाना
fan: ओसाना उसाना बरसाना डाली_देना गाहना
farm: कृषि_करना अन्न_उपजाना फ़सल_उगाना उगाना उपजाना पैदा_करना उआना उगवना उजियाना उतपानना उतपादना उतपातना उतपाना
fart: पादना पाद_छोड़ना
fascinate: मोहना मोहित_करना रिझाना लुभाना मोह_लेना
fast: टपना
fasten: अटकाना अड़ाना फँसाना अड़काना उलझाना अराना अरुझाना फंसाना तानना खींचना खीचना ईचना ईंचना ऐंचना
fatigue: थकना हारना
fear: डरना डरना भयभीत_होना डर_जाना अपडरना डरपना सँकाना
feast: भोज_देना दावत_देना
feather: पतवार_घुमाना पतवार_मोड़ना
feature: दिखाना
feed: खिलाना जिमाना बहना निकलना
feel: महसूस_करना महसूसना
fell: गिराना
fence: दीवार_से_घेरना वितंडा_करना दलीलबाज़ी_करना बाल_की_खाल_निकालना
fence_in: दीवार_से_घेरना
ferment: किण्वन_करना तुर्शाना खट्टा_होना
fete: उत्सव_मनाना मनाना
fight: प्रतिद्वंद्विता_करना लड़ना लड़ना लड़ाई_करना
figure_out: हल_करना समाधान_करना निराकरण_करना
file: दायर_करना दाखिल_करना
fill: अँटवाना अंटवाना अटवाना अँटाना अंटाना अटाना समवाना भरवाना पुरवाना भरना भरा_होना परिपूर्ण_होना भरा_पड़ा_होना अपनाना लेना स्वीकार_करना स्वीकारना अघाना तृप्त_होना छकना संतुष्ट_होना तुष्ट_होना तोषणा पटना भरना समतल_होना
fill_up: अँटवाना अंटवाना अटवाना अँटाना अंटाना अटाना समवाना भरवाना पुरवाना भरना
film: फिल्माना फिलमाना
filter: निथरना थिरना टपकाना चुआना
filter_out: निथरना थिरना
filtrate: निथरना थिरना
find: खोज_करना पता_लगाना ढूँढ_निकालना खोज_निकालना आविष्कार_करना ढूंढ_निकालना डिस्कवर्ड फिर_से_पाना फिर_से_प्राप्त_करना
finish: चुकना छूटना छूट_जाना
fire: दागना दाग़ना निकालना बाहर_करना छूटना चलना
fire_up: जलाना
fit: आना ठीक_आना फिट_होना होना ठीक_होना फिट_आना सधना
fit_out: पहनाना डालना
fix: मरम्मत_करना ठीक_करना दुरुस्त_करना बनाना अटकाना अड़ाना फँसाना अड़काना उलझाना अराना अरुझाना फंसाना भोजन_पकाना भोजन_बनाना रसोई_बनाना पकाना खाना_बनाना खाना_पकाना राँधना रांधना रींधना कहना बदना बोलना अड़ना ठनना उतारू_होना अरना
fix_up: निर्धारित_करना नियत_करना सुनिश्चित_करना निश्चित_करना ठहराना तय_करना कायम_करना
flag: दबना धँसना
flap: लहराना लहरना लहराना फहरना उड़ना फरफराना
flare: फटना
flare_up: फटना
flash: अभिमान_प्रदर्शन_करना रोब_झाड़ना शान_दिखाना
flaunt: अभिमान_प्रदर्शन_करना रोब_झाड़ना शान_दिखाना
flavor: छौंकना बघारना तड़का_देना तड़का_लगाना आलन_लगाना
flavour: छौंकना बघारना तड़का_देना तड़का_लगाना आलन_लगाना
fleece: लूटना ठगना
fleet: मँडराना मडराना मँडलाना मंडराना मंडलाना
flesh_out: व्याख्या_करना समझाना अर्थ_समझाना अरथाना अर्थाना
flex: नवाना झुकाना
flick: झटकना झटकारना टिमटिमाना
flicker: टिमटिमाना
flim-flam: चकमा_देना झाँसा_देना झांसा_देना
fling: फेंकना थ्रो_करना
flip: टॉस_करना सिक्का_उछालना झटकना झटकारना
flirt: नख़रे_दिखाना चोचले_करना नाज़_नख़रा_करना बनना खेलना खिलवाड़_करना
flit: मँडराना मडराना मँडलाना मंडराना मंडलाना
float: चलना तैरना तिरना उतराना बहाना प्रवाहित_करना
flood: डुबोना डुबाना
floor: सकपकाना चकपकाना भौंचक्का_होना भौचक्का_होना चौंकना उछकना उझकना
flourish: घुमाना नचाना
flow: बहना निकलना बहवाना प्रवाहित_कराना
flower: खिलना फूलना चिटकना चटकना फूटना प्रस्फुटित_होना विकसित_होना बिकसना लगना
fluctuate: झूमना झूँमना लहराना
flump: पटकना
flunk: अनुत्तीर्ण_होना फेल_होना
flush: लज्जित_होना शर्मिन्दा_होना लजाना शरमाना शर्माना झेंपना झेंप_जाना
flush_it: अनुत्तीर्ण_होना फेल_होना
flutter: मँडराना मडराना मँडलाना मंडराना मंडलाना फड़फड़ाना फरफराना फुरफुराना धड़कना स्पंदित_होना
flux: मिलना अमेजना
fly: उड़ना उड़ान_भरना टेक_ऑफ टेकऑफ उड़ाना उड़ना उड़ाना
fly_the_coop: उढ़रना भगना भागना
fob: चकमा_देना झाँसा_देना झांसा_देना
focus: ध्यान_देना ध्यान_केंद्रित_करना ध्यान_केन्द्रित_करना गौर_करना ग़ौर_करना
foist: थोपना ठेलना मत्थे_मढ़ना ठेल_देना डालना लादना
fold: तह_करना दुहराना दोहराना दोहरा_करना दुसराना बंद_करना बन्द_करना
fold_up: तह_करना दुहराना दोहराना दोहरा_करना दुसराना
follow: पीछे_चलना अनुगमन_करना अनुसरना देखना नज़र_रखना नजर_रखना ध्यान_रखना ख्याल_रखना निगरानी_रखना देखते_रहना पीछा_करना पछियाना पीछे_लगना
fondle: सहलाना सोहराना सुहलाना सुहराना
fool: उल्लू_बनाना बनाना अपव्यय_करना फिजूलखर्च_करना फिज़ूलख़र्च_करना पैसा_उड़ाना पैसा_बहाना पैसा_फूँकना
fool_away: अपव्यय_करना फिजूलखर्च_करना फिज़ूलख़र्च_करना पैसा_उड़ाना पैसा_बहाना पैसा_फूँकना
foray: लूटना अपहरना मूसना
forbid: रोकना मना_करना अवारना
force: धकेलना ढकेलना ठेलना धक्का_देना धकेल_देना ढकेल_देना ठेल_देना धकियाना धकिया_देना रेलना पेलना रेल_देना पेल_देना खींचना खीचना
force_out: निकालना बाहर_करना उखाड़ना उखेड़ना उखारना उखेरना उखाड़_फेंकना
forge: आविष्कार_करना ईज़ाद_करना ईजाद_करना आविष्कृत_करना निकालना
forget: भूलना भूल_जाना विस्मरण_करना बिसारना बिसरना विस्मृत_करना छूटना छूट_जाना निकलना
forgive: क्षमा_कराना बख़्शाना बख्शाना माफ़_कराना माफ_कराना क्षमा_करवाना माफ़_करवाना माफ_करवाना
forgo: छोड़ना छोड़_देना त्यागना त्याग_देना त्याग_रखना परित्याग_करना परित्यागना
form: बैठाना बिठाना
formulate: आविष्कार_करना ईज़ाद_करना ईजाद_करना आविष्कृत_करना निकालना
foster: पालना
foul: अवरुद्ध_होना फँसना फंसना बाधा_पड़ना रुँधना रुंधना बंद_होना
found: चलाना स्थापित_करना अधिष्ठित_करना अधिष्ठापित_करना
founder: ढहना गिरना गिर_पड़ना
fox: चकमा_देना झाँसा_देना झांसा_देना भ्रमित_होना चकित_होना अक़ल_चकराना भ्रम_होना चकराना
frame: मढ़वाना मढ़ाना
free: छूटना छूट_जाना रिहा_होना मुक्त_होना निकलना बरी_होना छुड़ाना छोड़ाना हटाना उड़ाना निकालना हटा_देना उड़ा_देना दूर_करना अलग_करना मिटाना डिलीट अहुटाना निकालना जारी_करना लॉन्च_करना लान्च_करना मुक्त_करना स्वतंत्र_करना
freeze: पाला_पड़ना तुषार_पात_होना तुषार_गिरना जमना
freeze_down: जमना
freeze_off: ठुकराना
freeze_out: जमना
french-fry: छनना
fret: चिड़चिड़ाना
fright: डराना भयभीत_करना डरवाना डरपाना
frighten: डराना भयभीत_करना डरवाना डरपाना
frighten_away: डरवाना
frighten_off: डरवाना
frisk: उछल-कूद_करना कूद-फाँद_करना कूदफाँद_करना
fritter: अपव्यय_करना फिजूलखर्च_करना फिज़ूलख़र्च_करना पैसा_उड़ाना पैसा_बहाना पैसा_फूँकना
fritter_away: अपव्यय_करना फिजूलखर्च_करना फिज़ूलख़र्च_करना पैसा_उड़ाना पैसा_बहाना पैसा_फूँकना
frivol_away: अपव्यय_करना फिजूलखर्च_करना फिज़ूलख़र्च_करना पैसा_उड़ाना पैसा_बहाना पैसा_फूँकना
frizz: ऐंठना बल_खाना
frizzle: ऐंठना बल_खाना
frolic: उछल-कूद_करना कूद-फाँद_करना कूदफाँद_करना
front: रुख_होना रुख़_होना
frown: आँख_तरेरना आँख_दिखाना
fruit: फलना फलियाना
fuck: सटाना
fuddle: नशाना नसाना भ्रमित_होना चकित_होना अक़ल_चकराना भ्रम_होना चकराना
fudge: टालमटोल_करना टरकाना टालना आज_कल_करना
function: चलना उपयोग_में_आना काम_करना
furbish_up: मरम्मत_करना ठीक_करना दुरुस्त_करना बनाना
furnish: देना प्रदान_करना उपलब्ध_कराना सुलभ_कराना प्राप्त_कराना लब्ध_कराना अधिगत_कराना मुहैया_कराना मुहैय्या_कराना मयस्सर_कराना मुयस्सर_कराना मुयस्य_कराना खोलना खोल_देना जन्म_देना
fuse: मिलना अमेजना
gabble: बकवास_करना बकना बकबक_करना बकबकाना प्रलाप_करना
gad: आवारागर्दी_करना लुच्चापना_करना लुच्चई_करना अवटना
gag: मिचलाना मचलाना मिचली_आना अकुलाना उबकाई_आना जी-मिचलाना
gain: पाना प्राप्त_करना मिलना फलना फल_देना आना पहुँचना पहुंचना पधारना अवना आगमना जीतना विजय_पाना विजयी_होना हराना पराजित_करना परास्त_करना शिकस्त_देना पछाड़ना मात_देना जीत_दर्ज_करना जीत_लेना कामयाब_होना भाव_बढ़ना भाव_चढ़ना भाव_आसमान_छूना दाम_बढ़ना दाम_आसमान_छूना महँगा_होना चढ़ना तेजी_आना तेज़ी_आना
gain_ground: जीतना विजय_पाना विजयी_होना हराना पराजित_करना परास्त_करना शिकस्त_देना पछाड़ना मात_देना जीत_दर्ज_करना जीत_लेना कामयाब_होना
gallivant: आवारागर्दी_करना लुच्चापना_करना लुच्चई_करना अवटना
gamble: जुआ_खेलना जूआ_खेलना
gambol: उछल-कूद_करना कूद-फाँद_करना कूदफाँद_करना
garb: पहनाना डालना
garble: झुठलाना
garment: पहनाना डालना
garner: कमाना अर्जित_करना अर्जन_करना एकत्रित_करना इकट्ठा_करना बटोरना समेटना अंजोरना अँजोरना
gas: शेखी_बघारना बघारना डींग_हाँकना डींग_मारना
gasconade: शेखी_बघारना बघारना डींग_हाँकना डींग_मारना
gasp: हाँफना हाँपना हांफना हांपना
gather: एकत्रित_करना इकट्ठा_करना बटोरना समेटना अंजोरना अँजोरना जमना एकत्र_होना जमा_होना एकत्रित_होना जुटना गोलियाना इकट्ठा_होना अगटना जुड़ना घुमड़ना
gather_up: उठाना उचाना उकसाना उगसाना
gauge: भाँपना ताड़ना लखना भांपना भापना
gaze: घूरना
gazump: लूटना ठगना
gear_up: अड़ना ठनना उतारू_होना अरना
gentle: मनाना मनुहारना मान_मनुहार_करना
germinate: अंकुर_निकलना अँखुआना जमना अँकुरना अंकुरना अंकुर_फूटना अंकुरित_होना उकसना उकिसना
gesticulate: संकेत_देना संकेत_करना इशारा_करना
gesture: संकेत_देना संकेत_करना इशारा_करना
get: मिलना हाथ_लगना हाथ_आना प्राप्त_होना हासिल_होना बनाना धर_दबोचना बनाना उठाना चलाना छेड़ना आरम्भ_करना आरंभ_करना शुरू_करना निकालना
get_across: काटना
get_ahead: जीतना विजय_पाना विजयी_होना हराना पराजित_करना परास्त_करना शिकस्त_देना पछाड़ना मात_देना जीत_दर्ज_करना जीत_लेना कामयाब_होना
get_along: पटना उन्नत_होना उन्नति_करना उभरना विकास_करना बढ़ना फलना फलना-फूलना चमकना
get_along_with: पटना
get_around: सामाजिक_होना
get_away: फ़रार_होना फरार_होना भागना ग़ायब_होना चंपत_होना रफ़ू_चक्कर_होना रफू_चक्कर_होना पलायन_करना चम्पत_होना चम्पत_हो_जाना चंपत_हो_जाना काफूर_होना काफ़ूर_होना काफूर_हो_जाना काफ़ूर_हो_जाना अपावर्तन बच_निकलना
get_back: लौटना वापस_आना आना
get_by: बच_निकलना
get_down: उतारना अवतारना निगलना लीलना गटकना हतोत्साहित_होना बुझना ठंडा_पड़ना उठाना चलाना छेड़ना आरम्भ_करना आरंभ_करना शुरू_करना निकालना
get_going: खुलना
get_hitched_with: विवाह_करना शादी_करना ब्याहना बियाहना ब्याह_करना हाथ_थामना हाथ_धरना हाथ_पकड़ना
get_in: प्रवेश_करना अंदर_आना दाख़िल_होना प्रविष्ट_होना आना घुसना पैठना ढुकना हलना
get_into: प्रवेश_करना अंदर_आना दाख़िल_होना प्रविष्ट_होना आना घुसना पैठना ढुकना हलना
get_it_on: सटाना
get_laid: सटाना
get_married: विवाह_करना शादी_करना ब्याहना बियाहना ब्याह_करना हाथ_थामना हाथ_धरना हाथ_पकड़ना
get_off: बच_निकलना
get_on: पटना चढ़ना सवार_होना बैठना आरोहित_होना अरोहना सवारी_करना उन्नत_होना उन्नति_करना उभरना विकास_करना बढ़ना फलना फलना-फूलना चमकना बुढ़ाना वृद्ध_होना
get_on_with: पटना
get_out: निकालना काढ़ना बच_निकलना
get_over: काटना
get_the_better_of: पछाड़ना मात_देना पराजित_करना परास्त_करना हराना शिकस्त_देना ढेर_करना धूल_चटाना
get_the_picture: समझना पकड़ना
get_to: पहुँचना पहुंचना
get_up: उठाना
gibber: बकवास_करना बकना बकबक_करना बकबकाना प्रलाप_करना
gift: उपहार_देना भेंट_देना तोहफा_देना
giggle: खिलखिलाना खिल_खिल_करना ठट्ठा_लगाना
gimp: लँगड़ाना
gip: ठगना ऐंठना झटकना मूड़ना मूँड़ना लूटना झाड़ना मूसना
give: देना प्रदान_करना आयोजित_करना आयोजन_करना उपहार_देना भेंट_देना तोहफा_देना पकड़ाना धराना थमाना समर्पित_करना देना ढहना गिरना गिर_पड़ना खुलना
give-up_the_ghost: मरना मर_जाना परलोक_सिधारना गुजरना गुज़रना दम_तोड़ना चल_बसना मौत_होना अलविदा_कहना लुढ़कना ढेर_होना प्राण_त्यागना प्राण_निकलना जान_जाना जान_चली_जाना
give_away: खुलना उघड़ना उघरना उघढ़ना भांडा_फूटना भंडा_फूटना पर्दाफ़ाश_होना परदाफ़ाश_होना परदाफाश_होना पर्दाफाश_होना बेनक़ाब_होना बेनकाब_होना रहस्योद्घाटन_होना लीक_होना
give_back: पटना चुकना
give_birth: पैदा_करना जन्म_देना जन्माना जनना उत्पन्न_करना जनमाना
give_chase: दौड़ाना भगाना
give_in: अधीन_होना अधीनना आधीन_होना
give_notice: निकालना बाहर_करना
give_the_axe: निकालना बाहर_करना
give_the_sack: निकालना बाहर_करना
give_tongue_to: अभिव्यक्त_करना प्रकट_करना अभिव्यक्ति_करना व्यक्त_करना रखना जाहिर_करना उजागर_करना प्रगटाना उगसारना उजियाना
give_up: छोड़ना छोड़_देना अलविदा_कहना सौंपना छोड़ना सुपुर्द_करना हवाले_करना सौंप_देना छोड़_देना सुपुर्द_कर_देना हवाले_कर_देना छोड़ना छोड़_देना त्यागना त्याग_देना त्याग_रखना परित्याग_करना परित्यागना
give_way: ढहना गिरना गिर_पड़ना
glean: फ़सल_काटना कटाई_करना
glom: चुराना चोरी_करना हाथ_मारना चुरा_लेना उड़ाना उड़ा_लेना मूसना टीपना अपहरना
glow: चमकना जगमगाना झलझलाना दमकना जगजगाना झलकना
glower: आँख_तरेरना आँख_दिखाना
glue: चिपकाना चपकाना साटना सटाना चिपटाना ग्रंथन ग्रन्थन
glut: अघाना अफराना
gnarl: भुनभुनाना
go: जाना गुजरना गुज़रना प्रस्थान_करना रवाना_होना जाना चलना गमन_करना निकलना अभिसारना अभिसरना रुख_करना दौड़ना चलना जाना चलना उपयोग_में_आना काम_करना मरना मर_जाना परलोक_सिधारना गुजरना गुज़रना दम_तोड़ना चल_बसना मौत_होना अलविदा_कहना लुढ़कना ढेर_होना प्राण_त्यागना प्राण_निकलना जान_जाना जान_चली_जाना खुलना जाना खर्च_होना लगना व्यय_होना उठना
go_after: दौड़ाना भगाना
go_along: चलने_देना
go_around: उड़ाना फैलाना परिक्रमा_करना चक्कर_काटना चक्कर_लगाना फेरा_लगाना
go_away: प्रस्थान_करना रवाना_होना जाना चलना गमन_करना निकलना अभिसारना अभिसरना रुख_करना छोड़ना खोना गायब_होना गुमना गुम_होना उड़ना गायब_होना छू-मंतर_होना उड़न-छू_होना छूमंतर_होना उड़नछू_होना काफ़ूर_होना काफूर_होना उड़_जाना गायब_हो_जाना छू-मंतर_हो_जाना उड़न-छू_हो_जाना छूमंतर_हो_जाना उड़नछू_हो_जाना काफ़ूर_हो_जाना काफूर_हो_जाना
go_back: लौटना वापस_आना आना
go_bad: लगना
go_by: गुजरना गुज़रना निकलना
go_down: धँसना धँस_जाना डूबना ढलना अस्त_होना अस्तगत_होना
go_forth: छोड़ना निकलना निर्गत_होना प्रादुर्भूत_होना
go_forward: बढ़ना आगे_बढ़ना
go_in: प्रवेश_करना अंदर_आना दाख़िल_होना प्रविष्ट_होना आना घुसना पैठना ढुकना हलना
go_into: प्रवेश_करना अंदर_आना दाख़िल_होना प्रविष्ट_होना आना घुसना पैठना ढुकना हलना
go_off: बुझना छूटना चलना
go_on: चलने_देना चरितार्थ_होना घटना ठीक_उतरना
go_out: मिलना डेट_करना
go_past: गुजरना गुज़रना निकलना
go_steady: मिलना डेट_करना
go_through: भोगना पाना भुगतना उड़ाना
go_under: धँसना धँस_जाना डूबना ढलना अस्त_होना अस्तगत_होना
go_up: चढ़ना
go_wrong: हारना असफल_होना नाकाम_होना विफल_होना
gobble: भक्षण_करना भखना भकोसना
goldbrick: ठगना ऐंठना झटकना मूड़ना मूँड़ना लूटना झाड़ना मूसना
gorge: अघाना अफराना
gormandise: अघाना अफराना
gormandize: अघाना अफराना
gossip: बात_करना बातचीत_करना बतियाना वार्तालाप_करना बोलना-बतियाना बोलना बोलना_बतियाना
gouge: ऐंठना
gourmandize: अघाना अफराना
grab: लपकना लपक_लेना छीनना खसोटना अपहरना झटकना
grace: सजाना सँवारना अलंकृत_करना सज्जित_करना सँजोना संजोना शोभान्वित_होना शोभित_होना शोभना फबना शोभायमान_होना
grant: स्वीकृति_देना सहमति_देना सकारना स्वीकार_करना स्वीकारना मंजूरी_देना हाँ_करना ठप्पा_लगाना मुहर_लगाना मोहर_लगाना हरी_झंडी_देना हरी_झंडी_दिखाना घुटने_टेकना हथियार_डालना हार_मानना झुकना नवना हाथ_खड़े_करना
grapple: गूथना गूँथना
grasp: समझना पकड़ना
grate: कीसना कसना घिसना कद्दूकस_करना किटकिटाना कटकटाना
gratify: संतुष्ट_करना तृप्त_करना तुष्ट_करना तोषणा
gravitate: आकर्षित_होना खिंचना मंत्रमुग्ध_होना मोहित_होना इंचना इञ्चना खिंच_जाना आकृष्ट_होना खिंचे_चले_आना
graze: चरना चराना
grease_one's_palms: चटाना खिलाना घूस_देना रिश्वत_देना ज़ेब_गर्म_करना जेब_गर्म_करना ज़ेब_गरम_करना जेब_गरम_करना
green: हरियाना
grieve: सोचना दुखी_होना सोंचना अनमनाना पीड़ित_होना दुखित_होना अरूरना उदास_होना अनमनाना
grime: मचाना गंदा_करना मलिन_करना
grind: चुरमुराना किटकिटाना कटकटाना जाँतना जातना जांतना जोतना रगड़ना
grip: गूथना गूँथना
groan: काँखना
grok: समझना पकड़ना
groom: तैयार_करना
grope_for: टटोलना
ground: लंगर_डाला_होना बँधा_होना
grow: विकसित_होना फैलना बिकसना उत्पन्न_होना उगना उपजना उगवना उतपनना पैदा_होना उत्पन्न_होना उगाना उपजाना पैदा_करना उआना उगवना उजियाना उतपानना उतपादना उतपातना उतपाना
growl: गुर्राना
grumble: भुनभुनाना गुर्राना गड़गड़ाना गड़कना
gruntle: मनाना मनुहारना मान_मनुहार_करना
guess: भाँपना ताड़ना लखना भांपना भापना
gull: उल्लू_बनाना बनाना
guy: उपहास_करना खिल्ली_उड़ाना मज़ाक_उड़ाना हँसी_उड़ाना
gyp: ठगना ऐंठना झटकना मूड़ना मूँड़ना लूटना झाड़ना मूसना
gyrate: घूमना चक्कर_खाना घूर्णित_होना नाचना
habilitate: पहनाना डालना
habituate: सेवन_करना लेना उपभोग_करना अभ्यस्त_होना
hack: हैक_करना ढाँसना
hack_on: हैक_करना
hallow: अभिमंत्रण_करना अभिमंत्रित_करना
halt: रुकना रुक_जाना अटकना बंद_होना गतिरुद्ध_होना रहना रह_जाना
hammer: ठोंकना ठोकना जड़ना ठेसना ठेंसना
hand: पकड़ाना धराना थमाना पहुँचाना पहुंचाना छोड़ना
handle: सँभलना संभलना सम्हलना बरतना
hanker: तरसना
hap: चरितार्थ_होना घटना ठीक_उतरना
happen: चरितार्थ_होना घटना ठीक_उतरना आना
harass: सताना उत्पीड़ित_करना ताड़ना प्रताड़ना तपाना कष्ट_देना दुखी_करना दुःखी_करना पीड़ा_देना पेरना परेशान_करना तंग_करना तंङ्ग_करना नाक_में_दम_करना पीड़ित_करना अप्रसन्न_करना हैरान_करना नींद_हराम_करना नींद_उड़ाना उँगली_करना उंगली_करना अरूरना अर्दना अवडेरना अवसेरना
harbor: गुप्त_शरण_देना गुप्त_आश्रय_देना
harbour: गुप्त_शरण_देना गुप्त_आश्रय_देना
harden: तन्दुरुस्त_बनाना तंदुरुस्त_बनाना स्वस्थ_बनाना भला-चंगा_बनाना चंगा_बनाना
harness: जोतना जुआठना जुआ_पहनाना नाँधना नांधना नाधना
harrow: हेंगाना
harry: सताना उत्पीड़ित_करना ताड़ना प्रताड़ना तपाना कष्ट_देना दुखी_करना दुःखी_करना पीड़ा_देना पेरना परेशान_करना तंग_करना तंङ्ग_करना नाक_में_दम_करना पीड़ित_करना अप्रसन्न_करना हैरान_करना नींद_हराम_करना नींद_उड़ाना उँगली_करना उंगली_करना अरूरना अर्दना अवडेरना अवसेरना
harvest: फ़सल_काटना कटाई_करना
hash_out: वाद_विवाद_करना तर्क_वितर्क_करना तर्क_करना विवाद_करना बहस_करना बहसना
hassle: सताना उत्पीड़ित_करना ताड़ना प्रताड़ना तपाना कष्ट_देना दुखी_करना दुःखी_करना पीड़ा_देना पेरना परेशान_करना तंग_करना तंङ्ग_करना नाक_में_दम_करना पीड़ित_करना अप्रसन्न_करना हैरान_करना नींद_हराम_करना नींद_उड़ाना उँगली_करना उंगली_करना अरूरना अर्दना अवडेरना अवसेरना
hatch: सेना
hate: घृणा_करना नफ़रत_करना नफरत_करना
have: होना आयोजित_करना आयोजन_करना बचना शेष_रहना रहना अवशिष्ट_रहना बाकी_बचना बाकी_रहना लेना ग्रहण_करना पाना प्राप्त_करना बनाना पैदा_करना जन्म_देना जन्माना जनना उत्पन्न_करना जनमाना
have_a_go_at_it: सटाना
have_intercourse: सटाना
have_it_away: सटाना
have_it_off: सटाना
have_on: पहनना धारण_करना अवधारना डालना
have_sex: सटाना
have_words: धिक्कारना फटकारना लानत-मलामत_करना
head_for_the_hills: उढ़रना भगना भागना
hear: सुनना श्रवण_करना सुनना सुनना
heat: गरम_करना गरमाना गर्माना अँकोरना अंकोरना जलाना सेंकना तापना आँचना
heat_up: सेंकना तापना आँचना गरम_करना गरमाना गर्माना अँकोरना अंकोरना
heave: हाँफना हाँपना हांफना हांपना मिचलाना मचलाना मिचली_आना अकुलाना उबकाई_आना जी-मिचलाना
hedge: टालमटोल_करना टरकाना टालना आज_कल_करना
hee-haw: रेंकना
help: सहायता_करना मदद_करना सहयोग_करना हाथ_देना हाथ_थामना हाथ_बढ़ाना हाथ_बँटाना परोसना परसना
hem: तुरपना
hem_in: घिरना घेराना
hesitate: अटकना
hiccough: हिचकना हिचकी_लेना
hiccup: हिचकना हिचकी_लेना
hide: छिपाना छुपाना लुकाना छिपना छुपना लुकाना
hide_out: छिपना छुपना लुकाना
hightail_it: उढ़रना भगना भागना
hinder: अटकाना
hire: किराए_पर_लेना भाड़े_पर_लेना करना
hiss: फुफकारना फूत्कारना फुफकार_करना फूत्कार_करना
hit: टकराना भिड़ना भिड़ंत_होना टक्कर_खाना लड़ना मारना आना पहुँचना पहुंचना पधारना अवना आगमना पहुँचना पहुंचना मारना हत्या_करना प्राण_लेना जान_लेना मौत_के_घाट_उतारना हत_करना उड़ाना हनना वध_करना कत्ल_करना प्राण_निकालना जान_निकालना संहारना हनन_करना अरदना मौत_की_नींद_सुलाना जान_से_मारना खून_करना ख़ून_करना मार_डालना ठिकाने_लगाना ठिकाने_पहुँचाना
hit_the_books: पढ़ना अध्ययन_करना
hitch: लँगड़ाना
hive_away: भंडारण_करना
hoard: जोड़ना जमा_करना जुटाना संचित_करना इकट्ठा_करना एकत्रित_करना एकत्र_करना संग्रह_करना संग्रहना संजोना सँजोना
hobble: लँगड़ाना
hoist: लहराना फहराना फरफराना उड़ाना
hold: आयोजित_करना आयोजन_करना रखना पकड़ना थामना धरना गहना रखना होना सँभालना संभालना सम्हालना थामना सँभालना संभालना सम्हालना सम्भालना समाना आना भरना अटना पुराना अँटना अंटना अमाना अमावना आटना आपूरना आरक्षित_करना रोकना
hold_back: मन_मारना
hold_fast: चिपकना सटना
hold_in: सँभालना संभालना सम्हालना
hold_on: रखना
hold_out: रोकना रोक_देना ठहराना टिकना चलना ठहरना रहना
hold_over: टालना स्थगित_करना टरना मुलतवी_करना सस्पेन्ड_करना सस्पेंड_करना
hold_up: थामना सँभालना संभालना सम्हालना सम्भालना
holler: चिल्लाना चिंघाड़ना बँकारना भौंकना
hollo: चिल्लाना चिंघाड़ना बँकारना भौंकना
hollow: खोदना खुदाई_करना खनना
hone: निपुण_बनाना निपुण_करना प्रवीण_करना प्रवीण_बनाना पारंगत_करना पारंगत_बनाना काबिल_करना सिद्ध_करना
honk: उगलना उगिलना उग्रहना
hook: लूटना ठगना चुराना चोरी_करना हाथ_मारना चुरा_लेना उड़ाना उड़ा_लेना मूसना टीपना अपहरना पड़ना
hook_up_with: विवाह_करना शादी_करना ब्याहना बियाहना ब्याह_करना हाथ_थामना हाथ_धरना हाथ_पकड़ना
hop: फुदकना
hop-skip: फुदकना
hop_on: चढ़ना सवार_होना बैठना आरोहित_होना अरोहना सवारी_करना
hornswoggle: ठगना ऐंठना झटकना मूड़ना मूँड़ना लूटना झाड़ना मूसना
hospitalise: भर्ती_कराना भरती_कराना एडमिट_कराना
hospitalize: भर्ती_कराना भरती_कराना एडमिट_कराना
hot_up: सेंकना तापना आँचना
house: जगह_देना घर_देना
hover: डोलना
hug: गले_लगाना गले_मिलना आलिंगन_करना आलिङ्गन_करना चिपटाना लिपटाना अँकवारना अँकोरना अंकवारना अंकोरना अंग_लगाना अरसना-परसना आलिंगना आलिङ्गना
hull: छीलना छोलना
hum: गुनगुनाना
hump: सटाना
hunger: भुखाना
hunt: आखेट_करना शिकार_करना शिकार_खेलना
hunt_down: आखेट_करना शिकार_करना शिकार_खेलना
hurt: टीसना करकना कसकना चसकना चिलकना टहकना डबकना चबकना ठनकना लगाना दुखाना लगना चुभना खटकना बुरा_लगना अप्रिय_लगना टूटना कष्ट_सहना दुख_सहना दुख_झेलना कष्ट_झेलना दुख_उठाना तक़लीफ़_उठाना
hush: मौन_होना चुप_होना चुप्पी_साधना दम_साधना अरगाना
ideate: मानना मान_लेना कल्पना_करना फर्ज़_करना फर्ज_करना अवरेवना कयास_लगाना
identify: पहचानना चीन्हना जानना लेना बताना बोलना
idle: अलसाना आलस्य_करना अलसना अरसाना
ignite: जलाना सुलगाना फूँकना फूंकना जलना सुलगना दग्ध_होना दहना सिलगना अगियाना अगिआना जलाना
ignore: उपेक्षा_करना उपेक्षित_करना कन्नी_काटना निरस्त_करना रद्द_करना निरस्त_कर_देना रद्द_कर_देना ख़ारिज_करना खारिज_करना ख़ारिज_कर_देना खारिज_कर_देना छोड़_देना ध्यान_न_देना नजरअंदाज_करना नजरंदाज_करना
illume: प्रकाशित_होना आलोकित_होना दीप्त_होना
illuminate: प्रकाशित_होना आलोकित_होना दीप्त_होना
illumine: प्रकाशित_होना आलोकित_होना दीप्त_होना
imagine: मानना मान_लेना कल्पना_करना फर्ज़_करना फर्ज_करना अवरेवना कयास_लगाना
imbed: गाड़ना
imbibe: अवशोषित_करना खींचना चूसना सोखना पीना ईचना ईंचना ऐंचना पीना पान_करना
imitate: नक़ल_करना नकल_करना अनुकरण_करना अनुसरना अनुहरना अनुहारना
immix: मिलना अमेजना
impart: खुलना उघड़ना उघरना उघढ़ना भांडा_फूटना भंडा_फूटना पर्दाफ़ाश_होना परदाफ़ाश_होना परदाफाश_होना पर्दाफाश_होना बेनक़ाब_होना बेनकाब_होना रहस्योद्घाटन_होना लीक_होना
impede: अटकाना अड़ाना अराना
imperil: खतरे_में_डालना दाँव_पर_रखना
impersonate: अभिनय_करना रोल_करना खेलना
impinge_on: टकराना भिड़ना भिड़ंत_होना टक्कर_खाना लड़ना
implant: गाड़ना
impose: वसूलना वसूल_करना उगाहना उगहना उग्रहना उघाना
imprecate: कोसना
impress: प्रभावित_करना प्रभाव_डालना असर_डालना छाप_छोड़ना असर_करना रंग_जमाना रंगना छाना छापना
imprint: बैठाना बिठाना छापना
improve: बढ़ाना विकसित_करना उन्नत_करना बिकसाना ऊंचा_उठाना ऊँचा_उठाना सुधरना
incise: उत्कीर्ण_करना खोदना उकेरना उखेरना अवलेखना उकीरना उखेलना
include: समाविष्ट_होना विलय_होना लय_होना मिलना रिलना
incommode: झंझट_में_डालना अवडेरना
inconvenience: झंझट_में_डालना अवडेरना
increase: बढ़ाना
incubate: सेना
indemnify: क्षतिपूर्ति_करना नुकसान_भरना नुक़सान_भरना भरपाई_करना
indite: रचना लिखना
induct: बैठाना बिठाना आसीन_करना
inebriate: नशा_करना नशा_गाँठना नशापानी_करना
infatuate: लुब्ध_होना लुभना मन_डोलना
inflame: जलाना
inflate: फुलाना
inform: प्रकाश_डालना जानकारी_देना अवगत_कराना ज्ञात_कराना
ingurgitate: अघाना अफराना
inhabit: रहना निवास_करना
inhibit: दबाना हावी_होना
inject: सुई_लगाना इंजेक्शन_लगाना इंजेक्शन_देना इंजैक्शन_लगाना इंजैक्शन_देना इन्जेक्शन_लगाना इन्जेक्शन_देना इन्जैक्शन_लगाना इन्जैक्शन_देना
injure: दुखाना चुभना खटकना बुरा_लगना अप्रिय_लगना लगना
inquire: देखना छानबीन_करना जाँच-पड़ताल_करना अन्वेषण_करना तहक़ीकात_करना तफ़्तीश_करना तहकीकात_करना तफ्तीश_करना तफतीश_करना अवगाहना
inspect: देखना जाँचना जाँच_करना जांचना जांच_करना
inspire: प्रेरित_करना
inspissate: गढ़ाना गाढ़ा_होना
institute: स्थापित_करना अधिष्ठित_करना अधिष्ठापित_करना
instruct: सीख_देना सिखलाना सिखाना शिक्षा_देना बताना बताना बतलाना सिखाना सिखलाना निर्देश_करना
instrument: सुसज्जित_करना लैस_करना
insult: अपमानित_करना अपमान_करना अनादर_करना निरादर_करना निदरना पगड़ी_उछालना तिरस्कार_करना तिरस्कृत_करना अनरना अपमानना अवहेलना_करना अवमानना_करना
intend: अर्थ_लगाना अरथाना अर्थाना
interdict: रोकना मना_करना अवारना
interest: पड़ना
interfere: पड़ना
interpose: पड़ना
interpret: अनुवाद_करना भाषांतर_करना भाषांतरण_करना भाषान्तर_करना भाषान्तरण_करना तरजुमा_करना तरज़ुमा_करना उल्था_करना तर्जुमा_करना तर्ज़ुमा_करना समझना
interrogate: खोदना
interrupt: टोकना बोलना तोड़ना समाप्त_करना खत्म_करना
intervene: पड़ना
intoxicate: बहकना नशा_करना नशा_गाँठना नशापानी_करना
introduce: परिचय_कराना
intrude: घुसना
intumesce: सूजना फूलना
invade: आक्रमण_करना चढ़ाई_करना हमला_करना धावा_बोलना हमला_बोलना
inveigle: फुसलाना बहलाना बहकाना बरगलाना बर्गलाना
invent: आविष्कार_करना ईज़ाद_करना ईजाद_करना आविष्कृत_करना निकालना
invest: लगाना निवेश_करना बैठाना बिठाना आसीन_करना
investigate: छानबीन_करना जाँच-पड़ताल_करना अन्वेषण_करना तहक़ीकात_करना तफ़्तीश_करना तहकीकात_करना तफ्तीश_करना तफतीश_करना अवगाहना
invigorate: प्रेरित_करना
invite: ललचाना लालच_देना लुब्ध_करना लुभाना निमंत्रित_करना निमंत्रण_देना आमंत्रित_करना बुलाना निमन्त्रित_करना निमन्त्रण_देना निमंत्रना निमन्त्रना न्योतना नेवतना नेउतना न्यौता_देना तलब_करना अमातना
invoke: फ़रियाद_करना गुहारना गुहार_करना दुहाई_देना अपील_करना
involve: लेना शामिल_करना सम्मिलित_करना दाखिल_करना दाख़िल_करना माँग_होना
irrigate: पटना सिंचना सिंचाई_होना सिंचाना
irrupt: फटना
issue: निकलना प्रकाशित_होना जारी_करना निकलना निर्गत_होना प्रादुर्भूत_होना
itch: खुजलाना खुजाना चुनचुनाना चंचनाना
jab: घोंपना घुसेड़ना घुसाना भोंकना भौंकना पेलना धँसाना
jabber: हाँकना फेंकना झाड़ना
jade: थकना हारना
jam: अड़ाना अराना
jangle: ठनकना
jaw: बात_करना बातचीत_करना बतियाना वार्तालाप_करना बोलना-बतियाना बोलना बोलना_बतियाना चबाना धिक्कारना फटकारना लानत-मलामत_करना
jazz: सटाना
jazz_around: आवारागर्दी_करना लुच्चापना_करना लुच्चई_करना अवटना
jeopardise: खतरे_में_डालना दाँव_पर_रखना
jeopardize: खतरे_में_डालना दाँव_पर_रखना
jest: मज़ाक_करना विनोद_करना ठट्ठा_करना ठठ्ठा_करना मजाक_करना दिल्लगी_करना
jest_at: उपहास_करना खिल्ली_उड़ाना मज़ाक_उड़ाना हँसी_उड़ाना
jib: अड़ना अँड़ियाना अड़ियाना हठ_करना जिदियाना ज़िदियाना जिद_करना ज़िद_करना टेकना अरना
jingle: ठनकना
jingle-jangle: ठनकना
join: मिलना जुड़ना लगना जुटना संयुक्त_होना संलग्न_होना संबंध_होना संबद्ध_होना भिड़ना
joke: मज़ाक_करना विनोद_करना ठट्ठा_करना ठठ्ठा_करना मजाक_करना दिल्लगी_करना
jollify: हुड़दंग_मचाना हंगामा_करना
joy: अघाना
jubilate: खुशी_से_नाचना खुशी_से_उछलना खुशी_से_फूलना फूला_न_समाना अत्यानंदित_होना अत्यधिक_प्रसन्न_होना खुशी_से_पागल_होना
judder: हिलना
judge: भाँपना ताड़ना लखना भांपना भापना
jump: कूदना उछलना उछरना चढ़ना उछलना उछाल_मारना उचकना उच्छलना उच्छरना उछरना
jump_on: चढ़ना सवार_होना बैठना आरोहित_होना अरोहना सवारी_करना
junket: भोज_देना दावत_देना
keel: डगमगाना लड़खड़ाना डगडोलना अलुटना डगना उखटना
keen: आर्तनाद_करना क्रंदन_करना
keep: रखना चलने_देना रखना पहरा_देना रखवाली_करना रखाना अगोरना अँगोरना सँभालना संभालना थामना सम्हालना मन_मारना पोसना पालना बचाना रखना
keep_an_eye_on: देखना नज़र_रखना नजर_रखना ध्यान_रखना ख्याल_रखना निगरानी_रखना देखते_रहना
keep_back: मन_मारना रोकना रोक_देना
keep_down: अधीन_करना आधीन_करना वश_में_करना अधीनना क़ाबू_करना काबू_करना क़ाबू_में_लाना काबू_में_लाना क़ाबू_पाना काबू_पाना
keep_up: सँभालना संभालना सुरक्षित_रखना सम्हालना
kibosh: रहना रह_जाना
kick: लतियाना लताड़ना लात_मारना ठुकराना
kick_out: निकालना बहिराना बहरियाना निर्गत_करना बाहर_का_रास्ता_दिखाना बाहर_करना
kick_the_bucket: मरना मर_जाना परलोक_सिधारना गुजरना गुज़रना दम_तोड़ना चल_बसना मौत_होना अलविदा_कहना लुढ़कना ढेर_होना प्राण_त्यागना प्राण_निकलना जान_जाना जान_चली_जाना
kick_upstairs: पदोन्नति_करना पदोन्नति_देना
kidnap: अपहरण_करना हरण_करना हरना अगवा_करना हर_लेना किडनैप_करना
kill: मरवाना हत्या_करवाना
kink: ऐंठना बल_खाना
kink_up: ऐंठना बल_खाना
kip: सोना
kiss: चूमना चुंबन_लेना चुम्मा_लेना चुंबना
knap: तोड़ना टोरना तोरना
knead: माँड़ना गूँधना गूँथना मांड़ना गूंधना गूंथना गूथना सानना मलना मालिश_करना
knit: गींजना
knock: टकराना भिड़ाना टापना खूँद_करना निंदा_करना उँगली_उठाना थू_थू_करना बुरा_कहना बुराई_करना उंगली_उठाना अंगुली_उठाना
knock_off: चुराना चोरी_करना हाथ_मारना चुरा_लेना उड़ाना उड़ा_लेना मूसना टीपना अपहरना
know: जानना ज्ञान_होना ज्ञात_होना मालूम_होना पता_चलना अभिज्ञ_होना परिचित_होना रूबरू_होना आना अवकलना आना जानना पहचानना चीन्हना जानना जानना समझना बूझना अवगाहना मानना सटाना समझना समझ_पाना जानना पहचानना पहचानना
knuckle_under: अधीन_होना अधीनना आधीन_होना
labor: जोतना रगड़ना
labour: जोतना रगड़ना
lade: लदवाना
laden: लदवाना
lag: पिछड़ना पीछे_छूटना पीछे_होना पछड़ना पीछे_रहना पीछे_रह_जाना
lam: उढ़रना भगना भागना
lambast: धिक्कारना फटकारना लानत-मलामत_करना
lambaste: धिक्कारना फटकारना लानत-मलामत_करना
lament: आर्तनाद_करना क्रंदन_करना
lampoon: व्यंग्य_करना हँसी_उड़ाना ताना_मारना व्यंग_करना ताना_देना गोदना उघटना
languish: ललचना ललकना लालसा_करना लहकना
lap: चाटना चाटना
lap_up: चाटना
lapse: समाप्त_होना खतम_होना ख़तम_होना खत्म_होना ख़त्म_होना जाना समाप्त_हो_जाना खतम_हो_जाना ख़तम_हो_जाना खत्म_हो_जाना ख़त्म_हो_जाना
lark: उछल-कूद_करना कूद-फाँद_करना कूदफाँद_करना
lark_about: उछल-कूद_करना कूद-फाँद_करना कूदफाँद_करना
larn: सीखना
lasso: उलझाना फँसाना फाँसना बझाना अरुझाना फंसाना फांसना
last: रहना रह_जाना
laugh: हँसना
laugh_at: उपहास_करना खिल्ली_उड़ाना मज़ाक_उड़ाना हँसी_उड़ाना
launch: चलाना
launder: धुलना
lay: रखना धरना घालना लिटाना लेटाना
lay_in: भंडारण_करना
lay_off: छोड़ना छोड़_देना अलविदा_कहना
lay_out: प्रस्तुत_करना पेश_करना सामने_लाना
laze: अलसाना आलस्य_करना अलसना अरसाना
lead: दौड़ना चलना जाना पीछे_छोड़ना जाना
lead_astray: भटकाना बहलना बहकना फुसलना
lead_off: उठाना
lead_on: छलना धोखा_देना चकमा_देना छल_करना आँखों_में_धूल_झोंकना आंखों_में_धूल_झोंकना
lean: झुकना नवना
leap: कूदना उछलना उछाल_मारना उचकना उच्छलना उच्छरना उछरना
learn: सीखना सीख_देना सिखलाना सिखाना शिक्षा_देना बताना
lease: किराए_पर_लेना भाड़े_पर_लेना उठाना करना
leash: बाँधना बांधना ग्रंथन ग्रन्थन
leave: छोड़ना छोड़ना निकलना अलग_होना पृथक_होना हटना टूटना फूटना अरगाना वसीयत_करना छूटना छूट_जाना निकलना
leave_off: छोड़ना
leave_out: छोड़ना छूटना छूट_जाना रहना रह_जाना
lecture: धिक्कारना फटकारना लानत-मलामत_करना
lengthen: बढ़ाना लंबा_करना लम्बा_करना
lenify: मनाना मनुहारना मान_मनुहार_करना
lessen: कम_होना घटना ह्रास_होना गिरना क्षीण_होना नरम_पड़ना कमी_आना टूटना उतरना
let: उठाना
let_down: उतारना अवतारना
let_loose: बोलना आवाज_करना
let_on: खुलना उघड़ना उघरना उघढ़ना भांडा_फूटना भंडा_फूटना पर्दाफ़ाश_होना परदाफ़ाश_होना परदाफाश_होना पर्दाफाश_होना बेनक़ाब_होना बेनकाब_होना रहस्योद्घाटन_होना लीक_होना
let_out: बोलना आवाज_करना खुलना उघड़ना उघरना उघढ़ना भांडा_फूटना भंडा_फूटना पर्दाफ़ाश_होना परदाफ़ाश_होना परदाफाश_होना पर्दाफाश_होना बेनक़ाब_होना बेनकाब_होना रहस्योद्घाटन_होना लीक_होना
levy: वसूलना वसूल_करना उगाहना उगहना उग्रहना उघाना
liberate: छूटना छूट_जाना रिहा_होना मुक्त_होना निकलना बरी_होना
librate: तौलाना तौलना
lick: चाटना हल_करना समाधान_करना निराकरण_करना चाटना
lie: होना स्थित_होना झूठ_बोलना असत्य_बोलना लेटना पड़ना
lie_down: लेटना पड़ना
lie_in_wait: घात_लगाना घतियाना घात_में_बैठना ताक_में_बैठना ताक_में_रहना मौक़ा_ढूढना
lie_with: सटाना
lift: उठाना उठना ऊँचा_होना उचना उठाना हटाना दूर_करना समाप्त_करना बंद_करना
lift_up: उठाना उचाना उकसाना उगसाना बहकना
light: प्रकाशित_होना आलोकित_होना दीप्त_होना जलाना सुलगाना फूँकना फूंकना
light_up: प्रकाशित_होना आलोकित_होना दीप्त_होना
like: इच्छा_होना चाहना मन_होना अभिलाषा_होना अभिलाखना बाँछना आखना पसंद_आना पसन्द_आना अच्छा_लगना जँचना भाना रुचना पुसाना पोसाना रास_आना
limit: रोक_लगाना पाबंदी_लगाना पाबन्दी_लगाना रोक_लगा_देना पाबंदी_लगा_देना पाबन्दी_लगा_देना बंदिश_लगाना बन्दिश_लगाना निषेध_करना प्रतिबंध_लगाना प्रतिबंधित_करना प्रतिबन्ध_लगाना प्रतिबन्धित_करना बैन_लगाना
limp: लँगड़ाना
line: पंक्तिबद्ध_होना कतारबद्ध_होना कतार_में_होना लाइन_में_होना खींचना खीचना ईचना ईंचना ऐंचना
link: जोड़ना लगाना सटाना जुड़ना लगना जुटना संयुक्त_होना संलग्न_होना संबंध_होना संबद्ध_होना भिड़ना
link_up: जुड़ना लगना जुटना संयुक्त_होना संलग्न_होना संबंध_होना संबद्ध_होना भिड़ना जोड़ना लगाना सटाना
listen: सुनना
listen_in: अनकना
live: रहना निवास_करना जीना जीवित_रहना जीवन_यापन_करना जीवन_बिताना गुजर-बसर_करना जानना समझना बूझना अवगाहना
load: लदवाना लादना चढ़ाना
load_up: लदवाना
locate: बताना बतलाना निर्देशित_करना दिखाना दिखलाना बसना रहना निवास_करना
lodge: रुकना ठहरना रहना टिकना उतरना रुक_जाना ठहराना टिकाना रुकवाना
log_z's: सोना
long: तरसना
look: देखना निहारना ताकना तकना निरखना विलोकना नजर_डालना नज़र_डालना नज़र_दौड़ाना नजर_दौड़ाना आखना ईखना ईखन ईछना धाधना दिखना दृष्टिगोचर_होना नजर_आना नज़र_आना दिखाई_देना सूझना रुख_होना रुख़_होना दिखाना दिखलाना टपना
look_at: लेना ले_लेना
look_for: खोजना खोज_करना ढूँढ़ना ढूँढना तलाशना तलाश_करना पता_लगाना पता_करना छानना देखना मथना आखना
loose: छूटना छूट_जाना रिहा_होना मुक्त_होना निकलना बरी_होना
loot: लूटना लूटना अपहरना मूसना
lop_off: छाँटना छाँट_देना
lord: स्वामी_बनाना मालिक_बनाना अधिपति_बनाना
lose: पगलाना बौराना पागल_होना बउराना हारना फेंकना गिराना गँवाना गवाँ_देना खो_देना हाथ_धोना खोना गंवाना गवां_देना टूटना
lot: बाँटना वितरित_करना वितरण_करना बांटना
lour: आँख_तरेरना आँख_दिखाना
love: स्नेह_करना सटाना
low: रंभाना रम्भाना राँभना रम्याना
lower: उतारना अवतारना आँख_तरेरना आँख_दिखाना
lucubrate: व्याख्या_करना समझाना अर्थ_समझाना अरथाना अर्थाना
lull: बुझाना ठंडा_करना शांत_करना
lurch: डगमगाना लड़खड़ाना डगडोलना अलुटना डगना उखटना
lure: ललचाना लालच_देना लुब्ध_करना लुभाना
lurk: घात_लगाना घतियाना घात_में_बैठना ताक_में_बैठना ताक_में_रहना मौक़ा_ढूढना
maintain: रखना सँभालना संभालना सुरक्षित_रखना सम्हालना सँभालना संभालना थामना सम्हालना पहरा_देना रखवाली_करना रखाना अगोरना अँगोरना
major: मुख्य_विषय_के_रूप_में_पढ़ना मुख्य_विषय_होना
make: करना बनाना करना कारण_होना कारण_होना बनाना तैयार_करना निर्माण_करना रचना निर्माना खड़ा_कर_लेना खड़ा_करना विकसित_करना डिज़ाइन_करना पहुँचना पहुंचना उठना बनना तैयार_होना बनाना नियुक्त_करना बनाना आना पहुँचना पहुंचना पधारना अवना आगमना करना जोड़ना जोड़_करना योग_करना आयोजित_करना आयोजन_करना भोजन_पकाना भोजन_बनाना रसोई_बनाना पकाना खाना_बनाना खाना_पकाना राँधना रांधना रींधना हगना झाड़ा_फिरना पाखाना_करना पाख़ाना_करना टट्टी_करना मलत्याग_करना दिशा_मैदान_करना दिशा_मैदान_जाना करना बनना तैयार_होना लाना करना पहचान_होना पहचाना_जाना लगना समय_पर_पहुँचना जलाना प्रज्वलित_करना उजालना उजासना उजियारना उजेरना सफल_बनाना दिखाना दिखावा_करना शो_करना आँकना आंकना आनन्ददायक_बनाना आनंददायक_बनाना आनन्दप्रद_बनाना सुखदायक_बनाना सुखप्रद_बनाना आह्लादक_बनाना खुशनुमा_बनाना बनाना मूतना पेशाब_करना
make_believe: दिखाना दिखावा_करना शो_करना
make_clean: छुड़ाना छोड़ाना
make_for: करना
make_full: अँटवाना अंटवाना अटवाना अँटाना अंटाना अटाना समवाना भरवाना पुरवाना
make_fun: उपहास_करना खिल्ली_उड़ाना मज़ाक_उड़ाना हँसी_उड़ाना
make_happy: हुड़दंग_मचाना हंगामा_करना
make_headway: जीतना विजय_पाना विजयी_होना हराना पराजित_करना परास्त_करना शिकस्त_देना पछाड़ना मात_देना जीत_दर्ज_करना जीत_लेना कामयाब_होना
make_it: बचना उबरना बच_जाना उबर_जाना निकालना
make_love: सटाना
make_merry: हुड़दंग_मचाना हंगामा_करना
make_out: सटाना
make_pure: शोधन_करना परिष्कार_करना
make_up_one's_mind: निर्णय_लेना फैसला_लेना सोच_लेना फ़ैसला_करना निश्चय_करना तय_करना तै_करना
make_vibrant_sounds: घुरघुराना घुर्रघुराना
make_water: मूतना पेशाब_करना
make_whoopie: हुड़दंग_मचाना हंगामा_करना
maledict: कोसना
malfunction: बिगड़ना ख़राब_होना खराब_होना विकृत_होना काम_न_करना जवाब_देना गड़बड़ाना
manage: सँभलना संभलना सम्हलना
manducate: चबाना
manure: पाँसना
march: मार्च_करना मार्च_कराना चलाना प्रदर्शन_करना कदमताल_करना मार्च_करना सीमा_पर_होना सरहद_पर_होना किनारे_पर_होना
mark: चिह्न_बनाना निशान_बनाना अवलेखना
mark_off: चाकना हद_बाँधना हद_बांधना
mark_out: चाकना हद_बाँधना हद_बांधना
marry: विवाह_करना शादी_करना ब्याहना बियाहना ब्याह_करना हाथ_थामना हाथ_धरना हाथ_पकड़ना
mash: पेरना नख़रे_दिखाना चोचले_करना नाज़_नख़रा_करना बनना जाँतना जातना जांतना
massage: मलना मालिश_करना
masticate: चबाना
mat: गुथना गुँथना
match: पाना जाना जँचना मेल_खाना
mate: जोड़ा_खाना टपना
materialise: आना
materialize: आना
maturate: बुढ़ाना वृद्ध_होना
mature: औसाना बुढ़ाना वृद्ध_होना
maunder: बड़बड़ाना प्रलाप_करना बर्राना अकबक_बोलना अंड-बंड_बकना बकवास_करना बकना बकबक_करना बकबकाना प्रलाप_करना
mean: अर्थ_लगाना अरथाना अर्थाना
measure: मापना नापना मूल्यांकन_करना मूल्य_लगाना
measure_out: मापना नापना
meddle: बिगाड़ना खराब_करना ख़राब_करना घालना
meet: मिलना भेंट_होना मुलाकात_होना पिसना छुआना छुलाना छुवाना स्पर्श_कराना परसाना
meld: मिलना अमेजना
meliorate: बढ़ाना विकसित_करना उन्नत_करना बिकसाना ऊंचा_उठाना ऊँचा_उठाना सुधरना
mellow: पिघलना पसीजना द्रवित_होना
mellow_out: पिघलना पसीजना द्रवित_होना
melt: पिघलाना टघलाना टघराना टिघलाना पिघलना पसीजना द्रवित_होना उड़ना उड़_जाना फीका_पड़ना निकलना उतरना
melt_down: पिघलाना टघलाना टघराना टिघलाना
menace: खतरे_में_डालना दाँव_पर_रखना
mend: मरम्मत_करना ठीक_करना दुरुस्त_करना बनाना
mensurate: मापना नापना
mention: उल्लेख_करना जिक्र_करना ज़िक्र_करना
merge: मिलना अमेजना
mete_out: बाँटना वितरित_करना वितरण_करना बांटना
micturate: मूतना पेशाब_करना
milk: दुहना दोहना लगाना
mind: ध्यान_में_रखना याद_रखना स्मरण_रखना
mirror: प्रतिबिम्बित_करना प्रतिबिंबित_करना
misadvise: बहकाना भरमाना पट्टी_पढ़ाना
miscarry: हारना असफल_होना नाकाम_होना विफल_होना
misdirect: भटकाना
misfunction: बिगड़ना ख़राब_होना खराब_होना विकृत_होना काम_न_करना जवाब_देना गड़बड़ाना
misguide: भटकाना बहकाना भरमाना पट्टी_पढ़ाना
mislay: फेंकना गिराना
mislead: भटकाना
misplace: फेंकना गिराना
miss: चूकना अवसर_खोना छूटना छूट_जाना रहना रह_जाना चूकना चूक_जाना
mistake: भूल_करना गलती_करना अपराध_करना कुसूर_करना कसूर_करना ज़ुर्म_करना जुर्म_करना गुनाह_करना
mix: मिलना अमेजना मिलाना अभेरना अमेजना आमेजना
mix_in: मिलाना अभेरना अमेजना आमेजना
moan: काँखना
moderate: सँभालना संभालना सम्हालना
modify: बनाना कर_देना करना बना_देना परिवर्तित_करना
moil: जोतना रगड़ना
mold: ढालना
molest: सताना उत्पीड़ित_करना ताड़ना प्रताड़ना तपाना कष्ट_देना दुखी_करना दुःखी_करना पीड़ा_देना पेरना परेशान_करना तंग_करना तंङ्ग_करना नाक_में_दम_करना पीड़ित_करना अप्रसन्न_करना हैरान_करना नींद_हराम_करना नींद_उड़ाना उँगली_करना उंगली_करना अरूरना अर्दना अवडेरना अवसेरना
mollify: मनाना मनुहारना मान_मनुहार_करना बेहतर_बनाना और_अच्छा_बनाना बेहतर_करना और_अच्छा_करना
monish: चेतावनी_देना चेताना चिताना सावधान_करना आगाह_करना ख़बरदार_करना जताना
moo: रंभाना रम्भाना राँभना रम्याना
moon: दिवास्वप्न_देखना
mortgage: गिरवी_रखना आड़ना
motion: संकेत_देना संकेत_करना इशारा_करना
mould: ढालना
mount: चढ़ना सवार_होना बैठना आरोहित_होना अरोहना सवारी_करना
mount_up: चढ़ना सवार_होना बैठना आरोहित_होना अरोहना सवारी_करना
mourn: विलाप_करना कलपना बिलखना विलापना रोना-धोना
mouse: खिसकना सटकना खिसक_जाना सटक_जाना चलता_बनना सटक_लेना किड़कना
mouth: फूटना
mouth_off: हाँकना फेंकना झाड़ना
move: हटवाना हटवा_देना चला_जाना जाना गुजरना गुज़रना प्रभावित_करना प्रभाव_डालना असर_डालना छाप_छोड़ना असर_करना रंग_जमाना रंगना छाना
move_into: प्रवेश_करना अंदर_आना दाख़िल_होना प्रविष्ट_होना आना घुसना पैठना ढुकना हलना
muck: पाँसना
muddle: गड़बड़ाना अटपटाना
mulct: ठगना ऐंठना झटकना मूड़ना मूँड़ना लूटना झाड़ना मूसना
multiply: गुणा_करना
mumble: बड़बड़ाना प्रलाप_करना बर्राना अकबक_बोलना अंड-बंड_बकना
murder: मारना हत्या_करना प्राण_लेना जान_लेना मौत_के_घाट_उतारना हत_करना उड़ाना हनना वध_करना कत्ल_करना प्राण_निकालना जान_निकालना संहारना हनन_करना अरदना मौत_की_नींद_सुलाना जान_से_मारना खून_करना ख़ून_करना मार_डालना ठिकाने_लगाना ठिकाने_पहुँचाना
murmur: बड़बड़ाना बुदबुदाना बड़बड़_करना बर्राना बुड़बुड़ाना भुनभुनाना
mussitate: बड़बड़ाना प्रलाप_करना बर्राना अकबक_बोलना अंड-बंड_बकना
mutter: बड़बड़ाना प्रलाप_करना बर्राना अकबक_बोलना अंड-बंड_बकना भुनभुनाना
nab: बंदी_बनाना बंदी_बना_लेना क़ैद_करना कैद_करना गिरफ्तार_करना गिरफ़्तार_करना पकड़ना पकड़_लेना गिरफ़्त_में_लेना गिरफ्त_में_लेना हिरासत_में_लेना अरेस्ट_करना
nail: बंदी_बनाना बंदी_बना_लेना क़ैद_करना कैद_करना गिरफ्तार_करना गिरफ़्तार_करना पकड़ना पकड़_लेना गिरफ़्त_में_लेना गिरफ्त_में_लेना हिरासत_में_लेना अरेस्ट_करना
name: नाम_देना नाम_रखना नामित_करना लेना बताना बोलना बनाना नियुक्त_करना उल्लेख_करना जिक्र_करना ज़िक्र_करना
narrate: सुनाना
nasalise: नकियाना
nasalize: नकियाना
natter: बात_करना बातचीत_करना बतियाना वार्तालाप_करना बोलना-बतियाना बोलना बोलना_बतियाना
neaten: सुव्यवस्थित_करना सुविन्यस्त_करना सुप्रबंधित_करना
necessitate: माँग_होना
need: माँग_होना आवश्यकता_होना ज़रूरत_होना आवश्यकता_पड़ना ज़रूरत_पड़ना जरूरत_होना जरूरत_पड़ना
neglect: छूटना छूट_जाना रहना रह_जाना छोड़_देना ध्यान_न_देना नजरअंदाज_करना नजरंदाज_करना
neigh: हिनहिनाना
net: शुद्ध_लाभ_कमाना शुद्ध_बचत_करना शुद्ध_आय_करना शुद्ध_आमदनी_करना निवल_आय_करना निवल_लाभ_करना शुद्ध_लाभ_होना शुद्ध_बचत_होना शुद्ध_आय_होना शुद्ध_आमदनी_होना निवल_आय_होना निवल_लाभ_होना जाल_से_पकड़ना
nett: जाल_से_पकड़ना
nibble: कुतरना खोंटना उखटना टूँगना टुँगना
nicker: हिनहिनाना
nictate: मीचना
nictitate: मीचना
nip: चिकोटी_काटना चिकोटना चुटकी_काटना चिहुँटना चूँटी_काटना चुटकी_लेना बकोटना छाँटना
nip_off: छाँटना
nobble: ठगना ऐंठना झटकना मूड़ना मूँड़ना लूटना झाड़ना मूसना अपहरण_करना हरण_करना हरना अगवा_करना हर_लेना किडनैप_करना
nominate: नामित_करना मनोनीत_करना नामज़द_करना नामजद_करना नाम_बताना नाम_लेना बनाना नियुक्त_करना
note: टाँकना
nourish: पोषित_करना जीवित_रखना पालित_करना
numb: सोना
number: गिनना गिनती_करना संख्या_जानना
numerate: गिनना गिनती_करना संख्या_जानना
nurture: पालना पालना परवरिश_करना पालन-पोषण_करना पालन_करना पोषना पालना-पोषना पोषित_करना जीवित_रखना पालित_करना
obey: आज्ञा_पालन_करना कहा_करना बात_मानना
observe: देखना नज़र_रखना नजर_रखना ध्यान_रखना ख्याल_रखना निगरानी_रखना देखते_रहना पहरा_देना रखवाली_करना रखाना अगोरना अँगोरना
obstruct: अड़ाना अराना
obturate: अड़ाना अराना
occlude: अड़ाना अराना
occupy: लगना जुटना लिपटना व्यस्त_रहना लगा_रहना भरा_होना परिपूर्ण_होना भरा_पड़ा_होना पड़ना आक्रमण_करना चढ़ाई_करना हमला_करना धावा_बोलना हमला_बोलना
occur: चरितार्थ_होना घटना ठीक_उतरना सूझना मिलना पाया_जाना
off: मारना हत्या_करना प्राण_लेना जान_लेना मौत_के_घाट_उतारना हत_करना उड़ाना हनना वध_करना कत्ल_करना प्राण_निकालना जान_निकालना संहारना हनन_करना अरदना मौत_की_नींद_सुलाना जान_से_मारना खून_करना ख़ून_करना मार_डालना ठिकाने_लगाना ठिकाने_पहुँचाना
offend: चुभना खटकना बुरा_लगना अप्रिय_लगना
offer: प्रस्तुत_करना पेश_करना मानना स्वीकारना स्वीकार_करना सहमत_होना राज़ी_होना राजी_होना स्वीकार_कर_लेना सहमत_हो_जाना राज़ी_हो_जाना राजी_हो_जाना इत्तफाक_रखना इत्तफ़ाक़_रखना क़बूलना कबूलना देना उपलब्ध_कराना आफर_करना ऑफर_करना प्रस्तुत_करना पेश_करना विक्रय_के_लिए_उपलब्ध_कराना विक्रय_के_लिए_रखना देना प्रदान_करना चढ़ना अर्पित_होना करना विवाह_प्रस्ताव_रखना
offer_up: चढ़ना अर्पित_होना
oink: किकियाना
omit: छोड़ना छूटना छूट_जाना रहना रह_जाना
ooze: रिसना रसना बहना सीझना पसीजना छूटना स्राव_होना ओगरना पसीजना
ooze_out: पसीजना
open: खोलना उघारना उघाड़ना उघटना उघेलना खोलना खुलना उघड़ना उघरना उघढ़ना फैलाना पसारना डालना खुलना चालू_होना खुलना ओपन_करना खोलना
open_up: खोलना उघारना उघाड़ना उघटना उघेलना खुलना चालू_होना खोलना खुलना उघड़ना उघरना उघढ़ना खुलना संकोच_त्यागना
operate: चलाना चलना उपयोग_में_आना काम_करना आपरेशन_करना शल्य_कर्म_करना सर्जरी_करना
operate_on: आपरेशन_करना शल्य_कर्म_करना सर्जरी_करना
oppress: दबाना
order: कहना बोलना फ़रमाना फरमाना आज्ञा_करना आज्ञा_देना आदेश_देना हुक्म_देना ऑर्डर_देना आर्डर_देना
organise: सजाना लगाना व्यवस्थित_करना जमाना
organize: सजाना लगाना व्यवस्थित_करना जमाना
originate: पैदा_होना उत्पन्न_होना
ornament: सजाना सँवारना अलंकृत_करना सज्जित_करना सँजोना संजोना
oscillate: डोलना
osculate: चूमना चुंबन_लेना चुम्मा_लेना चुंबना
ostentate: अभिमान_प्रदर्शन_करना रोब_झाड़ना शान_दिखाना
outcry: चिल्लवाना चिलवाना
outlast: अधिक_जीना अधिक_समय_जीना अधिक_दिन_जीना
outlive: अधिक_जीना अधिक_समय_जीना अधिक_दिन_जीना
outwear: थकना हारना
overcharge: लूटना ठगना
overcome: पछाड़ना मात_देना पराजित_करना परास्त_करना हराना शिकस्त_देना ढेर_करना धूल_चटाना
overeat: अघाना अफराना
overgorge: अघाना अफराना
overhang: लटकना
overhaul: निकालना बढ़ाना पार_कराना उकतारना
overindulge: अघाना अफराना
overlap: चढ़ना
overleap: छूटना छूट_जाना रहना रह_जाना
overlook: छूटना छूट_जाना रहना रह_जाना
overspread: फैलना
overtake: निकालना बढ़ाना पार_कराना उकतारना
overturn: उलटना पलटना
overwhelm: तल्लीन_होना खोना डूबना डूब_जाना आत्मविस्मृत_होना ध्यानावस्थित_होना ध्यानमग्न_होना भावलीन_होना अवगाहना
overwork: चूसना निचोड़ना
pacify: मनाना मनुहारना मान_मनुहार_करना
pack: पैक_करना बाँधना बांधना
paddle: ठुमकना ठुनकना थिरकना
pain: दुखाना
paint: चित्र_बनाना चित्रांकन_करना चित्रित_करना तसवीर_बनाना अवरेवना अवरोहना रंगना रँगना
pair: जोड़ा_खाना टपना
palaver: बकवास_करना बकना बकबक_करना बकबकाना प्रलाप_करना फुसलाना बहलाना बहकाना बरगलाना बर्गलाना
palisade: दीवार_से_घेरना
pall: डरवाना
palpitate: धड़काना स्पंदित_करना फड़कना धड़कना स्पंदित_होना
panic: घबराना घबड़ाना
pant: हाँफना हाँपना हांफना हांपना
parcel_out: बाँटना वितरित_करना वितरण_करना बांटना
pare: छिलवाना
parent: पालना परवरिश_करना पालन-पोषण_करना पालन_करना पोषना पालना-पोषना
parrot: रटना रट्टा_लगाना घोंटना घोटना अभ्यास_करना
parry: टालमटोल_करना टरकाना टालना आज_कल_करना
part: बिछुड़ना बिलगना छूटना छूट_जाना विलग_होना अलग_होना अलग_होना प्रस्थान_करना रवाना_होना खुलना छूटना चलना निकलना बँटना बटना अलग_करना अलगाना बिलगाना वियुक्त_करना विलगाना विलग_करना बगलियाना उचेलना
participate: भाग_लेना हिस्सा_लेना सम्मिलित_होना शामिल_होना शिरकत_करना
party: पार्टी_करना
pass: गुजरना गुज़रना निकलना पकड़ाना धराना थमाना दौड़ना चलना जाना निकालना बढ़ाना पार_कराना उकतारना चरितार्थ_होना घटना ठीक_उतरना व्यतीत_होना कटना गुजरना गुज़रना बीतना निकलना ढलना निकालना मरना मर_जाना परलोक_सिधारना गुजरना गुज़रना दम_तोड़ना चल_बसना मौत_होना अलविदा_कहना लुढ़कना ढेर_होना प्राण_त्यागना प्राण_निकलना जान_जाना जान_चली_जाना
pass_away: मरना मर_जाना परलोक_सिधारना गुजरना गुज़रना दम_तोड़ना चल_बसना मौत_होना अलविदा_कहना लुढ़कना ढेर_होना प्राण_त्यागना प्राण_निकलना जान_जाना जान_चली_जाना टलना हटना टरना दूर_होना अलग_होना अहुटना
pass_by: गुजरना गुज़रना निकलना
pass_off: चरितार्थ_होना घटना ठीक_उतरना
pass_on: पकड़ाना धराना थमाना
pass_over: काटना पोछना पोंछना
pass_up: मना_करना ना_कहना
pass_water: मूतना पेशाब_करना
paste: चिपकाना चपकाना साटना सटाना चिपटाना ग्रंथन ग्रन्थन
pasture: चराना चरना
pat: थपथपाना थपकाना थपकी_देना
patter: पटपटाना
pattern: संरचना_होना रूप_होना फार्म_होना
pause: अटकना
pay: चुकाना भुगतान_करना देना अदा_करना चुकता_करना भरना भुगताना पटाना पूर्ति_करना भरवाना भराना
peal: बजना
peck: चुगना चुग्गा_लेना
pee: मूतना पेशाब_करना
pee-pee: मूतना पेशाब_करना
peel: छिलवाना
peel_off: उतारना उधेड़ना उचाड़ना उकेलना उकालना उचाटना उचारना उचालना उचेड़ना उचेलना उछाँटना
peep: झाँकना झांकना कलरव_करना चहकना चहचहाना
pelt: मूसलाधार_बारिश_होना जोरदार_बारिश_होना मूसलाधार_वर्षा_होना मूसलाधार_पानी_बरसना जोरदार_पानी_बरसना मूसलाधार_पानी_गिरना जोरदार_पानी_गिरना
pen: रचना लिखना
penalise: दंड_देना सज़ा_देना सजा_देना दण्ड_देना दंडित_करना दण्डित_करना सजा_सुनाना सज़ा_सुनाना दंड_सुनाना
penalize: दंड_देना सज़ा_देना सजा_देना दण्ड_देना दंडित_करना दण्डित_करना सजा_सुनाना सज़ा_सुनाना दंड_सुनाना
people: बसाना आबाद_करना बसना आबाद_होना
perfect: निपुण_बनाना निपुण_करना प्रवीण_करना प्रवीण_बनाना पारंगत_करना पारंगत_बनाना काबिल_करना सिद्ध_करना
perform: करना निपटाना संपादित_करना सम्पादित_करना करना
peril: खतरे_में_डालना दाँव_पर_रखना
perish: मरना मर_जाना परलोक_सिधारना गुजरना गुज़रना दम_तोड़ना चल_बसना मौत_होना अलविदा_कहना लुढ़कना ढेर_होना प्राण_त्यागना प्राण_निकलना जान_जाना जान_चली_जाना
perk_up: जगाना साधना साधन_करना
persist: चलना प्रचलित_होना जारी_होना रहना रह_जाना
personify: निभाना अदा_करना
perturb: घबराना घबड़ाना बेचैन_होना व्याकुल_होना अकुलाना बिकलाना बेकलाना उकताना
pester: छेड़ना छेड़छाड़_करना छेड़खानी_करना
pestle: मसलना मलना मींजना मसकना
petrify: पथराना
philander: नख़रे_दिखाना चोचले_करना नाज़_नख़रा_करना बनना
photograph: खींचना खीचना फोटो_खींचना फोटो_खीचना ईचना ईंचना ऐंचना तस्वीर_लेना तस्वीर_खींचना तस्वीर_खीचना
pick: निकालना टूँगना टुँगना
pick_apart: निंदा_करना उँगली_उठाना थू_थू_करना बुरा_कहना बुराई_करना उंगली_उठाना अंगुली_उठाना
pick_off: लोढ़ना चुनना
pick_out: छाँटना बीनना चुनना अलगाना छांटना बराना बाँछना उछाँटना
pick_up: उठाना उचाना उकसाना उगसाना बंदी_बनाना बंदी_बना_लेना क़ैद_करना कैद_करना गिरफ्तार_करना गिरफ़्तार_करना पकड़ना पकड़_लेना गिरफ़्त_में_लेना गिरफ्त_में_लेना हिरासत_में_लेना अरेस्ट_करना बहकना चुगना चुग्गा_लेना
piddle: मूतना पेशाब_करना
piece: टूँगना टुँगना
piffle: बकवास_करना बकना बकबक_करना बकबकाना प्रलाप_करना
pig_out: अघाना अफराना
pile_up: जमना एकत्र_होना जमा_होना एकत्रित_होना जुटना गोलियाना इकट्ठा_होना अगटना जुड़ना घुमड़ना जोड़ना जमा_करना जुटाना संचित_करना इकट्ठा_करना एकत्रित_करना एकत्र_करना संग्रह_करना संग्रहना संजोना सँजोना
pillage: लूटना अपहरना मूसना
pinch: चिकोटी_काटना चिकोटना चुटकी_काटना चिहुँटना चूँटी_काटना चुटकी_लेना बकोटना समेटना
pine: ललचना ललकना लालसा_करना लहकना
pink: टापना खूँद_करना
pipe_down: मौन_होना चुप_होना चुप्पी_साधना दम_साधना अरगाना
piss: मूतना पेशाब_करना
pitch: तानना
pitter-patter: पटपटाना
placate: मनाना मनुहारना मान_मनुहार_करना
place: रखना धरना घालना लगाना मिलना पाना प्राप्त_होना निशाना_साधना निशाना_बाँधना पहचानना चीन्हना जानना लगाना निवेश_करना दूसरे_स्थान_पर_आना प्लेस_करना
place_upright: उठाना
plague: सताना उत्पीड़ित_करना ताड़ना प्रताड़ना तपाना कष्ट_देना दुखी_करना दुःखी_करना पीड़ा_देना पेरना परेशान_करना तंग_करना तंङ्ग_करना नाक_में_दम_करना पीड़ित_करना अप्रसन्न_करना हैरान_करना नींद_हराम_करना नींद_उड़ाना उँगली_करना उंगली_करना अरूरना अर्दना अवडेरना अवसेरना
plan: इरादा_होना विचार_होना योजना_बनाना प्लानिंग_करना
plane: उड़ाना
plank: पटकना
plant: रोपना आरोपना गाड़ना स्थापित_करना अधिष्ठित_करना अधिष्ठापित_करना
plaster: थोपना
plaster_over: थोपना
play: खेलना निभाना अदा_करना खेलना क्रीड़ा_करना बजना खेलना खिलवाड़_करना करना
play_a_trick_on: चकमा_देना झाँसा_देना झांसा_देना
play_hooky: छुट्टी_मारना छुट्टी_पर_रहना छुट्टी_मनाना
please: सुखद_लगना अच्छा_लगना नीक_लगना सुहाना
pledge: प्रतिज्ञा_करना प्रण_करना प्रतिज्ञा_लेना प्रण_लेना कसम_खाना सौगंध_खाना सौगन्ध_खाना कसम_लेना सौगंध_लेना सौगन्ध_लेना
plight: रोकना प्रतिज्ञा_करना प्रण_करना प्रतिज्ञा_लेना प्रण_लेना कसम_खाना सौगंध_खाना सौगन्ध_खाना कसम_लेना सौगंध_लेना सौगन्ध_लेना
plonk: पटकना
plop: पटकना
plot: रचना
plough: रावनाना
plow: रावनाना
pluck: लोढ़ना चुनना लूटना ठगना
plug: अड़ाना अराना
plumb: थाहना गहराई_मापना गहराई_नापना थाह_लेना
plume: लूटना ठगना
plump: पटकना
plump_down: पटकना
plunder: लूटना लूटना अपहरना मूसना
plunge: डुबाना बोरना डुबोना बूड़ाना
plunk: पटकना
plunk_down: पटकना
pocket: हड़पना कब्ज़ा_करना हथियाना गटकना पचाना पचा_लेना हज़म_करना हजम_करना हज्म_करना खाना डकारना कब्ज़ा_जमाना कब्ज़ा_जमा_लेना
point: निशाना_साधना निशाना_बाँधना
poison: जहर_देना विष_देना जहर_खिलाना-पिलाना
poke: घोंपना घुसेड़ना घुसाना भोंकना भौंकना पेलना धँसाना
poke_fun: उपहास_करना खिल्ली_उड़ाना मज़ाक_उड़ाना हँसी_उड़ाना
polish: निखारना चमकाना उज्जवल_करना उजला_करना उजलाना उजराना झलकाना
polish_off: मारना हत्या_करना प्राण_लेना जान_लेना मौत_के_घाट_उतारना हत_करना उड़ाना हनना वध_करना कत्ल_करना प्राण_निकालना जान_निकालना संहारना हनन_करना अरदना मौत_की_नींद_सुलाना जान_से_मारना खून_करना ख़ून_करना मार_डालना ठिकाने_लगाना ठिकाने_पहुँचाना
pooh-pooh: ठुकराना
pool: दल_बनाना
pop: उभरना उभड़ना उकसना उकिसना उझकना धमक_पड़ना आ_टपकना सहसा_आना आ_धमकना अचानक_आना टपक_पड़ना आ_पहुँचना
pop_off: मरना मर_जाना परलोक_सिधारना गुजरना गुज़रना दम_तोड़ना चल_बसना मौत_होना अलविदा_कहना लुढ़कना ढेर_होना प्राण_त्यागना प्राण_निकलना जान_जाना जान_चली_जाना
pop_out: फूटना उभरना उभड़ना उकसना उकिसना उझकना
pop_the_question: विवाह_प्रस्ताव_रखना
pop_up: धमक_पड़ना आ_टपकना सहसा_आना आ_धमकना अचानक_आना टपक_पड़ना आ_पहुँचना
populate: बसना आबाद_होना बसाना आबाद_करना
pore: ध्यान_देना ध्यान_केंद्रित_करना ध्यान_केन्द्रित_करना गौर_करना ग़ौर_करना
portray: अभिनय_करना रोल_करना खेलना
pose: सामने_लाना खड़ा_करना रखना धरना घालना
position: रखना धरना घालना
postpone: टालना स्थगित_करना टरना मुलतवी_करना सस्पेन्ड_करना सस्पेंड_करना
postulate: माँग_होना
pounce: झपटना चपेटना झपकना लपकना
pour: बहाना प्रवाहित_करना टूटना उमड़ना उमड़ाना पसाना मूसलाधार_बारिश_होना जोरदार_बारिश_होना मूसलाधार_वर्षा_होना मूसलाधार_पानी_बरसना जोरदार_पानी_बरसना मूसलाधार_पानी_गिरना जोरदार_पानी_गिरना
pour_out: पसाना
pout: रूठना मुँह_फुलाना रुष्ट_होना रिसाना रूसना फूलना अनखना अनसाना अनखाना अनैसना
powder: पीसना
powderise: भुरभुराना पीसना
powderize: भुरभुराना पीसना
practice: साधना अभ्यास_करना साधना_करना
practise: अभ्यास_करना साधना_करना साधना
praise: प्रशंसा_करना तारीफ़_करना बखानना सराहना बड़ाई_करना शाबाशी_देना
prance: इतराना चमकना अँगराना इठलाना झमकना टमकना मटकना अँठलाना अंठलाना
prank: सँवरना सजना बनना-ठनना शृंगार_करना सजना-धजना आकल्प
prate: बकवास_करना बकना बकबक_करना बकबकाना प्रलाप_करना
prattle: बकवास_करना बकना बकबक_करना बकबकाना प्रलाप_करना
predominate: प्रबल_होना वर्चस्व_होना प्रधानता_होना शासन_होना अधिक_होना
prepare: अड़ना ठनना उतारू_होना अरना भोजन_पकाना भोजन_बनाना रसोई_बनाना पकाना खाना_बनाना खाना_पकाना राँधना रांधना रींधना तैयार_करना प्रशिक्षित_करना प्रशिक्षण_देना योग्य_बनाना
present: दिखाना दिखलाना प्रदर्शित_करना शो_करना प्रस्तुत_करना पेश_करना सामने_लाना मंचित_करना खेलना पेश_करना प्रस्तुत_करना सामने_लाना खड़ा_करना सम्मान_देना सम्मानित_करना उपहार_देना भेंट_देना तोहफा_देना भाषण_देना बोलना वक्तव्य_देना परिचय_कराना प्रस्तुत_करना पेश_करना परिचय_देना सलूट_करना सेलूट_करना सैल्यूट_करना सलाम_करना
preserve: बनाए_रखना जीवित_रखना जिंदा_रखना जिन्दा_रखना बरक़रार_रखना बरकरार_रखना सँभालना संभालना सुरक्षित_रखना सम्हालना बचाना रखना बचाना संरक्षित_रखना सुरक्षित_रखना
press: दबाना चाँपना चापना दबना चँपना चपना लड़ना लड़ाई_करना निवेदन_करना विनती_करना विनय_करना प्रार्थना_करना अनुनय_करना दुआ_करना अनुरोध_करना अनुराधना अपील_करना
pretend: दिखाना दिखावा_करना शो_करना
pretermit: छूटना छूट_जाना रहना रह_जाना
prevail: प्रबल_होना वर्चस्व_होना प्रधानता_होना शासन_होना अधिक_होना चलना प्रचलित_होना जारी_होना
price: मूल्य_रखना दाम_रखना
prick: गड़ाना चुभाना कोंचना सालना गड़ोना गोदना चुभना धँसना गड़ना डसना डँसना काटना
prickle: गड़ाना चुभाना कोंचना सालना गड़ोना गोदना
print: छपवाना छपाना प्रकाशित_कराना
prise: सम्मान_करना आदर_करना आदरना
prize: सम्मान_करना आदर_करना आदरना
proceed: बढ़ना आगे_बढ़ना जाना गुजरना गुज़रना चलने_देना
process: बनाना तैयार_करना मार्च_करना
prod: घोंपना घुसेड़ना घुसाना भोंकना भौंकना पेलना धँसाना
produce: उत्पादन_करना उत्पन्न_करना पैदा_करना अवतारना उतपाना बनाना तैयार_करना निर्माण_करना रचना निर्माना खड़ा_कर_लेना खड़ा_करना विकसित_करना डिज़ाइन_करना उगाना उपजाना पैदा_करना उआना उगवना उजियाना उतपानना उतपादना उतपातना उतपाना
proffer: प्रस्तुत_करना पेश_करना
profit: फलना फल_देना लाभ_कमाना लाभान्वित_होना फ़ायदा_कमाना
progress: उन्नत_होना उन्नति_करना उभरना विकास_करना बढ़ना फलना फलना-फूलना चमकना
progress_to: पहुँचना पहुंचना
prohibit: रोकना मना_करना अवारना
promise: वचन_देना वादा_करना ज़बान_देना करार_करना क़रार_करना क़रार_देना करार_देना
promote: पदोन्नति_करना पदोन्नति_देना
propose: प्रयोजन_होना मतलब_होना नामित_करना मनोनीत_करना नामज़द_करना नामजद_करना नाम_बताना नाम_लेना विवाह_प्रस्ताव_रखना
prorogue: टालना स्थगित_करना टरना मुलतवी_करना सस्पेन्ड_करना सस्पेंड_करना
proscribe: रोकना मना_करना अवारना
prosecute: डटना भिड़ना जुटना
protect: बचाना रक्षा_करना बरकाना अँदाना
protrude: उभरना उभड़ना उकसना उकिसना उझकना
prove: निकलना ठहरना साबित_होना सिद्ध_होना परखना जाँचना जाँच_करना परीक्षण_करना टेस्ट_करना जांचना जांच_करना
provide: देना प्रदान_करना उपलब्ध_कराना सुलभ_कराना प्राप्त_कराना लब्ध_कराना अधिगत_कराना मुहैया_कराना मुहैय्या_कराना मयस्सर_कराना मुयस्सर_कराना मुयस्य_कराना खोलना खोल_देना जन्म_देना करना भरण-पोषण_करना
provoke: सताना उत्पीड़ित_करना ताड़ना प्रताड़ना तपाना कष्ट_देना दुखी_करना दुःखी_करना पीड़ा_देना पेरना परेशान_करना तंग_करना तंङ्ग_करना नाक_में_दम_करना पीड़ित_करना अप्रसन्न_करना हैरान_करना नींद_हराम_करना नींद_उड़ाना उँगली_करना उंगली_करना अरूरना अर्दना अवडेरना अवसेरना
ptyalise: थूकना उगालना
ptyalize: थूकना उगालना
publish: छपवाना छपाना प्रकाशित_कराना निकलना प्रकाशित_होना प्रकाशित_करना
pucker: गींजना
puddle: गड़बड़ाना अटपटाना मूतना पेशाब_करना
puff: हाँफना हाँपना हांफना हांपना
puke: उगलना उगिलना उग्रहना
pull: खींचना खीचना आकर्षित_करना खींचना लुभाना आकृष्ट_करना आकर्षना निकालना काढ़ना खींचना चूसना खीचना
pull_a_fast_one_on: चकमा_देना झाँसा_देना झांसा_देना
pull_ahead: जीतना विजय_पाना विजयी_होना हराना पराजित_करना परास्त_करना शिकस्त_देना पछाड़ना मात_देना जीत_दर्ज_करना जीत_लेना कामयाब_होना
pull_back: पीछे_हटना
pull_in: आकर्षित_करना खींचना लुभाना आकृष्ट_करना आकर्षना
pull_in_one's_horns: पीछे_हटना
pull_off: लोढ़ना चुनना
pull_out: निकालना काढ़ना खींचना चूसना खीचना
pull_round: बचना उबरना बच_जाना उबर_जाना
pull_through: बचना उबरना बच_जाना उबर_जाना उबरना उद्धार_पाना निस्तार_पाना मुक्त_होना
pull_together: एकत्रित_करना इकट्ठा_करना बटोरना समेटना अंजोरना अँजोरना
pull_up: खींचना चूसना खीचना
pull_up_stakes: निकलना अलग_होना पृथक_होना हटना टूटना फूटना अरगाना
pullulate: टूटना उमड़ना उमड़ाना अंकुर_निकलना अँखुआना जमना अँकुरना अंकुरना अंकुर_फूटना अंकुरित_होना उकसना उकिसना
pulsate: धड़कना स्पंदित_होना
pulse: धड़कना स्पंदित_होना
pulverise: ढाहना ढाना भुरभुराना पीसना
pulverize: पीसना ढाहना ढाना भुरभुराना
punish: दंड_देना सज़ा_देना सजा_देना दण्ड_देना दंडित_करना दण्डित_करना सजा_सुनाना सज़ा_सुनाना दंड_सुनाना
purge: उगलना उगिलना उग्रहना
purify: शोधन_करना परिष्कार_करना
purport: प्रयोजन_होना मतलब_होना
purpose: प्रयोजन_होना मतलब_होना
purr: घरघराना घर्रघराना घड़घड़ना घुरघुराना घुर्रघुराना घुरघुराना घुर्रघुराना
pursue: डटना भिड़ना जुटना पीछा_करना पछियाना पीछे_लगना
push: धकेलना ढकेलना ठेलना धक्का_देना धकेल_देना ढकेल_देना ठेल_देना धकियाना धकिया_देना रेलना पेलना रेल_देना पेल_देना लड़ना लड़ाई_करना
push_aside: निरस्त_करना रद्द_करना निरस्त_कर_देना रद्द_कर_देना ख़ारिज_करना खारिज_करना ख़ारिज_कर_देना खारिज_कर_देना
pussyfoot: खिसकना सटकना खिसक_जाना सटक_जाना चलता_बनना सटक_लेना किड़कना
put: रखना धरना घालना लगाना निवेश_करना
put_away: फेंकना थ्रो_करना
put_down: लिटाना लेटाना चढ़वाना टँकवाना दर्ज_कराना
put_in: भंडारण_करना
put_off: टालना स्थगित_करना टरना मुलतवी_करना सस्पेन्ड_करना सस्पेंड_करना टालमटोल_करना टरकाना टालना आज_कल_करना
put_on: लिपना आलेपित_होना
put_out: झंझट_में_डालना अवडेरना बढ़ाना निकलना प्रकाशित_होना
put_over: टालना स्थगित_करना टरना मुलतवी_करना सस्पेन्ड_करना सस्पेंड_करना
put_to_work: काम_कराना काम_करवाना कराना करवाना
put_up: करना अपमान_सहना बरदाश्त_करना जहर_का_घूंट_पीना जगह_देना घर_देना
puzzle_out: हल_करना समाधान_करना निराकरण_करना
quake: फड़कना
quarrel: लड़ना झगड़ना झगड़ा_करना लड़ाई_करना तकरार_करना उलझना कलह_करना किचकिच_करना अखड़ाना अपड़ाना अरुझाना अलुझना
quash: अधीन_करना आधीन_करना वश_में_करना अधीनना क़ाबू_करना काबू_करना क़ाबू_में_लाना काबू_में_लाना क़ाबू_पाना काबू_पाना
quaver: अटपटाना ज़बान_लड़खड़ाना
quell: दबाना
quench: बुझना बुझाना बुताना बुझाना क्वेंच_करना क्वेन्च_करना दबाना
quest: माँगना मांगना अर्थना हाथ_फैलाना आगे_हाथ_फैलाना
question: खोदना
quiesce: मौन_होना चुप_होना चुप्पी_साधना दम_साधना अरगाना
quiet: मौन_होना चुप_होना चुप्पी_साधना दम_साधना अरगाना बुझाना ठंडा_करना शांत_करना
quiet_down: मौन_होना चुप_होना चुप्पी_साधना दम_साधना अरगाना
quieten: मौन_होना चुप_होना चुप्पी_साधना दम_साधना अरगाना बुझाना ठंडा_करना शांत_करना
quilt: निगंदना
quit: छोड़ना छोड़_देना अलविदा_कहना
quiver: फड़कना
quiz: परीक्षा_लेना इम्तहान_लेना इम्तिहान_लेना
rabbit_on: हाँकना फेंकना झाड़ना
race: दौड़_लगाना
rack: ऐंठना
racket: हुड़दंग_मचाना हंगामा_करना चिल्लाना शोर_मचाना हल्ला_मचाना चीखना शोर_करना हल्ला_करना अललाना अल्लाना रैकेट_से_मारना
radiate: चमकना जगमगाना झलझलाना दमकना जगजगाना झलकना
rag: उघटना उकटना उगटना धिक्कारना फटकारना लानत-मलामत_करना
rail: रेलिंग_लगाना
raiment: पहनाना डालना
rain: बारिश_होना बरसात_होना वर्षा_होना पानी_बरसना मेह_पड़ना बरसना
rain_buckets: मूसलाधार_बारिश_होना जोरदार_बारिश_होना मूसलाधार_वर्षा_होना मूसलाधार_पानी_बरसना जोरदार_पानी_बरसना मूसलाधार_पानी_गिरना जोरदार_पानी_गिरना
rain_cats_and_dogs: मूसलाधार_बारिश_होना जोरदार_बारिश_होना मूसलाधार_वर्षा_होना मूसलाधार_पानी_बरसना जोरदार_पानी_बरसना मूसलाधार_पानी_गिरना जोरदार_पानी_गिरना
rain_down: बारिश_होना बरसात_होना वर्षा_होना पानी_बरसना मेह_पड़ना बरसना
raise: उठाना उगाना उपजाना पैदा_करना उआना उगवना उजियाना उतपानना उतपादना उतपातना उतपाना पालना परवरिश_करना पालन-पोषण_करना पालन_करना पोषना पालना-पोषना पदोन्नति_करना पदोन्नति_देना उठाना हटाना दूर_करना समाप्त_करना बंद_करना
raise_up: हिलाना
rally: सँभलना संभलना सम्हलना उघटना उकटना उगटना
ramble: भटकना ख़ाक_छानना भरमना
range: भटकना ख़ाक_छानना भरमना चरना
ransack: लूटना अपहरना मूसना
rant: हाँकना फेंकना झाड़ना
rap: टापना खूँद_करना
rattle: धड़धड़ाना धड़काना
rave: हाँकना फेंकना झाड़ना
razz: उघटना उकटना उगटना
re-create: उतारना प्रतिरूप_बनाना नकल_करना नक़ल_करना
reach: आना पहुँचना पहुंचना पधारना अवना आगमना पहुँचना पहुंचना पहुँचना पहुंचना पकड़ाना धराना थमाना
read: पढ़ना बाँचना उचरना पढ़ना समझना
ready: भोजन_पकाना भोजन_बनाना रसोई_बनाना पकाना खाना_बनाना खाना_पकाना राँधना रांधना रींधना अड़ना ठनना उतारू_होना अरना
reap: फ़सल_काटना कटाई_करना
rear: पालना परवरिश_करना पालन-पोषण_करना पालन_करना पोषना पालना-पोषना उठना ऊँचा_होना उचना
reave: लूटना अपहरना मूसना
rebound: सँभलना संभलना सम्हलना
rebuke: धिक्कारना फटकारना लानत-मलामत_करना
rebut: खंडन_करना काटना
recall: याद_होना स्मरण_होना जुबान_पर_होना
recite: कहना सुनाना सुनाना
recognise: मानना
recognize: मानना
recollect: याद_होना स्मरण_होना जुबान_पर_होना
recompense: क्षतिपूर्ति_करना नुकसान_भरना नुक़सान_भरना भरपाई_करना
reconstruct: लाना पहले_जैसा_करना
record: चढ़वाना टँकवाना दर्ज_कराना टेप_करना रिकार्ड_करना अभिलेखन_करना
recount: सुनाना
recover: फिर_से_पाना फिर_से_प्राप्त_करना
recruit: नियुक्त_करना काम_देना नौकरी_देना भरती_करना रखना भर्ती_करना तैनात_करना मुकर्रर_करना
recycle: पुनर्चक्रण_करना पुनः_चक्रित_करना रीसाइकल_करना री-साइकल_करना
redden: लज्जित_होना शर्मिन्दा_होना लजाना शरमाना शर्माना झेंपना झेंप_जाना लाल_करना सुर्ख_बनाना अरुनाना लाल_होना सुर्ख_पड़ना अरुनाना
rede: परामर्श_देना सलाह_देना राय_देना
rediscover: फिर_से_प्राप्त_करना फिर_से_पाना फिर_से_खोज_निकालना
reduce: कटौती_करना अधीन_करना आधीन_करना वश_में_करना अधीनना क़ाबू_करना काबू_करना क़ाबू_में_लाना काबू_में_लाना क़ाबू_पाना काबू_पाना गढ़ाना गाढ़ा_करना
reef: नीचा_करना पाल_लपेटना पाल_समेटना घटाना कम_करना
reel: डगमगाना लड़खड़ाना डगडोलना अलुटना डगना उखटना घूमना चक्कर_खाना घूर्णित_होना नाचना
refer: उल्लेख_करना जिक्र_करना ज़िक्र_करना
reflect: चमकना चमचमाना चमाचम_करना तमतमाना झमझमाना
refund: पटना चुकना
refuse: मना_करना ना_कहना
refute: खंडन_करना काटना
regain: फिर_से_पाना फिर_से_प्राप्त_करना
regard: मानना
register: पंजीकरण_कराना पंजीकृत_कराना रजिस्टर_कराना दायर_करना दाखिल_करना
regorge: उगलना उगिलना उग्रहना
regret: पछताना पश्चाताप_करना अछताना-पछताना अफ़सोस_करना अफसोस_करना अपसोसना खलना बुरा_लगना अखरना
regurgitate: उगलना उगिलना उग्रहना
rehearse: अभ्यास_करना साधना_करना
reign: प्रबल_होना वर्चस्व_होना प्रधानता_होना शासन_होना अधिक_होना
reject: मना_करना ना_कहना ठुकराना
rejoice: अघाना खुशी_से_नाचना खुशी_से_उछलना खुशी_से_फूलना फूला_न_समाना अत्यानंदित_होना अत्यधिक_प्रसन्न_होना खुशी_से_पागल_होना
release: छूटना छूट_जाना रिहा_होना मुक्त_होना निकलना बरी_होना निकलना प्रकाशित_होना निकालना जारी_करना लॉन्च_करना लान्च_करना
relieve_oneself: मूतना पेशाब_करना
relish: आनंद_लेना आनन्द_लेना मजा_लेना लुत्फ_लेना लुत्फ़_लेना लुत्फ_उठाना लुत्फ़_उठाना आनंद_उठाना आनन्द_उठाना मौज_करना मस्ती_करना मौज-मस्ती_करना मौज_मस्ती_करना
rely: विश्वास_करना ठीक_मान_लेना पतियाना भरोसा_करना यकीन_करना पतिआना पतीजना
remain: रुकना ठहरना रहना रुक_जाना रहना रह_जाना
remainder: लुटाना
remember: याद_होना स्मरण_होना जुबान_पर_होना
remind: खटखटाना स्मरण_कराना याद_दिलाना
remit: टालना स्थगित_करना टरना मुलतवी_करना सस्पेन्ड_करना सस्पेंड_करना
remonstrate: धिक्कारना फटकारना लानत-मलामत_करना
remove: मिटाना दूर_करना दूर_हटाना अलग_करना हटाना टालना अवलोचना छँटना छँट_जाना मारना हत्या_करना प्राण_लेना जान_लेना मौत_के_घाट_उतारना हत_करना उड़ाना हनना वध_करना कत्ल_करना प्राण_निकालना जान_निकालना संहारना हनन_करना अरदना मौत_की_नींद_सुलाना जान_से_मारना खून_करना ख़ून_करना मार_डालना ठिकाने_लगाना ठिकाने_पहुँचाना हरना हरण_करना मिटाना हर_लेना
render: देना प्रदान_करना उपलब्ध_कराना सुलभ_कराना प्राप्त_कराना लब्ध_कराना अधिगत_कराना मुहैया_कराना मुहैय्या_कराना मयस्सर_कराना मुयस्सर_कराना मुयस्य_कराना खोलना खोल_देना जन्म_देना लौटाना फेरना वापस_करना वापस_देना पलटाना अनुवाद_करना भाषांतर_करना भाषांतरण_करना भाषान्तर_करना भाषान्तरण_करना तरजुमा_करना तरज़ुमा_करना उल्था_करना तर्जुमा_करना तर्ज़ुमा_करना
renounce: परित्याग_करना परित्यागना त्यागना तजना त्याग_करना छोड़ना छोड़_देना हटना उग्रहना
renovate: नवीनीकरण_करना नवीकरण_करना नया_करना
rent: उठाना करना किराए_पर_लेना भाड़े_पर_लेना
repair: मरम्मत_करना ठीक_करना दुरुस्त_करना बनाना क्षतिपूर्ति_करना नुकसान_भरना नुक़सान_भरना भरपाई_करना
repay: पटना चुकना
repeat: दुहराना दोहराना पुनरावृत्ति_करना दुसराना दुबारा_करना दोबारा_करना
repent: पछताना पश्चाताप_करना अछताना-पछताना अफ़सोस_करना अफसोस_करना अपसोसना
replace: बदलना बदल_जाना
replete: अघाना तृप्त_होना छकना संतुष्ट_होना तुष्ट_होना तोषणा
reply: उत्तर_देना उत्तर_बताना जवाब_देना
report: खींचना खीचना ईचना ईंचना ऐंचना
repose: लिटाना लेटाना
reposition: हटाना करना
repossess: ले_लेना वापस_लेना वापस_ले_लेना वापिस_लेना वापिस_ले_लेना
represent: बराबर_होना समतुल्य_होना समान_होना मंचित_करना खेलना पेश_करना प्रस्तुत_करना प्रस्तुत_करना पेश_करना सामने_लाना
repress: अधीन_करना आधीन_करना वश_में_करना अधीनना क़ाबू_करना काबू_करना क़ाबू_में_लाना काबू_में_लाना क़ाबू_पाना काबू_पाना
reprimand: धिक्कारना फटकारना लानत-मलामत_करना
reprocess: पुनर्चक्रण_करना पुनः_चक्रित_करना रीसाइकल_करना री-साइकल_करना
reproof: धिक्कारना फटकारना लानत-मलामत_करना
repudiate: परित्याग_करना परित्यागना त्यागना तजना त्याग_करना छोड़ना छोड़_देना हटना उग्रहना
request: माँगना मांगना अर्थना हाथ_फैलाना आगे_हाथ_फैलाना
require: माँग_होना आवश्यकता_होना ज़रूरत_होना आवश्यकता_पड़ना ज़रूरत_पड़ना जरूरत_होना जरूरत_पड़ना
resemble: पड़ना
reserve: अलग_रखना रक्षित_करना अलग_रखना अलग_रक्षित_करना पृथक_रक्षित_करना अलग_निकालना पृथक_निकालना आरक्षित_करना रोकना
resist: रोकना रोक_देना ठहराना अड़ना अँड़ियाना अड़ियाना हठ_करना जिदियाना ज़िदियाना जिद_करना ज़िद_करना टेकना अरना
resolve: निपटाना सुलझाना निबटाना फरियाना समाधान_करना निपटा_लेना सुलझा_लेना निबटा_लेना फरिया_लेना समाधान_कर_लेना निपटना निबटना घोलना घोरना मिलाना मिश्रित_करना सम्मिश्रित_करना
resound: गूँजना प्रतिध्वनित_होना प्रतिनोदित_होना
respect: सम्मान_करना आदर_करना आदरना
respire: साँस_लेना सांस_लेना श्वसन_करना श्वास_लेना श्वासोच्छवास_करना
respond: उत्तर_देना उत्तर_बताना जवाब_देना
rest: सुस्ताना आराम_करना विश्राम_करना थकान_उतारना थकान_मिटाना दम_भरना आराम_फरमाना कमर_सीधी_करना कमर_खोलना टिकाना टेकाना अड़ाना टेकना ठहराना अराना उठँगाना उठंगाना उढ़काना उढ़ुकाना
restitute: नवीनीकरण_करना नवीकरण_करना नया_करना
restore: लाना पहले_जैसा_करना मरम्मत_करना ठीक_करना दुरुस्त_करना बनाना
restrain: मन_मारना
retaliate: प्रतिशोध_लेना बदला_चुकाना हिसाब_बराबर_करना क़सर_निकालना
retch: उगलना उगिलना उग्रहना मिचलाना मचलाना मिचली_आना अकुलाना उबकाई_आना जी-मिचलाना
retell: कहना सुनाना
retool: दुहराना दोहराना पुनः_जाँचना दुसराना
retreat: पीछे_हटना
retrieve: फिर_से_पाना फिर_से_प्राप्त_करना याद_होना स्मरण_होना जुबान_पर_होना
return: लौटना वापस_आना आना लौटाना फेरना वापस_करना वापस_देना पलटाना लौटाना फेरना वापस_करना पलटाना फिराना पटना चुकना
reuse: पुनर्चक्रण_करना पुनः_चक्रित_करना रीसाइकल_करना री-साइकल_करना
reveal: खोलना उघाड़ना उघारना भांडा_फोड़ना भंडा_फोड़ना परदाफ़ाश_करना पर्दाफ़ाश_करना परदाफाश_करना पर्दाफाश_करना बेनक़ाब_करना बेनकाब_करना पर्दा_उठाना परदा_उठाना पर्दा_खोलना परदा_खेलना पर्दा_हटाना परदा_हटाना पोल_खोलना पोल-पट्टी_खोलना रहस्योद्घाटन_करना खुलना उघड़ना उघरना उघढ़ना भांडा_फूटना भंडा_फूटना पर्दाफ़ाश_होना परदाफ़ाश_होना परदाफाश_होना पर्दाफाश_होना बेनक़ाब_होना बेनकाब_होना रहस्योद्घाटन_होना लीक_होना
revel: हुड़दंग_मचाना हंगामा_करना
revenge: प्रतिशोध_लेना बदला_चुकाना हिसाब_बराबर_करना क़सर_निकालना
reverberate: गूँजना प्रतिध्वनित_होना प्रतिनोदित_होना दनदनाना
reverse: उलटना पलटना
revise: दुहराना दोहराना पुनः_जाँचना दुसराना
revolt: विद्रोह_करना बग़ावत_करना बगावत_करना द्रोह_करना बलवा_करना ग़दर_करना गदर_करना
revolve: परिक्रमा_करना चक्कर_काटना चक्कर_लगाना फेरा_लगाना
rhyme: तुकबंदी_करना तुक_जोड़ना
rib: उपहास_करना खिल्ली_उड़ाना मज़ाक_उड़ाना हँसी_उड़ाना
rid: छुड़ाना छोड़ाना
ride: उघटना उकटना उगटना
ridicule: उपहास_करना खिल्ली_उड़ाना मज़ाक_उड़ाना हँसी_उड़ाना
rifle: लूटना अपहरना मूसना
rime: तुकबंदी_करना तुक_जोड़ना
ring: बजना गूँजना प्रतिध्वनित_होना प्रतिनोदित_होना मंडराना मडराना मँडराना मंडलाना मँडलाना चक्कर_काटना
rinse: खँगालना खँगारना खँघारना खंगालना खंगारना खंघारना अँबासना
rinse_off: खँगालना खँगारना खँघारना खंगालना खंगारना खंघारना अँबासना
rip_off: ठगाना लुटाना मुड़ाना मुँड़ाना
ripen: औसाना औसना
rise: उठना ऊँचा_होना उचना उतराना पैदा_होना उत्पन्न_होना चढ़ना उठना
rise_up: उतराना
rival: पाना
rivet: ध्यान_देना ध्यान_केंद्रित_करना ध्यान_केन्द्रित_करना गौर_करना ग़ौर_करना
roam: भटकना ख़ाक_छानना भरमना
roar: गरजना दहाड़ना हुंकारना गरराना तड़पना तड़फना डंकना चिल्लाना गरजना दहाड़ना
roast: भुनना भुँजना भुंजना उपहास_करना खिल्ली_उड़ाना मज़ाक_उड़ाना हँसी_उड़ाना
rob: लूटना ठगना
rock: हिलना डोलना लरजना हिलना-डुलना अहरना अहलना इंग इङ्ग इंगन इङ्गन झुमाना
roll: लुढ़काना ढुलकाना ढुलाना बेलना अँटियाना अंटियाना लहराना भटकना ख़ाक_छानना भरमना
roll_in_the_hay: सटाना
roll_out: बेलना
roll_up: जोड़ना जमा_करना जुटाना संचित_करना इकट्ठा_करना एकत्रित_करना एकत्र_करना संग्रह_करना संग्रहना संजोना सँजोना
rollick: उछल-कूद_करना कूद-फाँद_करना कूदफाँद_करना
romance: नख़रे_दिखाना चोचले_करना नाज़_नख़रा_करना बनना
romp: उछल-कूद_करना कूद-फाँद_करना कूदफाँद_करना
rook: ठगना ऐंठना झटकना मूड़ना मूँड़ना लूटना झाड़ना मूसना
root: जमना
rope: उलझाना फँसाना फाँसना बझाना अरुझाना फंसाना फांसना बाँधना बांधना ग्रंथन ग्रन्थन
rot: सड़ना
rotate: परिक्रमा_करना चक्कर_काटना चक्कर_लगाना फेरा_लगाना
round: मंडराना मडराना मँडराना मंडलाना मँडलाना चक्कर_काटना
rouse: उकसाना चढ़ाना भड़काना उभाड़ना उभारना उसकाना उकतारना उगसाना उचटाना जगाना सचेत_करना
rout: खदेड़ना भगाना खदेड़_देना भगा_देना
rout_out: खदेड़ना भगाना खदेड़_देना भगा_देना
rove: भटकना ख़ाक_छानना भरमना
row: खेना
rub: रगड़ना घिसना अरेरना खुजलाना खुजाना
rub_down: मलना मालिश_करना
rub_out: मिटाना
rue: पछताना पश्चाताप_करना अछताना-पछताना अफ़सोस_करना अफसोस_करना अपसोसना
ruffle: इतराना चमकना अँगराना इठलाना झमकना टमकना मटकना अँठलाना अंठलाना
ruin: क्षय_करना नाश_करना अपहरना दिवालिया_बनाना दिवाला_निकालना दिवालिया_करना
rule: प्रबल_होना वर्चस्व_होना प्रधानता_होना शासन_होना अधिक_होना
rumble: गड़गड़ाना गड़कना गुर्राना
ruminate: जुगाली_करना जुगालना पगुराना कौरी_करना पागुर_करना उगालना
rumple: गींजना सिकुड़ना बल_पड़ना सलवट_पड़ना सिलवट_पड़ना सल_पड़ना
run: दौड़ना भागना धाना उढ़रना भगना भागना दौड़ना चलना जाना चलाना बहना निकलना चलना उपयोग_में_आना काम_करना चलाना चालित_करना चालू_करना गत्वरित_करना चलना प्रचलित_होना जारी_होना चला_आना अवैध_सौदा_करना अवैधानिक_सौदा_करना गैरकानूनी_सौदा_करना ग़ैरकानूनी_सौदा_करना चरने_के_लिए_छोड़ना चरने_हेतु_छोड़ना आखेट_करना शिकार_करना शिकार_खेलना पिघलाना टघलाना टघराना टिघलाना
run_along: पंक्तिबद्ध_होना कतारबद्ध_होना कतार_में_होना लाइन_में_होना
run_around: उछल-कूद_करना कूद-फाँद_करना कूदफाँद_करना
run_away: उढ़रना भगना भागना
run_into: टकराना भिड़ना भिड़ंत_होना टक्कर_खाना लड़ना
run_off: भगाना भागना भाग_जाना
run_out: छलकना छलछलाना
run_through: खपना लगना उठना खर्च_होना
run_up: लहराना फहराना फरफराना उड़ाना टाँकना टँकाई_करना लगाना
rupture: फाड़ना चीरना बिदराना
rustle: मरमराना
sack: निकालना बाहर_करना शुद्ध_लाभ_कमाना शुद्ध_बचत_करना शुद्ध_आय_करना शुद्ध_आमदनी_करना निवल_आय_करना निवल_लाभ_करना
sack_up: शुद्ध_लाभ_कमाना शुद्ध_बचत_करना शुद्ध_आय_करना शुद्ध_आमदनी_करना निवल_आय_करना निवल_लाभ_करना
sacrifice: बलि_देना
saddle: लादना
sag: दबना धँसना
salt_away: भंडारण_करना
salute: सलूट_करना सेलूट_करना सैल्यूट_करना सलाम_करना
sanctify: अभिमंत्रण_करना अभिमंत्रित_करना
sashay: इतराना चमकना अँगराना इठलाना झमकना टमकना मटकना अँठलाना अंठलाना
sate: अघाना तृप्त_होना छकना संतुष्ट_होना तुष्ट_होना तोषणा
satiate: अघाना तृप्त_होना छकना संतुष्ट_होना तुष्ट_होना तोषणा अघाना अफराना
satirise: व्यंग्य_करना हँसी_उड़ाना ताना_मारना व्यंग_करना ताना_देना गोदना उघटना
satirize: व्यंग्य_करना हँसी_उड़ाना ताना_मारना व्यंग_करना ताना_देना गोदना उघटना
satisfy: संतुष्ट_करना तृप्त_करना तुष्ट_करना तोषणा
save: उबरना उद्धार_पाना निस्तार_पाना मुक्त_होना बचाना बचत_करना
savor: आनंद_लेना आनन्द_लेना मजा_लेना लुत्फ_लेना लुत्फ़_लेना लुत्फ_उठाना लुत्फ़_उठाना आनंद_उठाना आनन्द_उठाना मौज_करना मस्ती_करना मौज-मस्ती_करना मौज_मस्ती_करना चुबलाना चिबलाना चुभलाना
savour: चुबलाना चिबलाना चुभलाना आनंद_लेना आनन्द_लेना मजा_लेना लुत्फ_लेना लुत्फ़_लेना लुत्फ_उठाना लुत्फ़_उठाना आनंद_उठाना आनन्द_उठाना मौज_करना मस्ती_करना मौज-मस्ती_करना मौज_मस्ती_करना
savvy: समझना पकड़ना
saw: आरा_चलाना
saw_logs: खर्राटा_लेना नाक_बजाना
saw_wood: खर्राटा_लेना नाक_बजाना
say: कहना बोलना फ़रमाना फरमाना आज्ञा_करना आज्ञा_देना आदेश_देना हुक्म_देना ऑर्डर_देना आर्डर_देना
scam: ठगना ऐंठना झटकना मूड़ना मूँड़ना लूटना झाड़ना मूसना
scare: डराना भयभीत_करना डरवाना डरपाना डरवाना
scare_away: डरवाना
scare_off: डरवाना
scarf_out: अघाना अफराना
scarper: उढ़रना भगना भागना
scat: उढ़रना भगना भागना
scatter: बिखेरना छितराना बिखराना उलछना विथराना पँवारना पवेरना छितराना फैलना बिखरना पसरना
schedule: कार्यक्रम_बनाना योजना_बनान
school: पढ़ना पढ़ाई_करना
scintillate: झिलमिलाना जुगजुगाना झिलमिल_करना
scold: धिक्कारना फटकारना लानत-मलामत_करना
scorch: झुलसना झुरसना झौंसना जलना जल_जाना
score_out: मिटाना
scorn: ठुकराना
scour: माँजना मलना मँजाई_करना मांजना
scrabble: टटोलना घसीटना
scramble: फेंटना
scranch: चुरचुराना
scrap: लड़ना झगड़ना झगड़ा_करना लड़ाई_करना तकरार_करना उलझना कलह_करना किचकिच_करना अखड़ाना अपड़ाना अरुझाना अलुझना
scrape: नोचना बकोटना खसोटना अवलुंचन अवलुञ्चन
scratch: नोचना बकोटना खसोटना अवलुंचन अवलुञ्चन खुजलाना खुजाना
scratch_up: नोचना बकोटना खसोटना अवलुंचन अवलुञ्चन
scraunch: चुरचुराना
screak: मचकना मचमचाना
scream: चिल्लाना चिंघाड़ना बँकारना भौंकना
screech: मचकना मचमचाना
screen: जाँचना जाँच_करना जांचना जांच_करना
screw: सटाना मरोड़ना ऐंठना उमेठना उमेड़ना घुमाना अमेठना कसना
scribble: घसीटना
scrutinise: परखना आज़माना जाँचना आजमाना अजमाना देखना कसौटी_पर_कसना परीक्षण_करना परीक्षा_लेना अवलोकना अविलोकना टेस्ट_करना जाँचना जाँच_करना जांचना जांच_करना
scrutinize: परखना आज़माना जाँचना आजमाना अजमाना देखना कसौटी_पर_कसना परीक्षण_करना परीक्षा_लेना अवलोकना अविलोकना टेस्ट_करना जाँचना जाँच_करना जांचना जांच_करना
sculpt: गढ़ना बनाना सरजना सिरजना आकार_देना रूप_देना
sculpture: गढ़ना बनाना सरजना सिरजना आकार_देना रूप_देना
scupper: घात_लगाना घतियाना घात_में_बैठना ताक_में_बैठना ताक_में_रहना मौक़ा_ढूढना
sear: झुलसना झुरसना झौंसना
search: खोजना खोज_करना ढूँढ़ना ढूँढना तलाशना तलाश_करना पता_लगाना पता_करना छानना देखना मथना आखना
season: छौंकना बघारना तड़का_देना तड़का_लगाना आलन_लगाना तन्दुरुस्त_बनाना तंदुरुस्त_बनाना स्वस्थ_बनाना भला-चंगा_बनाना चंगा_बनाना बेहतर_बनाना और_अच्छा_बनाना बेहतर_करना और_अच्छा_करना
seat: बैठाना बिठाना बैठारना बैठालना बैठाना बिठाना आसीन_करना
secern: अंतर_करना अन्तर_करना फर्क_करना फर्क_बताना भेद_करना फ़र्क़_करना फ़र्क़_बताना फरक_करना फरक_बताना फ़रक़_करना फ़रक़_बताना
secernate: अंतर_करना अन्तर_करना फर्क_करना फर्क_बताना भेद_करना फ़र्क़_करना फ़र्क़_बताना फरक_करना फरक_बताना फ़रक़_करना फ़रक़_बताना
second: नियुक्त_करना
secure: अटकाना अड़ाना फँसाना अड़काना उलझाना अराना अरुझाना फंसाना अड़ाना अराना
see: देखना भेंट_करना मिलना भेंटना मुलाकात_करना मुलाक़ात_करना मिलना डेट_करना समीक्षा_करना भोगना पाना भुगतना
see_red: क्रुद्ध_होना क्रोधित_होना गुस्साना गुस्सा_करना गरम_होना क्रोध_करना तमकना तमना बमकना बिगड़ना उखड़ना उखरना उबलना कुपित_होना तड़कना भड़कना उत्तेजित_होना आमरखना भौंहें_चढ़ाना भौंहें_तानना त्योरी_चढ़ाना उबल_पड़ना
seed: बोना बोआई_करना बोवाई_करना बीज_डालना दाँना दाना दांवना दांना दाँवना
seek: खोजना खोज_करना ढूँढ़ना ढूँढना तलाशना तलाश_करना पता_लगाना पता_करना छानना देखना मथना आखना
seem: लगना मालूम_पड़ना मालूम_होना प्रतीत_होना झलकना
seep: रिसना रसना बहना सीझना पसीजना छूटना स्राव_होना ओगरना
seize_with_teeth: काटना
select: छाँटना बीनना चुनना अलगाना छांटना बराना बाँछना उछाँटना
sell: बेचना बेंचना विक्रय_करना निकालना उठाना बिकना बिक्री_होना निकलना विक्रीत_होना उठना बिकाना
send: भेजना पठाना रवाना_करना
send_away: निकालना बाहर_करना
senesce: बुढ़ाना वृद्ध_होना
sense: महसूस_करना महसूसना
separate: अलग_करना अलगाना बिलगाना वियुक्त_करना विलगाना विलग_करना बगलियाना उचेलना अंतर_करना अन्तर_करना फर्क_करना फर्क_बताना भेद_करना फ़र्क़_करना फ़र्क़_बताना फरक_करना फरक_बताना फ़रक़_करना फ़रक़_बताना अधियाना आधा_करना बँटना बटना छाँटना फटना फूटना अलग_होना बिछुड़ना बिलगना छूटना छूट_जाना विलग_होना अलग_होना
separate_out: निथरना थिरना
serve: परोसना परसना सेना सेवा_करना अवराधना
set: रखना धरना घालना जड़ना लगाना बैठाना बिठाना फिट_करना अड़ना ठनना उतारू_होना अरना डूबना ढलना अस्त_होना अस्तगत_होना रोपना आरोपना चढ़ाना
set_about: उठाना चलाना छेड़ना आरम्भ_करना आरंभ_करना शुरू_करना निकालना
set_aside: अलग_रखना अलग_रक्षित_करना पृथक_रक्षित_करना अलग_निकालना पृथक_निकालना
set_back: टालना स्थगित_करना टरना मुलतवी_करना सस्पेन्ड_करना सस्पेंड_करना
set_forth: प्रस्थान_करना रवाना_होना खुलना छूटना चलना निकलना
set_off: प्रस्थान_करना रवाना_होना खुलना छूटना चलना निकलना फोड़ना छोड़ना
set_out: उठाना चलाना छेड़ना आरम्भ_करना आरंभ_करना शुरू_करना निकालना प्रस्थान_करना रवाना_होना खुलना छूटना चलना निकलना
set_up: चलाना तानना अड़ना ठनना उतारू_होना अरना
settle: बैठना जमना निपटाना सुलझाना निबटाना फरियाना समाधान_करना निपटा_लेना सुलझा_लेना निबटा_लेना फरिया_लेना समाधान_कर_लेना बसना रहना निवास_करना धँसना धँस_जाना जमना जमना पटना पक्का_होना ठहरना ठीक_होना तय_होना पटाना जमाना पक्का_करना ठहराना ठीक_करना तय_करना निथारना जमना बैठना
settle_down: बैठना जमना जमना पटाना शांत_होना शान्त_होना
severalise: अंतर_करना अन्तर_करना फर्क_करना फर्क_बताना भेद_करना फ़र्क़_करना फ़र्क़_बताना फरक_करना फरक_बताना फ़रक़_करना फ़रक़_बताना
severalize: अंतर_करना अन्तर_करना फर्क_करना फर्क_बताना भेद_करना फ़र्क़_करना फ़र्क़_बताना फरक_करना फरक_बताना फ़रक़_करना फ़रक़_बताना
sew: टाँकना टँकाई_करना लगाना सीना सिलना टाँकना सिलाई_करना
sew_together: टाँकना टँकाई_करना लगाना
shake: डुलाना हिलाना डोलाना विलोड़ना हिलना हिलना डोलना लरजना हिलना-डुलना अहरना अहलना इंग इङ्ग इंगन इङ्गन
shake_hands: हाथ_मिलाना
shake_up: हिलाना
shape_up: उन्नत_होना उन्नति_करना उभरना विकास_करना बढ़ना फलना फलना-फूलना चमकना
share: बाँटना बांटना
sharpen: रेतना
shave: मुँड़वाना मुँड़ाना मुड़वाना मुड़ाना मुंड़वाना मुंड़ाना मुंडन_कराना उड़ाना
shell_out: बाँटना वितरित_करना वितरण_करना बांटना
shelter: शरण_देना आश्रय_देना
shelve: टालना स्थगित_करना टरना मुलतवी_करना सस्पेन्ड_करना सस्पेंड_करना
shift: हटाना करना सरकना खिसकना खसकना हटना टसकना हिलना डिगना अपसवना डगना
shine: चमकना चमचमाना चमाचम_करना तमतमाना झमझमाना रोशन_करना चमकाना जगमगाना उजागर_करना चमकना जगमगाना झलझलाना दमकना जगजगाना झलकना निखारना चमकाना उज्जवल_करना उजला_करना उजलाना उजराना झलकाना
ship: भेजना पठाना रवाना_करना
shipwreck: फूँकना नष्ट_करना डुबोना डुबाना बरबाद_करना फेंकना बहाना लुटाना गँवाना बिलवाना बैठाना बिठाना तबाह_करना ठिकाने_लगाना नुकसान_उठाना हानि_उठाना घाटा_उठाना पोतभंग_होना
shirk: भागना जी_चुराना
shit: हगना झाड़ा_फिरना पाखाना_करना पाख़ाना_करना टट्टी_करना मलत्याग_करना दिशा_मैदान_करना दिशा_मैदान_जाना करना
shiver: थरथराना थर्राना थरहराना दहलना काँपना कँपना कंपित_होना कंपन_होना कम्पित_होना कम्पन_होना कांपना कंपना लरजना काँपना कँपना कंपित_होना कंपन_होना कम्पित_होना कम्पन_होना कांपना कंपना थरथराना सिहरना थर-थर_करना थरथर_करना लरजना
shock: सकपकाना चकपकाना भौंचक्का_होना भौचक्का_होना चौंकना उछकना उझकना चौंकना चिहुँकना अचकचाना
shoot: खींचना खीचना फोटो_खींचना फोटो_खीचना ईचना ईंचना ऐंचना तस्वीर_लेना तस्वीर_खींचना तस्वीर_खीचना अपव्यय_करना फिजूलखर्च_करना फिज़ूलख़र्च_करना पैसा_उड़ाना पैसा_बहाना पैसा_फूँकना अंकुर_निकलना अँखुआना जमना अँकुरना अंकुरना अंकुर_फूटना अंकुरित_होना उकसना उकिसना सुई_लगाना इंजेक्शन_लगाना इंजेक्शन_देना इंजैक्शन_लगाना इंजैक्शन_देना इन्जेक्शन_लगाना इन्जेक्शन_देना इन्जैक्शन_लगाना इन्जैक्शन_देना
shoot_a_line: शेखी_बघारना बघारना डींग_हाँकना डींग_मारना
shoot_the_breeze: बात_करना बातचीत_करना बतियाना वार्तालाप_करना बोलना-बतियाना बोलना बोलना_बतियाना
short-change: ठगना ऐंठना झटकना मूड़ना मूँड़ना लूटना झाड़ना मूसना
shoulder: कँधियाना
shout: चिल्लाना चिंघाड़ना बँकारना भौंकना चिल्लवाना चिलवाना गाली_देना गाली_बकना अपशब्द_कहना गरियाना
shout_out: चिल्लाना चिंघाड़ना बँकारना भौंकना
show: दिखाना दिखलाना प्रदर्शित_करना शो_करना दिखाना दिखलाना दर्शाना दरशाना दरसाना प्रस्तुत_करना पेश_करना जताना जतलाना जनाना
show_off: अभिमान_प्रदर्शन_करना रोब_झाड़ना शान_दिखाना
show_up: आना
shower: बरसाना बरषाना बारिश_करना वर्षा_करना बरसना बरषना बारिश_होना वर्षा_होना
shower_down: बरसना बरषना बारिश_होना वर्षा_होना
shrink: संकुचित_करना सिकोड़ना सिकुड़ना चढ़ना
shrivel: संकुचित_करना सिकोड़ना चढ़ना
shrivel_up: संकुचित_करना सिकोड़ना
shudder: काँपना कँपना कंपित_होना कंपन_होना कम्पित_होना कम्पन_होना कांपना कंपना थरथराना सिहरना थर-थर_करना थरथर_करना लरजना थरथराना थर्राना थरहराना दहलना काँपना कँपना कंपित_होना कंपन_होना कम्पित_होना कम्पन_होना कांपना कंपना लरजना
shun: बचना
shut: मूँदना बंद_करना बन्द_करना
shut_down: बंद_करना बन्द_करना
sibilate: फुफकारना फूत्कारना फुफकार_करना फूत्कार_करना
sick: उगलना उगिलना उग्रहना
sidestep: टालमटोल_करना टरकाना टालना आज_कल_करना
sieve: छानना छनाई_करना
sift: छानना छनाई_करना
sign: हस्ताक्षर_करना दस्तख़त_करना दस्तखत_करना सही_करना दसखत_करना
signify: अर्थ_लगाना अरथाना अर्थाना
simmer_down: पटाना शांत_होना शान्त_होना
simulate: नक़ल_करना नकल_करना अनुकरण_करना अनुसरना अनुहरना अनुहारना
sing: गाना सरसराना
singe: झुलसना झुरसना झौंसना
sink: धँसाना धाँसना धँसना धँस_जाना
siss: फुफकारना फूत्कारना फुफकार_करना फूत्कार_करना
sit: बैठना आसन_लेना आसन_ग्रहण_करना आसीन_होना बिराजना विराजना तशरीफ_रखना तशरीफ़_रखना बैठाना बिठाना बैठारना बैठालना
sit_down: बैठाना बिठाना बैठारना बैठालना बैठना आसन_लेना आसन_ग्रहण_करना आसीन_होना बिराजना विराजना तशरीफ_रखना तशरीफ़_रखना
situate: बताना बतलाना निर्देशित_करना दिखाना दिखलाना
size_up: परखना आज़माना जाँचना आजमाना अजमाना देखना कसौटी_पर_कसना परीक्षण_करना परीक्षा_लेना अवलोकना अविलोकना टेस्ट_करना
sizz: फुफकारना फूत्कारना फुफकार_करना फूत्कार_करना
skid: फिसलना बिछलना
skim_off: चुनवाना चुनाना छँटवाना छंटवाना
skin: छिलवाना
skip: फुदकना
skirt: टालमटोल_करना टरकाना टालना आज_कल_करना
skreak: मचकना मचमचाना
skylark: उछल-कूद_करना कूद-फाँद_करना कूदफाँद_करना
slack: मंद_होना शिथिल_होना शिथिल_पड़ना अरसना बुझाना
slacken: मंद_होना शिथिल_होना शिथिल_पड़ना अरसना
slake: बुझना बुझाना
slander: चुग़ली_करना चुग़ली_खाना चुगली_करना चुगली_लगाना चुगली_खाना लगाना_बुझाना चुगली_जड़ना
slant: झुकना नवना
slap: थप्पड़_मारना तामाचा_मारना झापड़_लगाना चाँटा_मारना चांटा_मारना चपत_लगाना हाथ_छोड़ना हाथ_चलाना थप्पड़_रसीद_करना
slay: मारना हत्या_करना प्राण_लेना जान_लेना मौत_के_घाट_उतारना हत_करना उड़ाना हनना वध_करना कत्ल_करना प्राण_निकालना जान_निकालना संहारना हनन_करना अरदना मौत_की_नींद_सुलाना जान_से_मारना खून_करना ख़ून_करना मार_डालना ठिकाने_लगाना ठिकाने_पहुँचाना
sleep: सोना
sleep_with: सटाना
slew: फिसलना बिछलना
slide: फिसलना बिछलना सरकाना खिसकाना खसकाना घसकाना घिसकाना टसकाना
slip: फिसलना बिछलना भूल_करना गलती_करना अपराध_करना कुसूर_करना कसूर_करना ज़ुर्म_करना जुर्म_करना गुनाह_करना
slop: छलकाना
slow: मंद_होना शिथिल_होना शिथिल_पड़ना अरसना
slow_down: मंद_होना शिथिल_होना शिथिल_पड़ना अरसना
slow_up: मंद_होना शिथिल_होना शिथिल_पड़ना अरसना
slue: फिसलना बिछलना
slug: अलसाना आलस्य_करना अलसना अरसाना
slumber: सोना
slurp: सुड़कना सुरकना
smart: टीसना करकना कसकना चसकना चिलकना टहकना डबकना चबकना ठनकना
smash: दिवालिया_बनाना दिवाला_निकालना दिवालिया_करना
smear: लिपवाना चुग़ली_करना चुग़ली_खाना चुगली_करना चुगली_लगाना चुगली_खाना लगाना_बुझाना चुगली_जड़ना
smell: सूँघना गंध_लेना वास_लेना महकना गमकना महमहाना बसाना दुर्गंध_देना बदबू_करना
smile: मुस्कुराना मुस्कराना मुस्काना
smirch: चुग़ली_करना चुग़ली_खाना चुगली_करना चुगली_लगाना चुगली_खाना लगाना_बुझाना चुगली_जड़ना
smoke: धूम्र-पान_करना धूम्र_पान_करना धूम्रपान_करना धूम-पान_करना धूम_पान_करना धूमपान_करना
smooth: निखारना चमकाना उज्जवल_करना उजला_करना उजलाना उजराना झलकाना
smoothen: निखारना चमकाना उज्जवल_करना उजला_करना उजलाना उजराना झलकाना
smother: दम_घुटना साँस_अटकना साँस_रुँधना श्वासावरोध_होना
snaffle: लपकना लपक_लेना
snap: गुर्राना फाड़ना चीरना बिदराना खींचना खीचना फोटो_खींचना फोटो_खीचना ईचना ईंचना ऐंचना तस्वीर_लेना तस्वीर_खींचना तस्वीर_खीचना
snap_off: टुकड़े_करना तोड़ना तोरना
snap_up: लपकना लपक_लेना
snare: फाँदना फँसाना फांदना फंसाना
snarl: गुर्राना गुथना गुँथना
snatch: अपहरण_करना हरण_करना हरना अगवा_करना हर_लेना किडनैप_करना
sneak: खिसकना सटकना खिसक_जाना सटक_जाना चलता_बनना सटक_लेना किड़कना
sneeze: छींकना
sniff: सुड़कना सुरकना
sniffle: पिनपिनाना सुड़कना सुरकना
snip: छाँटना
snip_off: छाँटना
snitch: चुराना चोरी_करना हाथ_मारना चुरा_लेना उड़ाना उड़ा_लेना मूसना टीपना अपहरना
snivel: पिनपिनाना
snooze: ऊँघना ऊँघाना ऊंघना ऊंघाना उँघना उँघाना उंघना उंघाना झपकी_लेना
snore: खर्राटा_लेना नाक_बजाना
snub: उपेक्षा_करना उपेक्षित_करना कन्नी_काटना
snuff_it: मरना मर_जाना परलोक_सिधारना गुजरना गुज़रना दम_तोड़ना चल_बसना मौत_होना अलविदा_कहना लुढ़कना ढेर_होना प्राण_त्यागना प्राण_निकलना जान_जाना जान_चली_जाना
snuff_out: बुझाना बुताना
snuffle: पिनपिनाना
soak: भिगोना भिगाना भिंगाना भिजाना भिंजाना लूटना ठगना नशा_करना नशा_गाँठना नशापानी_करना
soak_up: अवशोषित_करना खींचना चूसना सोखना पीना ईचना ईंचना ऐंचना
sob: सिसकना सिसकी_भरना सिसकी_लेना सुबकना सुबकी_लेना
soil: मचाना गंदा_करना मलिन_करना
solace: सांत्वना_देना समझाना ढाढ़स_बँधाना तसल्ली_देना दिलासा_देना
solve: हल_करना समाधान_करना निराकरण_करना
soothe: सांत्वना_देना समझाना ढाढ़स_बँधाना तसल्ली_देना दिलासा_देना
sop_up: अवशोषित_करना खींचना चूसना सोखना पीना ईचना ईंचना ऐंचना
sorrow: सोचना दुखी_होना सोंचना अनमनाना पीड़ित_होना दुखित_होना अरूरना
sough: बोना बोआई_करना बोवाई_करना बीज_डालना काँखना बोना
sound: बजाना नादना
sour: तुर्शाना खट्टा_होना
souse: डुबाना बोरना डुबोना बूड़ाना
sow: बोना बोआई_करना बोवाई_करना बीज_डालना बोना
sparge: सींचना छिड़कना
speak: फूटना बोलना बोलना कहना उचारना उच्चारना उच्चरना उच्चारण_करना अरंभना अरम्भना आखना उचरना बोलना आवाज़_करना आवाज_करना शब्द_करना
spend: व्यतीत_होना कटना गुजरना गुज़रना बीतना निकलना ढलना लगाना खपाना उठाना खर्च_करना खरचना ख़र्च_करना व्यय_करना खर्चना
spend_a_penny: मूतना पेशाब_करना
spew: थूकना उगालना उगलना उगिलना उग्रहना
spill: छलकाना छलकना छलछलाना उगलना उगिलना उग्रहना
spin: घूमना चक्कर_खाना घूर्णित_होना नाचना कातना
spin_around: घूमना चक्कर_खाना घूर्णित_होना नाचना
spit: थूकना उगालना
spit_out: थुथकारना थू-थू_करना खखारना खँखारना
spit_up: खखारना खँखारना
spite: चुभना खटकना बुरा_लगना अप्रिय_लगना
splash: छिड़कना छिड़काव_करना छींटना
splatter: छलकाना
split: अधियाना आधा_करना अलग_होना बिछुड़ना बिलगना छूटना छूट_जाना विलग_होना अलग_होना
split_up: तलाक़_देना विवाह_विच्छेद_करना अधियाना आधा_करना अलग_होना फटना फूटना
splosh: छिड़कना छिड़काव_करना छींटना
splutter: थुथकारना थू-थू_करना
spoil: लगना बिगाड़ना खराब_करना ख़राब_करना
sport: दिखाना उछल-कूद_करना कूद-फाँद_करना कूदफाँद_करना
spout: हाँकना फेंकना झाड़ना
spread: फैलाना बढ़ाना प्रसारित_करना विस्तृत_करना प्रसार_करना विस्तार_करना फैलना फैलाना पसारना डालना उड़ाना फैलाना छितराना फैलना बिखरना पसरना बिछाना डालना
spread_out: छितराना फैलना बिखरना पसरना फैलाना पसारना डालना
spring: कूदना
spring_to_mind: उठना
spring_up: पैदा_होना उत्पन्न_होना
sprinkle: बिखेरना छितराना बिखराना उलछना विथराना छिड़कना छिड़काव_करना छींटना सींचना छिड़कना
sprout: अंकुर_निकलना अँखुआना जमना अँकुरना अंकुरना अंकुर_फूटना अंकुरित_होना उकसना उकिसना
spud: अंकुर_निकलना अँखुआना जमना अँकुरना अंकुरना अंकुर_फूटना अंकुरित_होना उकसना उकिसना
spue: थूकना उगालना उगलना उगिलना उग्रहना
spurn: ठुकराना
sputter: थुथकारना थू-थू_करना
squall: किकियाना चिल्लाना चिंघाड़ना बँकारना भौंकना
squander: लुटाना
square: वर्गफल_निकालना चौकोर_बनाना वर्ग_बनाना वर्गाकार_बनाना चौकोर_करना वर्गाकार_करना पतवार_घुमाना पतवार_मोड़ना
square_away: सुव्यवस्थित_करना सुविन्यस्त_करना सुप्रबंधित_करना
squash: पेरना
squeak: मचकना मचमचाना
squeal: किकियाना
squeeze: पेरना ऐंठना चिकोटी_काटना चिकोटना चुटकी_काटना चिहुँटना चूँटी_काटना चुटकी_लेना बकोटना गले_लगाना गले_मिलना आलिंगन_करना आलिङ्गन_करना चिपटाना लिपटाना अँकवारना अँकोरना अंकवारना अंकोरना अंग_लगाना अरसना-परसना आलिंगना आलिङ्गना
squelch: दबाना पेरना
squirm: कसमसाना कुलबुलाना
stab: घोंपना घुसेड़ना घुसाना भोंकना भौंकना पेलना धँसाना
stack_away: भंडारण_करना
stage: मंचित_करना खेलना पेश_करना प्रस्तुत_करना मंचन_करना
stagger: डगमगाना लड़खड़ाना डगडोलना अलुटना डगना उखटना
stagnate: अलसाना आलस्य_करना अलसना अरसाना
stain: छोड़ना
stammer: तुतलाना तुतराना तोतलाना
stamp: ठप्पा_लगाना मुहर_लगाना मोहर_लगाना
stamp_down: दबाना हावी_होना
stand: उठना खड़ा_होना रहना खड़ा_होना अपमान_सहना बरदाश्त_करना जहर_का_घूंट_पीना उठाना
stand_firm: रोकना रोक_देना ठहराना
stand_for: अर्थ_लगाना अरथाना अर्थाना बराबर_होना समतुल्य_होना समान_होना
stand_up: उठाना उठना खड़ा_होना
stare: घूरना
start: उठाना चलाना छेड़ना आरम्भ_करना आरंभ_करना शुरू_करना निकालना उठाना प्रस्थान_करना रवाना_होना खुलना छूटना चलना निकलना छिड़ना ठनना शुरू_होना आरंभ_होना प्रारंभ_होना आरम्भ_होना प्रारम्भ_होना उछलना उछरना खुलना उभरना उभड़ना उकसना उकिसना उझकना
start_out: उठाना चलाना छेड़ना आरम्भ_करना आरंभ_करना शुरू_करना निकालना प्रस्थान_करना रवाना_होना खुलना छूटना चलना निकलना
startle: उछलना उछरना
stash_away: भंडारण_करना
state: बताना बतलाना
stay: बसना डेरा_डालना रुकना ठहरना रहना रुक_जाना सँभलना संभलना सम्हलना टिकना सहारा_लेना अवलंबना अवलम्बना उढ़कना उढ़ुकना रहना रह_जाना
stay_on: रुकना ठहरना रहना रुक_जाना
steady_down: जमना
steal: चुराना उड़ाना
steam: आग-बबूला_होना अगियाना आग-बगूला_होना
step: कदम_रखना पैर_रखना
step_in: पड़ना
stick: चिपकना सटना सटना चिपकना जुड़ना जुटना
stick_on: थोपना
stick_out: अपमान_सहना बरदाश्त_करना जहर_का_घूंट_पीना
stick_to: चिपकना सटना
stiffen: अकड़ना अँकड़ना ऐंठना
still: बुझाना ठंडा_करना शांत_करना
stimulate: उकसवाना चढ़वाना भड़कवाना उभड़वाना उसकवाना जगाना साधना साधन_करना
sting: परपराना डसना डँसना काटना चुभना धँसना गड़ना
stir: घोंटना मथना घोटना आलोड़ना सरकना खिसकना खसकना हटना टसकना हिलना डिगना अपसवना डगना
stir_up: जलाना हिलाना
stitch: टाँकना टँकाई_करना लगाना
stoke: झोंकना
stomach: अपमान_सहना बरदाश्त_करना जहर_का_घूंट_पीना
stonewall: अड़ंगा_लगाना अड़ंगा_डालना अवरोध_करना बाधा_डालना हस्तक्षेप_करना बाधा_उत्पन्न_करना अड़चन_डालना बाधित_करना
stool: हगना झाड़ा_फिरना पाखाना_करना पाख़ाना_करना टट्टी_करना मलत्याग_करना दिशा_मैदान_करना दिशा_मैदान_जाना करना
stop: रुकना रुक_जाना अटकना बंद_होना गतिरुद्ध_होना छोड़ना छोड़_देना अलविदा_कहना रहना रह_जाना रोकना ठहराना थामना अड़काना छूटना छूट_जाना बंद_कराना बन्द_कराना ब्लॉक_कराना ब्लॉक_करा_देना ब्लाक_कराना ब्लाक_करा_देना
stop_up: अड़ाना अराना
store: भंडारण_करना
straighten: सुव्यवस्थित_करना सुविन्यस्त_करना सुप्रबंधित_करना
straighten_out: सुव्यवस्थित_करना सुविन्यस्त_करना सुप्रबंधित_करना
strain: छानना छनाई_करना निथरना थिरना
stray: भटकना ख़ाक_छानना भरमना भटकना रास्ता_भूलना
stream: लहराना झूमना झूँमना लहरना लहकना झोंके_खाना लहरें_खाना टूटना उमड़ना उमड़ाना मूसलाधार_बारिश_होना जोरदार_बारिश_होना मूसलाधार_वर्षा_होना मूसलाधार_पानी_बरसना जोरदार_पानी_बरसना मूसलाधार_पानी_गिरना जोरदार_पानी_गिरना बहना प्रवाहित_होना
stretch: अँगड़ाना अँगड़ाई_लेना अंगड़ाना अंगड़ाई_लेना तनवाना पसर_जाना पसरना फैलना फैल_जाना
stretch_out: पसर_जाना पसरना फैलना फैल_जाना
stride: लाँघना फाँदना डाँकना लांघना फांदना डांकना टपना टापना अवलंघना लाँघना नाँधना लांघना नांधना फाँदना डाँकना फांदना डांकना अवलंघना
strike: टकराना भिड़ना भिड़ंत_होना टक्कर_खाना लड़ना प्रभावित_करना प्रभाव_डालना असर_डालना छाप_छोड़ना असर_करना रंग_जमाना रंगना छाना बजना
strike_down: गिराना
string: गूथना गूँथना गूंथना पिरोना पिरोहना पोहना नाधना नाँधना पिरोना
string_up: पिरोना
strip: नंगियाना नंगा_करना उघाड़ना उघारना लूटना अपहरना मूसना उतारना खोलना निकालना
strive: प्रयत्न_करना प्रयास_करना कोशिश_करना उद्यम_करना उद्योग_करना यत्न_करना चेष्टा_करना यतन_करना
stroke: सहलाना सोहराना सुहलाना सुहराना
struggle: जूझना संघर्ष_करना प्रतिद्वंद्विता_करना लड़ना
strut: इतराना चमकना अँगराना इठलाना झमकना टमकना मटकना अँठलाना अंठलाना
stub: उखाड़ना उखाड़_फेंकना उखेड़ना उखारना उखेरना उपाटना उकटना उचटाना उछटाना उछीनना उत्पाटना
study: पढ़ना अध्ययन_करना
stuff: ठूसना ठूँसना ठूंसना अघाना अफराना
stun: सकपकाना चकपकाना भौंचक्का_होना भौचक्का_होना चौंकना उछकना उझकना
stutter: तुतलाना तुतराना तोतलाना
style: स्टाइल_में_करना स्टाइल_करना बनाना स्टाइल_करना स्टाइल_में_करना शैलीगत_करना
subdue: अधीन_करना आधीन_करना वश_में_करना अधीनना क़ाबू_करना काबू_करना क़ाबू_में_लाना काबू_में_लाना क़ाबू_पाना काबू_पाना दबाना हावी_होना
subjugate: अधीन_करना आधीन_करना वश_में_करना अधीनना क़ाबू_करना काबू_करना क़ाबू_में_लाना काबू_में_लाना क़ाबू_पाना काबू_पाना
sublimate: शोधन_करना परिष्कार_करना
submerge: तल्लीन_होना खोना डूबना डूब_जाना आत्मविस्मृत_होना ध्यानावस्थित_होना ध्यानमग्न_होना भावलीन_होना अवगाहना
subscribe: हस्ताक्षर_करना दस्तख़त_करना दस्तखत_करना सही_करना दसखत_करना बँधवाना बाँधना बंधवाना बांधना
subscribe_to: बँधवाना बाँधना बंधवाना बांधना
subside: टूटना उतरना
substitute: बदलना बदल_जाना
subtract: घटाना घटान_करना
succumb: अधीन_होना अधीनना आधीन_होना
suck: चुसना चूसा_जाना अवशोषित_करना खींचना चूसना सोखना पीना ईचना ईंचना ऐंचना
suck_up: अवशोषित_करना खींचना चूसना सोखना पीना ईचना ईंचना ऐंचना
suffer: अपमान_सहना बरदाश्त_करना जहर_का_घूंट_पीना कष्ट_सहना दुख_सहना दुख_झेलना कष्ट_झेलना दुख_उठाना तक़लीफ़_उठाना टूटना पिसना
suffocate: दम_घुटना साँस_अटकना साँस_रुँधना श्वासावरोध_होना
suit: खिलना जँचना जमना फबना खुलना अच्छा_लगना शोभना शोभित_होना उगना
sulk: रूठना मुँह_फुलाना रुष्ट_होना रिसाना रूसना फूलना अनखना अनसाना अनखाना अनैसना
sully: चुग़ली_करना चुग़ली_खाना चुगली_करना चुगली_लगाना चुगली_खाना लगाना_बुझाना चुगली_जड़ना
summon: बुलाना
sunburn: चिलचिलाना
supercharge: बढ़ाना तेज_करना तेज़_करना तीव्र_करना
supply: देना प्रदान_करना उपलब्ध_कराना सुलभ_कराना प्राप्त_कराना लब्ध_कराना अधिगत_कराना मुहैया_कराना मुहैय्या_कराना मयस्सर_कराना मुयस्सर_कराना मुयस्य_कराना खोलना खोल_देना जन्म_देना
support: थामना सँभालना संभालना सम्हालना सम्भालना अपमान_सहना बरदाश्त_करना जहर_का_घूंट_पीना
suppress: दबाना हावी_होना दबाना मन_मारना
surcharge: लूटना ठगना
surface: उतराना आना
surfeit: अफरना
surpass: गुजरना गुज़रना निकलना
surprise: आश्चर्य_होना ताज्जुब_होना विस्मय_होना चकित_होना
surrender: सौंपना छोड़ना सुपुर्द_करना हवाले_करना सौंप_देना छोड़_देना सुपुर्द_कर_देना हवाले_कर_देना
surround: मंडराना मडराना मँडराना मंडलाना मँडलाना चक्कर_काटना दीवार_से_घेरना
survive: बचना उबरना बच_जाना उबर_जाना अधिक_जीना अधिक_समय_जीना अधिक_दिन_जीना
suspend: लटकाना
suspire: साँस_लेना सांस_लेना श्वसन_करना श्वास_लेना श्वासोच्छवास_करना
sustain: पोषित_करना जीवित_रखना पालित_करना सँभालना संभालना थामना सम्हालना थामना सँभालना संभालना सम्हालना सम्भालना
swag: दबना धँसना डगमगाना लड़खड़ाना डगडोलना अलुटना डगना उखटना
swagger: इतराना चमकना अँगराना इठलाना झमकना टमकना मटकना अँठलाना अंठलाना धमकाना धमकी_देना हड़काना
swallow: निगलना लीलना गटकना
swan: कसम_खाना सौगंध_खाना सौगन्ध_खाना कसम_लेना सौगंध_लेना सौगन्ध_लेना भटकना ख़ाक_छानना भरमना
swank: अभिमान_प्रदर्शन_करना रोब_झाड़ना शान_दिखाना
swarm: टूटना उमड़ना उमड़ाना
swash: शेखी_बघारना बघारना डींग_हाँकना डींग_मारना
sway: हिलना डोलना लरजना हिलना-डुलना अहरना अहलना इंग इङ्ग इंगन इङ्गन झुमाना
swear: कसम_खाना सौगंध_खाना सौगन्ध_खाना कसम_लेना सौगंध_लेना सौगन्ध_लेना विश्वास_करना ठीक_मान_लेना पतियाना भरोसा_करना यकीन_करना पतिआना पतीजना
sweep: बुहारना झाड़ू_देना झाड़ू_लगाना बहारना घसीटना छाना छा_जाना
sweep_up: घसीटना
sweet-talk: फुसलाना बहलाना बहकाना बरगलाना बर्गलाना
swell: सूजना फूलना
swell_up: सूजना फूलना
swim: तैरना पैरना पौड़ना पौंरना पौरना हेलना तैरना तिरना उतराना
swindle: ठगना ऐंठना झटकना मूड़ना मूँड़ना लूटना झाड़ना मूसना
swing: लटकना झूलना सामाजिक_होना
switch_off: बुझाना
swoop: झपटना चपेटना झपकना लपकना
table: टालना स्थगित_करना टरना मुलतवी_करना सस्पेन्ड_करना सस्पेंड_करना
tack: तागना
tackle: लेना ग्रहण_करना प्राप्त_करना स्वीकार_करना जोतना जुआठना जुआ_पहनाना नाँधना नांधना नाधना
tag: दौड़ाना भगाना
tail: दौड़ाना भगाना पूँछ_काटना
tailor: सीना सिलना टाँकना सिलाई_करना
tailor-make: सीना सिलना टाँकना सिलाई_करना
take: लाना ले_आना आनना माँग_होना छाँटना बीनना चुनना अलगाना छांटना बराना बाँछना उछाँटना पकड़ना लेना लेना ग्रहण_करना पाना प्राप्त_करना अपनाना लेना स्वीकार_करना स्वीकारना लेना ले_लेना मिटाना दूर_करना दूर_हटाना अलग_करना हटाना टालना अवलोचना कब्जा_करना क़ब्ज़ा_करना अधिकार_में_करना काबू_पाना क़ाबू_पाना कब्जे_में_लेना क़ब्ज़े_में_लेना कब्जा_कर_लेना क़ब्ज़ा_कर_लेना काबिज_होना क़ाबिज़_होना अपनाना स्वीकारना स्वीकार_करना चुनना अपना_बनाना अंगीकार_करना अपना_लेना अख़्तियार_करना अख्तियार_करना सकारना करना बँधवाना बाँधना बंधवाना बांधना खरीदना ख़रीदना क्रय_करना मोल_लेना लेना लेना समाना आना भरना अटना पुराना अँटना अंटना अमाना अमावना आटना आपूरना
take_a_breath: साँस_लेना सांस_लेना श्वसन_करना श्वास_लेना श्वासोच्छवास_करना
take_a_breather: सुस्ताना आराम_करना विश्राम_करना थकान_उतारना थकान_मिटाना दम_भरना आराम_फरमाना कमर_सीधी_करना कमर_खोलना
take_a_crap: हगना झाड़ा_फिरना पाखाना_करना पाख़ाना_करना टट्टी_करना मलत्याग_करना दिशा_मैदान_करना दिशा_मैदान_जाना करना
take_a_leak: मूतना पेशाब_करना
take_a_shit: हगना झाड़ा_फिरना पाखाना_करना पाख़ाना_करना टट्टी_करना मलत्याग_करना दिशा_मैदान_करना दिशा_मैदान_जाना करना
take_aback: सकपकाना चकपकाना भौंचक्का_होना भौचक्का_होना चौंकना उछकना उझकना
take_away: मिटाना दूर_करना दूर_हटाना अलग_करना हटाना टालना अवलोचना निकालना हरना हरण_करना मिटाना हर_लेना
take_back: लौटाना फेरना वापस_करना पलटाना फिराना ले_लेना वापस_लेना वापस_ले_लेना वापिस_लेना वापिस_ले_लेना
take_care: सावधान_होना सतर्क_होना सँभलना संभलना सम्हलना बचना चेतना चेत_जाना
take_down: उतारना अवतारना टाँकना
take_fire: जलना सुलगना दग्ध_होना दहना सिलगना अगियाना अगिआना
take_for: रखना
take_heed: सुनना
take_hold: पकड़ना थामना धरना गहना
take_in: देखना अवशोषित_करना खींचना चूसना सोखना पीना ईचना ईंचना ऐंचना गोद_लेना दत्तक_लेना
take_issue: असहमत_होना असहमति_जताना
take_off: प्रस्थान_करना रवाना_होना खुलना छूटना चलना निकलना घटाना घटान_करना
take_on: लेना ग्रहण_करना प्राप्त_करना स्वीकार_करना अपनाना स्वीकारना स्वीकार_करना चुनना अपना_बनाना अंगीकार_करना अपना_लेना अख़्तियार_करना अख्तियार_करना सकारना
take_out: निकालना काढ़ना खींचना चूसना खीचना छोड़ना
take_over: दुहराना दोहराना पुनरावृत्ति_करना दुसराना दुबारा_करना दोबारा_करना
take_place: चरितार्थ_होना घटना ठीक_उतरना
take_root: जमना
take_stock: परखना आज़माना जाँचना आजमाना अजमाना देखना कसौटी_पर_कसना परीक्षण_करना परीक्षा_लेना अवलोकना अविलोकना टेस्ट_करना
take_the_air: टहलना घूमना चलना-फिरना विचरना
take_to_task: धिक्कारना फटकारना लानत-मलामत_करना
take_to_the_woods: उढ़रना भगना भागना
take_up: अवशोषित_करना खींचना चूसना सोखना पीना ईचना ईंचना ऐंचना
talk: बोलना फूटना बोलना कहना उचारना उच्चारना उच्चरना उच्चारण_करना अरंभना अरम्भना आखना उचरना उगलना उगिलना उग्रहना
talk_over: वाद_विवाद_करना तर्क_वितर्क_करना तर्क_करना विवाद_करना बहस_करना बहसना
tamper: बिगाड़ना खराब_करना ख़राब_करना घालना
tan: चमड़ा_कमाना कमाना
tangle: घसीटना गुथना गुँथना
tantalise: उघटना उकटना उगटना
tantalize: उघटना उकटना उगटना
tap: टापना खूँद_करना
tape: टेप_करना रिकार्ड_करना अभिलेखन_करना
target: निशाना_साधना निशाना_बाँधना
taste: चुबलाना चिबलाना चुभलाना
tattle: बकवास_करना बकना बकबक_करना बकबकाना प्रलाप_करना
tattoo: गोदनी
taunt: उघटना उकटना उगटना
teach: सीख_देना सिखलाना सिखाना शिक्षा_देना बताना
tear: फाड़ना चीरना बिदराना आँसू_बहना अश्रुपात_होना अश्रु_बहना आँसू_टपकना
tease: छेड़ना छेड़छाड़_करना छेड़खानी_करना उघटना उकटना उगटना धुनना धुनकना पींजना छेड़ना
teem: टूटना उमड़ना उमड़ाना
tell: कहना बताना बतलाना सूचना_देना सूचित_करना बता_देना बतला_देना सुनाना कहना बोलना फ़रमाना फरमाना आज्ञा_करना आज्ञा_देना आदेश_देना हुक्म_देना ऑर्डर_देना आर्डर_देना कहना बोलना अंतर_करना अन्तर_करना फर्क_करना फर्क_बताना भेद_करना फ़र्क़_करना फ़र्क़_बताना फरक_करना फरक_बताना फ़रक़_करना फ़रक़_बताना
tell_apart: अंतर_करना अन्तर_करना फर्क_करना फर्क_बताना भेद_करना फ़र्क़_करना फ़र्क़_बताना फरक_करना फरक_बताना फ़रक़_करना फ़रक़_बताना
temper: बेहतर_बनाना और_अच्छा_बनाना बेहतर_करना और_अच्छा_करना
tempt: ललचाना लालच_देना लुब्ध_करना लुभाना ललचाना लालच_देना लुब्ध_करना लुभाना
tend: सँभालना संभालना सम्हालना देख-रेख_करना देखरेख_करना देख-भाल_करना देखभाल_करना देखना साज_सँभाल_करना देखना-भालना अवरेवना
tender: देना प्रदान_करना
terminate: खत्म_करना खतम_करना समाप्त_करना पूरा_करना पूरा_कर_लेना पूर्ण_करना तय_करना तै_करना दूर_करना हटाना ठिकाने_लगाना छूटना छूट_जाना निकालना बाहर_करना
terrify: दहलाना
terrorise: दहलाना
terrorize: दहलाना
test: परखना जाँचना जाँच_करना परीक्षण_करना टेस्ट_करना जांचना जांच_करना जाँचना जाँच_करना जांचना जांच_करना परीक्षा_लेना इम्तहान_लेना इम्तिहान_लेना परीक्षण_परिणाम_निकलना जाँच_परिणाम_निकलना अंक_पाना अंक_प्राप्त_करना परीक्षण_कराना जाँच_कराना टेस्ट_कराना
thicken: गढ़ाना गाढ़ा_होना
thieve: चुराना चोरी_करना हाथ_मारना चुरा_लेना उड़ाना उड़ा_लेना मूसना टीपना अपहरना
think: समझना सोचना विचारना विचार_करना देखना सोंचना अनुसंधानना अनुसन्धानना अवगतना याद_होना स्मरण_होना जुबान_पर_होना
thrash: माँड़ना
thread: पिरोना पिरोहना गूथना गूँथना गूंथना पिरोना पिरोहना पोहना नाधना नाँधना
threaten: खतरे_में_डालना दाँव_पर_रखना
thresh: माँड़ना
thrill: थरथराना थर्राना थरहराना दहलना काँपना कँपना कंपित_होना कंपन_होना कम्पित_होना कम्पन_होना कांपना कंपना लरजना
throb: धड़कना स्पंदित_होना थरथराना थर्राना थरहराना दहलना काँपना कँपना कंपित_होना कंपन_होना कम्पित_होना कम्पन_होना कांपना कंपना लरजना
throw: उछालना ऊपर_उछालना फेंकना उचकाना उछारना आयोजित_करना आयोजन_करना भ्रमित_होना चकित_होना अक़ल_चकराना भ्रम_होना चकराना
throw_away: फेंकना थ्रो_करना
throw_out: फेंकना थ्रो_करना निकालना बहिराना बहरियाना निर्गत_करना बाहर_का_रास्ता_दिखाना बाहर_करना
throw_up: उगलना उगिलना उग्रहना
thud: धमधमाना
thump: धमधमाना
thunder: गरजना दहाड़ना हुंकारना गरराना तड़पना तड़फना डंकना चिल्लाना गरजना गरराना
tickle: गुदगुदी_करना गुदगुदाना
tidy: सुव्यवस्थित_करना सुविन्यस्त_करना सुप्रबंधित_करना
tidy_up: सुव्यवस्थित_करना सुविन्यस्त_करना सुप्रबंधित_करना
tie: बँधना बंधना जोड़ना लगाना सटाना
tighten: तानना खींचना खीचना ईचना ईंचना ऐंचना चढ़ना तनना
tile: खपड़े_से_छाना टाइल_से_छाना टाइल_लगाना
tilt: झुकना नवना
time: समय_मापना समयावधि_मापना काल_मापना समय_निर्धारित_करना समय_निश्चित_करना समय_नियत_करना समय_ठीक_करना समय_सेट_करना घड़ी_मिलाना समय_निर्धारित_करना समय_नियत_करना समय_तय_करना
tink: टनटनाना
tinkle: टनटनाना
tip: झुकना नवना
tip_over: उलटना पलटना
tire: थकना हारना
tire_out: थकना हारना
tissue: बुनना बिनना बुनाई_करना
titillate: गुदगुदी_करना गुदगुदाना गुदगुदाना
titter: खिलखिलाना खिल_खिल_करना ठट्ठा_लगाना
tittle-tattle: बकवास_करना बकना बकबक_करना बकबकाना प्रलाप_करना
tittup: इतराना चमकना अँगराना इठलाना झमकना टमकना मटकना अँठलाना अंठलाना
toast: सिंकना सेंकाना सिंकाना सिकना सिकाना
toddle: ठुमकना ठुनकना थिरकना
tog: पहनाना डालना
toil: जोतना रगड़ना
tolerate: अपमान_सहना बरदाश्त_करना जहर_का_घूंट_पीना
top: पीछे_छोड़ना
tope: पीना चढ़ाना
toss: टॉस_करना सिक्का_उछालना फेंकना थ्रो_करना
toss_away: फेंकना थ्रो_करना
toss_out: फेंकना थ्रो_करना
totter: ठुमकना ठुनकना थिरकना
touch: छूना स्पर्श_करना परसना छुआना छुलाना छुवाना स्पर्श_कराना परसाना पाना
touch_on: मरम्मत_करना ठीक_करना दुरुस्त_करना बनाना
tour: घूमना घूमना-फिरना सैर_करना पर्यटन_करना रमना अटना भ्रमण_करना
tout: शेखी_बघारना बघारना डींग_हाँकना डींग_मारना
towel: अँगोछना अंगोछना
toy: खेलना खिलवाड़_करना
trace: खींचना खीचना ईचना ईंचना ऐंचना
track: दौड़ाना भगाना काटना
track_down: आखेट_करना शिकार_करना शिकार_खेलना
trail: दौड़ाना भगाना घिसटना
train: प्रशिक्षित_करना प्रशिक्षण_देना योग्य_बनाना तैयार_करना अनुवर्धन_करना घिसटना
trammel: फाँदना फँसाना फांदना फंसाना
tramp: भटकना ख़ाक_छानना भरमना
tramp_down: रौंदना
trample: रौंदना
trance: मोहना मोहित_करना रिझाना लुभाना मोह_लेना
tranquilize: बुझाना ठंडा_करना शांत_करना
tranquillise: बुझाना ठंडा_करना शांत_करना
tranquillize: बुझाना ठंडा_करना शांत_करना
transfer: स्थानांतरित_करना स्थानान्तरित_करना
translate: अनुवाद_करना भाषांतर_करना भाषांतरण_करना भाषान्तर_करना भाषान्तरण_करना तरजुमा_करना तरज़ुमा_करना उल्था_करना तर्जुमा_करना तर्ज़ुमा_करना समझना
transport: ढोना वहन_करना भेजना पठाना रवाना_करना
transude: पसीजना
trap: उलझना फँसना फंसना फँस_जाना फंस_जाना अटकना अलुझना फाँदना फँसाना फांदना फंसाना
travail: जोतना रगड़ना
travel_by: गुजरना गुज़रना निकलना
travel_to: जाना यात्रा_करना सैर_करना
traverse: काटना
tread: कदम_रखना पैर_रखना
tread_down: रौंदना
treat: बरतना
trek: लंबी_कठिन_यात्रा_करना ट्रेक_करना
trespass: घुसना
trick: चकमा_देना झाँसा_देना झांसा_देना
trickle: टपकाना चुआना
trim: कटौती_करना
trim_back: कटौती_करना
trim_down: कटौती_करना
trip_the_light_fantastic: ठुमकना थिरकना
trip_the_light_fantastic_toe: ठुमकना थिरकना
triumph: खुशी_से_नाचना खुशी_से_उछलना खुशी_से_फूलना फूला_न_समाना अत्यानंदित_होना अत्यधिक_प्रसन्न_होना खुशी_से_पागल_होना
trouble: झंझट_में_डालना अवडेरना घबराना घबड़ाना बेचैन_होना व्याकुल_होना अकुलाना बिकलाना बेकलाना उकताना
trounce: धिक्कारना फटकारना लानत-मलामत_करना
trumpet: चिंघाड़ना
trust: विश्वास_करना ठीक_मान_लेना पतियाना भरोसा_करना यकीन_करना पतिआना पतीजना
try: परखना जाँचना जाँच_करना परीक्षण_करना टेस्ट_करना जांचना जांच_करना सुनना
try_out: परखना जाँचना जाँच_करना परीक्षण_करना टेस्ट_करना जांचना जांच_करना
tumefy: सूजना फूलना
tumesce: सूजना फूलना
tump_over: उलटना पलटना
turf_out: निकालना बहिराना बहरियाना निर्गत_करना बाहर_का_रास्ता_दिखाना बाहर_करना
turn: घुमाना भुलवाना घुमाना घुमा_देना मोड़ना मोड़_देना उलटना पलटना रावनाना खरादना तुर्शाना खट्टा_होना नवाना झुकाना
turn_a_loss: टूटना
turn_a_profit: लाभ_कमाना लाभान्वित_होना फ़ायदा_कमाना
turn_back: भगाना
turn_down: मना_करना ना_कहना ठुकराना
turn_off: बुझाना
turn_on: उकसाना चढ़ाना भड़काना उभाड़ना उभारना उसकाना उकतारना उगसाना उचटाना
turn_out: निकलना ठहरना साबित_होना सिद्ध_होना निकालना बहिराना बहरियाना निर्गत_करना बाहर_का_रास्ता_दिखाना बाहर_करना बुझाना
turn_over: पकड़ाना धराना थमाना लुढ़काना ढुलकाना ढुलाना उलटना पलटना
turn_tail: उढ़रना भगना भागना
turn_to: संबोधित_करना सम्बोधित_करना संबोधन_करना सम्बोधन_करना
turn_up: आना तह_करना दुहराना दोहराना दोहरा_करना दुसराना निकलना ठहरना साबित_होना सिद्ध_होना
twaddle: बकवास_करना बकना बकबक_करना बकबकाना प्रलाप_करना
twang: टंकारना
tweak: लोढ़ना चुनना
tweet: चिकोटी_काटना चिकोटना चुटकी_काटना चिहुँटना चूँटी_काटना चुटकी_लेना बकोटना
twine: अँटियाना अंटियाना बटना ऐंठना पूरना भाँजना बँटना
twinge: चुभना धँसना गड़ना चिकोटी_काटना चिकोटना चुटकी_काटना चिहुँटना चूँटी_काटना चुटकी_लेना बकोटना
twinkle: झिलमिलाना जुगजुगाना झिलमिल_करना
twirp: कलरव_करना चहकना चहचहाना
twist: कसमसाना कुलबुलाना नवाना झुकाना लौटना फिरना पलटना मुड़ना घूमना बटना ऐंठना पूरना भाँजना बँटना
twit: उघटना उकटना उगटना
twitch: चिकोटी_काटना चिकोटना चुटकी_काटना चिहुँटना चूँटी_काटना चुटकी_लेना बकोटना खींचना खीचना ईचना ईंचना ऐंचना
twitter: चहकना चहचहाना उमगना
uncover: खोलना उघाड़ना उघारना भांडा_फोड़ना भंडा_फोड़ना परदाफ़ाश_करना पर्दाफ़ाश_करना परदाफाश_करना पर्दाफाश_करना बेनक़ाब_करना बेनकाब_करना पर्दा_उठाना परदा_उठाना पर्दा_खोलना परदा_खेलना पर्दा_हटाना परदा_हटाना पोल_खोलना पोल-पट्टी_खोलना रहस्योद्घाटन_करना
undergo: भोगना पाना भुगतना
understand: समझना
undertake: लेना ग्रहण_करना प्राप्त_करना स्वीकार_करना
undress: उतारना खोलना निकालना
undulate: लहराना
unfasten: खुलना खुल_जाना
unfold: फैलाना पसारना डालना
unhinge: घबराना घबड़ाना बेचैन_होना व्याकुल_होना अकुलाना बिकलाना बेकलाना उकताना
unite: जुड़ना लगना जुटना संयुक्त_होना संलग्न_होना संबंध_होना संबद्ध_होना भिड़ना
unknot: सुलझाना
unlash: खोलना
unloose: छूटना छूट_जाना रिहा_होना मुक्त_होना निकलना बरी_होना
unloosen: छूटना छूट_जाना रिहा_होना मुक्त_होना निकलना बरी_होना
unpick: सुलझाना
unravel: सुलझाना
unscramble: सुलझाना
unscrew: खोलना
untangle: सुलझना समाधान_होना उत्तर_निकलना हल_निकलना सुलझाना
unveil: खोलना उघाड़ना उघारना भांडा_फोड़ना भंडा_फोड़ना परदाफ़ाश_करना पर्दाफ़ाश_करना परदाफाश_करना पर्दाफाश_करना बेनक़ाब_करना बेनकाब_करना पर्दा_उठाना परदा_उठाना पर्दा_खोलना परदा_खेलना पर्दा_हटाना परदा_हटाना पोल_खोलना पोल-पट्टी_खोलना रहस्योद्घाटन_करना
unwrap: खुलना उघड़ना उघरना उघढ़ना भांडा_फूटना भंडा_फूटना पर्दाफ़ाश_होना परदाफ़ाश_होना परदाफाश_होना पर्दाफाश_होना बेनक़ाब_होना बेनकाब_होना रहस्योद्घाटन_होना लीक_होना
upchuck: उगलना उगिलना उग्रहना
upgrade: पदोन्नति_करना पदोन्नति_देना
uphold: बनाए_रखना जीवित_रखना जिंदा_रखना जिन्दा_रखना बरक़रार_रखना बरकरार_रखना
uplift: बहकना
uprise: पैदा_होना उत्पन्न_होना उठना
urinate: मूतना पेशाब_करना
use: अनवाँसना सेवन_करना लेना उपभोग_करना करना काम_करना
use_up: खपना लगना उठना खर्च_होना
utilise: अनवाँसना
utilize: अनवाँसना
utter: अभिव्यक्त_करना प्रकट_करना अभिव्यक्ति_करना व्यक्त_करना रखना जाहिर_करना उजागर_करना प्रगटाना उगसारना उजियाना बोलना आवाज_करना फूटना
vacate: स्थान_त्यागना स्थान_खाली_करना स्थान_छोड़ना
vacillate: डोलना झूमना झूँमना लहराना
vagabond: भटकना ख़ाक_छानना भरमना
valuate: मूल्यांकन_करना मूल्य_लगाना
value: सम्मान_करना आदर_करना आदरना मूल्यांकन_करना मूल्य_लगाना
vanish: उड़ना गायब_होना छू-मंतर_होना उड़न-छू_होना छूमंतर_होना उड़नछू_होना काफ़ूर_होना काफूर_होना उड़_जाना गायब_हो_जाना छू-मंतर_हो_जाना उड़न-छू_हो_जाना छूमंतर_हो_जाना उड़नछू_हो_जाना काफ़ूर_हो_जाना काफूर_हो_जाना खोना गायब_होना गुमना गुम_होना
vaporise: जलाना वाष्पित_करना जलना वाष्पित_होना
vary: बदलना बदलाव_आना परिवर्तित_होना परिवर्तन_आना बदल_जाना तब्दील_होना भटकना रास्ता_भूलना
vaunt: शेखी_बघारना बघारना डींग_हाँकना डींग_मारना
vellicate: गुदगुदी_करना गुदगुदाना
verbalise: फूटना अभिव्यक्त_करना प्रकट_करना अभिव्यक्ति_करना व्यक्त_करना रखना जाहिर_करना उजागर_करना प्रगटाना उगसारना उजियाना
verbalize: फूटना अभिव्यक्त_करना प्रकट_करना अभिव्यक्ति_करना व्यक्त_करना रखना जाहिर_करना उजागर_करना प्रगटाना उगसारना उजियाना
verify: जाँचना जाँच_करना जांचना जांच_करना कसम_खाना सौगंध_खाना सौगन्ध_खाना कसम_लेना सौगंध_लेना सौगन्ध_लेना
veto: रोकना मना_करना अवारना
vex: हिलाना
vibrate: डोलना
victimize: ठगना ऐंठना झटकना मूड़ना मूँड़ना लूटना झाड़ना मूसना
vie: प्रतियोगिता_करना होड़_लगाना प्रतिस्पर्धा_करना भिड़ना लड़ना मुक़ाबला_करना मुक़ाबिला_करना मुकाबला_करना मुकाबिला_करना बहसना
view: देखना
view_as: रखना
visit: जाना यात्रा_करना सैर_करना देखना बात_करना बातचीत_करना बतियाना वार्तालाप_करना बोलना-बतियाना बोलना बोलना_बतियाना प्रकोप_होना आक्रमण_होना हमला_होना
volunteer: मानना स्वीकारना स्वीकार_करना सहमत_होना राज़ी_होना राजी_होना स्वीकार_कर_लेना सहमत_हो_जाना राज़ी_हो_जाना राजी_हो_जाना इत्तफाक_रखना इत्तफ़ाक़_रखना क़बूलना कबूलना
vomit: उगलना उगिलना उग्रहना
vomit_up: उगलना उगिलना उग्रहना
vow: मानना मन्नत_करना
waddle: ठुमकना ठुनकना थिरकना
wait: प्रतीक्षा_करना बाट_जोहना रास्ता_देखना इंतजार_करना इन्तजार_करना इंतज़ार_करना इन्तज़ार_करना राह_देखना अगोरना अँगोरना टपना
wait_on: सेना सेवा_करना अवराधना
wake: जागना सजग_रहना सावधान_रहना जागना जगना उठना आँख_खोलना सोकर_उठना जलाना जगाना सचेत_करना
wake_up: जगाना सचेत_करना जागना जगना उठना आँख_खोलना सोकर_उठना
waken: जगाना सचेत_करना जागना जगना उठना आँख_खोलना सोकर_उठना
walk: चलना टहलना घूमना चलना-फिरना विचरना टहलाना घुमाना फिराना
wall: दीवार_से_घेरना
wallow: लोटना
wander: भटकना ख़ाक_छानना भरमना
want: इच्छा_करना कामना_करना अहकना इच्छना इच्छा_रखना ईछना ईठना आवश्यकता_होना ज़रूरत_होना आवश्यकता_पड़ना ज़रूरत_पड़ना जरूरत_होना जरूरत_पड़ना
war: युद्ध_करना लड़ना जूझना
ware: लुटाना
warm: तपना तप्त_होना गरम_होना तपाना गरम_करना तप्त_करना
warm_up: तपना तप्त_होना गरम_होना
warn: चेताना चिताना सावधान_करना सचेत_करना चेतावनी_देना चेताना चिताना सावधान_करना आगाह_करना ख़बरदार_करना जताना
warp: झुठलाना
wash: धुलना
wassail: हुड़दंग_मचाना हंगामा_करना
waste: लुटाना सड़ना
watch: देखना देखना नज़र_रखना नजर_रखना ध्यान_रखना ख्याल_रखना निगरानी_रखना देखते_रहना देखना
watch_over: देखना नज़र_रखना नजर_रखना ध्यान_रखना ख्याल_रखना निगरानी_रखना देखते_रहना
water: पटना सिंचना सिंचाई_होना सिंचाना पानी_दिखाना पानी_पिलाना पानी_आना भर_आना डबडबाना अँसुआना
waul: किकियाना
wave: घुमाना नचाना लहराना लपेटना
waver: झूमना झूँमना लहराना अटपटाना ज़बान_लड़खड़ाना
wawl: किकियाना
waylay: घात_लगाना घतियाना घात_में_बैठना ताक_में_बैठना ताक_में_रहना मौक़ा_ढूढना
weaken: दुर्बल_होना क्षीण_होना टूटना अशक्त_होना
wear: पहनना धारण_करना अवधारना डालना टिकना चलना ठहरना रहना फूटना भग्न_होना थकना हारना
wear_down: थकना हारना
wear_out: थकना हारना फूटना भग्न_होना
wear_upon: थकना हारना
weary: थकना हारना
weave: बुनना बिनना बुनाई_करना
wed: विवाह_करना शादी_करना ब्याहना बियाहना ब्याह_करना हाथ_थामना हाथ_धरना हाथ_पकड़ना
wee: मूतना पेशाब_करना
wee-wee: मूतना पेशाब_करना
weed: खुरपिआना खुर्पिआना खुर्पियाना खुरपियाना
weep: रोना रुदन_करना आँसू_बहाना क्रंदन_करना
weigh: तौलाना तौलना
weight: गरुआना
weight_down: गरुआना
weld: झालना वेल्डिंग_करना टंकण_करना टँकाई_करना झाल_लगाना पंजाना
well_out: बहना प्रवाहित_होना
welter: लोटना
wet: भीगना भीजना भींगना भींजना
wheedle: फुसलाना बहलाना बहकाना बरगलाना बर्गलाना
whicker: हिनहिनाना
whinny: हिनहिनाना
whir: घरघराना घर्रघराना घड़घड़ना घुरघुराना घुर्रघुराना
whirl: घूमना चक्कर_खाना घूर्णित_होना नाचना
whirr: घरघराना घर्रघराना घड़घड़ना घुरघुराना घुर्रघुराना
whisper: फुसफुसाना कानाफूसी_करना
whistle: सरसराना
whiz: घरघराना घर्रघराना घड़घड़ना घुरघुराना घुर्रघुराना
whizz: घरघराना घर्रघराना घड़घड़ना घुरघुराना घुर्रघुराना
whoop: ललकारना ढाँसना
whoop_it_up: हुड़दंग_मचाना हंगामा_करना
will: वसीयत_करना
win: जीतना सफल_होना सफलता_पाना सफलता_हासिल_करना बाजी_मारना पार_पाना जीत_लेना कामयाब_होना जीतना विजय_पाना विजयी_होना हराना पराजित_करना परास्त_करना शिकस्त_देना पछाड़ना मात_देना जीत_दर्ज_करना जीत_लेना कामयाब_होना
win_over: समझाना
wind: अँटियाना अंटियाना चाबी_देना कूकना चाबी_भरना
wind_up: चाबी_देना कूकना चाबी_भरना
wing: उड़ना उड़ान_भरना टेक_ऑफ टेकऑफ
wink: मीचना
winkle: झिलमिलाना जुगजुगाना झिलमिल_करना
winnow: ओसाना उसाना बरसाना डाली_देना गाहना फटकना फटकारना
wipe: पोछना पोंछना
wipe_off: मिटाना
wipe_out: खपना लगना उठना खर्च_होना मिटाना
wish: इच्छा_होना चाहना मन_होना अभिलाषा_होना अभिलाखना बाँछना आखना आशा_करना अपेक्षा_करना अपेक्षा_रखना उम्मीद_करना शुभकामना_देना
withdraw: मिटाना दूर_करना दूर_हटाना अलग_करना हटाना टालना अवलोचना पीछे_हटना
wither: संकुचित_करना सिकोड़ना मुरझाना कुम्हलाना म्लान_होना मुर्झाना उतरना
withhold: रोकना रोक_देना
withstand: रोकना रोक_देना ठहराना
work: परिश्रम_करना मेहनत_करना श्रम_करना उद्यम_करना मशक्कत_करना पसीना_बहाना नौकरी_करना काम_करना काम_करना असर_करना असर_डालना चलना उपयोग_में_आना काम_करना बनाना तैयार_करना कसरत_कराना व्यायाम_कराना अभ्यास_कराना कसरत_करवाना व्यायाम_करवाना अभ्यास_करवाना करना काम_कराना काम_करवाना कराना करवाना कृषि_योग्य_बनाना खेती_योग्य_बनाना काम_करना संचालन_करना संचालित_करना चलाना चलाना उत्तेजित_करना माँड़ना गूँधना गूँथना मांड़ना गूंधना गूंथना गूथना सानना चूसना हल_करना समाधान_करना निराकरण_करना किण्वन_करना तुर्शाना खट्टा_होना होना
work_on: बनाना तैयार_करना
work_out: हल_करना समाधान_करना निराकरण_करना कसरत_कराना व्यायाम_कराना अभ्यास_कराना कसरत_करवाना व्यायाम_करवाना अभ्यास_करवाना
work_over: मारना पीटना प्रहार_करना ठोंकना ठोकना पिटाई_करना धुनना धुनाई_करना ताड़ना लगाना रसीद_करना हनन_करना
worm: कसमसाना कुलबुलाना
worry: चिंता_करना फिक्र_करना फिकर_करना सोचना सोंचना पड़ना चिन्ता_होना पड़ना
worsen: पतन_होना
worship: पूजा_करना अर्चना_करना आराधना_करना उपासना_करना पूजना अरचना अराधना अवराधना पूजना
wound: दुखाना चुभना खटकना बुरा_लगना अप्रिय_लगना
wrap: लपेटना लिपटाना लपटाना अँटियाना अंटियाना पूरी_तरह_से_ढँकना पूरी_तरह_से_ढाँकना
wrap_up: लपेटना लिपटाना लपटाना
wreak: करना
wrestle: कसमसाना कुलबुलाना कुश्ती_लड़ना कुश्ती_करना कुश्तीबाज़ी_करना
wriggle: कसमसाना कुलबुलाना
wring: ऐंठना निचोड़ना गारना
wrinkle: सिकुड़ना बल_पड़ना सलवट_पड़ना सिलवट_पड़ना सल_पड़ना
write: रचना लिखना लिखना प्रकाशित_करना संगीत_की_रचना_करना संगीत_रचना लिखना अंकित_करना दर्ज_करना दर्ज़_करना चिह्नित_करना दागना दाग़ना लिखना
writhe: कसमसाना कुलबुलाना
yawn: जँभाना जँभाई_लेना जमुहाना
yearn: तरसना ललचना ललकना लालसा_करना लहकना
yell: चिल्लाना चिंघाड़ना बँकारना भौंकना
yen: ललचना ललकना लालसा_करना लहकना
yield: घुटने_टेकना हथियार_डालना हार_मानना झुकना नवना हाथ_खड़े_करना अधीन_होना अधीनना आधीन_होना
yoke: नत्थी_करना नाथना नाधना नाँधना
