abandon: ସ୍ଥାନ_ତ୍ୟାଗ_କରିବା ଜାଗା_ଛାଡିବା ଜାଗା_ଖାଲି_କରିବା ସ୍ଥାନ_ଖାଲି_କରିବା
abduct: ଅପହରଣ_କରିବା ହରଣ_କରିବା|
abide: ରହିବା ବାସକରିବା ଅବସ୍ଥାନକରିବା ଅପମାନ_ସହିବା ବରଦାସ୍ତ_କରିବା
abound: ପ୍ରଚୁର_ହେବା ଯଥେଷ୍ଟ_ହେବା ବହୁତ_ହେବା ଅନେକ_ହେବା ଢେର_ହେବା ବହୁଳ_ଭାବରେ_ହେବା ପର୍ଯ୍ୟାପ୍ତ_ପରିମାଣରେ_ହେବା
abrade: ମାଜିବା ମାଜ_କରିବା|
absorb: ଶୋଷଣ_କରିବା ଅବଶୋଷିତ_କରିବା ଟାଣିବା ପିଇବା|
abuse: ଗାଳି_ଦେବା ଖରାପ_ଶବ୍ଦ_କହିବା ବକିବା
abut: ଅବସ୍ଥିତ_ହେବା ସ୍ଥିତ_ହେବା ଅବସ୍ଥାନ_କରିବା
accept: ସ୍ବୀକାର_କରିବା ଗ୍ରହଣ_କରିବା ମାନିନେବା ନେବା ଗ୍ରହଣ_କରିବା ପ୍ରାପ୍ତ_କରିବା ପାଇବା ଅଙ୍ଗୀକାରକରିବା ଆପଣେଇନେବା ସ୍ବୀକାରକରିବା
accommodate: ରଖିବା ଆଶ୍ରୟ_ଦେବା
account: ଟାଣିବା ଆଙ୍କିବା
accumulate: ସଞ୍ଚୟ_କରିବା ସଂଗ୍ରହ_କରିବା ଏକାଠି_କରିବା ଏକତ୍ରିତ_କରିବା ରୁଣ୍ଡହେବା ଏକାଠି_ହେବା ଏକତ୍ରିତ_ହେବା ଜମିବା
accustom: ଅଭ୍ୟସ୍ତ_ହେବା
ache: ପୀଡାହେବା ଯନ୍ତ୍ରଣାହେବା| ଲଳାୟିତ_ହେବା ଲାଳସା_କରିବା ବିନ୍ଧିବା ଯନ୍ତ୍ରଣା_ହେବା ପୀଡାଦେବା
acknowledge: ମାନିବା ସ୍ବୀକାରକରିବା ବୁଝିବା|
acquaint: ପରିଚୟ_କରାଇବା ଭେଟ_କରଇବା ସାକ୍ଷାତ_କରାଇବା
acquire: ମିଳିବା ଶିକ୍ଷାକରିବା ଶିଖିବା
acquit: ଅପରାଧ_ମୁକ୍ତ_କରିବା ଦୋଷ_ମୁକ୍ତ_କରିବା ଛାଡିଦେବା
act: ବ୍ୟବହାର କାମ_କରିବା କାମ_ଦେବା ଫଳପ୍ରଦ_ହେବା ଫଳପ୍ରସୂ_ହେବା
addict: ପଡିବା|
addle: ଅସ୍ତବ୍ୟସ୍ତ_ହେବା ହଡବଡ_ହେବା ଏପାଖ_ସେପାଖ_ହେବା
address: ସମ୍ବୋଧିତ_କରିବା ସମ୍ବୋଧନ_କରିବା| କହିବା ବୋଲିବା
adhere: ଜାବୁଡି_ଧରିବା ମିଶିଯିବା ଲାଗିବା ଯୋଡିହେବା ଜଡିଯିବା ଲାଗିଯିବ ଯୋଡିଯିବା
adjoin: ଅବସ୍ଥିତ_ହେବା ସ୍ଥିତ_ହେବା ଅବସ୍ଥାନ_କରିବା ଛୁଆଁଇବା ଛୁଏଁଇବା ସ୍ପର୍ଶ_କରେଇବା
adjudicate: ମୀମାଂସା_କରିବା ବୁଝାଶୁଝା_କରିବା ସମାଧାନ_କରିବା
adjure: ନିବେଦନ_କରିବା ବିନତି_କରିବା ବିନୟ_କରିବା ପ୍ରାର୍ଥନା_କରିବା ଅନୁନୟ_କରିବା ଅନୁରୋଧ_କରିବା
adjust: ଚଢାଇବା|
administer: ବାଣ୍ଟିବା ବିତରଣ_କରିବା
admit: ଅଙ୍ଗୀକାରକରିବା ଆପଣେଇନେବା ସ୍ବୀକାରକରିବା
admonish: ଚେତାବନୀ_ଦେବା ସାବଧାନ_କରିବା ଖବରଦାର_କରିବା
adolesce: ଯୁବକ_ହେବା ଯବାନ_ହେବା ଯୁବା_ହେବା|
adopt: କୋଳେଇ_ନେବା ସନ୍ତାନରୂପେ_ଗ୍ରହଣ_କରିବା
adorn: ସଜେଇବା ଅଳଙ୍କୃତ_କରିବା ସଜ୍ଜିତ_କରିବା ଶୋଭାନ୍ବିତ_ହେବା ଶୋଭିତ_ହେବା_
advance: ବଢାଇବା ତୀବ୍ର_କରିବା ଜିତିବା ଜୟ_ଜରିବା ବିଜୟୀ_ହେବା| ଉନ୍ନତି_କରିବା ଉନ୍ନତ_ହେବା ବିକାଶ_କରିବା ବଢିବା| ପଦୋନ୍ନତି_କରିବା ପଦୋନ୍ନତି_ହେବା ଦାମ୍‌ବଢିବା ଭାଉବଢିବା
advert: ଉଲ୍ଲେଖ_କରିବା ରଚନା_କରିବା ପ୍ରସଙ୍ଗ_କରିବା ଚର୍ଚ୍ଚା_କରିବା|
advise: ପରାମର୍ଶ_ଦେବା ଉପଦେଶ_ଦେବା
affect: ପ୍ରଭାବିତ_କରିବା ପ୍ରଭାବ_ପକାଇବା
affiance: ସ୍ଥିର_କରିବା ପକ୍କା_କରିବା
affirm: ରାଣ_ଖାଇବା ରାଣ_ପକାଇବା ଶପଥ_କରିବା ଦୁହାଇ_କରିବା ପ୍ରତିଜ୍ଞା_କରିବା
afford: ଖୋଲିବା
affright: ଡରେଇବା ଭୟଭୀତ_କରିବା ଭୟ_ସୃଷ୍ଟି_କରିବା
affront: ଅପମାନିତ_କରିବା ତିରସ୍କାର_କରିବା ଅପମାନ_ଦେବା
age: ବୁଢା_ହେବା ବୃଦ୍ଧ_ହେବା
aggrieve: ଉଦାସ_ହେବା
agitate: ଟିହାଇବା ଉସକେଇବା ଚିଡେଇବା ଉତ୍ତେଜିତକରିବା| ଲଢେଇ_କରିବା ଲଢିବା ସଂଗ୍ରାମ_କରିବା ଆନ୍ଦୋଳନ_କରିବା ହଲିବା ହଟିବା ଝୁଲାଇବା ଝୁମାଇବା ହଲାଇବା ହଲେଇବା ଦୋହଲେଇବା
aid: ସାହାଯ୍ୟ_କରିବା ସହାୟତା_କରିବା ସହଯୋଗ_କରିବା ହାତ_ବଢେଇବା |
aim: ପ୍ରୟୋଜନ_ହେବା ମତଲବ_ଥିବା ନିଶାନା_ସାଧିବା ଲକ୍ଷ୍ୟ_ସ୍ଥିର_କରିବା
alight: ଓହ୍ଲେଇବା ଅବତରଣକରିବା
allay: ମେଣ୍ଟିବା
allot: ବାଣ୍ଟିବା ବିତରଣ_କରିବା
allow: ସ୍ବୀକୃତିଦେବା ସହମତ_ଦେବା ମତପ୍ରଦାନକରିବା ସମ୍ମତିଦେବା ଅଲଗା_ରଖିବା ପୃଥକ_ରଖିବା ସଂରକ୍ଷିତ_ରଖିବା
alter: କରିବା ବଦଳାଇବା ପରିବର୍ତ୍ତନ_କରିବା ପରିବର୍ତ୍ତନ ପରିବର୍ତ୍ତନ_ହେବା ବଦଳେଇବା ପରିବର୍ତ୍ତନ_ଆଣିବା ବଦଳିଯିବା
altercate: କଳି_କରିବା ଝଗଡା_କରିବା ଲଢିବା ଲଢେଇକରିବା ଗଣ୍ଡଗୋଳ_କରିବା
amass: ରୁଣ୍ଡହେବା ଏକାଠି_ହେବା ଏକତ୍ରିତ_ହେବା ଜମିବା ସଞ୍ଚୟ_କରିବା ସଂଗ୍ରହ_କରିବା ଏକାଠି_କରିବା ଏକତ୍ରିତ_କରିବା
amaze: ଆଶ୍ଚର୍ଯ୍ୟଚକିତ_ହେବ ଆଶ୍ଚର୍ଯ୍ୟହେବା ବିସ୍ମ୍ୟହେବା
ambuscade: ଗୁପ୍ତ_ଆକ୍ରମଣପାଇଁ_ରହିବା
ambush: ଗୁପ୍ତ_ଆକ୍ରମଣପାଇଁ_ରହିବା
ameliorate: ବିକଶିତ_କରିବା ବଢେଇବା ଉନ୍ନତ_କରିବା ସୁଧୁରିବା
amend: ବିକଶିତ_କରିବା ବଢେଇବା ଉନ୍ନତ_କରିବା
amuse: ଆନନ୍ଦିତ_କରିବା ମୋହିତ_କରିବା ଖୁସି_କରିବା|
anathemise: ଗାଳିଦେବା
anathemize: ଗାଳିଦେବା
anchor: ଲଙ୍ଗର_ପକାଇବା ଲଙ୍ଗର_ବାନ୍ଧିବା
anger: ରାଗ_ମାଡିବା କ୍ରୋଧିତ_କରିବା କ୍ରୋଧ_ଦେବା ଭଡକେଇବା ରାଗିବା ଗରମ_ହେବା କ୍ରୋଧ_କରିବା ଉତ୍ତେଜିତ_ହେବା|
angle: ନଇଁବା ବଙ୍କା_ହେବା ଝୁଙ୍କିବା
anguish: ଦୁଃଖ_ଦେବା
animate: ପ୍ରେରିତ_କରିବା
answer: ଉତ୍ତର_ଦେବା ଜବାବ୍‌_ଦେବା
anticipate: ସମ୍ଭାବନା_ହେବା|
apparel: ପିନ୍ଧାଇବା|
appeal: ଗୁହାରି_କରିବା ନିବେଦନ_କରିବା ଅପିଲ୍‌_କରିବା
appear: ଆବିର୍ଭୁତ_ହେବା ଉଠିବା‌ ଠିଆ_ହେବା ଉପସ୍ଥିତ_ହେବା
appease: ମନାଇବା ପ୍ରସନ୍ନ_କରେଇବା
apply: ଅନୁକୂଳ_କରିବା ଲିପିବା
appraise: ମୂଲ୍ୟାଙ୍କନ_କରିବା ମୂଲ୍ୟଧାରଣ_କରିବା ମୂଲ୍ୟ_ନିର୍ଣ୍ଣୟ_କରିବା
apprehend: ବୁଝେଇବା ଧରିବା ବନ୍ଦୀ_ବରିବା କଏଦୀ_କରିବା ବ୍ରପ୍ତାର_କରିବା ଧରିବା|
appropriate: ଅଲଗା_ରଖିବା ପୃଥକ_ରଖିବା ସଂରକ୍ଷିତ_ରଖିବା
approximate: ଅନୁମାନକରିବା ଲକ୍ଷ_କରିବା ଧାରଣାକରିବା
argue: ଯୁକ୍ତିତର୍କକରିବା ବିତଣ୍ଡାକରିବା ବିବାଦକରିବା
argufy: କଳି_କରିବା ଝଗଡା_କରିବା ଲଢିବା ଲଢେଇକରିବା ଗଣ୍ଡଗୋଳ_କରିବା
arise: ସୃଷ୍ଟିହେବା ଜାତ_ହେବା ଉତ୍ପନ୍ନ_ହେବା ଉଠିବା ପଡିବା ଆସିବା|
arouse: ଉଠିବା ଜାଗିବା ଆଖି_ଖୋଲିବା ଶୋଇକି_ଉଠିବା ଜାଗୃତ_କରିବା ଜଗେଇବା ସାଧନ_କରିବା ଜଗେଇବା ସଚେତ_କରିବା
arrange: ସ୍ଥିର_କରିବା ନିର୍ଦ୍ଧାରଣ_କରିବା ନିଶ୍ଚିତ_କରିବା ଥୟ_କରିବା ନିର୍ଦ୍ଧାରିତ_କରିବା ନିର୍ଣ୍ଣୟ_କରିବା ପରିଚାଳନା_କରିବା ସଞ୍ଚାଳିତ_କରିବା
arrest: ବନ୍ଦୀ_ବରିବା କଏଦୀ_କରିବା ବ୍ରପ୍ତାର_କରିବା ଧରିବା|
arrive_at: ଆସିବା ପହଞ୍ଚିବା ଆଗମନ_କରିବା ଉପସ୍ଥିତ_ହେବା
ascend: ଚଢିବା ଉଠିବା ଆରୋହଣ_କରିବା ଉଠିବା ଉଇଁବା ଉଦୟ_ହେବା|
ask: ଦେଖିବା ପଚାରିବା ପଚରା_ଉଚୁରା_କରିବା ଚାହିଦା_ରହିବା
asperse: ଚୁଗୁଲି_କରିବା ଫୋଡିବା|
asphyxiate: ଅଣନିଶ୍ବାସୀ_ହେବା ଶ୍ବାସ_ଅଟକିବା ଶ୍ବାସରୋଧ_ହେବା|
assert: ରାଣ_ଖାଇବା ରାଣ_ପକାଇବା ଶପଥ_କରିବା ଦୁହାଇ_କରିବା ପ୍ରତିଜ୍ଞା_କରିବା
assess: ମୂଲ୍ୟାଙ୍କନ_କରିବା ମୂଲ୍ୟଧାରଣ_କରିବା ମୂଲ୍ୟ_ନିର୍ଣ୍ଣୟ_କରିବା
assist: ସାହାଯ୍ୟ_କରିବା ସହାୟତା_କରିବା ସହଯୋଗ_କରିବା ହାତ_ବଢେଇବା | ସେବାକରିବା ପରିଚର୍ଯ୍ୟା_କରିବା
assoil: ଅପରାଧ_ମୁକ୍ତ_କରିବା ଦୋଷ_ମୁକ୍ତ_କରିବା ଛାଡିଦେବା
assuage: ମନାଇବା ପ୍ରସନ୍ନ_କରେଇବା ମେଣ୍ଟିବା
assure: କହିବା ବ୍ୟକ୍ତକରିବା ବିବରଣୀଦେବା ସ୍ପଷ୍ଟକରିବା ପ୍ରତିଜ୍ଞାକରିବା ସତ୍ୟକରିବା କଥାଦେବା ନିୟମକରିବା ଜବାବଦେବା
astonish: ଆଶ୍ଚର୍ଯ୍ୟଚକିତ_ହେବ ଆଶ୍ଚର୍ଯ୍ୟହେବା ବିସ୍ମ୍ୟହେବା
astound: ଆଶ୍ଚର୍ଯ୍ୟଚକିତ_ହେବ ଆଶ୍ଚର୍ଯ୍ୟହେବା ବିସ୍ମ୍ୟହେବା
attach: ସଂଲଗ୍ନକରିବା ଯୋଡିବା|
attain: ପହଞ୍ଚିବା ଆସିବା ପହଞ୍ଚିବା ଆଗମନ_କରିବା ଉପସ୍ଥିତ_ହେବା
attend: ସେବାକରିବା ପରିଚର୍ଯ୍ୟା_କରିବା
attend_to: ସେବାକରିବା ପରିଚର୍ଯ୍ୟା_କରିବା
attract: ଆକର୍ଷିତ_କରିବା ଆକୃଷ୍ଟ_କରିବା ଲୋଭାନ୍ବିତ_କରିବା ଟାଣିବା|
auction: ନିଲାମକରିବା|
auction_off: ନିଲାମକରିବା|
auctioneer: ନିଲାମକରିବା|
audit: ଯାଞ୍ଚ୍_କରିବା ତଦାରଖ_କରିବା
avenge: ପ୍ରତିଶୋଧ_ନେବା ହିସାବ_ବରାବର_କରିବା ବଦଲା_ନେବା
aver: ରାଣ_ଖାଇବା ରାଣ_ପକାଇବା ଶପଥ_କରିବା ଦୁହାଇ_କରିବା ପ୍ରତିଜ୍ଞା_କରିବା
avow: ରାଣ_ଖାଇବା ରାଣ_ପକାଇବା ଶପଥ_କରିବା ଦୁହାଇ_କରିବା ପ୍ରତିଜ୍ଞା_କରିବା
await: ଚାହିଁ_ବସିବା ବେକାରରେ_ଅପେକ୍ଷା_କରିବା ବ୍ୟର୍ଥ_ପ୍ରତୀକ୍ଷା_କରିବା
awake: ଉଠିବା ଜାଗିବା ଆଖି_ଖୋଲିବା ଶୋଇକି_ଉଠିବା
awaken: ଜଗେଇବା ସଚେତ_କରିବା ଉଠିବା ଜାଗିବା ଆଖି_ଖୋଲିବା ଶୋଇକି_ଉଠିବା
award: ସମ୍ମାନ_ଦେବା ସମ୍ମାନିତ_କରିବା|
baa: ମେଁ_ମେଁ_ବୋବେଇବା ମେଁ_ମେଁ_ରଡିକରିବା|
back_away: ପଛକୁ_ହଟିବା ପଶ୍ଚାତଗତି_ହେବା
back_out: ପଛକୁ_ହଟିବା ପଶ୍ଚାତଗତି_ହେବା
back_up: ଅବରୁଦ୍ଧହେବା ବାଧାପଡିବା ଅଟକିଯିବା ବନ୍ଦହେବା ଫସିଯିବା
badger: ଚିଡାଇବା ହାସ୍ୟ_ରସ_କରିବା
bag: ଜବରଦଖଲ_କରିବା ହାତେଇନେବା ହଡପ_କରିନେବା|
bait: ବିରକ୍ତ_କରିବା ଚିଡେଇବା ରଗାଇବା କଷ୍ଟ_ଦେବା
balk: ଅଡିବସିବା ଅଡିବା ଜିଦକରିବା ଅଝଟକରିବା
ball_over: ଆଶ୍ଚର୍ଯ୍ୟାନ୍ବିତ_ହେବା ବିସ୍ମିତ_ହେବା ଚକିତ_ହେବା
bandage: ଘେରେଇବା ମୁଜିବା ବୁଜିବା|
bang: ରତିକରିବା ରମଣକରିବା ସମ୍ଭୋଗକରିବା
bank: ବିଶ୍ୱାସ_କରିବା ଠିକ_ମାନିନେବା ଭରସା_କରିବା
bankrupt: ଦେବାଳିଆ_କରିବା ଦେବାଲିଆ_କରିବା
banquet: ଭୋଜୀ_ଦେବା ଭୋଜନ_ଦେବା ଖୁଆଇବା|
bar: ବନ୍ଦ_କରିବା ସିଲ୍_କରିବା ବ୍ଲକ୍_କରିବା ବଂଦ_କରିବା
bare: ଉଲଗ୍ନ_କରାଇବା
barf: ଥୁକିବା ଛେପପକାଇବା
bark: ଭୁକିବା ଭୋ_ଭୋ_କରିବା
barricade: ବନ୍ଦ_କରିବା ସିଲ୍_କରିବା ବ୍ଲକ୍_କରିବା ବଂଦ_କରିବା
bask: ଆନନ୍ଦ_ନେବା ମଜା_ନେବା ସୁଖଲାଭ_କରିବା ସନ୍ତୋଷଲାଭ_କରିବା ସନ୍ତୁଷ୍ଟ_ହେବା
baste: କୁଟିବା ମାଡ_ଦେବା ସିଲେଇ_କରିବା ସିଇଁବା ସୀବନକରିବା
bath: ନିମଜ୍ଜନ_ହେବା ଅବଗାହନ_ହେବା ବୁଡିବା ଗାଧୋଇବା ସ୍ନାନ_କରିବା
bathe: ଗାଧୋଇବା ସ୍ନାନ_କରିବା ନିମଜ୍ଜନ_ହେବା ଅବଗାହନ_ହେବା ବୁଡିବା ଗାଧୋଇବା ସ୍ନାନ_କରିବା
batter: କୁଟିବା ମାଡ_ଦେବା
baulk: ଅଡିବସିବା ଅଡିବା ଜିଦକରିବା ଅଝଟକରିବା
bawl_out: ଧିକ୍କାରିବା ଗାଳିଦେବା ଅପମାନ_କରିବା ତିରସ୍କାର_କରିବା
be: ଲାଗିବା| ଆକ୍ରମଣ_ହେବା| ନିର୍ବାହ ସଂପାଦନ ପ୍ରତିପାଦନ ବଞ୍ଚିରହିବା ଜୀଇଁବା ଜୀବିତ_ରହିବା ଜୀବନ_ଯାପନ_କରିବା ଜୀବନ_ବିତାଇବା ପଡିଲା|
be_adrift: ଚାଲିବା
be_after: ଉଦ୍ଦେଶ୍ୟ_ରହିବା ଇଚ୍ଛା_କରିବା ମନହେବା ଯୋଜନା_କରିବା
be_born: ଜନ୍ମ_ନେବା ଜନ୍ମିବା ଭୂମିଷ୍ଟ_ହେବା|
be_intimate: ରତିକରିବା ରମଣକରିବା ସମ୍ଭୋଗକରିବା
be_sick: ଥୁକିବା ଛେପପକାଇବା
beam: ଚମକିବା ଝଲମଲ_କରିବା ଦମକିବା
bear: ଜନ୍ମକରିବା ଜନ୍ମ_ଦେବା ଉତ୍ପନ୍ନ_କରିବା ପ୍ରସବ_କରିବା ଅପମାନ_ସହିବା ବରଦାସ୍ତ_କରିବା ରହିବା|
bear_in_mind: ଧ୍ୟାନରେ_ରଖିବା ମନେ_ରଖିବା ସ୍ମରଣ_ରଖିବା
bear_on: ବଜାୟ_ରଖିବା ଜୀବିତ_ରଖିବା ସଜୀବ_ରଖିବା ବଞ୍ଚେଇ_ରଖିବା ରକ୍ଷାକରିବା ସୁରକ୍ଷିତ_ରଖିବା
beat: ପିଟିବା ମାରିବା ଚଟକଣି_ପକେଇବା ଚଟକଣି_ଦେବା ପ୍ରହାର_କରିବା ବାଡେଇବା ଧୁଲେଇକରିବା ପିଟିବା ବାଡେଇବା ଆଘାତ_କରିବା| ଫେଣ୍ଟିବା ଫରଫର_ହୋଇ_ଉଡିବା ଆନ୍ଦୌଳିତ_ହେବା
beat_up: ପିଟିବା ମାରିବା ଚଟକଣି_ପକେଇବା ଚଟକଣି_ଦେବା ପ୍ରହାର_କରିବା ବାଡେଇବା ଧୁଲେଇକରିବା
beautify: ଶୋଭାନ୍ବିତ_ହେବା ଶୋଭିତ_ହେବା_ ସଜେଇବା ଅଳଙ୍କୃତ_କରିବା ସଜ୍ଜିତ_କରିବା
becharm: ମୋହିତ_କରିବା ମୋହେଇବା ସମ୍ମୋହନ_କରିବା|
become: ତିଆରି_ହେବା ଗଢାହେବା ନିର୍ମାଣ_ହେବା ମାନିବା ଶୋଭିତ_ହେବା ଭଲ_ଲାଗିବା|
bed: ବିଛଣା_ଯୋଗାଇଦେବା ବିସ୍ତର_ଦେବା ରତିକରିବା ରମଣକରିବା ସମ୍ଭୋଗକରିବା
bedamn: ଗାଳିଦେବା
bedazzle: ଝଲସିଯିବା|
bedevil: ଭ୍ରମିତ_ହେବା ଭ୍ରମ_ହେବା ଅକଲ_ଗୁଡୁମ_ହେବା|
beetle: ଝୁଙ୍କିବା ଝୁଲିବା ଓହଳିବା
befool: ବୋକା_ବନେଇବା ଓଲୁ_ବନେଇବା ଏପ୍ରିଲ_ଫୁଲ_କରିବା
befuddle: ଭ୍ରମିତ_ହେବା ଭ୍ରମ_ହେବା ଅକଲ_ଗୁଡୁମ_ହେବା|
beg: ଭିକ_ମାଗିବା ଭିକ୍ଷା_ଗ୍ରହଣ_କରିବା
begin: ଉଠାଇବା ଆରମ୍ଭ_କରିବା ବାହାର_କରିବା ଆରମ୍ଭ_କରିବା ପ୍ରାରମ୍ଭ_କରିବା ଉଠାଇବା ଆରମ୍ଭ_କରିବା ଆସିବା ଆରମ୍ଭ_ହେବା
begrime: ଗୋଳିଆ_କରିବା ମଇଳା_କରିବା ଅପରିଷ୍କାର_କରିବା
beguile: ମୋହିତ_କରିବା ମୋହେଇବା ସମ୍ମୋହନ_କରିବା|
behave: ବ୍ୟବହାର
belch: ହେଉଡି
beleaguer: ଚିଡାଇବା ହାସ୍ୟ_ରସ_କରିବା
believe: ବୁଝିବା ଶ୍ରଦ୍ଧା_କରିବା ସ୍ବୀକାର_କରିବା|
bellow: ଗର୍ଜନ_କରିବା ଗରଜିବା|
bemire: ଗୋଳିଆ_କରିବା ମଇଳା_କରିବା ଅପରିଷ୍କାର_କରିବା
bend: ନୁଆଁଇବା ଝୁଙ୍କାଇବା ତଳକୁକରିବା|
benefit: ଫଳିବା
benumb: ଅଚଳହେବା ଗତିହୀନହେବା ନିଶ୍ଚଳହେବା
bequeath: ଉଇଲ୍_କରିବା ଇଚ୍ଛାପତ୍ର_କରିବା
berate: ଧିକ୍କାରିବା ଗାଳିଦେବା ଅପମାନ_କରିବା ତିରସ୍କାର_କରିବା
beseech: ନିବେଦନ_କରିବା ବିନତି_କରିବା ବିନୟ_କରିବା ପ୍ରାର୍ଥନା_କରିବା ଅନୁନୟ_କରିବା ଅନୁରୋଧ_କରିବା
beset: ହଇରାଣ_କରିବା ପୀଡିତ_କରିବା|
beshrew: ଗାଳିଦେବା
besmirch: ଚୁଗୁଲି_କରିବା ଫୋଡିବା|
bespeak: ମାଗିବା
besprinkle: ଛିଞ୍ଚିବା ଛିଟିକାଇବା ଛିଡିକାଇବା ସିଞ୍ଚିବା ସେଚନକରିବା
bestride: ଚଢିବା ବସିବା ଆରୋହଣ_କରିବା ଅବସ୍ଥାନ_କରିବା ଆସୀନ_ହେବା
betray: ଧୋକାଖାଇବା ଫୁସୁଲେଇବା|
betroth: ସ୍ଥିର_କରିବା ପକ୍କା_କରିବା
better: ବିକଶିତ_କରିବା ବଢେଇବା ଉନ୍ନତ_କରିବା ସୁଧୁରିବା
bewitch: ମୋହିତ_କରିବା ମୋହେଇବା ସମ୍ମୋହନ_କରିବା|
bid: ଦେବା ପ୍ରଦାନ_କରିବା ଦାନ_କରିବା ଶୁଭକାମନା_ଜଣାଇବା ନିବେଦନ_କରିବା ବିନତି_କରିବା ବିନୟ_କରିବା ପ୍ରାର୍ଥନା_କରିବା ଅନୁନୟ_କରିବା ଅନୁରୋଧ_କରିବା
bide: ରହିବା ବାସକରିବା ଅବସ୍ଥାନକରିବା
bind: ଜଡିଯିବା ଲାଗିଯିବ ଯୋଡିଯିବା ଘେରେଇବା ମୁଜିବା ବୁଜିବା| ମଡେଇବା| ବାନ୍ଧିହେବା ଛନ୍ଦିହେବା|
binge: ତୃପ୍ତ_ହେବା
birr: ଘଡଘଡ_ହେବା ଘରଘର_ହେବା ଚଡଚଡ_ହେବା|
birth: ଜନ୍ମକରିବା ଜନ୍ମ_ଦେବା ଉତ୍ପନ୍ନ_କରିବା ପ୍ରସବ_କରିବା
bite: କାମୁଡିବା ପୋଡିବା ଜଳିବା ଚୋଟ_ମାରିବା କାମୁଡିବା ଦଂଶନ_କରିବା_
blab: ଅଯଥା_କଥା_କହିବା ବକ୍‌ବକ୍‌_କରିବା ବକ୍‌_ବକ୍‌_ହେବା
blabber: ଅଯଥା_କଥା_କହିବା ବକ୍‌ବକ୍‌_କରିବା ବକ୍‌_ବକ୍‌_ହେବା
black_market: ବେଆଇନ_କାରବାର_କରିବା ଅବୈଧ_କାରବାର_କରିବା ଅବୈଧାନିକ_କାରବାର_କରିବା
blackguard: ଉପହାସ_କରିବା ନିନ୍ଦା_କରିବା ଦୋଷ_ବାହାର_କରିବା ହସି_ଉଡାଇବା| ଗାଳି_ଦେବା ଖରାପ_ଶବ୍ଦ_କହିବା ବକିବା
blame: ଲଦିବା ଲଦିଦେବା ଠେଲିବା ଥୋପିବା|
blank_out: ଭୁଲିବା
blarney: ବହଲାଇବା ଆହ୍ଲାଦିତ_କରିବା ପ୍ରବୋଧିତ_କରିବା
blat: ମେଁ_ମେଁ_ବୋବେଇବା ମେଁ_ମେଁ_ରଡିକରିବା|
blate: ମେଁ_ମେଁ_ବୋବେଇବା ମେଁ_ମେଁ_ରଡିକରିବା|
blaze: ଡହକିବା ପ୍ରଜ୍ବଳିତହେବା
bleat: ମେଁ_ମେଁ_ବୋବେଇବା ମେଁ_ମେଁ_ରଡିକରିବା|
blend: ମିଶିବା|
bless: ଆଶୀର୍ବାଦ_ଦେବା ଆଶୀଷ_ଦେବା କଲ୍ୟାଣ_କରିବା| ଅଭିମନ୍ତ୍ରଣ_କରିବା
blink: ବୁଜିବା ବନ୍ଦ_କରିବା
block: ବନ୍ଦ_କରିବା ସିଲ୍_କରିବା ବ୍ଲକ୍_କରିବା ବଂଦ_କରିବା ରହିଯିବା ରଖିବା ରୋକିବା ଅଟକାଇବା ଭୁଲିବା
block_off: ବନ୍ଦ_କରିବା ସିଲ୍_କରିବା ବ୍ଲକ୍_କରିବା ବଂଦ_କରିବା
block_up: ବନ୍ଦ_କରିବା ସିଲ୍_କରିବା ବ୍ଲକ୍_କରିବା ବଂଦ_କରିବା
blockade: ବନ୍ଦ_କରିବା ସିଲ୍_କରିବା ବ୍ଲକ୍_କରିବା ବଂଦ_କରିବା
bloom: ଫୁଟି_ଉଠିବା ଫୁଟିବା ପ୍ରସ୍ଫୁଟିତ_ହେବା ବିକଶିତ_ହେବା ଖେଳିଯିବା
blossom: ଫୁଟି_ଉଠିବା ଫୁଟିବା ପ୍ରସ୍ଫୁଟିତ_ହେବା ବିକଶିତ_ହେବା ଖେଳିଯିବା
blow: ଫୁଙ୍କିବା ଫୁଙ୍କମାରିବା| ସରସର_ବହିବା ଛିଙ୍କିବା ଚାଲିବା ଉଡାଇ_ଦେବା ଅପବ୍ୟୟ_କରିବା ଫୁଙ୍କିବା ଫୁଟାଣି_ମାରିବା ବଡିମା_ଦେଖାଇବା ଆସ୍ଫାଳନ_କରିବା
blow_out: ଲିଭେଇବା ପ୍ରସମିତକରିବା|
blow_out_of_the_water: ଆଶ୍ଚର୍ଯ୍ୟାନ୍ବିତ_ହେବା ବିସ୍ମିତ_ହେବା ଚକିତ_ହେବା
blow_up: ଫୁଟାଇବା ଫୁଲାଇବା ବତୁରାଇବା
blub: ନାକରେ_କାନ୍ଦିବା_
blubber: ନାକରେ_କାନ୍ଦିବା_
blunt: ଅଚଳହେବା ଗତିହୀନହେବା ନିଶ୍ଚଳହେବା
blush: ଲଜ୍ଜିତହେବା ଲାଜେଇବା
bluster: ଫୁଟାଣି_ମାରିବା ବଡିମା_ଦେଖାଇବା ଆସ୍ଫାଳନ_କରିବା
boast: ଫୁଟାଣି_ମାରିବା ବଡିମା_ଦେଖାଇବା ଆସ୍ଫାଳନ_କରିବା ଦେଖାଇବା ପ୍ରଦର୍ଶନ_କରିବା ପ୍ରଦର୍ଶିତ_କରିବା ଉପସ୍ଥାପନ_କରିବା ପ୍ରତ୍ୟକ୍ଷ_କରାଇବା
bob: ଲାଞ୍ଜ_କାଟିବା ଲାଙ୍ଗୁଡ_କାଟିବା ପୁଚ୍ଛ_କାଟିବା
bob_up: ଉଠିବା ପଡିବା ଆସିବା|
boggle: ସ୍ତବ୍ଧ_ହୋଇଯିବା ଜଡ_ହୋଇଯିବା ନିଶ୍ଚଳହୋଇଯିବା ସ୍ତମ୍ଭିତହୋଇଯିବା ସ୍ତମ୍ଭୀଭୂତହୋଇଯିବା ନିର୍ବାକହୋଇଯିବା
boil: ଫୁଟିବା ଉତୁରିବା| ଗରମକରିବା ଆଉଟିବା
boil_down: ବହଳିଆ_କରିବା ଗାଢା_କରିବା
bolster: ସହାୟତା_କରିବା ସହଭାଗୀ_ହେବା ସମର୍ଥନ_କରିବା ଆଶ୍ରୟ_ଦେବା
bolster_up: ସହାୟତା_କରିବା ସହଭାଗୀ_ହେବା ସମର୍ଥନ_କରିବା ଆଶ୍ରୟ_ଦେବା
bolt: ଭକ୍ଷଣ_କରିବା ଖାଇବା|
bomb: ଅନୁତ୍ତୀର୍ଣ୍ଣ_ହେବା ଉତ୍ତୀର୍ଣ୍ଣ_ନ_ହେବା
bombilate: ଗୁଞ୍ଜରଣ_କରିବା ଗୁଣୁଗୁଣୁ_କରିବା
bombinate: ଗୁଞ୍ଜରଣ_କରିବା ଗୁଣୁଗୁଣୁ_କରିବା
bond: ଜଡିଯିବା ଲାଗିଯିବ ଯୋଡିଯିବା ଭେଟକରାଇବା ମିଶେଇବା ମିଶିବା
bonk: ରତିକରିବା ରମଣକରିବା ସମ୍ଭୋଗକରିବା
book: ସଂରକ୍ଷଣ_କରିବା ଆରକ୍ଷିତ_କରିବା
boost: ବଢାଇବା ତୀବ୍ର_କରିବା
boot_out: ବାହାର_କରିଦେବା
booze: ନିଶା_ହେବା
border: ସୀମା_ନିର୍ଦ୍ଧାରଣ_କରିବା ସୀମା_ଥୟ_କରିବା ସୀମା_ନିଶ୍ଚିତ_କରିବା ଧଡି_ତିଆରି_କରିବା ଧଡି_ପକାଇବା କିନାରି_ତିଆରି_କରିବା କିନାରି_ପକାଇବା ବର୍ଡର_କରିବା ଅବସ୍ଥିତ_ହେବା ସ୍ଥିତ_ହେବା ଅବସ୍ଥାନ_କରିବା
bore: ଛେଦ_କରିବା ଛେଦିବା ଭେଦ_କରିବା
borrow: ଉଧାର_ନେବା ଧାର_ନେବା
bosom: କୁଣ୍ଢେଇ_ପକାଇବା ଆଲିଙ୍ଗନ_କରିବା
bother: ଅସୁବିଧାରେ_ପକାଇବା ଝଞ୍ଜଟରେ_ପକାଇବା ଜଞ୍ଜାଳରେ_ପକାଇବା ଗୋଳମାଳରେ_ପକାଇବା ସମସ୍ୟାରେ_ପକାଇବା ହଇରାଣ_କରିବା
bound: ଡେଇଁବା ଲମ୍ଫପ୍ରଦାନ_କରିବା| ସୀମା_ନିର୍ଦ୍ଧାରଣ_କରିବା ସୀମା_ଥୟ_କରିବା ସୀମା_ନିଶ୍ଚିତ_କରିବା
bourgeon: ଅଙ୍କୁର_ବାହାରିବା ଅଙ୍କୁରିତ_ହେବା ଗଜେଇବା ଗଜା_ବାହାରିବା
bowl: ଗଡିବା|
brace: ଜାଗୃତ_କରିବା ଜଗେଇବା ସାଧନ_କରିବା
brag: ଫୁଟାଣି_ମାରିବା ବଡିମା_ଦେଖାଇବା ଆସ୍ଫାଳନ_କରିବା
brandish: ବୁଲାଇବା ଚଲାଇବା_
bray: ରଡି ବୋବାଳି ଚୂରିବା ଚୂନାକରିବା ପେଷିବା ଗୁଣ୍ଡକରିବା ଚୂର୍ଣ୍ଣକରିବା
break: ତୁଟାଇବା ଭଙ୍ଗ_କରିବା ଶେଷ_କରିବା ସମାପ୍ତ_କରିବା ଫାଟିବା| ଫଟେଇବା ଭାଙ୍ଗିବା ଭଗ୍ନ_କରିବା ଉଦ୍ଗିରଣ_ହେବା ଫୁଟିବା ଖୋଲିବା ପଦାକୁବାହାରିବା ଉନ୍ମୋଚନ_ହେବା| ଭାଙ୍ଗିବା ଭାଙ୍ଗିଯିବା ଅଲଗାହେବା ପୃଥକହେବା ଦେବାଳିଆ_କରିବା ଦେବାଲିଆ_କରିବା ଭୁଷୁଡି_ପଡିବା ଗଳିପଡିବା ଟଳିପଡିବା | ଫୁଟିବା ଭଗ୍ନ_ହେବା ଖଣ୍ଡ_କରିବା ଭାଙ୍ଗିବା ଗଡକରିବା ଭାଗକରିବା| ଚଡକିଯିବା ଚଡକରିଫାଟିଯିବା ଭାଙ୍ଗି_ପଡିବା
break_away: ଭାଙ୍ଗିବା ଭାଙ୍ଗିଯିବା ପଳେଇଯିବା|
break_loose: ଫେରାର_ହେବା ପଳାୟନ_କରିବା
break_off: ଖଣ୍ଡ_କରିବା ଭାଙ୍ଗିବା ଗଡକରିବା ଭାଗକରିବା| ତୋଳିବା
break_open: ବିନ୍ଧିବା ଫାଟିବା|
break_up: ଅଲଗାହେବା ପୃଥକହେବା ଗୋଳାଇବା ମିଶେଇବା ମିଶ୍ରିତ_କରିବା ଭାଙ୍ଗିଯିବା|
break_wind: ପାଡିବା ବାୟୁତ୍ୟାଗକରିବା
breathe: ଶ୍ବାସପ୍ରଶ୍ବାସ_ନେବା ଶ୍ବାସଗ୍ରହଣ_କରିବା ବିଶ୍ରାମକରିବା ଆରାମ_କରିବା ଥକ୍କାମାରିବା
bribe: ଲାଞ୍ଚଦେବା ତେଲେଇବା ଉତ୍କୋଚଦେବା
bring: ଆଣିବା ନେଇଆସିବା ପହଞ୍ଚାଇବା କରିବା କାମ_କରିବା କାର୍ଯ୍ୟ_କରିବା
bring_back: ଲେଉଟାଇଆଣିବା ଫେରାଇଆଣିବା
bring_down: ଓହ୍ଲାଇବା ଛାଡ_କରିବା ଋଣ_ଛାଡ_କରିବା|
bring_forth: ଉତ୍ପାଦନ_କରିବା ଉତ୍ପନ୍ନ_କରିବା ନିଷ୍ପନ୍ନ_କରିବା ନିର୍ଣ୍ଣୟ_କରିବା
bring_home_the_bacon: ଭରଣପୋଷଣ_କରିବା ପୋଷଣ_କରିବା ପାଳନ_କରିବା ପ୍ରତିପାଳନ_କରିବା ପରିବାର_ଚଳାଇବା
bring_out: ଖୋଲିବା ପ୍ରକାଶ_କରିବା ପର୍ଦାଫାଶ_କରିବା ଉନ୍ମୋଚିତ_କରିବା ବାହାରିବା ପ୍ରକାଶିତ_ହେବା ଖୋଲିବା ପଦାକୁବାହାରିବା ଉନ୍ମୋଚନ_ହେବା|
bring_through: ମୁକ୍ତ_କରିବା ମୁକ୍ତି_ପାଇବା ଉଦ୍ଧାର_କରିବା ଉଦ୍ଧାର_ପାଇବା ନିସ୍ତାର_ପାଇବା
bring_together: ଭେଟକରାଇବା ମିଶେଇବା ମିଶିବା
bring_up: ପାଳିବା ପୋଷିବା ପାଳନ_କରିବା ପାଳନ_ପୋଷଣ_କରିବା ଉଠେଇବା ଉଲ୍ଲେଖ_କରିବା ରଚନା_କରିବା ପ୍ରସଙ୍ଗ_କରିବା ଚର୍ଚ୍ଚା_କରିବା|
brood: ରୁଷିବା ରୁଷ୍ଟ_ହେବା ମୁଁହ_ଫୁଲେଇବା କ୍ରୋଧିତ_ହେବା କ୍ରୁଦ୍ଧ_ହେବା କୁପିତ_ହେବା ଉଷୁମାଇବା
brook: ଅପମାନ_ସହିବା ବରଦାସ୍ତ_କରିବା
broom: ଝାଡି_ସଫା_କରିବା ଝାଡୁ_କରିବା ଝାଡୁ_ଲଗାଇବା
browbeat: ଧମକେଇବା ଦମକଦେବା ଡରେଇବା
browse: ଚରିବା
bruise: କଣ୍ଟା_ଫୋଡିବା ଖଟକା_ଲାଗିବା ଅପ୍ରିୟ_ଲାଗିବା ଖରାପ_ଲାଗିବା କୁଟିବା ଛେଚିବା
brush: ଓଳାଇବା ଖରକିବା ଝାଡିବା ଝାଡୁମାରିବା
brush_aside: ରଦ୍ଦ_କରିବା ରଦ୍ଦ_କରି_ଦେବା ଖାରିଜ_କରିବା|
brush_off: ରଦ୍ଦ_କରିବା ରଦ୍ଦ_କରି_ଦେବା ଖାରିଜ_କରିବା|
bubble: ଟକଟକ_ହେବା ଟକମକ_ହେବା ହେଉଡି
buckle_under: ଅଧୀନ_ହେବା ଅନୁଗତ_ହେବା
bud: ପଲ୍ଲବିତହେବା|
budge: ହଲିବା ହଟିବା
bug: ଚିଡାଇବା ହାସ୍ୟ_ରସ_କରିବା
bug_out: ଫୁଲିଯାଇଛି
build: ଉଠିବା ତିଆରି_ହେବା| ଗଢାଇବା ତିଆରି_କରାଇବା ନିର୍ମାଣ_କରାଇବା ସୁସ୍ଥ_ହେବା ସବଳ_ହେବା
bulge: ଫୁଲିଯାଇଛି
bulge_out: ଫୁଲିଯାଇଛି
bully: ଧମକେଇବା ଦମକଦେବା ଡରେଇବା
bumble: ଥଙ୍ଗେଇବା ଅଟକିବା|
bump: ବାଡେଇବା ଧକ୍କାଦେବା
bump_off: ମରିବା ହତ୍ୟାକରିବା ଜୀବନନେବା ଶେଷକରିବା ଖଲାସକରିବା
bunch: ଗୋଲ_କରିବା ଗୋଟଳା_ତିଆରି_କରିବା|
bunch_up: ଗୋଲ_କରିବା ଗୋଟଳା_ତିଆରି_କରିବା|
bunco: ଠକିବା
bundle: ଗୋଲ_କରିବା ଗୋଟଳା_ତିଆରି_କରିବା|
bunk: ପଳେଇଯିବା|
bunk_off: ଛୁଟିରେ_ରହିବା ଛୁଟିନେବା ଅନୁପସ୍ଥିତ_ହେବା
burden: ଭାରି_ହେବା ଦାୟିତ୍ବଦେବା ଲଦିବା|
burgeon_forth: ଅଙ୍କୁର_ବାହାରିବା ଅଙ୍କୁରିତ_ହେବା ଗଜେଇବା ଗଜା_ବାହାରିବା
burn: ପୋଡିବା ଜଳିବା ଜଳିବା ସେକକରିବା ଚେଙ୍ଗିବା| ଟାଇଁଟାଇଁ_ଖରା_ମାରିବା ଟାଣଖରା_ହେବା ନିଆ_ଲାଗିବା ନିଆଁ_ଜଳିବା ଅଗ୍ନିକାଣ୍ଡ_ହେବା
burp: ହେଉଡି
burst: ଉଦ୍ଗିରଣ_ହେବା ଫୁଟିବା ଫାଟିବା
burst_out: ଫାଟିଯିବା ବିନ୍ଧିବା ଫାଟିବା|
burthen: ଭାରି_ହେବା
bury: ପୋତିଦେବା
bushel: ମରାମତି_କରିବା ସଜାଡିବା ଠିକ_କରିବା
bushwhack: ଗୁପ୍ତ_ଆକ୍ରମଣପାଇଁ_ରହିବା
buss: ଚୁମା ଚୁମ୍ବନ
bust: ଚିରିବା ବିଦାରିବା ଫାଡିବା ଫୁଟିବା ଭଗ୍ନ_ହେବା
busy: ଲାଗିବା ଜୁଟିବା କାର୍ଯ୍ୟରତ_ରହିବା କାର୍ଯ୍ୟବ୍ୟସ୍ତରହିବା
butt: ଅବସ୍ଥିତ_ହେବା ସ୍ଥିତ_ହେବା ଅବସ୍ଥାନ_କରିବା
butt_against: ଅବସ୍ଥିତ_ହେବା ସ୍ଥିତ_ହେବା ଅବସ୍ଥାନ_କରିବା
butt_on: ଅବସ୍ଥିତ_ହେବା ସ୍ଥିତ_ହେବା ଅବସ୍ଥାନ_କରିବା
butterfly: ଛଇ ଚତୁରୀ ଛୋପରି|
buy: ଲାଞ୍ଚଦେବା ତେଲେଇବା ଉତ୍କୋଚଦେବା
buy_the_farm: ମରିବା ପରଲୋକ_ଗମନ_କରିବା ପ୍ରାଣଛାଡିଯିବା ପ୍ରାଣବାୟୁ_ଉଡିଯିବା ମହା_ନିର୍ବାଣ_ପ୍ରାପ୍ତ_ହେବା ସ୍ୱର୍ଗପ୍ରାପ୍ତି_ହେବା
buzz: ଗୁଞ୍ଜରଣ_କରିବା ଗୁଣୁଗୁଣୁ_କରିବା
ca-ca: ଝାଡା_ଫେରିବା ଝାଡାଯିବା ହଗିବା ମଳତ୍ୟାଗ_କରିବା ପାଇଖାନା_ଯିବା
cajole: ବହଲାଇବା ଆହ୍ଲାଦିତ_କରିବା ପ୍ରବୋଧିତ_କରିବା
call: ନାମଦେବା ନାମିତ_କରିବା ନାମ_ରଖିବା ନାମକରଣ_କରିବା ଚିଲ୍ଲାଇବା ରଡି_କରିବା ଚିତ୍କାର_କରିବା ଗର୍ଜନ_କରିବା କହିବା ବୋଲିବା
call_back: ମନେ_ପଡିବା ସ୍ମରଣ_ହେବା
call_down: ଧିକ୍କାରିବା ଗାଳିଦେବା ଅପମାନ_କରିବା ତିରସ୍କାର_କରିବା
call_for: ମାଗିବା ଚାହିଦା_ରହିବା ନିମନ୍ତ୍ରଣ_କରିବା ଆମନ୍ତ୍ରଣ_କରିବା ଡାକିବା ନିମନ୍ତ୍ରିତ_କରିବା
call_on_the_carpet: ଧିକ୍କାରିବା ଗାଳିଦେବା ଅପମାନ_କରିବା ତିରସ୍କାର_କରିବା
call_out: ଚିତ୍କାର_କରାଇବା ଡାକିବା
call_up: ମନେ_ପଡିବା ସ୍ମରଣ_ହେବା
calm: କମାଇଦେବା ହ୍ରାସକରିବା ଥଣ୍ଡାକରିବା ଶାନ୍ତକରିବା ନିର୍ବାପିତକରିବା ଆପଣେଇ_ନେବା
calm_down: ଆପଣେଇ_ନେବା କମାଇଦେବା ହ୍ରାସକରିବା ଥଣ୍ଡାକରିବା ଶାନ୍ତକରିବା ନିର୍ବାପିତକରିବା
calumniate: ଚୁଗୁଲି_କରିବା ଫୋଡିବା|
camouflage: ଛଦ୍ମବେଶରେ_ଲୁଚାଇବା ରୂପ_ବଦଳାଇବା ଛଦ୍ମବେଶ_ଧାରଣ_କରିବା
campaign: ଲଢେଇ_କରିବା ଲଢିବା ସଂଗ୍ରାମ_କରିବା ଆନ୍ଦୋଳନ_କରିବା
can: ବାହାରକରିଦେବା
captivate: ମୋହିତ_କରିବା ମୋହେଇବା ସମ୍ମୋହନ_କରିବା|
capture: ମୋହିତ_କରିବା ମୋହେଇବା ସମ୍ମୋହନ_କରିବା| ଧରି_ପକାଇବା ଗିରଫ_କରିବା
card: ଭିଣିବା|
care: ଇଚ୍ଛା_ହେବା ଚାହିଁବା ମନ_ହେବା ଅଭିଳାଷ_କରିବା ସମ୍ଭାଳିହେବା| ଚିନ୍ତା_ହେବା
careen: ଟଳଟଳ_ହେବା ଟଳମଳ_ହେବା|
cark: ବ୍ୟାକୁଳ_ହେବା ଅଶାନ୍ତ_ହେବା
carry: ବୋହିନେବା ବୋହିବା ଭାବବ୍ୟକ୍ତକରିବା ଭାବପ୍ରକଟକରିବା ଭାବବ୍ୟକ୍ତିକରିବା ବୋଝବୋହିବା ରହିବା|
carry_on: ବଜାୟ_ରଖିବା ଜୀବିତ_ରଖିବା ସଜୀବ_ରଖିବା ବଞ୍ଚେଇ_ରଖିବା ରକ୍ଷାକରିବା ସୁରକ୍ଷିତ_ରଖିବା
carry_through: ମୁକ୍ତ_କରିବା ମୁକ୍ତି_ପାଇବା ଉଦ୍ଧାର_କରିବା ଉଦ୍ଧାର_ପାଇବା ନିସ୍ତାର_ପାଇବା
carve: ଖୋଦେଇକରିବା ଖୋଦନକରିବା ଖୋଳିବା
carve_up: ଅଧା_କରିବା ଅଧା_ଅଧା_ବାଣ୍ଟିବା
cash: ଚେକ_ଭଙ୍ଗାଇବା
cash_in: ଚେକ_ଭଙ୍ଗାଇବା
cash_in_one's_chips: ମରିବା ପରଲୋକ_ଗମନ_କରିବା ପ୍ରାଣଛାଡିଯିବା ପ୍ରାଣବାୟୁ_ଉଡିଯିବା ମହା_ନିର୍ବାଣ_ପ୍ରାପ୍ତ_ହେବା ସ୍ୱର୍ଗପ୍ରାପ୍ତି_ହେବା
cast: ଏଣେତେଣେ_ବୁଲିବା ଇତସ୍ତତଃ_ଭ୍ରମଣ_କରିବା ଢାଳିବା ଥୁକିବା ଛେପପକାଇବା
cast_aside: ପକେଇବା ଫୋପାଡିବା
cast_away: ପକେଇବା ଫୋପାଡିବା
cast_down: ହତୋତ୍ସାହିତ_ହେବା|
cast_out: ପକେଇବା ଫୋପାଡିବା
castrate: ଖାସୁ_କରିବା ଧରିବା
cat: ଥୁକିବା ଛେପପକାଇବା
catch: ଧରିବା ଧରି_ପକାଇବା ଗିରଫ_କରିବା ଧରିବା ଦେଖିବା ଦର୍ଶନ_କରିବା ମୋହିତ_କରିବା ମୋହେଇବା ସମ୍ମୋହନ_କରିବା|
catch_fire: ଜଳିବା ଦଗ୍ଦହେବା
catch_one's_breath: ବିଶ୍ରାମକରିବା ଆରାମ_କରିବା ଥକ୍କାମାରିବା
catch_some_z's: ଶୋଇବା ନିଦ୍ରାଯିବା
catch_up: ଧରିପକେଇବା
cause: କାରଣ_ହେବା ହେତୁହେବା ନିମିତ୍ତହେବା
cauterise: ସେକକରିବା ଚେଙ୍ଗିବା|
cauterize: ସେକକରିବା ଚେଙ୍ଗିବା|
cave_in: ଭୁଷୁଡି_ପଡିବା ଗଳିପଡିବା ଟଳିପଡିବା |
cavort: ଡିଆଁଡେଇଁ_କରିବା ଡିଆଁକୁଦା_କରିବା ଖେଳକୁଦ_କରିବା ଘୋ-ଘା_କରିବା
cease: ଛାଡିଦେବା ଛୁଟିହେବା ସମାପ୍ତ_ହେବା|
cede: ହାର_ମାନିବା ଅସ୍ତ୍ରସମର୍ପଣ_କରିବା ନଇଁବା ଦାୟିତ୍ବ_ଦେବା ନ୍ୟସ୍ତ_କରିବା ଜିମା_କରିବା
celebrate: ଉତ୍ସବ_ପାଳନ ପାଳନ_କରିବା
center: ଧ୍ୟାନ_କେନ୍ଦ୍ରୀଭୂତ_କରିବା ଧ୍ୟାନ_ଦେବା ଧ୍ୟାନ_ଏକାଗ୍ର_କରିବା
centre: ଧ୍ୟାନ_କେନ୍ଦ୍ରୀଭୂତ_କରିବା ଧ୍ୟାନ_ଦେବା ଧ୍ୟାନ_ଏକାଗ୍ର_କରିବା
cerebrate: ଚିନ୍ତାକରିବା ଭାବିବା ବିଚାରକରିବା ଅନ୍ବେଷଣ_କରିବା ଅନୁସନ୍ଧାନ_କରିବା
chafe: ଚିଡିବା ଚିଡିଚିଡି_ହେବା
chaffer: ଆଲୋଚନା କଥାବାର୍ତ୍ତା ବାର୍ତ୍ତାଳାପ କଥା_
challenge: ଆହ୍ବାନ_ଦେବା
change: କରିବା ବଦଳାଇବା ପରିବର୍ତ୍ତନ_କରିବା ପରିବର୍ତ୍ତନ ପରିବର୍ତ୍ତନ_ହେବା ବଦଳେଇବା ପରିବର୍ତ୍ତନ_ଆଣିବା ବଦଳିଯିବା ବଦଳେଇବା ଫେରେଇବା ଫେରସ୍ତ_କରିବା ବଦଳାଇବା
change_by_reversal: ଓଲଟି_ଯିବା
change_state: ମୋଡିବା ମୋଡିଦେବା_
chap: ଫାଟିବା ବିଦୀର୍ଣ୍ଣ_ହେବା
characterise: ବିଶେଷତା_ହେବା
characterize: ବିଶେଷତା_ହେବା
charge: ଟିହାଇବା ଉସକେଇବା ଚିଡେଇବା ଉତ୍ତେଜିତକରିବା| ଦାୟିତ୍ବଦେବା ଲଦିବା| ଲଦିବା ଲଦିଦେବା ଠେଲିବା ଥୋପିବା|
charge_up: ଟିହାଇବା ଉସକେଇବା ଚିଡେଇବା ଉତ୍ତେଜିତକରିବା|
charm: ମୋହିତ_କରିବା ମୋହେଇବା ସମ୍ମୋହନ_କରିବା|
charter: ଭଡାରେ_ନେବା ଭଡା_କରିବା ଭଡା_ନେବା|
chase: ଦୌଡେଇବା
chase_after: ଦୌଡେଇବା
chase_away: ହଟେଦେବା ଭଗେଇଦେବା ତଡିଦେବା
chat: ଆଲୋଚନା କଥାବାର୍ତ୍ତା ବାର୍ତ୍ତାଳାପ କଥା_
chat_up: ଛଇ ଚତୁରୀ ଛୋପରି|
chatter: ଦାନ୍ତ_କଟକଟ_କରିବା ଦାନ୍ତଚାଉଳଚୋବେଇବା| ଆଲୋଚନା କଥାବାର୍ତ୍ତା ବାର୍ତ୍ତାଳାପ କଥା_ ଅଯଥା_କଥା_କହିବା ବକ୍‌ବକ୍‌_କରିବା ବକ୍‌_ବକ୍‌_ହେବା
cheat: ଠକେଇଯିବା ଧୋକାଖାଇବା|
check: ସମ୍ଭାଳିବା ଆୟତ୍ତ_କରିବା ସଂଯତ_କରିବା ସହିବା ସ୍ଥିର_ରହିବା ଯାଞ୍ଚ୍_କରିବା ଚଡକିଯିବା ଚଡକରିଫାଟିଯିବା
check_out: ଯାଞ୍ଚ୍_କରିବା
cheep: କଳରବ_କରିବା
cheer: ଖୁସି_ହେବା ଆନନ୍ଦିତ_ହେବା ପ୍ରସନ୍ନ_ହେବା ସନ୍ତୁଷ୍ଟ_ହେବା ପ୍ରଫୁଲ୍ଲ_ହେବା
cheer_up: ଖୁସି_ହେବା ଆନନ୍ଦିତ_ହେବା ପ୍ରସନ୍ନ_ହେବା ସନ୍ତୁଷ୍ଟ_ହେବା ପ୍ରଫୁଲ୍ଲ_ହେବା
chevvy: ହଇରାଣ_କରିବା ପୀଡିତ_କରିବା|
chevy: ହଇରାଣ_କରିବା ପୀଡିତ_କରିବା|
chew: କାମୁଡିବା ଚୋବାଇବା ଦବାଇବା
chew_out: ଧିକ୍କାରିବା ଗାଳିଦେବା ଅପମାନ_କରିବା ତିରସ୍କାର_କରିବା
chew_the_fat: ଆଲୋଚନା କଥାବାର୍ତ୍ତା ବାର୍ତ୍ତାଳାପ କଥା_
chew_up: ଧିକ୍କାରିବା ଗାଳିଦେବା ଅପମାନ_କରିବା ତିରସ୍କାର_କରିବା
chide: ଧିକ୍କାରିବା ଗାଳିଦେବା ଅପମାନ_କରିବା ତିରସ୍କାର_କରିବା
chill: ଥଣ୍ଡା_ହେବା
chill_out: ଆପଣେଇ_ନେବା
chink: ଟଣଟଣ_କରିବା ଠଣଠଣ_କରିବା
chip: ତୋଳିବା
chirk_up: ଖୁସି_ହେବା ଆନନ୍ଦିତ_ହେବା ପ୍ରସନ୍ନ_ହେବା ସନ୍ତୁଷ୍ଟ_ହେବା ପ୍ରଫୁଲ୍ଲ_ହେବା
chirp: କଳରବ_କରିବା
chirrup: କଳରବ_କରିବା
chisel: ଠକେଇଯିବା ଧୋକାଖାଇବା|
chitchat: ଆଲୋଚନା କଥାବାର୍ତ୍ତା ବାର୍ତ୍ତାଳାପ କଥା_
chitter: କୁରୁଳିବା
chivvy: ହଇରାଣ_କରିବା ପୀଡିତ_କରିବା|
chivy: ହଇରାଣ_କରିବା ପୀଡିତ_କରିବା|
choke: ଅବରୁଦ୍ଧହେବା ବାଧାପଡିବା ଅଟକିଯିବା ବନ୍ଦହେବା ଫସିଯିବା ମରିବା ପରଲୋକ_ଗମନ_କରିବା ପ୍ରାଣଛାଡିଯିବା ପ୍ରାଣବାୟୁ_ଉଡିଯିବା ମହା_ନିର୍ବାଣ_ପ୍ରାପ୍ତ_ହେବା ସ୍ୱର୍ଗପ୍ରାପ୍ତି_ହେବା
choke_off: ଅବରୁଦ୍ଧହେବା ବାଧାପଡିବା ଅଟକିଯିବା ବନ୍ଦହେବା ଫସିଯିବା
choose: ବାଛିବା ଅଲଗା_କରିବା
chop_off: କାଟିବା
chuck: ଥୁକିବା ଛେପପକାଇବା
chuck_out: ପକେଇବା ଫୋପାଡିବା ବାହାର_କରିଦେବା
churn: ମନ୍ଥିବା ଘଷିବା ଘୋଳିବା
circle: ଚକ୍କର_ମାରିବା ଚକ୍କର_କାଟିବା
circulate: ପ୍ରଘଟ_କରିବ|
circumscribe: ନିଷେଧ_କରିବା ମନା_କରିବା ବାରଣ_କରିବା ପ୍ରତିବନ୍ଧକ_ଲଗାଇବା
circumvent: କଥା_ଟାଳିବା ଟାଳିବା
cite: ଉଲ୍ଲେଖ_କରିବା ରଚନା_କରିବା ପ୍ରସଙ୍ଗ_କରିବା ଚର୍ଚ୍ଚା_କରିବା|
clack: ଅଯଥା_କଥା_କହିବା ବକ୍‌ବକ୍‌_କରିବା ବକ୍‌_ବକ୍‌_ହେବା
clapperclaw: ଗାଳି_ଦେବା ଖରାପ_ଶବ୍ଦ_କହିବା ବକିବା
claver: ଆଲୋଚନା କଥାବାର୍ତ୍ତା ବାର୍ତ୍ତାଳାପ କଥା_
claw: ନଖେଇବା
clean: ଛଡାଇବା ସଫାକରିବା| ଫୋପାଡିଦେବା ତ୍ୟାଗକରିବା ବର୍ଜନକରିବା
clean_up: ସଜାଡିବା ସୁବ୍ୟବସ୍ଥିତ_କରିବା
clear: ପରିଷ୍କାର_କରିବା ସଫା_କରିବା ନିର୍ମଳ_କରିବା ସ୍ବଚ୍ଛ_କରିବା ସୁଧ_ମିଳିବା ସୁଧ_ପ୍ରାପ୍ତିହେବା ସୁଧ_ଉପାର୍ଜନ_ହେବା ସୁଧ_ଲାଭକରିବା ସୁଧ_ପାଇବା ସୁଧପ୍ରାପ୍ତି_କରିବା ଅପରାଧ_ମୁକ୍ତ_କରିବା ଦୋଷ_ମୁକ୍ତ_କରିବା ଛାଡିଦେବା
cleave: ଜାବୁଡି_ଧରିବା ମିଶିଯିବା ଲାଗିବା ଯୋଡିହେବା
clench: ବାନ୍ଧିବା
click: ଦାନ୍ତ_କଟକଟ_କରିବା ଦାନ୍ତଚାଉଳଚୋବେଇବା|
climb_down: ଓହ୍ଲେଇବା ଅବତରଣକରିବା
climb_on: ଚଢିବା ବସିବା ଆରୋହଣ_କରିବା ଅବସ୍ଥାନ_କରିବା ଆସୀନ_ହେବା
climb_up: ଉଠିବା
clinch: ବାନ୍ଧିବା
cling: ଜାବୁଡି_ଧରିବା ମିଶିଯିବା ଲାଗିବା ଯୋଡିହେବା
clink: ଟଣଟଣ_କରିବା ଠଣଠଣ_କରିବା
clip: ଛୋଟ_କରିବା
clobber: କୁଟିବା ମାଡ_ଦେବା
clock: ସମୟାବଧି_ମାପିବା ସମୟ_ମାପିବା କାଳ_ମାପିବା
clog: ଅବରୁଦ୍ଧହେବା ବାଧାପଡିବା ଅଟକିଯିବା ବନ୍ଦହେବା ଫସିଯିବା
clog_up: ଅବରୁଦ୍ଧହେବା ବାଧାପଡିବା ଅଟକିଯିବା ବନ୍ଦହେବା ଫସିଯିବା
close: ବନ୍ଦ_କରିବା ଛୁଟି_କରିବା ଆବଦ୍ଧ_କରିବା ବୁଜିବା ମୁଦିବା ବନ୍ଦ_କରିବା ସରିଯିବା ସମାପ୍ତ_ହେବା|
close_down: ବନ୍ଦ_କରିବା ଛୁଟି_କରିବା ଆବଦ୍ଧ_କରିବା
close_up: ବନ୍ଦ_କରିବା ଛୁଟି_କରିବା ଆବଦ୍ଧ_କରିବା ରଖିବା ରୋକିବା ଅଟକାଇବା
clothe: ପିନ୍ଧାଇବା|
clump: ଗୋଲ_କରିବା ଗୋଟଳା_ତିଆରି_କରିବା|
cluster: ଗୋଲ_କରିବା ଗୋଟଳା_ତିଆରି_କରିବା|
coalesce: ମିଶିବା|
coax: ବହଲାଇବା ଆହ୍ଲାଦିତ_କରିବା ପ୍ରବୋଧିତ_କରିବା
cock: ଫୁଟାଣି_ମାରିବା ଗର୍ବରେ_ଟହଲମାରିବା
cockle: ମକଚିବା ଦଳିବା
cod: ବିରକ୍ତ_କରିବା ଚିଡେଇବା ରଗାଇବା କଷ୍ଟ_ଦେବା
coggle: ଚାଳନକରିବା|
cogitate: ଚିନ୍ତାକରିବା ଭାବିବା ବିଚାରକରିବା ଅନ୍ବେଷଣ_କରିବା ଅନୁସନ୍ଧାନ_କରିବା
cognise: ଜାଣିବା ଜ୍ଞାନ_ହେବା ପରିଚିତ_ହେବା ଅଭିଜ୍ଞ_ହେବା
cognize: ଜାଣିବା ଜ୍ଞାନ_ହେବା ପରିଚିତ_ହେବା ଅଭିଜ୍ଞ_ହେବା
cohere: ଜାବୁଡି_ଧରିବା ମିଶିଯିବା ଲାଗିବା ଯୋଡିହେବା
coincide: ଏକସଙ୍ଗେ_ହେବା ଏକସଙ୍ଗେ_ଘଟିବା ଏକସାଥିରେ_ହେବା ଏକ_ସମୟରେ_ହେବା
collapse: ଭୁଷୁଡି_ପଡିବା ଗଳିପଡିବା ଟଳିପଡିବା |
collar: ବନ୍ଦୀ_ବରିବା କଏଦୀ_କରିବା ବ୍ରପ୍ତାର_କରିବା ଧରିବା|
collect: ସଞ୍ଚୟ_କରିବା ସଂଗ୍ରହ_କରିବା ଏକାଠି_କରିବା ଏକତ୍ରିତ_କରିବା ଏକାଠିକରିବା ମେଣ୍ଡେଇବା ଗଦେଇବା|
collide_with: ଧକକା_ହେବା ବାଡେଇହେବା
colly: ଗୋଳିଆ_କରିବା ମଇଳା_କରିବା ଅପରିଷ୍କାର_କରିବା
color: ରଙ୍ଗାଇବା ରଙ୍ଗେଇବା ରଙ୍ଗ_କରିବା|
color_in: ରଙ୍ଗାଇବା ରଙ୍ଗେଇବା
colorise: ରଙ୍ଗାଇବା ରଙ୍ଗେଇବା
colorize: ରଙ୍ଗାଇବା ରଙ୍ଗେଇବା
colour: ରଙ୍ଗ_କରିବା| ରଙ୍ଗାଇବା ରଙ୍ଗେଇବା
colour_in: ରଙ୍ଗାଇବା ରଙ୍ଗେଇବା
colourise: ରଙ୍ଗାଇବା ରଙ୍ଗେଇବା
colourize: ରଙ୍ଗାଇବା ରଙ୍ଗେଇବା
combine: ମିଶିବା ମିଳିବା ଭେଟିବା ଏକହେବା ଏକାଠି_ହେବା ଏକତ୍ରିତ_ହେବା ସଂଘବଦ୍ଧ_ହେବା ମିଶିବା|
combust: ଜଳିବା ଦଗ୍ଦହେବା
come: ଲାଗିବା| ଆସିବା ରହିବା ପହଞ୍ଚିବା ମିଳିବା ଦୃଷ୍ଟିଗୋଚର_ହେବା
come_about: ଠିକ_ଘଟିବା ପ୍ରମାଣିତ_ହେବା
come_alive: ଉଠିବା ଜାଗିବା ଆଖି_ଖୋଲିବା ଶୋଇକି_ଉଠିବା
come_along: ଉନ୍ନତି_କରିବା ଉନ୍ନତ_ହେବା ବିକାଶ_କରିବା ବଢିବା|
come_apart: ଫାଟିବା|
come_back: ଫେରିବା ଆସିବା ଲେଉଟିବା
come_forth: ବାହାରିବା ନିର୍ଗମ_ହେବା
come_in: ପ୍ରବେଶ_କରିବା ପଶିବା ଭିତରକୁ_ଆସିବା ଉପସ୍ଥିତ_ହେବା ଆସିବା| ପହଞ୍ଚିବା ମିଳିବା ମିଳିବା ପାଇବା ପ୍ରାପ୍ତହେବା
come_on: ଆସିବା ଧରିବା| ଉନ୍ନତି_କରିବା ଉନ୍ନତ_ହେବା ବିକାଶ_କରିବା ବଢିବା|
come_out: ଆସିବା ଧରିବା| ବାହାରିବା ନିର୍ଗମ_ହେବା ଝଡିବା ଖସିବା ମିଳିବା ପାଇବା ପ୍ରାପ୍ତହେବା ଫୁଲିଯାଇଛି
come_through: ବଞ୍ଚିବା ରକ୍ଷାପାଇବା
come_to_mind: ଉଠିବା ଉଇଁଲା ଉଙ୍କିମାରିବା|
come_up: ଭାସିବା| ଉଠିବା ପଡିବା ଆସିବା| ଉଠିବା ଉଇଁବା ଉଦୟ_ହେବା|
comfort: ସାନ୍ତ୍ବନା_ଦେବା ବୁଝାଇବା
commence: ଉଠାଇବା ଆରମ୍ଭ_କରିବା ବାହାର_କରିବା ଉଠାଇବା ଆରମ୍ଭ_କରିବା
commingle: ମିଶିବା|
comminute: ଚୂରିବା ଚୂନାକରିବା ପେଷିବା ଗୁଣ୍ଡକରିବା ଚୂର୍ଣ୍ଣକରିବା
commit: ସମର୍ପିତ_କରିବା| ଲଗାଇବା ଖଟାଇବା ନିବେଶ_କରିବା
commove: ଟିହାଇବା ଉସକେଇବା ଚିଡେଇବା ଉତ୍ତେଜିତକରିବା| ହଲେଇବା ଦୋହଲେଇବା
commute: ବଦଳେଇବା ଫେରେଇବା ଫେରସ୍ତ_କରିବା
compass: ବୁଝେଇବା ଧରିବା
compensate: କ୍ଷତିପୂରଣ_କରିବା
compete: ପ୍ରତିଯୋଗିତା_କରିବା ପ୍ରତିଦ୍ବନ୍ଦିତା_କରିବା ପ୍ରତିସ୍ପର୍ଦ୍ଧା_କରିବା
compile: ସଞ୍ଚୟ_କରିବା ସଂଗ୍ରହ_କରିବା ଏକାଠି_କରିବା ଏକତ୍ରିତ_କରିବା
complement: ସଂପୂର୍ଣ୍ଣ_କରିବା ଉତ୍ତମ_କରିବା ପୂରା_କରିବା ଭଲରୂପେ_କରିବା ଉତ୍କୃଷ୍ଟ_କରିବା
complete: ସମାପ୍ତ_ହେବା ଶେଷ_ହେବା ସରିବା ହୋଇସାରିବା
compose: ସଂଗୀତ_ରଚନା_କରିବା ଲେଖିବା ରଚନା_କରିବା
comprehend: ବୁଝେଇବା ଧରିବା
comprise: ତିଆରିହେବା ପ୍ରସ୍ତୁତହେବା
con: ଠକିବା
conceal: ଲୁଚେଇବା
concede: ହାର_ମାନିବା ଅସ୍ତ୍ରସମର୍ପଣ_କରିବା ନଇଁବା
conceive: ବୁଝିବା
conceive_of: କଳ୍ପନା_କରିବା ମାନିବା ଭାବିବା ଗ୍ରହଣ_କରିବା
concentrate: ଧ୍ୟାନ_କେନ୍ଦ୍ରୀଭୂତ_କରିବା ଧ୍ୟାନ_ଦେବା ଧ୍ୟାନ_ଏକାଗ୍ର_କରିବା ବହଳିଆ_କରିବା ଗାଢା_କରିବା
concern: ଚିନ୍ତାଲାଗିବା|
conciliate: ମନାଇବା ପ୍ରସନ୍ନ_କରେଇବା
conclude: ସମାଧାନ_ହେବା ସମାଧାନ_କରିବା ନିର୍ଣ୍ଣିତ_ହେବା ମୀମାଂସିତ_ହେବା ସରିଯିବା ସମାପ୍ତ_ହେବା|
concur: ଏକସଙ୍ଗେ_ହେବା ଏକସଙ୍ଗେ_ଘଟିବା ଏକସାଥିରେ_ହେବା ଏକ_ସମୟରେ_ହେବା
confab: ଆଲୋଚନା କଥାବାର୍ତ୍ତା ବାର୍ତ୍ତାଳାପ କଥା_
confabulate: ଆଲୋଚନା କଥାବାର୍ତ୍ତା ବାର୍ତ୍ତାଳାପ କଥା_
confine: ନିଷେଧ_କରିବା ମନା_କରିବା ବାରଣ_କରିବା ପ୍ରତିବନ୍ଧକ_ଲଗାଇବା
conflagrate: ଜଳିବା ଦଗ୍ଦହେବା
conflate: ମିଶିବା|
conform: ସପକ୍ଷ_ହେବା ଅନୁକୁଳ_ହେବା
confound: ଭ୍ରମିତ_ହେବା ଭ୍ରମ_ହେବା ଅକଲ_ଗୁଡୁମ_ହେବା|
confront: ମୁକାବଲାକରିବା ଟକରଦେବା ମୁଁହାମୁଁହିହେବା| ପ୍ରସ୍ତୁତ_କରିବା|
confuse: ଭ୍ରମିତ_ହେବା ଭ୍ରମ_ହେବା ଅକଲ_ଗୁଡୁମ_ହେବା|
congest: ଅବରୁଦ୍ଧହେବା ବାଧାପଡିବା ଅଟକିଯିବା ବନ୍ଦହେବା ଫସିଯିବା
conglomerate: ରୁଣ୍ଡହେବା ଏକାଠି_ହେବା ଏକତ୍ରିତ_ହେବା ଜମିବା
conjoin: ମିଶିବା| ବିବାହ_କରିବା ବାହାହେବା ପାଣିଗ୍ରହଣ_କରିବା
conjure: ନିବେଦନ_କରିବା ବିନତି_କରିବା ବିନୟ_କରିବା ପ୍ରାର୍ଥନା_କରିବା ଅନୁନୟ_କରିବା ଅନୁରୋଧ_କରିବା
conk: ମରିବା ପରଲୋକ_ଗମନ_କରିବା ପ୍ରାଣଛାଡିଯିବା ପ୍ରାଣବାୟୁ_ଉଡିଯିବା ମହା_ନିର୍ବାଣ_ପ୍ରାପ୍ତ_ହେବା ସ୍ୱର୍ଗପ୍ରାପ୍ତି_ହେବା
connect: ଜୋଡିବା ଲଗାଇବା ମିଶାଇବା_| ଯୋଡିହେବା ଲଗେଇବା ସଂଯୁକ୍ତ_କରିବା ସଂଲଗ୍ନ_କରିବା ଯୋଡିବା
conquer: ହରେଇବା ହାଲିଆ_କରିଦେବା|
consecrate: ସମର୍ପିତ_କରିବା| ମାନସିକ_କରିବା ଯାଚିବା ଯାଚଜ୍ଞା_କରିବା ଅଭିମନ୍ତ୍ରଣ_କରିବା
conserve: ସମ୍ଭାଳିବା ସୁରକ୍ଷିତ_ରଖିବା
consider: ନେବା ବୁଝିବା ମାନିବା ସ୍ନେହ_କରିବା ଆଦର_କରିବା
consist: ତିଆରିହେବା ପ୍ରସ୍ତୁତହେବା
console: ସାନ୍ତ୍ବନା_ଦେବା ବୁଝାଇବା
constitute: ସ୍ଥାପନ_କରିବା ଅଧିଷ୍ଠିତ_କରିବା|
construct: ଉଠିବା ତିଆରି_ହେବା|
consume: ଗିଳିବା ଗେଫିବା ଗ୍ରାସକରିବା ବ୍ୟୟକରିବା ଖର୍ଚ୍ଚ_କରିବା| ଲାଗିବା ଖର୍ଚ୍ଚହେବା
contact: ଛୁଆଁଇବା ଛୁଏଁଇବା ସ୍ପର୍ଶ_କରେଇବା
contain: ରହିବା| ସମ୍ଭାଳିବା ଆୟତ୍ତ_କରିବା ସଂଯତ_କରିବା ସହିବା ସ୍ଥିର_ରହିବା ଭର୍ତ୍ତିକରିବା ଭରିବା ପୂରେଇବା
contend: ଯୁକ୍ତିତର୍କକରିବା ବିତଣ୍ଡାକରିବା ବିବାଦକରିବା ପ୍ରତିଯୋଗିତା_କରିବା ପ୍ରତିଦ୍ବନ୍ଦିତା_କରିବା ପ୍ରତିସ୍ପର୍ଦ୍ଧା_କରିବା ପ୍ରତିଦ୍ବନ୍ଦିତା_କରିବା ଲଢିବା_
continue: ଚାଲିବାକୁ_ଦେବା ଚଲାଇବା ପରିଚାଳିତ_କରିବା ଚାଲୁରହିବା ଜାରି_ରଖିବା ବଜାୟ_ରଖିବା ଜୀବିତ_ରଖିବା ସଜୀବ_ରଖିବା ବଞ୍ଚେଇ_ରଖିବା ରକ୍ଷାକରିବା ସୁରକ୍ଷିତ_ରଖିବା ଚାଲିବା ବଢିବା ମାଡିବା| ରୋକିଯିବା ଅଟକି_ଯିବା ରହିଯିବା
contract: କୁଞ୍ଚିତ_ହେବା ଛୋଟ_ହେବା
contrive: ଆବିଷ୍କାର_କରିବା ଉଦ୍ଭାବନ_କରିବା ବାହାର_କରିବା ଖୋଜି_ବାହାର_କରିବା
control: ସମ୍ଭାଳିବା ଆୟତ୍ତ_କରିବା ସଂଯତ_କରିବା ସହିବା ସ୍ଥିର_ରହିବା
convert: ପରିବର୍ତ୍ତନ_କରିବା ବଦଳେଇବା ବଦଳେଇବା ଫେରେଇବା ଫେରସ୍ତ_କରିବା ବୁଝାଇବା
convey: ଭାବବ୍ୟକ୍ତକରିବା ଭାବପ୍ରକଟକରିବା ଭାବବ୍ୟକ୍ତିକରିବା ଆଣିବା ନେଇଆସିବା
convince: ବୁଝାଇବା
cook: ରାନ୍ଧିବା ରୋଷେଇ_କରିବା ଖାଦ୍ୟ_ତିଆରି_କରିବା ଖାଦ୍ୟ_ରାନ୍ଧିବା
cool: ଥଣ୍ଡା_ହେବା
cool_down: ଥଣ୍ଡା_ହେବା
cool_it: ଆପଣେଇ_ନେବା
cool_off: ଆପଣେଇ_ନେବା
coordinate: ସଜାଇବା ବ୍ୟବସ୍ଥିତ_କରିବା
cop: ଚୋରେଇବା ଅପହରଣ_କରିବା ହାତ_ମାରିବା ବନ୍ଦୀ_ବରିବା କଏଦୀ_କରିବା ବ୍ରପ୍ତାର_କରିବା ଧରିବା|
copulate: ଯୋଡି_ଲାଗିବା ବିହାର_କରିବା କ୍ରୀଡା_କରିବା
copy: କପି_କରିବା ଟିପିବା ଅନୁକରଣ_କରିବା ନକଲ୍_କରିବା ନକଲକରିବା ପ୍ରତିରୂପକରିବା ଉତାରିବା
coquet: ଛଇ ଚତୁରୀ ଛୋପରି|
coquette: ଛଇ ଚତୁରୀ ଛୋପରି|
correct: ଚଢାଇବା|
correspond: ସମାନ_ହେବା ସମତୁଲ୍ୟ_ହେବା|
corrupt: ଖରାପ_କରିବା ବିଗାଡିବା ଲାଞ୍ଚଦେବା ତେଲେଇବା ଉତ୍କୋଚଦେବା
cost: ପଡିଲା| ପଡିବା|
costume: ପୋଷାକରେ_ସୁସଜ୍ଜିତ_କରିବା ବେଶ_କରାଇବା କଷ୍ଟ୍ୟୁମ୍_କରିବା
cough: ଖାସିବା
cough_out: ଖଙ୍କାରିବା|
cough_up: ଖଙ୍କାରିବା|
counsel: ପରାମର୍ଶ_ଦେବା ଉପଦେଶ_ଦେବା
count: ଗଣିବା ଗଣତି_କରିବା ସଂଖ୍ୟା_ଜାଣିବା
couple: ଯୋଡି_ଲାଗିବା ବିହାର_କରିବା କ୍ରୀଡା_କରିବା
course: ବୋହିବା ବାହାରିବା
cover: ଘୋଡେଇବା ଢାଙ୍କିବା ଥୟକରିବା ସ୍ଥିରକରିବା ନିଶ୍ଚିତ_କରିବା ନିର୍ଦ୍ଦିଷ୍ଟ_କରିବା ଲୁଚେଇବା ଗୁପ୍ତରଖିବା କାମ_କରିବା ଦାୟିତ୍ବ_ତୁଲାଇବା ଉଷୁମାଇବା
cover_up: ଲୁଚେଇବା ଗୁପ୍ତରଖିବା
cozen: ଛଳନା_କରିବା ଛଳ_କରିବା_ଧୋକାଦେବା ପ୍ରବଞ୍ଚନା_କରିବା ଆଖିରେ_ଧୂଳି_ଦେବା ଫିଙ୍ଗିଦେବା
crack: ଚଡକିଯିବା ଚଡକରିଫାଟିଯିବା
crackle: ଘଡଘଡ_କରିବା ଚଡଚ‌ଡ_କରିବା ଖସଖସ_ହେବା ଚୁଡୁମୁଡୁ_ହେବା
cram: ଭର୍ତ୍ତି_କରିବା ଜମା_କରିବା
cranch: ଚୁଡୁମୁଡୁ_ହେବା
crap: ଝାଡା_ଫେରିବା ଝାଡାଯିବା ହଗିବା ମଳତ୍ୟାଗ_କରିବା ପାଇଖାନା_ଯିବା
crape: ପାକଳହେବା ଶକ୍ତହେବା ମଝବୁତହେବା
craunch: ଚୁଡୁମୁଡୁ_ହେବା
crawfish: ପଛକୁ_ହଟିବା ପଶ୍ଚାତଗତି_ହେବା
crawfish_out: ପଛକୁ_ହଟିବା ପଶ୍ଚାତଗତି_ହେବା
crawl: ବଲବଲହେବା|
creak: ମଚମଚ_ହେବା
cream_off: ବଛାଇବା ଅଲଗା_କରାଇବା
crease: ଭାଙ୍ଗ_ପଡିବା କୁଞ୍ଚ_ପଡିବା ଜାକିଜୁକିହେବା
create: କରିବା କାରଣ_ହେବା ହେତୁ_ହେବା ନିମିତ୍ତ_ହେବା ରଚନା_କରିବା ସୃଷ୍ଟି_କରିବା ସୃଜନ_କରିବା ସର୍ଜନା_କରିବା ପ୍ରସ୍ତୁତ_କରିବା ଗଢିବା ତିଆରିକରିବା ନିର୍ମାଣ_କରିବା
creep: ବଲବଲହେବା| ଖସିଯିବା
crepitate: ଘଡଘଡ_କରିବା ଚଡଚ‌ଡ_କରିବା
crimp: ଗୋଛାଇବା ଗୋଛା_କରି_ରଖିବା ଏକାଠି_କରି_ରଖିବା ଏକତ୍ର_କରି_ରଖିବା ସଜାଡିକି_ରଖିବା ପାକଳହେବା ଶକ୍ତହେବା ମଝବୁତହେବା
crimson: ଲଜ୍ଜିତହେବା ଲାଜେଇବା
crinkle: ଭାଙ୍ଗ_ପଡିବା କୁଞ୍ଚ_ପଡିବା ଜାକିଜୁକିହେବା
crisp: ସେକିହେବା
crispen: ସେକିହେବା
criticise: ନିନ୍ଦାକରିବା ଖରାପକହିବା ଖଚକହିବା ବଦନାମକରିବା ଆଙ୍ଗୁଳିଦେଖେଇବା
criticize: ନିନ୍ଦାକରିବା ଖରାପକହିବା ଖଚକହିବା ବଦନାମକରିବା ଆଙ୍ଗୁଳିଦେଖେଇବା
croak: ମରିବା ପରଲୋକ_ଗମନ_କରିବା ପ୍ରାଣଛାଡିଯିବା ପ୍ରାଣବାୟୁ_ଉଡିଯିବା ମହା_ନିର୍ବାଣ_ପ୍ରାପ୍ତ_ହେବା ସ୍ୱର୍ଗପ୍ରାପ୍ତି_ହେବା କେଁ_କଟର_କରିବା ଗୁଣୁଗୁଣୁ_ହେବା
cronk: କେଁ_କଟର_କରିବା
crop: କୃଷିଯୋଗ୍ୟ_କରିବା ଚାଷଯୋଗ୍ୟ_କରିବା ଚରାଇବା ଚରିବା
crop_up: ହଠାତ୍‌_ପହଞ୍ଚିଯିବା ସହସା_ଆସିବା ଅଚାନକ_ଆସିବା|
cross: ଥୟକରିବା ସ୍ଥିରକରିବା ନିଶ୍ଚିତ_କରିବା ନିର୍ଦ୍ଦିଷ୍ଟ_କରିବା
crow: ଖିଲଖିଲ_ହସିବା
crumble: ଚୂନାହେବା ଗୁଣ୍ଡହେବା ଚୂରିହେବା ଚୂର୍ଣ୍ଣହେବା
crumple: ମକଚିବା ଦଳିବା ଭାଙ୍ଗ_ପଡିବା କୁଞ୍ଚ_ପଡିବା ଜାକିଜୁକିହେବା
crunch: ଖସଖସ_ହେବା ଚୁଡୁମୁଡୁ_ହେବା ଚୁଡୁମୁଡୁ_ହେବା ଚୂରିବା ଚୂନାକରିବା ପେଷିବା ଗୁଣ୍ଡକରିବା ଚୂର୍ଣ୍ଣକରିବା
crusade: ଲଢେଇ_କରିବା ଲଢିବା ସଂଗ୍ରାମ_କରିବା ଆନ୍ଦୋଳନ_କରିବା
crush: ଦବେଇଦେବା| ପେଶିବା ପେଡିବା| ଚାପିହେବା ପେସିହେବା ଦଳିଚକଟିହେବା
cry: ଚିଲ୍ଲାଇବା ରଡି_କରିବା ଚିତ୍କାର_କରିବା ଗର୍ଜନ_କରିବା କାନ୍ଦିବା ରୋଦନ_କରିବା କ୍ରନ୍ଦନ_କରିବା ଲୁହ_ଗଡାଇବା ଅଶ୍ରୁପାତ_କରିବା ଚିତ୍କାର_କରାଇବା
cry_out: ଚିତ୍କାର_କରାଇବା
cultivate: କୃଷିଯୋଗ୍ୟ_କରିବା ଚାଷଯୋଗ୍ୟ_କରିବା
cumulate: ରୁଣ୍ଡହେବା ଏକାଠି_ହେବା ଏକତ୍ରିତ_ହେବା ଜମିବା
curb: ସମ୍ଭାଳିବା ଆୟତ୍ତ_କରିବା ସଂଯତ_କରିବା ସହିବା ସ୍ଥିର_ରହିବା ହରେଇବା ହାଲିଆ_କରିଦେବା|
curl: ଗୁଡାଇବା ଗୁଡେଇବା
curse: ଗାଳିଦେବା
cut: ଛାଡ_କରିବା ଋଣ_ଛାଡ_କରିବା| କାଟିବା କାଟିବା ଅଲଗା_କରିବା ଲିଭାଇବା ଅବମାନନା_କରିବା ଉପେକ୍ଷା_କରିବା କାଟିବା
cut_across: ଥୟକରିବା ସ୍ଥିରକରିବା ନିଶ୍ଚିତ_କରିବା ନିର୍ଦ୍ଦିଷ୍ଟ_କରିବା
cut_back: ଛାଡ_କରିବା ଋଣ_ଛାଡ_କରିବା|
cut_down: ଛାଡ_କରିବା ଋଣ_ଛାଡ_କରିବା| ପକାଇଦେବା
cut_off: କାଟିବା ଚାପିହେବା କଟିବା ତୋଳିବା
cut_out: ଚାପିହେବା କଟିବା
cut_through: ଥୟକରିବା ସ୍ଥିରକରିବା ନିଶ୍ଚିତ_କରିବା ନିର୍ଦ୍ଦିଷ୍ଟ_କରିବା
dab: ଥାପୁଡିବା ଆଉଁଶିବା
dally: ଖେଳିବା ବେଖାତିର_କରିବା ବେପରୁଆ_ହେବା ଛଇ ଚତୁରୀ ଛୋପରି|
damage: ଖରାପ_କରିବା ବିଗାଡିବା
damn: ଗାଳିଦେବା
dance: ନାଚିବା ନୃତ୍ୟ_କରିବା ପାଦ_ତାଳଦେଇ_ନାଚିବା ନାଚିବା ଉଛୁଳିବା
dandle: ଗେଲକରିବା ପ୍ରେମକରିବା ଶ୍ରଦ୍ଧାକରିବା ଆଦରକରିବା
dangle: ଝୁଲିବା ଲଟକିବା ଝୁଲାଇବା
dart: ଘୂରିବୁଲିବା ଚକ୍କରକାଟିବା
dash: ଡରାଇବା ଭୟଭୀତକରାଇବା ଭୟାତୁର_କରାଇବା
date: ଅଭିସାର_କରିବା ତାରିଖ_ସ୍ଥିର_କରିବା ତାରିଖ_ଥୟ_କରିବା ତାରିଖ_ନିଶ୍ଚିତ_କରିବା ତାରିଖ_ନିର୍ଦ୍ଧାରଣ_କରିବା ମିଶିବା ଦେଖାହେବା ସାକ୍ଷାତ_କରିବା ଭେଟିବା ଏକତ୍ର_ହେବା ସଙ୍ଗୀହେବା ସଂସର୍ଗରେ_ରହିବା
daub: ଲିପାଇବା
daunt: ଡରାଇବା ଭୟଭୀତକରାଇବା ଭୟାତୁର_କରାଇବା
dawdle: ପଛେଇ_ଯିବା ପଛରେ_ରହିଯିବା|
daydream: ଦିବାସ୍ବପ୍ନ_ଦେଖିବା ଖିଆଲରେ_ବୁଡିବା
daze: ଝଲସିଯିବା|
dazzle: ଝଲସିଯିବା|
deal: ନେବା ବାଣ୍ଟିବା ବିତରଣ_କରିବା ସମ୍ଭାଳିହେବା|
deal_out: ବାଣ୍ଟିବା ବିତରଣ_କରିବା
debate: ଯୁକ୍ତିତର୍କକରିବା ବିତଣ୍ଡାକରିବା ବିବାଦକରିବା
debilitate: ଶୁଖାଇବା
decant: ଭାତ_ଗାଳିବା ପେଜ_ଗାଳିବା
decay: ସଢିବା ପଚିବା
decease: ମରିବା ପରଲୋକ_ଗମନ_କରିବା ପ୍ରାଣଛାଡିଯିବା ପ୍ରାଣବାୟୁ_ଉଡିଯିବା ମହା_ନିର୍ବାଣ_ପ୍ରାପ୍ତ_ହେବା ସ୍ୱର୍ଗପ୍ରାପ୍ତି_ହେବା
deceive: ଛଳନା_କରିବା ଛଳ_କରିବା_ଧୋକାଦେବା ପ୍ରବଞ୍ଚନା_କରିବା ଆଖିରେ_ଧୂଳି_ଦେବା ଧୋକାଖାଇବା ଫୁସୁଲେଇବା|
decide: ନିର୍ଣ୍ଣୟ_ନେବା ନିଷ୍ପତ୍ତି_ନେବା ମୀମାଂସା_କରିବା ବୁଝାଶୁଝା_କରିବା ସମାଧାନ_କରିବା
deck: ଶୋଭାନ୍ବିତ_ହେବା ଶୋଭିତ_ହେବା_
declare_oneself: ବିବାହ_ପ୍ରସ୍ତାବ_ଦେବା ବିବାହ_ପ୍ରସ୍ତାବ_ରଖିବା
decline: ପତନ_ହେବା ମନା_କରିବା ନାଁ_କହିବା ନାହିଁ_କରିବା
decorate: ସଜେଇବା ଅଳଙ୍କୃତ_କରିବା ସଜ୍ଜିତ_କରିବା ଶୋଭାନ୍ବିତ_ହେବା ଶୋଭିତ_ହେବା_
decrease: କମ_ହେବା ହ୍ରାସ_ହେବା କମି_ଯିବା କ୍ଷୀଣ_ହେବା
dedicate: ସମର୍ପିତ_କରିବା|
deduct: ବିୟୋଗକରିବା ବିଯୁକ୍ତ_କରିବା ଫେଡିବା ହଟେଇବା
deem: ରଖିବା
deep-fry: ଛଣାହେବା
defame: ଚୁଗୁଲି_କରିବା ଫୋଡିବା|
defeat: ହରେଇବା ପରାଜିତ_କରିବା ପରାସ୍ତ_କରିବା
defecate: ଝାଡା_ଫେରିବା ଝାଡାଯିବା ହଗିବା ମଳତ୍ୟାଗ_କରିବା ପାଇଖାନା_ଯିବା
defer: ସ୍ଥଗିତ_ରଖିବା
deform: ନୁଆଁଇବା ଝୁଙ୍କାଇବା ତଳକୁକରିବା|
defraud: ଠକିବା
degenerate: ବୁଡିଯିବା ନଷ୍ଟ_ହେବା
deject: ହତୋତ୍ସାହିତ_ହେବା|
delay: ବିଳମ୍ବ_ହେବା ଡେରି_ହେବା_ ସମ୍ଭାଳିବା ରହିବା ଆଶ୍ରୟ_ନେବା ସମ୍ଭାଳି_ହେବା_
delight: ଖୁସି_ଲାଗିବା ଭଲ_ଲାଗିବା ସୁଖଦ_ଲାଗିବା
delineate: ଟାଣିବା ଖିଞ୍ଚିବା ବର୍ଣନା_କରିବା ବଖାଣିବା ବୟାନ_କରିବା|
deliver: ଭାଷଣଦେବା ବକ୍ତବ୍ୟପ୍ରଦାନକରିବା କହିବା_ ପହଞ୍ଚାଇବା ଛାଡିକି_ଆସିବା| ଦାୟିତ୍ବ_ଦେବା ନ୍ୟସ୍ତ_କରିବା ଜିମା_କରିବା ଜନ୍ମକରିବା ଜନ୍ମ_ଦେବା ଉତ୍ପନ୍ନ_କରିବା ପ୍ରସବ_କରିବା
delude: ଛଳନା_କରିବା ଛଳ_କରିବା_ଧୋକାଦେବା ପ୍ରବଞ୍ଚନା_କରିବା ଆଖିରେ_ଧୂଳି_ଦେବା
demand: ଚାହିଦା_ରହିବା
demasculinise: ଖାସୁ_କରିବା ଧରିବା
demasculinize: ଖାସୁ_କରିବା ଧରିବା
demo: ଦେଖାଇବା ପ୍ରଦର୍ଶିତ_କରିବା ଶୋ_କରିବା ପ୍ରଦର୍ଶନ_କରିବା
demolish: ଭାଙ୍ଗିବା|
demonstrate: ଦେଖାଇବା ପ୍ରଦର୍ଶିତ_କରିବା ଶୋ_କରିବା ପ୍ରଦର୍ଶନ_କରିବା ପ୍ରଦର୍ଶନ_କରିବା
demoralise: ହତୋତ୍ସାହିତ_ହେବା|
demoralize: ହତୋତ୍ସାହିତ_ହେବା|
denigrate: ଚୁଗୁଲି_କରିବା ଫୋଡିବା|
denudate: ଉଲଗ୍ନ_କରାଇବା
denude: ଉଲଗ୍ନ_କରାଇବା
depart: ପ୍ରସ୍ଥାନ_କରିବା ଯିବା ଗମନକରିବା ବାହାରିବା ପଥ_ହୁଡିବା ପ୍ରସ୍ଥାନ_କରିବା ଛାଡିବା ଚାଲିବା| ବାହାରିଯିବା ପୃଥକ_ହେବା ଅଲଗା_ହେବା ହଟିଯିବା|
depend: ନିର୍ଭର_କରିବା ଆଶ୍ରିତ_ହେବା
deplete: ଲାଗିବା ଖର୍ଚ୍ଚହେବା
depress: ହତୋତ୍ସାହିତ_ହେବା|
derive: ପାଇବା ପ୍ରାପ୍ତ_କରିବା ମିଳିବା|
describe: ଟାଣିବା ଆଙ୍କିବା ଟାଣିବା ଖିଞ୍ଚିବା
desire: ଇଚ୍ଛା_କରିବା ଇଚ୍ଛା_ହେବା ମନ_କରିବା ମନହେବା କାମନା‌_କରିବା ବାଞ୍ଛା_କରିବା
despoil: ଲୁଟପାଟ_କରିବା ଲୋଟିବା ଅପହରଣ_କରିବା
destroy: ନଷ୍ଟଭ୍ରଷ୍ଟକରିବା ଛିନ୍ନଭିଛିନ୍ନ_କରିବା ଉତ୍ପାଟନ_କରିବା କ୍ଷୟ_କରିବା ନାଶ_କରିବା
destruct: ନଷ୍ଟଭ୍ରଷ୍ଟକରିବା ଛିନ୍ନଭିଛିନ୍ନ_କରିବା ଉତ୍ପାଟନ_କରିବା
detain: ସମ୍ଭାଳିବା ରହିବା ଆଶ୍ରୟ_ନେବା ସମ୍ଭାଳି_ହେବା_
deteriorate: ବୁଡିଯିବା ନଷ୍ଟ_ହେବା
determine: ନିର୍ଣ୍ଣୟ_ନେବା ନିଷ୍ପତ୍ତି_ନେବା
detest: ଘୃଣା_କରିବା ଖରାପ_ଭାବିବା ନୀଚବୋଲି_ଭାବିବା
detonate: ଫୁଟାଇବା
develop: ବାହାର_କରିବା ଆବିଷ୍କୃତ_କରିବା ଉଦ୍ଭାବନ_କରିବା| ସୃଷ୍ଟିହେବା ଜାତ_ହେବା ଉତ୍ପନ୍ନ_ହେବା ପ୍ରଶିକ୍ଷିତ_କରାଯିବା ତାଲିମକରାଯିବା ଯୋଗ୍ୟକରାଯିବା|
deviate: ପଥ_ହୁଡିବା
devise: ଆବିଷ୍କାର_କରିବା ଉଦ୍ଭାବନ_କରିବା ବାହାର_କରିବା ଖୋଜି_ବାହାର_କରିବା
devolve: ବୁଡିଯିବା ନଷ୍ଟ_ହେବା
devote: ସମର୍ପିତ_କରିବା| ରଖା_ଯିବା ସମର୍ପିତ_ହେବା|
devour: ଗିଳିବା ଗେଫିବା ଗ୍ରାସକରିବା
dictate: ଲେଖାଇବା ଲିଖନ_କରାଇବା ଲିପିବଦ୍ଧ_କରାଇବା
diddle: ଠକିବା
die: ମରିବା ପରଲୋକ_ଗମନ_କରିବା ପ୍ରାଣଛାଡିଯିବା ପ୍ରାଣବାୟୁ_ଉଡିଯିବା ମହା_ନିର୍ବାଣ_ପ୍ରାପ୍ତ_ହେବା ସ୍ୱର୍ଗପ୍ରାପ୍ତି_ହେବା ଲିପ୍ତ_ରହିବା ଆସକ୍ତ_ହେବା ମୋହିତ_ହେବା ମରିବା ଢଳିବା ମରିବା ମରିଯିବା ମରିବା
die_hard: ପ୍ରଚଳିତ_ହେବା ଚାଲିବା
die_off: ବିଲୁପ୍ତ_ହେବା ଅଦୃଶ୍ୟ_ହେବା ଲୁପ୍ତ_ହେବା ହଜି_ଯିବା
die_out: ବିଲୁପ୍ତ_ହେବା ଅଦୃଶ୍ୟ_ହେବା ଲୁପ୍ତ_ହେବା ହଜି_ଯିବା
differ: ଅସହମତ_ହେବା ଅମତ_ହେବା ଅମାନ୍ୟ_କରିବା
differentiate: ଅଲଗା_କରିବା ଅନ୍ତର_କରିବା ବିଭେଦ_କରିବା ବିଚ୍ଛିନ୍ନ_କରିବା ପୃଥକ_କରିବା ପାର୍ଥକ୍ୟ_କରିବା ବିଭିନ୍ନତା_ଦର୍ଶାଇବା
dig: ଖୋଳାଯିବା ଖୋଳାହେବା| ଖଟେଇବା ରଗଡିବା ଲଗେଇବା ଖୋଳିବା ଖନନ_କରିବା ଭୁସିବା କେଞ୍ଚିବା ବିନ୍ଧିବା ହାଣିବା ବୁଝେଇବା ଧରିବା
dig_out: ଖୋଳାଯିବା ଖୋଳାହେବା|
digest: ହଜମ_କରିବା ଅପମାନ_ସହିବା ବରଦାସ୍ତ_କରିବା ପାଚନ ହଜମ
dilate: ବ୍ୟାଖ୍ୟା_କରିବା ଅର୍ଥ_ବୁଝେଇବା ବିଶ୍ଳେଷଣ_କରିବା ବିସ୍ତାରିତ_ଭାବେ_ବର୍ଣ୍ଣନାକରିବା|
diminish: କମ_ହେବା ହ୍ରାସ_ହେବା କମି_ଯିବା କ୍ଷୀଣ_ହେବା
dip: ବୁଡେଇବା_ଡୁବେଇବା
direct: ନିଶାନା_ସାଧିବା ଲକ୍ଷ୍ୟ_ସ୍ଥିର_କରିବା
dirty: ଗୋଳିଆ_କରିବା ମଇଳା_କରିବା ଅପରିଷ୍କାର_କରିବା
disagree: ଅସହମତ_ହେବା ଅମତ_ହେବା ଅମାନ୍ୟ_କରିବା
disallow: ମନାକରିବା ରୋକିବା ଅବରୋଧକରିବା
disappear: ଉଡିଯିବା ହଜିଯିବା ଛୁ_ମନ୍ତର_ହୋଇଯିବା| ନ_ଦିଶିବା ହଜିଯିବା
discard: ପକେଇବା ଫୋପାଡିବା
discharge: ମୁକ୍ତ_କରିବା ସ୍ବାଧୀନ_କରିବା ସ୍ବତନ୍ତ୍ର_କରିବା ଛୁଟିବା ଚାଲିବା ଅପରାଧ_ମୁକ୍ତ_କରିବା ଦୋଷ_ମୁକ୍ତ_କରିବା ଛାଡିଦେବା ଚଳାଇବା ମାରିବା ଫୁଟାଇବା|
disclose: ଖୋଲିବା ପଦାକୁବାହାରିବା ଉନ୍ମୋଚନ_ହେବା|
discombobulate: ଭ୍ରମିତ_ହେବା ଭ୍ରମ_ହେବା ଅକଲ_ଗୁଡୁମ_ହେବା|
discommode: ଅସୁବିଧାରେ_ପକାଇବା ଝଞ୍ଜଟରେ_ପକାଇବା ଜଞ୍ଜାଳରେ_ପକାଇବା ଗୋଳମାଳରେ_ପକାଇବା ସମସ୍ୟାରେ_ପକାଇବା ହଇରାଣ_କରିବା
discontinue: ଛାଡିଦେବା
discount: ରଦ୍ଦ_କରିବା ରଦ୍ଦ_କରି_ଦେବା ଖାରିଜ_କରିବା|
discourage: ଚେତାବନୀ_ଦେବା ସାବଧାନ_କରିବା ଖବରଦାର_କରିବା
discover: ଆବିଷ୍କାର_କରିବା ଖୋଜି_ବାହାର_କରିବା ପତ୍ତା_ଲଗାଇବା ଖୋଲିବା ପଦାକୁବାହାରିବା ଉନ୍ମୋଚନ_ହେବା|
discuss: ଯୁକ୍ତିତର୍କ ବାଦବିବାଦ ତର୍କବିତର୍କ ବିତଣ୍ଡା
disdain: ତଡି_ଦେବା ପ୍ରତ୍ୟାଖାନ_କରିବା
disembarrass: ମୁକାଳିବା ମୁକୁଳେଇବା ୱାପସଆଣିବା|
disencumber: ସମାଧାନ_ହେବା ଉତ୍ତର_ମିଳିବା
disentangle: ସମାଧାନ_ହେବା ଉତ୍ତର_ମିଳିବା
disgorge: ଥୁକିବା ଛେପପକାଇବା
dish_out: ବାଣ୍ଟିବା ବିତରଣ_କରିବା
disinvest: ଖୋଲିବା ବଦଳିବା ବାହାର_କରିବା
disk: ମଇଦେବା_
dislodge: ହଟେଇବା ଉଠେଇବା କାଟିଦେବା ଉଡେଇଦେବା| ଘୁଞ୍ଚାଇବା ହଟେଇବା
dismay: ହତୋତ୍ସାହିତ_ହେବା|
dismiss: ରଦ୍ଦ_କରିବା ରଦ୍ଦ_କରି_ଦେବା ଖାରିଜ_କରିବା| ବାହାରକରିଦେବା
disoblige: ଅସୁବିଧାରେ_ପକାଇବା ଝଞ୍ଜଟରେ_ପକାଇବା ଜଞ୍ଜାଳରେ_ପକାଇବା ଗୋଳମାଳରେ_ପକାଇବା ସମସ୍ୟାରେ_ପକାଇବା ହଇରାଣ_କରିବା
disorder: ବ୍ୟାକୁଳ_ହେବା ଅଶାନ୍ତ_ହେବା
dispatch: ମରିବା ହତ୍ୟାକରିବା ଜୀବନନେବା ଶେଷକରିବା ଖଲାସକରିବା
dispel: ହଟେଦେବା ଭଗେଇଦେବା ତଡିଦେବା
dispense: ବାଣ୍ଟିବା ବିତରଣ_କରିବା
disperse: ବୁଣିବା ଖେଳେଇବା ଛିଞ୍ଚିବା ବିକୀର୍ଣ୍ଣ_କରିବା
dispirit: ହତୋତ୍ସାହିତ_ହେବା|
displace: ମୂଳୋତ୍ପାଟନ_କରିବା ଉନ୍ମୂଳନ_କରିବା ନିର୍ମୂଳ_କରିବା ହଟାଇବା
display: ଦେଖାଇବା
displease: ଅରାଜି_ହେବା ନାରାଜ_ହେବା ଅପ୍ରସନ୍ନ_ହେବା
disport: ଆନନ୍ଦିତ_କରିବା ମୋହିତ_କରିବା ଖୁସି_କରିବା| ଡିଆଁଡେଇଁ_କରିବା ଡିଆଁକୁଦା_କରିବା ଖେଳକୁଦ_କରିବା ଘୋ-ଘା_କରିବା
dispose: ପକେଇବା ଫୋପାଡିବା
dispute: କଳି_କରିବା ଝଗଡା_କରିବା ଲଢିବା ଲଢେଇକରିବା ଗଣ୍ଡଗୋଳ_କରିବା
disquiet: ବ୍ୟାକୁଳ_ହେବା ଅଶାନ୍ତ_ହେବା
disregard: ଅବମାନନା_କରିବା ଉପେକ୍ଷା_କରିବା ରଦ୍ଦ_କରିବା ରଦ୍ଦ_କରି_ଦେବା ଖାରିଜ_କରିବା| ଛାଡିବା ଅବହେଳା_କରିବା ଧ୍ୟାନ_ନଦେବା
disrupt: କଥା_ମଝିରେ_କଥା_କହିବା
diss: ଅପମାନିତ_କରିବା ତିରସ୍କାର_କରିବା ଅପମାନ_ଦେବା
dissent: ଅସହମତ_ହେବା ଅମତ_ହେବା ଅମାନ୍ୟ_କରିବା
dissever: ଅଧା_କରିବା ଅଧା_ଅଧା_ବାଣ୍ଟିବା
dissipate: ଅପବ୍ୟୟ_କରିବା ପଇସା_ଉଡାଇବା
dissolve: ଗୋଳାଇବା ମିଶେଇବା ମିଶ୍ରିତ_କରିବା ମିଶିବା ମିଳେଇବା ଗୋଳିହେବା ମିଶ୍ରିତ_ହେବା ସମିଶ୍ରଣ_ହେବା ଏକାଠି_ହେବା| ଭାଙ୍ଗିଯିବା|
distend: ଫୁଲିବା
distil: ଆସବନ_କରିବା
distill: ଶୋଧନ ବିଶୋଧନ ପରିଷ୍କାର ଆସବନ_କରିବା
distinguish: ଅଲଗା_କରିବା ଅନ୍ତର_କରିବା ବିଭେଦ_କରିବା ବିଚ୍ଛିନ୍ନ_କରିବା ପୃଥକ_କରିବା ପାର୍ଥକ୍ୟ_କରିବା ବିଭିନ୍ନତା_ଦର୍ଶାଇବା
distort: ମିଛ_କରିଦେବା ରସି_ବୋଳିବା ଦଉଡି_ବୋଳିବା ଦଉଡି_ଭାଙ୍ଗିବା
distract: ବ୍ୟାକୁଳ_ହେବା ଅଶାନ୍ତ_ହେବା
distress: ବ୍ୟଥିତ_ହେବା
distribute: ବାଣ୍ଟିବା ବିତରଣ_କରିବା ପ୍ରସାରିତ_କରିବା ବିସ୍ତୃତ_କରିବା ପ୍ରସାର_କରିବା ବଢେଇବା|
disturb: ହଲେଇବା ଦୋହଲେଇବା
disunite: ଅଲଗା_କରିବା ବାଛିବା ବାହାର_କରିବା_
diverge: ପଥ_ହୁଡିବା
divert: ଅନ୍ୟ_ଦିଗକୁ_ନେଇଯିବା ବିପରୀତ_ଦିଗକୁ_ନେଇଯିବା ଦିଗ_ପରିବର୍ତ୍ତନ_କରିବା ଗତି_ପରିବର୍ତ୍ତନ_କରିବା ଡାଇଭର୍ଟ_କରିବା ଆନନ୍ଦିତ_କରିବା ମୋହିତ_କରିବା ଖୁସି_କରିବା|
divest: ଖୋଲିବା ବଦଳିବା ବାହାର_କରିବା
divide: ଅଧା_କରିବା ଅଧା_ଅଧା_ବାଣ୍ଟିବା ବାଣ୍ଟିହେବା ବଣ୍ଟାହେବା ଅଲଗା_କରିବା ବାଛିବା ବାହାର_କରିବା_
divorce: ଛାଡପତ୍ର ବିବାହ_ବିଛେଦ_କରିବା
divulge: ଖୋଲିବା ପଦାକୁବାହାରିବା ଉନ୍ମୋଚନ_ହେବା|
do: କରିବା ସାରିବା ସଂପାଦିତ_କରିବା କରିବା କାରଣ_ହେବା ହେତୁହେବା ନିମିତ୍ତହେବା ବ୍ୟବହାର
do_by: ବ୍ୟବହାର_କରିବା ଆଚରଣ_କରିବା ବେଭାରକରିବା
do_it: ରତିକରିବା ରମଣକରିବା ସମ୍ଭୋଗକରିବା
do_work: ଚାକିରୀ_କରିବା କାମ_କରିବା
dock: ଲାଞ୍ଜ_କାଟିବା ଲାଙ୍ଗୁଡ_କାଟିବା ପୁଚ୍ଛ_କାଟିବା
doctor: ମରାମତି_କରିବା ସଜାଡିବା ଠିକ_କରିବା
dodder: ଚାଳନକରିବା|
dodge: କଥା_ଟାଳିବା ଟାଳିବା
dog: ଦୌଡେଇବା
dole_out: ବାଣ୍ଟିବା ବିତରଣ_କରିବା
domiciliate: ଘର_ଦେବା ଜାଗାଦେବା
dominate: ଶକ୍ତିଶାଳୀ_ହେବା ବଳବାନ_ହେବା ପ୍ରଧାନ_ହେବା ସାମର୍ଥ୍ୟସମ୍ପନ୍ନ_ହେବା
donate: ଦାନ_କରିବା ଦାନ_ଦେବା
dot: ବୁଣିବା ଖେଳେଇବା ଛିଞ୍ଚିବା ବିକୀର୍ଣ୍ଣ_କରିବା
douse: ଲିଭାଇବା ଲିଭେଇବା ନିଭାଇବା ନିର୍ବାପିତ_କରିବା ବୁଡେଇବା_ଡୁବେଇବା
down: ଗିଳିବା ଗେଫିବା ଗ୍ରାସକରିବା
download: ଡାଉନଲୋଡ_କରିବା
doze: ଢୋଳେଇ_ପଡିବା
drag: ଟାଣିବା ଘୋଷାରିବା ଘୋଷାଡିବା ଟାଣିବା ଜବରଦସ୍ତି_କରିବା|
drag_in: ଟାଣିବା ଜବରଦସ୍ତି_କରିବା|
drain: ଶୁଖିଯିବା ଝଡିବା ଶୀର୍ଣ୍ଣହେବା ଶୁଖାଇବା
drape: ଘୋଡିବା ଉଢିବା
draw: ଟାଣିବା ଟାଣିବା ଖିଞ୍ଚିବା ବାହାର_କରିବା କାଢିବା| ଶୋଷଣ_କରିବା ଅବଶୋଷିତ_କରିବା ଟାଣିବା ପିଇବା| ଆକର୍ଷିତ_କରିବା ଆକୃଷ୍ଟ_କରିବା ଲୋଭାନ୍ବିତ_କରିବା ଟାଣିବା| ଗୁନ୍ଥିବା
draw_a_blank: ଭୁଲିବା
draw_in: ଆକର୍ଷିତ_କରିବା ଆକୃଷ୍ଟ_କରିବା ଲୋଭାନ୍ବିତ_କରିବା ଟାଣିବା|
draw_out: କାଢିବା ଟାଣିବା ଚୁଷିବା|
draw_together: ଭେଟକରାଇବା ମିଶେଇବା ମିଶିବା
dread: ଡରିବା ଭୟଭିତ_ହେବା ଡରିଯିବା ଶଙ୍କିଯିବା ଶଙ୍କା_ପଶିବା
dress: ପିନ୍ଧାଇବା|
dress_down: ଧିକ୍କାରିବା ଗାଳିଦେବା ଅପମାନ_କରିବା ତିରସ୍କାର_କରିବା
dribble: ଟପ_ଟପ_କରିବା
drift: ଚାଲିବା ଏଣେ_ତେଣେ_ବୁଲିବା ପଥ_ହୁଡିବା ଇତସ୍ତତଃ_ବୁଲିବା ଏଣେତେଣେ_ବୁଲିବା ଇତସ୍ତତଃ_ଭ୍ରମଣ_କରିବା
drill: ଛେଦ_କରିବା ଛେଦିବା ଭେଦ_କରିବା ସାଧନା_କରିବା ଅଭ୍ୟାସ_କରିବା ସିଦ୍ଧହସ୍ତ_ହେବା ସିଦ୍ଧିଲାଭ_କରିବା
drink: ପିଇବା ପାନ_କରିବା ନିଶା_ହେବା ମଦ_ପିଇବା ମଦ_ଚଢାଇବା|
drip: ଟପଟପ_ହୋଇ_ପଡିବା
drive: ଚଲାଇବା ଚାଳନ_କରିବା ଚାଳିତ_କରିବା ପରିଚାଳିତ_କରାଇବା ଗତି_କରାଇବା
drive_away: ହଟେଦେବା ଭଗେଇଦେବା ତଡିଦେବା
drive_off: ହଟେଦେବା ଭଗେଇଦେବା ତଡିଦେବା
drive_out: ହଟେଦେବା ଭଗେଇଦେବା ତଡିଦେବା
drone: ଭଣଭଣ_ହେବା ଫଣଫଣ_ହେବା|
droop: ଦବିବା|
drop: ପକାଇବା ପକାଇଦେବା ଝୁଲିବା ଲଟକିବା ଛାଡିଦେବା ପଳେଇଲା| ବୁଡିଯିବା ନଷ୍ଟ_ହେବା ଜନ୍ମକରିବା ଜନ୍ମଦେବା
drop_dead: ମରିବା ପରଲୋକ_ଗମନ_କରିବା ପ୍ରାଣଛାଡିଯିବା ପ୍ରାଣବାୟୁ_ଉଡିଯିବା ମହା_ନିର୍ବାଣ_ପ୍ରାପ୍ତ_ହେବା ସ୍ୱର୍ଗପ୍ରାପ୍ତି_ହେବା
drown: ତଲ୍ଲୀନ_ହେବା ଲୀନ_ହେବା ଭାବାନ୍ବିତ_ହେବା ଆତ୍ମବିସ୍ମ୍ରୁତ_ହେବା ଧ୍ୟାନାବସ୍ଥିତ_ହେବା ବୁଡି_ଯିବା ବୁଡି_ମରିବା ସଲିଳ_ସମାଧି_ହେବା
drowse: ଢୋଳେଇ_ପଡିବା
drudge: ଖଟେଇବା ରଗଡିବା ଲଗେଇବା
drum: ପିଟିବା ବଜାଉଛି
dry: ଶୁଖାଇବା ଶୁଖିବା
dry_out: ଶୁଖିବା ଶୁଖାଇବା
duck: କଥା_ଟାଳିବା ଟାଳିବା
dull: ଅଚଳହେବା ଗତିହୀନହେବା ନିଶ୍ଚଳହେବା
dunk: ବୁଡେଇବା_ଡୁବେଇବା
dust: ଝାଡିବା ବୁଣିବା ଖେଳେଇବା ଛିଞ୍ଚିବା ବିକୀର୍ଣ୍ଣ_କରିବା
dwell: ରହିବା ନିବାସକରିବା ବାସକରିବା
dye: ରଙ୍ଗାଇବା ରଙ୍ଗେଇବା ରଙ୍ଗକରାଇବା ରଞ୍ଜିତକରାଇବା
earmark: ଅଲଗା_ରଖିବା ପୃଥକ_ରଖିବା ସଂରକ୍ଷିତ_ରଖିବା
earn: ଅର୍ଜନ_କରିବା କମେଇବା
eat: ଖାଇବା ଆହାର_କରିବା ଭୋଜନ_କରିବା ଖାଇବା ଲାଗିବା ଖର୍ଚ୍ଚହେବା ଖାଇବା|
eat_on: ଖାଇବା|
eat_up: ଲାଗିବା ଖର୍ଚ୍ଚହେବା
eavesdrop: ଲୁଚିକରି_ଶୁଣିବା
ebb: ଭଟ୍ଟା_ପଡିବା
ebb_away: ଭଟ୍ଟା_ପଡିବା
ebb_down: ଭଟ୍ଟା_ପଡିବା
ebb_off: ଭଟ୍ଟା_ପଡିବା
ebb_out: ଭଟ୍ଟା_ପଡିବା
echo: ପ୍ରତିଧ୍ବନିତ_ହେବା ବାଡେଇହେବା
eclipse: ଗ୍ରହଣ_ଲାଗିବା ଗ୍ରାସ_ଲାଗିବା
economise: ବଞ୍ଚାଇବା ରଖିବା_
economize: ବଞ୍ଚାଇବା ରଖିବା_
edge: ଧଡି_ତିଆରି_କରିବା ଧଡି_ପକାଇବା କିନାରି_ତିଆରି_କରିବା କିନାରି_ପକାଇବା ବର୍ଡର_କରିବା ଅବସ୍ଥିତ_ହେବା ସ୍ଥିତ_ହେବା ଅବସ୍ଥାନ_କରିବା
educate: ପ୍ରଶିକ୍ଷିତ_କରାଯିବା ତାଲିମକରାଯିବା ଯୋଗ୍ୟକରାଯିବା|
eff: ରତିକରିବା ରମଣକରିବା ସମ୍ଭୋଗକରିବା
efface: ଲିଭାଇବା
egress: ବାହାରିବା ନିର୍ଗମ_ହେବା
eject: ବାହାର_କରିଦେବା
elaborate: ବ୍ୟାଖ୍ୟା_କରିବା ଅର୍ଥ_ବୁଝେଇବା ବିଶ୍ଳେଷଣ_କରିବା ବିସ୍ତାରିତ_ଭାବେ_ବର୍ଣ୍ଣନାକରିବା|
elate: ଘାରିହେବା ନିଶାସକ୍ତ_ହେବା
elect: ବାଛିବା ନିର୍ବାଚିତ_କରିବା
elevate: ପଦୋନ୍ନତି_କରିବା ପଦୋନ୍ନତି_ହେବା ଉଠେଇବା
elongate: ଟଣାଇବା ପ୍ରସାରିତ_କରାଇବା ବିସ୍ତାରିତ_କରାଇବା
elope: ପଳେଇବା
elude: କଥା_ଟାଳିବା ଟାଳିବା
emasculate: ଖାସୁ_କରିବା ଧରିବା
embed: ପୋତିବା
embellish: ଶୋଭାନ୍ବିତ_ହେବା ଶୋଭିତ_ହେବା_ ସଜେଇବା ଅଳଙ୍କୃତ_କରିବା ସଜ୍ଜିତ_କରିବା
emblazon: ରଙ୍ଗ_କରିବା|
embody: ନିର୍ବାହ ସଂପାଦନ ପ୍ରତିପାଦନ
embrace: କୁଣ୍ଢେଇ_ପକାଇବା ଆଲିଙ୍ଗନ_କରିବା
embroil: ଟାଣିବା ଜବରଦସ୍ତି_କରିବା|
emerge: ବାହାରିବା ନିର୍ଗମ_ହେବା
emit: ରାବିବା_
employ: ଅନୁକୂଳ_କରିବା
empty: ଖାଲି_କରିବା ଶୂନ୍ୟ_କରିବା ସ୍ଥାନ_ତ୍ୟାଗ_କରିବା ଜାଗା_ଛାଡିବା ଜାଗା_ଖାଲି_କରିବା ସ୍ଥାନ_ଖାଲି_କରିବା
enamor: ମୋହିତ_କରିବା ମୋହେଇବା ସମ୍ମୋହନ_କରିବା|
enamour: ମୋହିତ_କରିବା ମୋହେଇବା ସମ୍ମୋହନ_କରିବା|
enchant: ମୋହିତ_କରିବା ମୋହେଇବା ସମ୍ମୋହନ_କରିବା|
encircle: ଚକ୍କର_ମାରିବା ଚକ୍କର_କାଟିବା
enclose: ପୂରାପୂରି_ଭାବେ_ଢାଙ୍କିବା ପୂରାପୂରିଭାବେ_ଘୋଡେଇବା ପୂରାପୂରିଭାବେ_ଆବୃତ୍ତ_କରିବା ସମ୍ପୂର୍ଣ୍ଣଭାବେ_ଆଚ୍ଛାଦିତ_କରିବା ପୂରାପୂରିଭାବେ_ଲୁଚାଇବା
enclothe: ପିନ୍ଧାଇବା|
end: ଛୁଟିହେବା ସମାପ୍ତ_ହେବା| ଶେଷ_କରିବା ସମାପ୍ତ_କରିବା ପୂରା_କରିବା ପୂର୍ଣ୍ଣକରିବା
endanger: ବିପଦରେ_ପକାଇବା ସଙ୍କଟରେ_ପକାଇବା ସମସ୍ୟାରେ_ପକାଇବା
endeavor: ପ୍ରଯତ୍ନ_କରିବା ପ୍ରୟାସ_କରିବା ଚେଷ୍ଟା_କରିବା ଉଦ୍ୟମ_କରିବା ଉଦଯୋଗ_କରିବା ଯତ୍ନ_କରିବା କଷ୍ଟ_କରିବା
endeavour: ପ୍ରଯତ୍ନ_କରିବା ପ୍ରୟାସ_କରିବା ଚେଷ୍ଟା_କରିବା ଉଦ୍ୟମ_କରିବା ଉଦଯୋଗ_କରିବା ଯତ୍ନ_କରିବା କଷ୍ଟ_କରିବା
endure: ଅପମାନ_ସହିବା ବରଦାସ୍ତ_କରିବା ଚାଲିବା ରହିବା| ରହିବ| ପ୍ରଚଳିତ_ହେବା ଚାଲିବା
energise: ଜାଗୃତ_କରିବା ଜଗେଇବା ସାଧନ_କରିବା
energize: ଜାଗୃତ_କରିବା ଜଗେଇବା ସାଧନ_କରିବା
enfeeble: ଶୁଖାଇବା
enfold: ପୂରାପୂରି_ଭାବେ_ଢାଙ୍କିବା ପୂରାପୂରିଭାବେ_ଘୋଡେଇବା ପୂରାପୂରିଭାବେ_ଆବୃତ୍ତ_କରିବା ସମ୍ପୂର୍ଣ୍ଣଭାବେ_ଆଚ୍ଛାଦିତ_କରିବା ପୂରାପୂରିଭାବେ_ଲୁଚାଇବା
engage: ବ୍ୟସ୍ତରହିବା ଲାଗିବା ଲାଗିରହିବା ସ୍ଥିର_କରିବା ପକ୍କା_କରିବା ଭଡା_କରିବା ଭଡା_ନେବା|
englut: ତୃପ୍ତ_ହେବା
engorge: ତୃପ୍ତ_ହେବା
engraft: ପୋତିବା
enjoin: କହିବା ଆଜ୍ଞା_କରିବା ଆଜ୍ଞା_ଦେବା ଆଦେଶ_ଦେବା|
enjoy: ଆନନ୍ଦ_ନେବା ମଜା_ନେବା ସୁଖଲାଭ_କରିବା ସନ୍ତୋଷଲାଭ_କରିବା ସନ୍ତୁଷ୍ଟ_ହେବା
enlarge: ବ୍ୟାଖ୍ୟା_କରିବା ଅର୍ଥ_ବୁଝେଇବା ବିଶ୍ଳେଷଣ_କରିବା ବିସ୍ତାରିତ_ଭାବେ_ବର୍ଣ୍ଣନାକରିବା|
enliven: ପ୍ରେରିତ_କରିବା
enquire: ଦେଖିବା ଅନୁସାନ୍ଧନ_କରିବା ଯାଞ୍ଚ_କରିବା ଅନ୍ବେଷଣ_କରିବା|
ensconce: ଲାଖିବା ଅଟକିବା ନିବିଷ୍ଟ_ହୋଇ_ରହିବା
ensnare: ଫାନ୍ଦିବା ଫାଶରେପକାଇବା|
entangle: ଗୁନ୍ଥିହେବା
enter: ପ୍ରବେଶ_କରିବା ପଶିବା ଭିତରକୁ_ଆସିବା ଉପସ୍ଥିତ_ହେବା ଆସିବା| ଭାଗ_ନେବା ସାମିଲ_ହେବା| ତାଲିକାଭୁକ୍ତ_କରାଇବା ସୂଚୀଭୁକ୍ତ_କରାଇବା
entice: ଲୋଭଦେଖେଇବା|
entrance: ମୋହିତ_କରିବା ମୋହେଇବା ସମ୍ମୋହନ_କରିବା|
entrap: ଫାନ୍ଦିବା ଫାଶରେପକାଇବା|
entreat: ନିବେଦନ_କରିବା ବିନତି_କରିବା ବିନୟ_କରିବା ପ୍ରାର୍ଥନା_କରିବା ଅନୁନୟ_କରିବା ଅନୁରୋଧ_କରିବା
enumerate: ଗଣିବା ଗଣତି_କରିବା ସଂଖ୍ୟା_ଜାଣିବା
envelop: ପୂରାପୂରି_ଭାବେ_ଢାଙ୍କିବା ପୂରାପୂରିଭାବେ_ଘୋଡେଇବା ପୂରାପୂରିଭାବେ_ଆବୃତ୍ତ_କରିବା ସମ୍ପୂର୍ଣ୍ଣଭାବେ_ଆଚ୍ଛାଦିତ_କରିବା ପୂରାପୂରିଭାବେ_ଲୁଚାଇବା
environ: ଚକ୍କର_ମାରିବା ଚକ୍କର_କାଟିବା
envisage: କଳ୍ପନା_କରିବା ମାନିବା ଭାବିବା ଗ୍ରହଣ_କରିବା
envy: ଈର୍ଷ୍ୟା_କରିବା ଦ୍ବେଷ_କରିବା ଜଳିବା|
enwrap: ପୂରାପୂରି_ଭାବେ_ଢାଙ୍କିବା ପୂରାପୂରିଭାବେ_ଘୋଡେଇବା ପୂରାପୂରିଭାବେ_ଆବୃତ୍ତ_କରିବା ସମ୍ପୂର୍ଣ୍ଣଭାବେ_ଆଚ୍ଛାଦିତ_କରିବା ପୂରାପୂରିଭାବେ_ଲୁଚାଇବା
equal: ସମାସ୍କନ୍ଦ_ହେବା ସମାନ_ହେବା ପାଖାପାଖି_ହେବା
erase: ହଟାଇବା ମୂଳପୋଛ_କରିବା ଦୂରେଇବା ଲିଭାଇବା
err: ଭୁଲ_କରିବା ଅପରାଧକରିବା ଏଣେ_ତେଣେ_ବୁଲିବା ପଥ_ହୁଡିବା ଇତସ୍ତତଃ_ବୁଲିବା
eruct: ହେଉଡି
erupt: ବିନ୍ଧିବା ଫାଟିବା| ଜଳିବା ଦଗ୍ଦହେବା ଉଦ୍ଗିରଣ_ହେବା ଫୁଟିବା ବାହାରିବା ଫୁଟିବା|
escape: ଫେରାର_ହେବା ପଳାୟନ_କରିବା ଖସି_ପଳାଇବା ରକ୍ଷା_ପାଇବା ସ୍ପଷ୍ଟଭାବେ_ବଞ୍ଚିଯିବା ପଳେଇଯିବା|
eschew: ବଞ୍ଚିତ_ରହିବ ଦୂରେଇ_ରହିବା|
espouse: ବିବାହ_କରିବା ବାହାହେବା ପାଣିଗ୍ରହଣ_କରିବା
essay: ପରୀକ୍ଷା_କରିବା ପରୀକ୍ଷଣ_କରିବା ଜାଞ୍ଚ_କରିବା|
establish: ଚଳାଇବା ସ୍ଥାପନ_କରିବା ଅଧିଷ୍ଠିତ_କରିବା|
esteem: ସମ୍ମାନ_କରିବା ଆଦର_କରିବା
estimate: ଅନୁମାନକରିବା ଲକ୍ଷ_କରିବା ଧାରଣାକରିବା
evade: କଥା_ଟାଳିବା ଟାଳିବା
evaluate: ମୂଲ୍ୟାଙ୍କନ_କରିବା ମୂଲ୍ୟଧାରଣ_କରିବା ମୂଲ୍ୟ_ନିର୍ଣ୍ଣୟ_କରିବା
evaporate: ଫୁଟାଇବା ବମ୍ଫେଇବା ଜଳିବା ବାଷ୍ପିତହେବା
evince: ଜଣାଇବା ସୂଚନାଦେବା ସୂଚିତକରିବା ଜ୍ଞାତ_କରିବା ସତର୍କ_କରିବା
exalt: ପ୍ରେରିତ_କରିବା
examine: ସମୀକ୍ଷା_କରିବା| ପରୀକ୍ଷା_କରିବା ପରୀକ୍ଷଣ_କରିବା ଜାଞ୍ଚ_କରିବା|
excavate: ଖୋଳିବା ଖନନ_କରିବା
except: ଛାଡିବା|
exchange: ବଦଳେଇବା ଫେରେଇବା ଫେରସ୍ତ_କରିବା
excite: ଉସ୍କେଇବା ମତେଇବା ମତାଇବା ଉତ୍ସାହିତ_କରିବା ପ୍ରବର୍ତ୍ତେଇବା ପ୍ରବର୍ତ୍ତାଇବା ଟିହାଇବା ଉସକେଇବା ଚିଡେଇବା ଉତ୍ତେଜିତକରିବା|
exclaim: ଚିତ୍କାର_କରାଇବା
exclude: ଛାଡିବା| ବାହାର_କରିଦେବା
excogitate: ଆବିଷ୍କାର_କରିବା ଉଦ୍ଭାବନ_କରିବା ବାହାର_କରିବା ଖୋଜି_ବାହାର_କରିବା
exculpate: ଅପରାଧ_ମୁକ୍ତ_କରିବା ଦୋଷ_ମୁକ୍ତ_କରିବା ଛାଡିଦେବା
execute: ଚଳାଇବା ଚାଳିତକରିବା ଚାଲୁକରିବା_
exercise: କସରତ_କରାଇବା ବ୍ୟାୟାମ_କରାଇବା| ସାଧନା_କରିବା ଅଭ୍ୟାସ_କରିବା ସିଦ୍ଧହସ୍ତ_ହେବା ସିଦ୍ଧିଲାଭ_କରିବା
exhaust: ଲାଗିବା ଖର୍ଚ୍ଚହେବା
exhibit: ଦେଖାଇବା ଦେଖାଇବା ପ୍ରଦର୍ଶିତ_କରିବା ଶୋ_କରିବା ପ୍ରଦର୍ଶନ_କରିବା
exit: ମରିବା ପରଲୋକ_ଗମନ_କରିବା ପ୍ରାଣଛାଡିଯିବା ପ୍ରାଣବାୟୁ_ଉଡିଯିବା ମହା_ନିର୍ବାଣ_ପ୍ରାପ୍ତ_ହେବା ସ୍ୱର୍ଗପ୍ରାପ୍ତି_ହେବା
exonerate: ଅପରାଧ_ମୁକ୍ତ_କରିବା ଦୋଷ_ମୁକ୍ତ_କରିବା ଛାଡିଦେବା
expand: ପ୍ରସାରିତ ବିସ୍ତାରିତ ବ୍ୟାଖ୍ୟା_କରିବା ଅର୍ଥ_ବୁଝେଇବା ବିଶ୍ଳେଷଣ_କରିବା ବିସ୍ତାରିତ_ଭାବେ_ବର୍ଣ୍ଣନାକରିବା|
expatiate: ବ୍ୟାଖ୍ୟା_କରିବା ଅର୍ଥ_ବୁଝେଇବା ବିଶ୍ଳେଷଣ_କରିବା ବିସ୍ତାରିତ_ଭାବେ_ବର୍ଣ୍ଣନାକରିବା|
expect: ସମ୍ଭାବନା_ହେବା| ଚାହିଁ_ବସିବା ବେକାରରେ_ଅପେକ୍ଷା_କରିବା ବ୍ୟର୍ଥ_ପ୍ରତୀକ୍ଷା_କରିବା
expectorate: ଖଙ୍କାରିବା|
expel: ବାହାର_କରିଦେବା ଘଉଡାଇବା ତଡିବା
experience: ଭୋଗିବା ପାଇବା ଜାଣିବା ବୁଝିବା
expire: ମରିବା ପରଲୋକ_ଗମନ_କରିବା ପ୍ରାଣଛାଡିଯିବା ପ୍ରାଣବାୟୁ_ଉଡିଯିବା ମହା_ନିର୍ବାଣ_ପ୍ରାପ୍ତ_ହେବା ସ୍ୱର୍ଗପ୍ରାପ୍ତି_ହେବା
explain: ବୁଝେଇବା ବତେଇବା ଅବଗତ_କରିବା
explode: ଫୁଟାଇବା ଫାଟିବା
exploit: ଶୋଷିତ_କରିବା ଚୂଷିବା ଲୋଟିବା ଶୋଷଣ_କରିବା
expose: ଖୋଲିବା ପଦାକୁବାହାରିବା ଉନ୍ମୋଚନ_ହେବା| ଦେଖାଇବା
exposit: ବ୍ୟାଖ୍ୟା_କରିବା ଅର୍ଥ_ବୁଝେଇବା ବିଶ୍ଳେଷଣ_କରିବା ବିସ୍ତାରିତ_ଭାବେ_ବର୍ଣ୍ଣନାକରିବା|
expound: ବ୍ୟାଖ୍ୟା_କରିବା ଅର୍ଥ_ବୁଝେଇବା ବିଶ୍ଳେଷଣ_କରିବା ବିସ୍ତାରିତ_ଭାବେ_ବର୍ଣ୍ଣନାକରିବା|
express: ଜଣାଇବା ସୂଚନାଦେବା ସୂଚିତକରିବା ଜ୍ଞାତ_କରିବା ସତର୍କ_କରିବା ବ୍ୟକ୍ତକରିବା ଉପସ୍ଥାପିତକରିବା ଅଭିବ୍ୟକ୍ତକରିବା ବତାଇବା ଜଣାଇବା ଜ୍ଞାତ_କରାଇବା ଭାବବ୍ୟକ୍ତକରିବା ଭାବପ୍ରକଟକରିବା ଭାବବ୍ୟକ୍ତିକରିବା
express_joy: ହସିବା
express_mirth: ହସିବା
extend: ଯିବା ଚାଲିବା ଗମନ_କରିବା ଦୌଡିବା ବିସ୍ତାରିତ_ହେବା ବିସ୍ତୃତ_ହେବା ଦେବା ପ୍ରଦାନ_କରିବା ଅଳସ_ଭାଙ୍ଗିବା ଭିଡିମୋଡିହେବା
extinguish: ଲିଭେଇବା ପ୍ରସମିତକରିବା|
extort: ଠକିନେବା
extract: କାଢିବା ଟାଣିବା ଚୁଷିବା| ଆସବନ_କରିବା
extricate: ସମାଧାନ_ହେବା ଉତ୍ତର_ମିଳିବା
exuberate: ଖୁସିରେ_ନାଚିବା ଅତି_ଆନନ୍ଦିତ_ହେବା ଖୁସିରେ_କୁରୁଳିବା
exudate: ଝାଳେଇବା_|
exude: ଝାଳେଇବା_|
exult: ଖୁସିରେ_ନାଚିବା ଅତି_ଆନନ୍ଦିତ_ହେବା ଖୁସିରେ_କୁରୁଳିବା
face: ମୁକାବଲାକରିବା ଟକରଦେବା ମୁଁହାମୁଁହିହେବା| ମୁହଁ_କରିବା ମୁହଁ_ହେବା_ଜ୍ୟୋତିଷ ପ୍ରସ୍ତୁତ_କରିବା|
fade: ଉଡିଯିବା ଛାଡିଯିବା| ମଉଳିଯିବା ମ୍ଳାନ_ପଡିଯିବା ମ୍ଳାନ_ହେବା
fag: ଖଟେଇବା ରଗଡିବା ଲଗେଇବା ଥକି_ପଡିବା|
fag_out: ଥକି_ପଡିବା|
fail: ହାରିବା ବିଫଳହେବା| ଅନୁତ୍ତୀର୍ଣ୍ଣ_ହେବା ଉତ୍ତୀର୍ଣ୍ଣ_ନ_ହେବା
fall: ପଡିବା ପଡିଯିବା ଆସିବା ରହିବା କମ_ହେବା ହ୍ରାସ_ହେବା କମି_ଯିବା କ୍ଷୀଣ_ହେବା ଭାଙ୍ଗିପଡିବା ପଡିବା
fall_apart: ଫୁଟିବା ଭଗ୍ନ_ହେବା ଚୂନାହେବା ଗୁଣ୍ଡହେବା ଚୂରିହେବା ଚୂର୍ଣ୍ଣହେବା ଫାଟିବା|
fall_back: ପଛେଇ_ଯିବା ପଛରେ_ରହିଯିବା|
fall_behind: ପଛେଇ_ଯିବା ପଛରେ_ରହିଯିବା|
fall_down: ଭାଙ୍ଗିପଡିବା
fall_in: ଭୁଷୁଡି_ପଡିବା ଗଳିପଡିବା ଟଳିପଡିବା |
fall_out: ଝଡିବା ଖସିବା ଠିକ_ଘଟିବା ପ୍ରମାଣିତ_ହେବା
falsify: ମିଛ_କରିଦେବା
falter: ଥଙ୍ଗେଇବା ଅଟକିବା|
fan: ଉଡାଇବା
farm: ଚାଷ_କରିବା କୃଷି_କରିବା ଫସଲ_ଉତ୍ପାଦନ_କରିବା ସଶ୍ୟ_ଅମଳ_କରିବା ଉତ୍ପନ୍ନକରିବା ଉପୁଜେଇବା ଉତ୍ପାଦନକରିବା|
fart: ପାଡିବା ବାୟୁତ୍ୟାଗକରିବା
fascinate: ମୋହିତ_କରିବା ମୋହେଇବା ସମ୍ମୋହନ_କରିବା|
fast: କଷ୍ଟରେ_ରହିବା ବ୍ୟଥିତ_ହେବା
fasten: ଅଟକାଇବା ଟାଣିବା
fatigue: ଥକି_ପଡିବା|
fear: ଡରିବା ଭୟକରିବା ଭୟଭୀତ_ହେବା ଡରିବା ଭୟଭିତ_ହେବା ଡରିଯିବା ଶଙ୍କିଯିବା ଶଙ୍କା_ପଶିବା
feast: ଭୋଜୀ_ଦେବା ଭୋଜନ_ଦେବା ଖୁଆଇବା|
feather: ମଙ୍ଗୁଆଳ_ମୋଡିବା ମଙ୍ଗୁଆଳ_ଘୁରାଇବା ମଙ୍ଗଧରା_ମୋଡିବା ମଙ୍ଗଧରା_ଘୁରାଇବା
feature: ଦେଖାଇବା ପ୍ରଦର୍ଶନ_କରିବା ପ୍ରଦର୍ଶିତ_କରିବା ଉପସ୍ଥାପନ_କରିବା ପ୍ରତ୍ୟକ୍ଷ_କରାଇବା
feed: ଖୁଆଇବା ବୋହିବା ବାହାରିବା
feel: ଅନୁଭବ_କରିବା ବୋଧ_କରିବା ଜ୍ଞାନ_କରିବା ଅନୁଭୂତ_ହେବା
fell: ପକାଇଦେବା
fence: କାନ୍ଥଦ୍ବାରା_ଘେରାଇବା ପାଚେରୀଦ୍ବାରା_ଘେରାଇବା ଯୁକ୍ତିତର୍କକରିବା ବିତଣ୍ଡାକରିବା ବିବାଦକରିବା
fence_in: କାନ୍ଥଦ୍ବାରା_ଘେରାଇବା ପାଚେରୀଦ୍ବାରା_ଘେରାଇବା
ferment: କିଣ୍ବନ_କରିବା ଆମ୍ବିଳା_ହୋଇଯିବା ଖଟା_ହୋଇଯିବା
fete: ଉତ୍ସବ_ପାଳନ ପାଳନ_କରିବା
fight: ପ୍ରତିଦ୍ବନ୍ଦିତା_କରିବା ଲଢିବା_ ଲଢେଇ_କରିବା ଲଢିବା ସଂଗ୍ରାମ_କରିବା ଆନ୍ଦୋଳନ_କରିବା
figure_out: ସମାଧାନ_କରିବା ନିରାକରଣ_କରିବା ପ୍ରତିକାର_କରିବା ମୀମାଂସା_କରିବା
file: ଦାଏର_କରିବା ଦାଖଲ_କରିବା ଉପସ୍ଥାପନା_କରିବା ପେଶ_କରିବା
fill: ପୁରାଇବା ଭରିବା ବୋଝେଇକରିବା ଭର୍ତ୍ତିକରିବା ପୂର୍ଣ୍ଣକରିବା ଭର୍ତ୍ତିହେବା ପୁରିବା ଭର୍ତ୍ତି_ହେବା ଭରା_ହେବା ପରିପୂର୍ଣ୍ଣ_ହେବା| ଗ୍ରହଣ_କରିବା ନେବା ସ୍ବୀକାର_କରିବା ତୁଷ୍ଟ_ହେବା ତୃପ୍ତ_ହେବା ସନ୍ତୁଷ୍ଟ_ହେବା ଭରିବା ପୂରିବା ପୂର୍ଣ୍ଣହେବା ସମତଳ_ହେବା
fill_up: ପୁରାଇବା ଭରିବା ବୋଝେଇକରିବା ଭର୍ତ୍ତିକରିବା ପୂର୍ଣ୍ଣକରିବା ଭର୍ତ୍ତିହେବା ପୁରିବା
film: ଫିଲ୍ମ_କରାଇବା
filter: ସ୍ଥିର_ହୋଇଯିବା ବସିଯିବା ଟପ_ଟପ_କରିବା
filter_out: ସ୍ଥିର_ହୋଇଯିବା ବସିଯିବା
filtrate: ସ୍ଥିର_ହୋଇଯିବା ବସିଯିବା
find: ଆବିଷ୍କାର_କରିବା ଖୋଜି_ବାହାର_କରିବା ପତ୍ତା_ଲଗାଇବା ପୁଣି_ପ୍ରାପ୍ତ_କରିବା ପୁଣି_ଲାଭ_କରିବା ପୁଣି_ପ୍ରାପ୍ତ_କରିବା ପୁନର୍ବାର_ପାଇବା
finish: ସମାପ୍ତ_ହେବା ଶେଷ_ହେବା ସରିବା ହୋଇସାରିବା ଛୁଟିହେବା ସମାପ୍ତ_ହେବା|
fire: ଚଳାଇବା ମାରିବା ଫୁଟାଇବା| ବାହାରକରିଦେବା ଛୁଟିବା ଚାଲିବା
fire_up: ଜଳେଇବା ଇର୍ଷାନ୍ବିତ_କରାଇବା ଚିଡେଇବା
fit: ଫିଟ_ହେବା ଠିକ_ହେବା|
fit_out: ପିନ୍ଧାଇବା|
fix: ମରାମତି_କରିବା ସଜାଡିବା ଠିକ_କରିବା ଅଟକାଇବା ରାନ୍ଧିବା ରୋଷେଇ_କରିବା ଖାଦ୍ୟ_ତିଆରି_କରିବା ଖାଦ୍ୟ_ରାନ୍ଧିବା କହିବା କଥା_ଦେବା ଉଦ୍ୟତହେବା ପ୍ରସ୍ତୁତ_ହେବା ତତ୍ପର_ହେବା
fix_up: ସ୍ଥିର_କରିବା ନିର୍ଦ୍ଧାରଣ_କରିବା ନିଶ୍ଚିତ_କରିବା ଥୟ_କରିବା ନିର୍ଦ୍ଧାରିତ_କରିବା ନିର୍ଣ୍ଣୟ_କରିବା
flag: ଦବିବା|
flap: ଦୋଳାୟମାନ_ହେବା ଲହରେଇବା ପଡିବା_ଉଠିବା ତ୍ବରଣ_ହେବା ଫରଫର_ହୋଇ_ଉଡିବା ଆନ୍ଦୌଳିତ_ହେବା
flare: ବିନ୍ଧିବା ଫାଟିବା|
flare_up: ବିନ୍ଧିବା ଫାଟିବା|
flash: ଅଭିମାନ_ପ୍ରଦର୍ଶନ_କରିବା ଇଜ୍ଜତ_ଦେଖେଇବା
flaunt: ଅଭିମାନ_ପ୍ରଦର୍ଶନ_କରିବା ଇଜ୍ଜତ_ଦେଖେଇବା
flavor: ଛୁଙ୍କ_କରିବା ବଘାରିବା
flavour: ଛୁଙ୍କ_କରିବା ବଘାରିବା
fleece: ଲୋଟିବା ଠକିବା
fleet: ଘୂରିବୁଲିବା ଚକ୍କରକାଟିବା
flesh_out: ବ୍ୟାଖ୍ୟା_କରିବା ଅର୍ଥ_ବୁଝେଇବା ବିଶ୍ଳେଷଣ_କରିବା ବିସ୍ତାରିତ_ଭାବେ_ବର୍ଣ୍ଣନାକରିବା|
flex: ନୁଆଁଇବା ଝୁଙ୍କାଇବା ତଳକୁକରିବା|
flick: ଛାଟିବା ଟାଣିବା| ମିଞ୍ଜିମିଞ୍ଜିକରିବା ଧପଧପକରିବା|
flicker: ମିଞ୍ଜିମିଞ୍ଜିକରିବା ଧପଧପକରିବା|
flim-flam: ଆଖିରେ_ଧୂଳି_ଦେବା ଚକମା_ଦେବା
fling: ପକେଇବା ଫୋପାଡିବା
flip: ଟସ୍_କରିବା କଏନ୍_ପକାଇବା ଛାଟିବା ଟାଣିବା|
flirt: ଛଇ ଚତୁରୀ ଛୋପରି| ଖେଳିବା ବେଖାତିର_କରିବା ବେପରୁଆ_ହେବା
flit: ଘୂରିବୁଲିବା ଚକ୍କରକାଟିବା
float: ଚାଲିବା ଭାସିବା| ଭସାଇଦେବା ବିସର୍ଜନ_କରିବା ପ୍ରବାହିତ_କରିବା
flood: ବୁଡିଯିବା
floor: ଆଶ୍ଚର୍ଯ୍ୟାନ୍ବିତ_ହେବା ବିସ୍ମିତ_ହେବା ଚକିତ_ହେବା
flourish: ବୁଲାଇବା ଚଲାଇବା_
flow: ବୋହିବା ବାହାରିବା ବହାଇବା ପ୍ରବାହିତ_କରାଇବା
flower: ଫୁଟି_ଉଠିବା ଫୁଟିବା ପ୍ରସ୍ଫୁଟିତ_ହେବା ବିକଶିତ_ହେବା ଖେଳିଯିବା
fluctuate: ହଲିବା ଝୁଲିବା|
flump: କଚାଡିବା ଫୋପାଡିବା ଫିଙ୍ଗିବା|
flunk: ଅନୁତ୍ତୀର୍ଣ୍ଣ_ହେବା ଉତ୍ତୀର୍ଣ୍ଣ_ନ_ହେବା
flush: ଲଜ୍ଜିତହେବା ଲାଜେଇବା
flush_it: ଅନୁତ୍ତୀର୍ଣ୍ଣ_ହେବା ଉତ୍ତୀର୍ଣ୍ଣ_ନ_ହେବା
flutter: ଘୂରିବୁଲିବା ଚକ୍କରକାଟିବା ଫଡଫଡ_କରିବା କମ୍ପିତ_ହେବା ସ୍ପନ୍ଦିତ_ହେବା|
flux: ମିଶିବା|
fly: ଉଡିବା ଉଡେଇବା ଉଡିବା ଉଡାଇବା
fly_the_coop: ପଳେଇଯିବା|
fob: ଆଖିରେ_ଧୂଳି_ଦେବା ଚକମା_ଦେବା
focus: ଧ୍ୟାନ_କେନ୍ଦ୍ରୀଭୂତ_କରିବା ଧ୍ୟାନ_ଦେବା ଧ୍ୟାନ_ଏକାଗ୍ର_କରିବା
foist: ଲଦିଦେବା ଥୋପିଦେବା ଦେବା|
fold: ଚଉତିବା ବନ୍ଦ_କରିବା ଛୁଟି_କରିବା ଆବଦ୍ଧ_କରିବା
fold_up: ଚଉତିବା
follow: ପଛରେ_ଚାଲିବା ଅନୁଧାବନ_କରିବା ଅନୁସରଣ_କରିବା ଦେଖିବା ନଜର_ରଖିବା ପିଛା_କରିବା ଅନୁସରଣ_କରିବା|
fondle: ଆଉଁଷିବା|
fool: ବୋକା_ବନେଇବା ଓଲୁ_ବନେଇବା ଏପ୍ରିଲ_ଫୁଲ_କରିବା ଅପବ୍ୟୟ_କରିବା ପଇସା_ଉଡାଇବା
fool_away: ଅପବ୍ୟୟ_କରିବା ପଇସା_ଉଡାଇବା
foray: ଲୁଟପାଟ_କରିବା ଲୋଟିବା ଅପହରଣ_କରିବା
forbid: ମନାକରିବା ରୋକିବା ଅବରୋଧକରିବା
force: ଧକ୍କାଦେବା ଠେଲାପେଲା_ହେବା ଟାଣିବା
force_out: ବାହାରକରିଦେବା ମୂଳୋତ୍ପାଟନ_କରିବା ଉନ୍ମୂଳନ_କରିବା ନିର୍ମୂଳ_କରିବା
forge: ଆବିଷ୍କାର_କରିବା ଉଦ୍ଭାବନ_କରିବା ବାହାର_କରିବା ଖୋଜି_ବାହାର_କରିବା
forget: ଭୁଲିବା ଚାଲିଯିବା ଅତିକ୍ରାନ୍ତ_ହୋଇଯିବା ପଛରେ_ରହିଯିବା
forgive: କ୍ଷମା_କରାଇବା
forgo: ଛାଡି_ଦେବା ତ୍ୟାଗ_କରିବା
form: ବସାଇବା ରହିବା
formulate: ଆବିଷ୍କାର_କରିବା ଉଦ୍ଭାବନ_କରିବା ବାହାର_କରିବା ଖୋଜି_ବାହାର_କରିବା
foster: ରଖିବା
foul: ଅବରୁଦ୍ଧହେବା ବାଧାପଡିବା ଅଟକିଯିବା ବନ୍ଦହେବା ଫସିଯିବା
found: ଚଳାଇବା ସ୍ଥାପନ_କରିବା ଅଧିଷ୍ଠିତ_କରିବା|
founder: ଭୁଷୁଡି_ପଡିବା ଗଳିପଡିବା ଟଳିପଡିବା |
fox: ଆଖିରେ_ଧୂଳି_ଦେବା ଚକମା_ଦେବା ଭ୍ରମିତ_ହେବା ଭ୍ରମ_ହେବା ଅକଲ_ଗୁଡୁମ_ହେବା|
frame: ବନ୍ଧେଇ_କରାଇବା ବନ୍ଧାଇବା
free: ଖଲାସ_ହେବା ମୁକ୍ତ_ହେବା ମୁକାଳିବା ମୁକୁଳେଇବା ୱାପସଆଣିବା| ହଟେଇବା ଉଠେଇବା କାଟିଦେବା ଉଡେଇଦେବା| ପ୍ରଚଳନ_କରିବା ଜାରି_କରିବା ବାହାର_କରିବା ମୁକ୍ତ_କରିବା ସ୍ବାଧୀନ_କରିବା ସ୍ବତନ୍ତ୍ର_କରିବା
freeze: କୁଆପଥର ତୁଷାର_ଖଣ୍ଡ| ଜମିବା
freeze_down: ଜମିବା
freeze_off: ତଡି_ଦେବା ପ୍ରତ୍ୟାଖାନ_କରିବା
freeze_out: ଜମିବା
french-fry: ଛଣାହେବା
fret: ଚିଡିଚିଡ_ହେବା ବିରକ୍ତ_ହେବା_
fright: ଡରେଇବା ଭୟଭୀତ_କରିବା ଭୟ_ସୃଷ୍ଟି_କରିବା
frighten: ଡରେଇବା ଭୟଭୀତ_କରିବା ଭୟ_ସୃଷ୍ଟି_କରିବା
frighten_away: ଡରାଇବା ଭୟଭୀତକରାଇବା ଭୟାତୁର_କରାଇବା
frighten_off: ଡରାଇବା ଭୟଭୀତକରାଇବା ଭୟାତୁର_କରାଇବା
frisk: ଡିଆଁଡେଇଁ_କରିବା ଡିଆଁକୁଦା_କରିବା ଖେଳକୁଦ_କରିବା ଘୋ-ଘା_କରିବା
fritter: ଅପବ୍ୟୟ_କରିବା ପଇସା_ଉଡାଇବା
fritter_away: ଅପବ୍ୟୟ_କରିବା ପଇସା_ଉଡାଇବା
frivol_away: ଅପବ୍ୟୟ_କରିବା ପଇସା_ଉଡାଇବା
frizz: ପାକଳହେବା ଶକ୍ତହେବା ମଝବୁତହେବା
frizzle: ପାକଳହେବା ଶକ୍ତହେବା ମଝବୁତହେବା
frolic: ଡିଆଁଡେଇଁ_କରିବା ଡିଆଁକୁଦା_କରିବା ଖେଳକୁଦ_କରିବା ଘୋ-ଘା_କରିବା
front: ମୁହଁ_କରିବା ମୁହଁ_ହେବା_ଜ୍ୟୋତିଷ
frown: କ୍ରୋଧାନ୍ବିତ_ହେବା
fruit: ଫଳନ୍ତି_ହେବା ଫଳିବା
fuck: ରତିକରିବା ରମଣକରିବା ସମ୍ଭୋଗକରିବା
fuddle: ନିଶା_ହେବା ଭ୍ରମିତ_ହେବା ଭ୍ରମ_ହେବା ଅକଲ_ଗୁଡୁମ_ହେବା|
fudge: କଥା_ଟାଳିବା ଟାଳିବା
function: ଚାଲିବା ଉପଯୋଗରେ_ଆସିବା କାମ_କରିବା
furbish_up: ମରାମତି_କରିବା ସଜାଡିବା ଠିକ_କରିବା
furnish: ଯୋଗାଇଦେବା ପ୍ରଦାନ_କରିବା ଉପଲବ୍ଧ_କରିବା
fuse: ମିଶିବା|
gabble: ଅଯଥା_କଥା_କହିବା ବକ୍‌ବକ୍‌_କରିବା ବକ୍‌_ବକ୍‌_ହେବା
gad: ବିନା_କାରଣରେ_ବୁଲିବା
gag: ବାନ୍ତି_ଲାଗିବା ଓକାର_ଦେଖେଇବା|
gain: ପାଇବା ପ୍ରାପ୍ତ_କରିବା ମିଳିବା| ଫଳିବା ଆସିବା ପହଞ୍ଚିବା ଆଗମନ_କରିବା ଉପସ୍ଥିତ_ହେବା ଜିତିବା ଜୟ_ଜରିବା ବିଜୟୀ_ହେବା| ଦାମ୍‌ବଢିବା ଭାଉବଢିବା
gain_ground: ଜିତିବା ଜୟ_ଜରିବା ବିଜୟୀ_ହେବା|
gallivant: ବିନା_କାରଣରେ_ବୁଲିବା
gamble: ଜୁଆ_ଖେଳିବା ପଶା_ଖେଳିବା ପାଲି_ଖେଳିବା ଦ୍ୟୁତକ୍ରୀଡା_କରିବା
gambol: ଡିଆଁଡେଇଁ_କରିବା ଡିଆଁକୁଦା_କରିବା ଖେଳକୁଦ_କରିବା ଘୋ-ଘା_କରିବା
garb: ପିନ୍ଧାଇବା|
garble: ମିଛ_କରିଦେବା
garment: ପିନ୍ଧାଇବା|
garner: ଅର୍ଜନ_କରିବା କମେଇବା ଏକାଠିକରିବା ମେଣ୍ଡେଇବା ଗଦେଇବା|
gas: ଫୁଟାଣି_ମାରିବା ବଡିମା_ଦେଖାଇବା ଆସ୍ଫାଳନ_କରିବା
gasconade: ଫୁଟାଣି_ମାରିବା ବଡିମା_ଦେଖାଇବା ଆସ୍ଫାଳନ_କରିବା
gasp: ଧଇଁସଇଁ_ହେବା
gather: ଏକାଠିକରିବା ମେଣ୍ଡେଇବା ଗଦେଇବା| ରୁଣ୍ଡହେବା ଏକାଠି_ହେବା ଏକତ୍ରିତ_ହେବା ଜମିବା
gather_up: ଉଠେଇବା
gauge: ଅନୁମାନକରିବା ଲକ୍ଷ_କରିବା ଧାରଣାକରିବା
gaze: ଆଖିପକାଇବା ନଜର_ଲଗାଇବା
gazump: ଲୋଟିବା ଠକିବା
gear_up: ଉଦ୍ୟତହେବା ପ୍ରସ୍ତୁତ_ହେବା ତତ୍ପର_ହେବା
gentle: ମନାଇବା ପ୍ରସନ୍ନ_କରେଇବା
germinate: ଅଙ୍କୁର_ବାହାରିବା ଅଙ୍କୁରିତ_ହେବା ଗଜେଇବା ଗଜା_ବାହାରିବା
gesticulate: ସଙ୍କେତ_ଦେବା ସଙ୍କେତ_କରିବା ଇସାରା_କରିବା ଇଙ୍ଗିତ_କରିବା ଠାର_ମାରିବା
gesture: ସଙ୍କେତ_ଦେବା ସଙ୍କେତ_କରିବା ଇସାରା_କରିବା ଇଙ୍ଗିତ_କରିବା ଠାର_ମାରିବା
get: ମିଳିବା ପାଇବା ହାସଲ_କରିବା ପ୍ରାପ୍ତକରିବା ଧରି_ପକାଇବା ଗିରଫ_କରିବା କରିବା ତିଆରିକରିବା ବନାଇବା| ଉଠାଇବା ଆରମ୍ଭ_କରିବା ବାହାର_କରିବା
get_across: ଥୟକରିବା ସ୍ଥିରକରିବା ନିଶ୍ଚିତ_କରିବା ନିର୍ଦ୍ଦିଷ୍ଟ_କରିବା
get_ahead: ଜିତିବା ଜୟ_ଜରିବା ବିଜୟୀ_ହେବା|
get_along: ପଟିବା ଉନ୍ନତି_କରିବା ଉନ୍ନତ_ହେବା ବିକାଶ_କରିବା ବଢିବା|
get_along_with: ପଟିବା
get_around: ସାମାଜିକ_ହେବା
get_away: ଫେରାର_ହେବା ପଳାୟନ_କରିବା ଖସି_ପଳାଇବା ରକ୍ଷା_ପାଇବା ସ୍ପଷ୍ଟଭାବେ_ବଞ୍ଚିଯିବା
get_back: ଫେରିବା ଆସିବା ଲେଉଟିବା
get_by: ଖସି_ପଳାଇବା ରକ୍ଷା_ପାଇବା ସ୍ପଷ୍ଟଭାବେ_ବଞ୍ଚିଯିବା
get_down: ଓହ୍ଲାଇବା ଗିଳିବା ହତୋତ୍ସାହିତ_ହେବା| ଉଠାଇବା ଆରମ୍ଭ_କରିବା ବାହାର_କରିବା
get_going: ଖୋଲିବା|
get_hitched_with: ବିବାହ_କରିବା ବାହାହେବା ପାଣିଗ୍ରହଣ_କରିବା
get_in: ପ୍ରବେଶ_କରିବା ପଶିବା ଭିତରକୁ_ଆସିବା ଉପସ୍ଥିତ_ହେବା ଆସିବା|
get_into: ପ୍ରବେଶ_କରିବା ପଶିବା ଭିତରକୁ_ଆସିବା ଉପସ୍ଥିତ_ହେବା ଆସିବା|
get_it_on: ରତିକରିବା ରମଣକରିବା ସମ୍ଭୋଗକରିବା
get_laid: ରତିକରିବା ରମଣକରିବା ସମ୍ଭୋଗକରିବା
get_married: ବିବାହ_କରିବା ବାହାହେବା ପାଣିଗ୍ରହଣ_କରିବା
get_off: ଖସି_ପଳାଇବା ରକ୍ଷା_ପାଇବା ସ୍ପଷ୍ଟଭାବେ_ବଞ୍ଚିଯିବା
get_on: ପଟିବା ଚଢିବା ବସିବା ଆରୋହଣ_କରିବା ଅବସ୍ଥାନ_କରିବା ଆସୀନ_ହେବା ଉନ୍ନତି_କରିବା ଉନ୍ନତ_ହେବା ବିକାଶ_କରିବା ବଢିବା| ବୁଢା_ହେବା ବୃଦ୍ଧ_ହେବା
get_on_with: ପଟିବା
get_out: ବାହାର_କରିବା କାଢିବା| ଖସି_ପଳାଇବା ରକ୍ଷା_ପାଇବା ସ୍ପଷ୍ଟଭାବେ_ବଞ୍ଚିଯିବା
get_over: ଥୟକରିବା ସ୍ଥିରକରିବା ନିଶ୍ଚିତ_କରିବା ନିର୍ଦ୍ଦିଷ୍ଟ_କରିବା
get_the_better_of: ହରେଇବା ପରାଜିତ_କରିବା ପରାସ୍ତ_କରିବା
get_the_picture: ବୁଝେଇବା ଧରିବା
get_to: ପହଞ୍ଚିବା ଉପନୀତ_ହେବା|
get_up: ଉଠେଇବା
gibber: ଅଯଥା_କଥା_କହିବା ବକ୍‌ବକ୍‌_କରିବା ବକ୍‌_ବକ୍‌_ହେବା
gift: ଉପହାର_ଦେବା
giggle: ଖିଲ୍‌ଖିଲ୍‌_ହସ
gimp: ଛୋଟେଇବା|
gip: ଠକିବା
give: ଦେବା ପ୍ରଦାନ_କରିବା ଆୟୋଜନ_କରିବା ଆୟୋଜିତ_ହେବା ଯୋଗାଡ_କରିବା ଉପହାର_ଦେବା ଧରାଇବା ରଖିବା_ ସମର୍ପିତ_କରିବା| ଭୁଷୁଡି_ପଡିବା ଗଳିପଡିବା ଟଳିପଡିବା | ଖୋଲିବା
give-up_the_ghost: ମରିବା ପରଲୋକ_ଗମନ_କରିବା ପ୍ରାଣଛାଡିଯିବା ପ୍ରାଣବାୟୁ_ଉଡିଯିବା ମହା_ନିର୍ବାଣ_ପ୍ରାପ୍ତ_ହେବା ସ୍ୱର୍ଗପ୍ରାପ୍ତି_ହେବା
give_away: ଖୋଲିବା ପଦାକୁବାହାରିବା ଉନ୍ମୋଚନ_ହେବା|
give_back: ଚୁକ୍ତି_ହେବା
give_birth: ଜନ୍ମକରିବା ଜନ୍ମ_ଦେବା ଉତ୍ପନ୍ନ_କରିବା ପ୍ରସବ_କରିବା
give_chase: ଦୌଡେଇବା
give_in: ଅଧୀନ_ହେବା ଅନୁଗତ_ହେବା
give_notice: ବାହାରକରିଦେବା
give_the_axe: ବାହାରକରିଦେବା
give_the_sack: ବାହାରକରିଦେବା
give_tongue_to: ବ୍ୟକ୍ତକରିବା ଉପସ୍ଥାପିତକରିବା ଅଭିବ୍ୟକ୍ତକରିବା
give_up: ଛାଡିଦେବା ଦାୟିତ୍ବ_ଦେବା ନ୍ୟସ୍ତ_କରିବା ଜିମା_କରିବା ଛାଡି_ଦେବା ତ୍ୟାଗ_କରିବା
give_way: ଭୁଷୁଡି_ପଡିବା ଗଳିପଡିବା ଟଳିପଡିବା |
glean: ଫସଲ_କାଟିବା ଫସଲ_କଟାଇବା
glom: ଚୋରେଇବା ଅପହରଣ_କରିବା ହାତ_ମାରିବା
glow: ଚମକିବା ଝଲମଲ_କରିବା ଦମକିବା
glower: କ୍ରୋଧାନ୍ବିତ_ହେବା
glue: ଲଗାଇବା ଚପେଇବା ଲଖେଇବା ମାରିବା
glut: ତୃପ୍ତ_ହେବା
gnarl: ଗୁଣୁଗୁଣୁ_ହେବା
go: ଜାଣିବା ଅଙ୍ଗେ_ନିଭେଇବା ଅନୁଭବ_କରିବା ଅବଗତ_ହେବା ଉପଲବ୍ଧି_କରିବା ପ୍ରସ୍ଥାନ_କରିବା ଯିବା ଗମନକରିବା ବାହାରିବା ଯିବା ଚାଲିବା ଗମନ_କରିବା ଦୌଡିବା ବିସ୍ତାରିତ_ହେବା ବିସ୍ତୃତ_ହେବା ଚାଲିବା ଉପଯୋଗରେ_ଆସିବା କାମ_କରିବା ମରିବା ପରଲୋକ_ଗମନ_କରିବା ପ୍ରାଣଛାଡିଯିବା ପ୍ରାଣବାୟୁ_ଉଡିଯିବା ମହା_ନିର୍ବାଣ_ପ୍ରାପ୍ତ_ହେବା ସ୍ୱର୍ଗପ୍ରାପ୍ତି_ହେବା ଖୋଲିବା| ଯିବା ବ୍ୟାପ୍ତ_ହେବା ପ୍ରସାରିତ_ହେବା ଖର୍ଚ୍ଚହୋଇଯିବା ଖର୍ଚ୍ଚହେବା ବ୍ୟୟହେବା_
go_after: ଦୌଡେଇବା
go_along: ଚାଲିବାକୁ_ଦେବା ଚଲାଇବା ପରିଚାଳିତ_କରିବା ଚାଲୁରହିବା ଜାରି_ରଖିବା
go_around: ପ୍ରଘଟ_କରିବ| ପରିକ୍ରମା_କରିବା ବୁଲିବା ଘୁରିବା ଚକକର_ମାରିବା
go_away: ପ୍ରସ୍ଥାନ_କରିବା ଯିବା ଗମନକରିବା ବାହାରିବା ଛାଡି_ଦେବା ନ_ଦିଶିବା ହଜିଯିବା ଉଡିଯିବା ହଜିଯିବା ଛୁ_ମନ୍ତର_ହୋଇଯିବା|
go_back: ଫେରିବା ଆସିବା ଲେଉଟିବା
go_bad: ସଢିବା ପଚିବା ଦବିବା|
go_by: ଯିବା ଚାଲିବା
go_down: ପଶିବା ପଶିଯିବା ଅସ୍ତ_ହେବା ବୁଡିବା ଡୁବିବା
go_forth: ଛାଡି_ଦେବା ବାହାରିବା ନିର୍ଗମ_ହେବା
go_forward: ଚାଲିବା ବଢିବା ମାଡିବା|
go_in: ପ୍ରବେଶ_କରିବା ପଶିବା ଭିତରକୁ_ଆସିବା ଉପସ୍ଥିତ_ହେବା ଆସିବା|
go_into: ପ୍ରବେଶ_କରିବା ପଶିବା ଭିତରକୁ_ଆସିବା ଉପସ୍ଥିତ_ହେବା ଆସିବା|
go_off: ଲିଭିଯିବା ଛୁଟିବା ଚାଲିବା
go_on: ଚାଲିବାକୁ_ଦେବା ଚଲାଇବା ପରିଚାଳିତ_କରିବା ଚାଲୁରହିବା ଜାରି_ରଖିବା ଠିକ_ଘଟିବା ପ୍ରମାଣିତ_ହେବା
go_out: ମିଶିବା ଦେଖାହେବା ସାକ୍ଷାତ_କରିବା ଭେଟିବା ଏକତ୍ର_ହେବା ସଙ୍ଗୀହେବା ସଂସର୍ଗରେ_ରହିବା
go_past: ଯିବା ଚାଲିବା
go_steady: ମିଶିବା ଦେଖାହେବା ସାକ୍ଷାତ_କରିବା ଭେଟିବା ଏକତ୍ର_ହେବା ସଙ୍ଗୀହେବା ସଂସର୍ଗରେ_ରହିବା
go_through: ଭୋଗିବା ପାଇବା ଗିଳିବା ଗେଫିବା ଗ୍ରାସକରିବା
go_under: ପଶିବା ପଶିଯିବା ଅସ୍ତ_ହେବା ବୁଡିବା ଡୁବିବା
go_up: ଚଢିବା ଉଠିବା ଆରୋହଣ_କରିବା
go_wrong: ହାରିବା ବିଫଳହେବା|
gobble: ଭକ୍ଷଣ_କରିବା ଖାଇବା|
goldbrick: ଠକିବା
gorge: ତୃପ୍ତ_ହେବା
gormandise: ତୃପ୍ତ_ହେବା
gormandize: ତୃପ୍ତ_ହେବା
gossip: ଆଲୋଚନା କଥାବାର୍ତ୍ତା ବାର୍ତ୍ତାଳାପ କଥା_
gouge: ଠକିନେବା
gourmandize: ତୃପ୍ତ_ହେବା
grab: କ୍ଷୀପ୍ର_ଗତିରେ_କାବୁ_କରିବା ଫୂର୍ତ୍ତିରେ_ଅକ୍ତିଆର_କରିବା ଶୀଘ୍ର_ଆଗକୁ_ବଢି_ଧରିବା ନେବା ଲୁଟି_ନେବା ଅପହରଣ_କରିନେବା
grace: ସଜେଇବା ଅଳଙ୍କୃତ_କରିବା ସଜ୍ଜିତ_କରିବା ଶୋଭାନ୍ବିତ_ହେବା ଶୋଭିତ_ହେବା_
grant: ସ୍ବୀକୃତିଦେବା ସହମତ_ଦେବା ମତପ୍ରଦାନକରିବା ସମ୍ମତିଦେବା ହାର_ମାନିବା ଅସ୍ତ୍ରସମର୍ପଣ_କରିବା ନଇଁବା
grapple: କାବୁକରିବା ଆୟତ୍ତକରିବା ଶକ୍ତିହୀନକରିବା
grasp: ବୁଝେଇବା ଧରିବା
grate: ଘଷିବା କଟକଟ_ହେବା
gratify: ସନ୍ତୁଷ୍ଟ_କରିବା ତୃପ୍ତ_କରିବା
gravitate: ଆକର୍ଷିତ_ହେବା ମୋହିତ_ହେବା ମନ୍ତ୍ର_ମୁଗ୍ଧ_ହେବ|
graze: ଚରିବା ଚରାଇବା
grease_one's_palms: ଲାଞ୍ଚଦେବା ତେଲେଇବା ଉତ୍କୋଚଦେବା
green: ସବୁଜରଙ୍ଗ|
grieve: ଚିନ୍ତା_କରିବା ଭାବିବା ଦୁଃଖିତ_ହେବା ପୀଡିତ_ହେବା ଉଦାସ_ହେବା
grime: ଗୋଳିଆ_କରିବା ମଇଳା_କରିବା ଅପରିଷ୍କାର_କରିବା
grind: ଚୁଡୁମୁଡୁ_ହେବା କଟକଟ_ହେବା ଚୂରିବା ଚୂନାକରିବା ପେଷିବା ଗୁଣ୍ଡକରିବା ଚୂର୍ଣ୍ଣକରିବା ଖଟେଇବା ରଗଡିବା ଲଗେଇବା
grip: କାବୁକରିବା ଆୟତ୍ତକରିବା ଶକ୍ତିହୀନକରିବା
groan: ହୁଙ୍କାର_ମାରିବା ଶବ୍ଦକରିବା ଚିତ୍କାରକରିବା
grok: ବୁଝେଇବା ଧରିବା
groom: ବ୍ୟବସ୍ଥା_କରିବା ପ୍ରସ୍ତୁତ_ହେବା ତିଆରି_କରିବା ଆୟୋଜନ_କରିବା ବନ୍ଦୋବସ୍ତ_କରିବା
grope_for: ଅଣ୍ଡାଳିବା ଦରାଣ୍ଡିବା ଖୋଜିବା
ground: ଲଙ୍ଗର_ପକାଇବା ଲଙ୍ଗର_ବାନ୍ଧିବା
grow: ବିକଶିତ_ହେବା ଉନ୍ନତ_ହେବା ପ୍ରସାରିତ_ହେବା| ଉତ୍ପନ୍ନ_ହେବା ଉପୁଜିବା| ସୃଷ୍ଟିହେବା ଜାତ_ହେବା ଉତ୍ପନ୍ନ_ହେବା ଉତ୍ପନ୍ନକରିବା ଉପୁଜେଇବା ଉତ୍ପାଦନକରିବା|
growl: ଗର୍ଜ୍ଜିବା
grumble: ଗୁଣୁଗୁଣୁ_ହେବା ଗର୍ଜ୍ଜିବା ଘଡଘଡି_ମାରିବା
gruntle: ମନାଇବା ପ୍ରସନ୍ନ_କରେଇବା
guess: ଅନୁମାନକରିବା ଲକ୍ଷ_କରିବା ଧାରଣାକରିବା
gull: ବୋକା_ବନେଇବା ଓଲୁ_ବନେଇବା ଏପ୍ରିଲ_ଫୁଲ_କରିବା
guy: ଉପହାସ_କରିବା ନିନ୍ଦା_କରିବା ଦୋଷ_ବାହାର_କରିବା ହସି_ଉଡାଇବା|
gyp: ଠକିବା
gyrate: ଘୁରିବା ଚକକର_ମାରିବା ଚକରି_ଖାଇବା ଭଉଁରି_କାଟିବା ନାଚିବା|
habilitate: ପିନ୍ଧାଇବା|
habituate: ସେବନକରିବା ଉପଭୋଗକରିବା ଅଭ୍ୟସ୍ତ_ହେବା
hack: ହ୍ୟାକିଂ_କରିବା କାଶିବା
hack_on: ହ୍ୟାକିଂ_କରିବା
hallow: ଅଭିମନ୍ତ୍ରଣ_କରିବା
halt: ଅଟକିବା ବନ୍ଦହେବା ଗତିରୋଧ_ହେବା ରହିଯିବା
hammer: ବାଡେଇବା ପିଟିବା ଠୁକିବା|
hand: ଧରାଇବା ରଖିବା_ ପହଞ୍ଚାଇବା
handle: ସମ୍ଭାଳିହେବା| ବ୍ୟବହାର_କରିବା ଆଚରଣ_କରିବା ବେଭାରକରିବା
hanker: ବିକଳ_ହେବା ବ୍ୟାକୁଳ_ହେବା
hap: ଠିକ_ଘଟିବା ପ୍ରମାଣିତ_ହେବା
happen: ଠିକ_ଘଟିବା ପ୍ରମାଣିତ_ହେବା ଆସିବା ଆଗମନ_ହେବା ଘଟିବା ଆରମ୍ଭ_ହେବା ଉପସ୍ଥିତ_ହେବା
harass: ହଇରାଣ_କରିବା ପୀଡିତ_କରିବା|
harbor: ଗୁପ୍ତରେ_ଶରଣ_ଦେବା ଗୁପ୍ତରେ_ଆଶ୍ରୟ_ଦେବା ଗୁପ୍ତରେ_ସୁରକ୍ଷା_ଦେବା
harbour: ଗୁପ୍ତରେ_ଶରଣ_ଦେବା ଗୁପ୍ତରେ_ଆଶ୍ରୟ_ଦେବା ଗୁପ୍ତରେ_ସୁରକ୍ଷା_ଦେବା
harden: ନୀରୋଗ_କରିବା ସୁସ୍ଥକରିବା ରୋଗଶୂନ୍ୟ_କରିବା ସ୍ବାସ୍ଥ୍ୟବାନ୍_କରିବା ସୁସ୍ଥସବଳ_କରିବା ସ୍ବାସ୍ଥ୍ୟଯୁକ୍ତ_କରିବା
harness: ଯୋଚିବା ଯୋଡିବା
harrow: ମଇଦେବା_
harry: ହଇରାଣ_କରିବା ପୀଡିତ_କରିବା|
harvest: ଫସଲ_କାଟିବା ଫସଲ_କଟାଇବା
hash_out: ଯୁକ୍ତିତର୍କ ବାଦବିବାଦ ତର୍କବିତର୍କ ବିତଣ୍ଡା
hassle: ହଇରାଣ_କରିବା ପୀଡିତ_କରିବା|
hatch: ଉଷୁମାଇବା
hate: ଘୃଣା_କରିବା ଖରାପ_ଭାବିବା ନୀଚବୋଲି_ଭାବିବା
have: ହେବା ରହିବା ଥିବା ଘଟିବା ସଂପର୍କ_ଥିବା ଆୟୋଜନ_କରିବା ଆୟୋଜିତ_ହେବା ଯୋଗାଡ_କରିବା ବଳିବା ନେବା ଗ୍ରହଣ_କରିବା ପ୍ରାପ୍ତ_କରିବା ପାଇବା ପାଇବା ହାସଲ_କରିବା ପ୍ରାପ୍ତକରିବା ଜନ୍ମକରିବା ଜନ୍ମ_ଦେବା ଉତ୍ପନ୍ନ_କରିବା ପ୍ରସବ_କରିବା
have_a_go_at_it: ରତିକରିବା ରମଣକରିବା ସମ୍ଭୋଗକରିବା
have_intercourse: ରତିକରିବା ରମଣକରିବା ସମ୍ଭୋଗକରିବା
have_it_away: ରତିକରିବା ରମଣକରିବା ସମ୍ଭୋଗକରିବା
have_it_off: ରତିକରିବା ରମଣକରିବା ସମ୍ଭୋଗକରିବା
have_on: ପିନ୍ଧିବା ପରିଧାନ_କରିବା ଧାରଣ_କରିବା
have_sex: ରତିକରିବା ରମଣକରିବା ସମ୍ଭୋଗକରିବା
have_words: ଧିକ୍କାରିବା ଗାଳିଦେବା ଅପମାନ_କରିବା ତିରସ୍କାର_କରିବା
head_for_the_hills: ପଳେଇଯିବା|
hear: ଶୁଣିବା ଶ୍ରବଣ_କରିବା ଶୁଣିବା ଶୁଣିବା ମାନିବା|
heat: ଗରମ_କରିବା ତତାଇବା ଜଳେଇବା ଇର୍ଷାନ୍ବିତ_କରାଇବା ଚିଡେଇବା ସେକିବା
heat_up: ସେକିବା ଗରମ_କରିବା ତତାଇବା
heave: ଧଇଁସଇଁ_ହେବା ବାନ୍ତି_ଲାଗିବା ଓକାର_ଦେଖେଇବା|
hedge: କଥା_ଟାଳିବା ଟାଳିବା
hee-haw: ରଡି ବୋବାଳି
help: ସାହାଯ୍ୟ_କରିବା ସହାୟତା_କରିବା ସହଯୋଗ_କରିବା ହାତ_ବଢେଇବା | ପରଷିବା ବାଢିବା
hem: ସିଲେଇ_କରିବା ସିଇଁବା_
hem_in: ଘେରାଉ_କରିବା ଘେରିବା ଅବରୋଧ_କରିବା
hesitate: ଅଟକିଯିବା_
hiccough: ହେକୁଡି_ହେବା ହେକୁଡି_ମାରିବା_|
hiccup: ହେକୁଡି_ହେବା ହେକୁଡି_ମାରିବା_|
hide: ଲୁଚେଇବା ଲୁଚିବା ଛପିବା
hide_out: ଲୁଚିବା ଛପିବା
hightail_it: ପଳେଇଯିବା|
hinder: ଅଟକାଇବା
hire: ଭଡାରେ_ନେବା ଭଡା_କରିବା ଭଡା_ନେବା|
hiss: ଫଁ_ଫଁ_ହେବା ଫଁ_ଫଁ_କରିବା ଫୁଫୁକାର_କରିବା ଗର୍ଜନ_କରିବା ଫୁତ୍କାର_କରିବା
hit: ଧକକା_ହେବା ବାଡେଇହେବା ମାରିବା ଆସିବା ପହଞ୍ଚିବା ଆଗମନ_କରିବା ଉପସ୍ଥିତ_ହେବା ପହଞ୍ଚିବା ମରିବା ହତ୍ୟାକରିବା ଜୀବନନେବା ଶେଷକରିବା ଖଲାସକରିବା
hit_the_books: ପଢିବା ଅଧ୍ୟୟନ_କରିବା
hitch: ଛୋଟେଇବା|
hive_away: ଗଚ୍ଛିତ_କରିବା ରଖିବା|
hoard: ସଞ୍ଚୟ_କରିବା ସଂଗ୍ରହ_କରିବା ଏକାଠି_କରିବା ଏକତ୍ରିତ_କରିବା
hobble: ଛୋଟେଇବା|
hoist: ହଲାଇବା ଲହରାଇବା
hold: ଆୟୋଜନ_କରିବା ଆୟୋଜିତ_ହେବା ଯୋଗାଡ_କରିବା ରଖିବା ଚଳାଇବା ନିର୍ବାହ_କରିବା ସ୍ଥାପନ_କରିବା ଧାରଣ_କରିବା ଧରିବା ରଖିବା ରହିବା| ସମ୍ଭାଳିବା ଆୟତ୍ତ_କରିବା ସଂଯତ_କରିବା ସହିବା ସ୍ଥିର_ରହିବା ଅଟକେଇବା ସମ୍ଭାଳିବା ଧରିବା ରଖିବା ଭର୍ତ୍ତିକରିବା ଭରିବା ପୂରେଇବା ସଂରକ୍ଷଣ_କରିବା ଆରକ୍ଷିତ_କରିବା
hold_back: ମନମାରିବା
hold_fast: ଜଡିଯିବା ଲାଗିଯିବ ଯୋଡିଯିବା
hold_in: ସମ୍ଭାଳିବା ଆୟତ୍ତ_କରିବା ସଂଯତ_କରିବା ସହିବା ସ୍ଥିର_ରହିବା
hold_on: ରଖିବା
hold_out: ଅଟକାଇଦେବା ରୋକିଦେବା ଚାଲିବା ରହିବା|
hold_over: ସ୍ଥଗିତ_ରଖିବା
hold_up: ଅଟକେଇବା ସମ୍ଭାଳିବା ଧରିବା ରଖିବା
holler: ଚିଲ୍ଲାଇବା ରଡି_କରିବା ଚିତ୍କାର_କରିବା ଗର୍ଜନ_କରିବା
hollo: ଚିଲ୍ଲାଇବା ରଡି_କରିବା ଚିତ୍କାର_କରିବା ଗର୍ଜନ_କରିବା
hollow: ଖୋଳିବା ଖନନ_କରିବା
hone: ନିପୂଣ_କରିବା ପ୍ରବୀଣ_କରିବା ପାରଙ୍ଗମ_କରିବା ଦକ୍ଷକରିବା
honk: ଥୁକିବା ଛେପପକାଇବା
hook: ଲୋଟିବା ଠକିବା ଚୋରେଇବା ଅପହରଣ_କରିବା ହାତ_ମାରିବା ପଡିବା|
hook_up_with: ବିବାହ_କରିବା ବାହାହେବା ପାଣିଗ୍ରହଣ_କରିବା
hop: ଡେଇବା କୁଦାମାରିବା ଦୁମ୍_ଦୁମ୍_କରିବା|
hop-skip: ଡେଇବା କୁଦାମାରିବା ଦୁମ୍_ଦୁମ୍_କରିବା|
hop_on: ଚଢିବା ବସିବା ଆରୋହଣ_କରିବା ଅବସ୍ଥାନ_କରିବା ଆସୀନ_ହେବା
hornswoggle: ଠକିବା
hospitalise: ଭର୍ତ୍ତି_କରାଇବା
hospitalize: ଭର୍ତ୍ତି_କରାଇବା
hot_up: ସେକିବା
house: ଘର_ଦେବା ଜାଗାଦେବା
hover: ଢଳିବା ଆକୃଷ୍ଟ_ହେବା
hug: କୁଣ୍ଢେଇ_ପକାଇବା ଆଲିଙ୍ଗନ_କରିବା
hull: ଛେଲିବା ଛଡେଇବା
hum: ଗୁଣୁଗୁଣେଇବା
hump: ରତିକରିବା ରମଣକରିବା ସମ୍ଭୋଗକରିବା
hunger: ଭୋକେଇବା ଭୋଖେଇବା ଭୋକିଲାହେବା
hunt: ଶିକାର_କରିବା|
hunt_down: ଶିକାର_କରିବା|
hurt: ବିନ୍ଧିବା ଯନ୍ତ୍ରଣା_ହେବା ପୀଡାଦେବା ଆଘାତ_କରିବା କେଞ୍ଚିବା ଖୋବିବା| ଦୁଃଖ_ଦେବା ଲାଗିବା କାଟିଲା ବାଧିବା କଷ୍ଟହେବା କଣ୍ଟା_ଫୋଡିବା ଖଟକା_ଲାଗିବା ଅପ୍ରିୟ_ଲାଗିବା ଖରାପ_ଲାଗିବା ପୀଡାହେବା ଯନ୍ତ୍ରଣାହେବା| କଷ୍ଟ_ସହିବା ଦୁଃଖ_ସହିବା କଷ୍ଟ_ଭୋଗିବା
hush: ମୌନ_ହେବା ଚୁପ_ହେବା|
ideate: କଳ୍ପନା_କରିବା ମାନିବା ଭାବିବା ଗ୍ରହଣ_କରିବା
identify: ଚିହ୍ନିବା ଜାଣିବା ବତାଇବା କହିବା
idle: ଆଳସ୍ୟ_କରିବା ଅଳସାଇବା
ignite: ଜଳେଇବା ଫୁଙ୍କିବା ଜଳିବା ଦଗ୍ଦହେବା ଜଳେଇବା ଇର୍ଷାନ୍ବିତ_କରାଇବା ଚିଡେଇବା
ignore: ଅବମାନନା_କରିବା ଉପେକ୍ଷା_କରିବା ରଦ୍ଦ_କରିବା ରଦ୍ଦ_କରି_ଦେବା ଖାରିଜ_କରିବା| ଛାଡିବା ଅବହେଳା_କରିବା ଧ୍ୟାନ_ନଦେବା
illume: ଆଲୋକିତ_ହେବା ପ୍ରକାଶିତ_ହେବା
illuminate: ଆଲୋକିତ_ହେବା ପ୍ରକାଶିତ_ହେବା
illumine: ଆଲୋକିତ_ହେବା ପ୍ରକାଶିତ_ହେବା
imagine: କଳ୍ପନା_କରିବା ମାନିବା ଭାବିବା ଗ୍ରହଣ_କରିବା
imbed: ପୋତିବା
imbibe: ଶୋଷଣ_କରିବା ଅବଶୋଷିତ_କରିବା ଟାଣିବା ପିଇବା| ପିଇବା ପାନ_କରିବା
imitate: ଅନୁକରଣ_କରିବା ନକଲ୍_କରିବା
immix: ମିଶିବା|
impart: ଖୋଲିବା ପଦାକୁବାହାରିବା ଉନ୍ମୋଚନ_ହେବା|
impede: ଅଟକାଇବା ରଖିବା ରୋକିବା ଅଟକାଇବା
imperil: ବିପଦରେ_ପକାଇବା ସଙ୍କଟରେ_ପକାଇବା ସମସ୍ୟାରେ_ପକାଇବା
impersonate: ଅଭିନୟ_କରିବା ରୋଲ_କରିବା|
impinge_on: ଧକକା_ହେବା ବାଡେଇହେବା
implant: ପୋତିବା
impose: ଆଦାୟ_କରିବା
imprecate: ଗାଳିଦେବା
impress: ପ୍ରଭାବିତ_କରିବା ପ୍ରଭାବ_ପକାଇବା ଛାପିବା
imprint: ବସାଇବା ରହିବା ଛାପିବା
improve: ବିକଶିତ_କରିବା ବଢେଇବା ଉନ୍ନତ_କରିବା ସୁଧୁରିବା
incise: ଉତ୍କୀର୍ଣ୍ଣ_କରିବା ଖୋଦିତ_କରିବା ଖୋଦନ_କରିବା|
include: ମିଶିବା ସମାବିଷ୍ଟ_ହେବା ବିଲୀନ_ହେବା|
incommode: ଅସୁବିଧାରେ_ପକାଇବା ଝଞ୍ଜଟରେ_ପକାଇବା ଜଞ୍ଜାଳରେ_ପକାଇବା ଗୋଳମାଳରେ_ପକାଇବା ସମସ୍ୟାରେ_ପକାଇବା ହଇରାଣ_କରିବା
inconvenience: ଅସୁବିଧାରେ_ପକାଇବା ଝଞ୍ଜଟରେ_ପକାଇବା ଜଞ୍ଜାଳରେ_ପକାଇବା ଗୋଳମାଳରେ_ପକାଇବା ସମସ୍ୟାରେ_ପକାଇବା ହଇରାଣ_କରିବା
increase: ବଢାଇବା ଅଧିକ_କରାଇବା ବୃଦ୍ଧି_କରାଇବା ବର୍ଦ୍ଧିତ_କରାଇବା
incubate: ଉଷୁମାଇବା
indemnify: କ୍ଷତିପୂରଣ_କରିବା
indite: ଲେଖିବା ରଚନା_କରିବା
induct: ବସାଇବା ଆସୀନ_କରିବା|
inebriate: ନିଶା_ଖାଇବା ନିଶାପାଣି_କରିବା
infatuate: ବାୟୁକୋଣ ଉତ୍ତର-ପଶ୍ଚିମ_ଦିଗ ବାୟୁ_ଦିଗ__
inflame: ଜଳେଇବା ଇର୍ଷାନ୍ବିତ_କରାଇବା ଚିଡେଇବା
inflate: ଫୁଲାଇବା ବତୁରାଇବା
inform: ଆଲୋକପାତ_କରିବା ବିବରଣୀ_ଦେବା ଅବଗତ_କରାଇବା ଜ୍ଞାତ_କରାଇବା
ingurgitate: ତୃପ୍ତ_ହେବା
inhabit: ରହିବା ନିବାସକରିବା ବାସକରିବା
inhibit: ହରେଇବା ହାଲିଆ_କରିଦେବା|
inject: ଟୀକା_ଲଗାଇବା ଟୀଙ୍କା_ଲଗାଇବା ଇଞ୍ଜେସନ_ଲଗାଇବା|
injure: କଷ୍ଟ_ଦେବା| କଣ୍ଟା_ଫୋଡିବା ଖଟକା_ଲାଗିବା ଅପ୍ରିୟ_ଲାଗିବା ଖରାପ_ଲାଗିବା ଲାଗିବା କାଟିଲା ବାଧିବା କଷ୍ଟହେବା
inquire: ଦେଖିବା ଅନୁସାନ୍ଧନ_କରିବା ଯାଞ୍ଚ_କରିବା ଅନ୍ବେଷଣ_କରିବା|
inspect: ଦେଖିବା ଯାଞ୍ଚ୍_କରିବା ତଦାରଖ_କରିବା
inspire: ପ୍ରେରିତ_କରିବା
inspissate: ବହଳିଆ_ହେବା ଗାଢା_ହେବା
institute: ସ୍ଥାପନ_କରିବା ଅଧିଷ୍ଠିତ_କରିବା|
instruct: ଶିକ୍ଷା_ଦେବା ଶିଖେଇବା ବତେଇବା| ବତେଇବା ବୁଝେଇବା ଶିଖେଇବା
instrument: ସଜାଇବା ସୁସଜ୍ଜିତ_କରିବା ସଜ୍ଜିତ_କରିବା ସଜ୍ଜୀକୃତ_କରିବା ସଜ୍ଜୀକରଣ_କରିବା
insult: ଅପମାନିତ_କରିବା ତିରସ୍କାର_କରିବା ଅପମାନ_ଦେବା
intend: ଅର୍ଥ_ବାହାରକରିବା
interdict: ମନାକରିବା ରୋକିବା ଅବରୋଧକରିବା
interest: ଚିନ୍ତାଲାଗିବା|
interfere: ପଡିବା ଆସିବା|
interpose: ପଡିବା ଆସିବା|
interpret: ଅନୁବାଦ_କରିବା ଭାଷାନ୍ତର_କରିବା ଭାଷାନ୍ତରଣ_କରିବା ରୂପାନ୍ତର_କରିବା ତର୍ଜମା_କରିବା ବୁଝିବା
interrogate: ଉଖୁରେଇବା
interrupt: କଥା_ମଝିରେ_କଥା_କହିବା ତୁଟାଇବା ଭଙ୍ଗ_କରିବା ଶେଷ_କରିବା ସମାପ୍ତ_କରିବା
intervene: ପଡିବା ଆସିବା|
intoxicate: ଘାରିହେବା ନିଶାସକ୍ତ_ହେବା ନିଶା_ଖାଇବା ନିଶାପାଣି_କରିବା
introduce: ପରିଚୟ_କରାଇବା ଭେଟ_କରଇବା ସାକ୍ଷାତ_କରାଇବା
intrude: ପଶିବା ଅନୁପ୍ରବେଶ_କରିବା ପ୍ରବେଶ_କରିବା ପଶିଯିବା|
intumesce: ଫୁଲିବା ସ୍ଫୀତ_ହେବା
invade: ଆକ୍ରମଣ_କରିବା
inveigle: ବହଲାଇବା ଆହ୍ଲାଦିତ_କରିବା ପ୍ରବୋଧିତ_କରିବା
invent: ଆବିଷ୍କାର_କରିବା ଉଦ୍ଭାବନ_କରିବା ବାହାର_କରିବା ଖୋଜି_ବାହାର_କରିବା
invest: ଲଗାଇବା ଖଟାଇବା ନିବେଶ_କରିବା ବସାଇବା ଆସୀନ_କରିବା|
investigate: ଅନୁସାନ୍ଧନ_କରିବା ଯାଞ୍ଚ_କରିବା ଅନ୍ବେଷଣ_କରିବା|
invigorate: ପ୍ରେରିତ_କରିବା
invite: ଲୋଭାଇବା ଲାଳସେଇବା| ନିମନ୍ତ୍ରଣ_କରିବା ଆମନ୍ତ୍ରଣ_କରିବା ଡାକିବା ନିମନ୍ତ୍ରିତ_କରିବା
invoke: ଗୁହାରି_କରିବା ନିବେଦନ_କରିବା ଅପିଲ୍‌_କରିବା
involve: ସାମିଲ_କରିବା ସମ୍ମିଳିତ_କରିବା ମିଶେବା ଚାହିଦା_ରହିବା
irrigate: ମଡାଇବା ବଳେଇବା
irrupt: ବିନ୍ଧିବା ଫାଟିବା|
issue: ବାହାରିବା ପ୍ରକାଶିତ_ହେବା ଜାରି_କରିବା ପ୍ରକାଶ_କରିବା ପ୍ରବର୍ତ୍ତିତ_କରିବା ବାହାରିବା ନିର୍ଗମ_ହେବା
itch: କୁଣ୍ଡେଇବା କୁଣ୍ଡେଇହେବା କଣ୍ଡୁହେବା
jab: ଭୁସିବା କେଞ୍ଚିବା ବିନ୍ଧିବା ହାଣିବା
jabber: ହାଙ୍କିମରିବା ବଢେଇ_ଚଢେଇ_କହିବା ଫୋପାଡିବା
jade: ଥକି_ପଡିବା|
jam: ରଖିବା ରୋକିବା ଅଟକାଇବା
jangle: ଠନଠନ_କରିବା
jaw: ଆଲୋଚନା କଥାବାର୍ତ୍ତା ବାର୍ତ୍ତାଳାପ କଥା_ କାମୁଡିବା ଚୋବାଇବା ଦବାଇବା ଧିକ୍କାରିବା ଗାଳିଦେବା ଅପମାନ_କରିବା ତିରସ୍କାର_କରିବା
jazz: ରତିକରିବା ରମଣକରିବା ସମ୍ଭୋଗକରିବା
jazz_around: ବିନା_କାରଣରେ_ବୁଲିବା
jeopardise: ବିପଦରେ_ପକାଇବା ସଙ୍କଟରେ_ପକାଇବା ସମସ୍ୟାରେ_ପକାଇବା
jeopardize: ବିପଦରେ_ପକାଇବା ସଙ୍କଟରେ_ପକାଇବା ସମସ୍ୟାରେ_ପକାଇବା
jest: ଥଟ୍ଟା_କରିବା ପରିହାସ_କରିବା ମଜା_କରିବା ବିନୋଦ_କରିବା
jest_at: ଉପହାସ_କରିବା ନିନ୍ଦା_କରିବା ଦୋଷ_ବାହାର_କରିବା ହସି_ଉଡାଇବା|
jib: ଅଡିବସିବା ଅଡିବା ଜିଦକରିବା ଅଝଟକରିବା
jingle: ଠନଠନ_କରିବା
jingle-jangle: ଠନଠନ_କରିବା
join: ମିଶିବା| ଯୋଡିହେବା ଲଗେଇବା ସଂଯୁକ୍ତ_କରିବା ସଂଲଗ୍ନ_କରିବା
joke: ଥଟ୍ଟା_କରିବା ପରିହାସ_କରିବା ମଜା_କରିବା ବିନୋଦ_କରିବା
jollify: ହୋ_ହଲ୍ଲା_କରିବା ଘୋ-ଘା_କରିବା କୋଳାହଳ_କରିବା ଚିତ୍କାର_କରିବା ଉତ୍ପାତ_କରିବା ପାଟିତୁଣ୍ଡ_କରିବା ହୁରି_ପକାଇବା
joy: ପ୍ରସନ୍ନହେବା ପରିତୃପ୍ତହେବା ପରିତୁଷ୍ଟହେବା ସନ୍ତୁଷ୍ଟହେବା ତୃପ୍ତହେବା ପରିତୋଷହେବା ଖୁସିହେବା ସନ୍ତୋଷହେବା ପ୍ରୀତହେବା
jubilate: ଖୁସିରେ_ନାଚିବା ଅତି_ଆନନ୍ଦିତ_ହେବା ଖୁସିରେ_କୁରୁଳିବା
judder: ହଲିବା|
judge: ଅନୁମାନକରିବା ଲକ୍ଷ_କରିବା ଧାରଣାକରିବା
jump: ଡେଇଁବା ଲମ୍ଫପ୍ରଦାନ_କରିବା| ଉଛୁଳି_ଉଠିବା ଚମକି_ପଡିବା ଉଠିବା ଡେଇଁବା ଡିଆଁ_ମାରିବା|
jump_on: ଚଢିବା ବସିବା ଆରୋହଣ_କରିବା ଅବସ୍ଥାନ_କରିବା ଆସୀନ_ହେବା
junket: ଭୋଜୀ_ଦେବା ଭୋଜନ_ଦେବା ଖୁଆଇବା|
keel: ଟଳଟଳ_ହେବା ଟଳମଳ_ହେବା|
keen: ଆର୍ତ୍ତନାଦ_କରିବା ଜୋରରେ_କାନ୍ଦିବା କ୍ରନ୍ଦନ_କରିବା
keep: ରଖିବା ଚଳାଇବା ନିର୍ବାହ_କରିବା ସ୍ଥାପନ_କରିବା ଧାରଣ_କରିବା ଚାଲିବାକୁ_ଦେବା ଚଲାଇବା ପରିଚାଳିତ_କରିବା ଚାଲୁରହିବା ଜାରି_ରଖିବା ରଖିବା ଜଗିବା ପହରାଦେବା ରକ୍ଷାକରିବା ସମ୍ଭାଳିବା ମନମାରିବା ପୋଷିବା ପାଳିବା ରହିବା ସୁରକ୍ଷିତ_ରଖିବା
keep_an_eye_on: ଦେଖିବା ନଜର_ରଖିବା
keep_back: ମନମାରିବା ରୋକିବା ରୋକିଦେବା ବନ୍ଦକରିବା|
keep_down: ଅଧୀନ_କରିବା କରଗତ_କରିବା ବଶକୁ_ଆଣିବା|
keep_up: ସମ୍ଭାଳିବା ସୁରକ୍ଷିତ_ରଖିବା
kibosh: ରହିଯିବା
kick: ଗୋଇଠା_ମାରିବା ଲାତ_ମାରିବା ଗୋଇଠା_ମାରିବା
kick_out: ବାହାର_କରିଦେବା
kick_the_bucket: ମରିବା ପରଲୋକ_ଗମନ_କରିବା ପ୍ରାଣଛାଡିଯିବା ପ୍ରାଣବାୟୁ_ଉଡିଯିବା ମହା_ନିର୍ବାଣ_ପ୍ରାପ୍ତ_ହେବା ସ୍ୱର୍ଗପ୍ରାପ୍ତି_ହେବା
kick_upstairs: ପଦୋନ୍ନତି_କରିବା ପଦୋନ୍ନତି_ହେବା
kidnap: ଅପହରଣ_କରିବା ହରଣ_କରିବା|
kill: ମରେଇବା ହତ୍ୟାକରେଇବା
kink: ପାକଳହେବା ଶକ୍ତହେବା ମଝବୁତହେବା
kink_up: ପାକଳହେବା ଶକ୍ତହେବା ମଝବୁତହେବା
kip: ଶୋଇବା ନିଦ୍ରାଯିବା
kiss: ଚୁମା ଚୁମ୍ବନ
knap: ତୋଳିବା
knead: ଚକଟିବା ଦଳିବା ମର୍ଦ୍ଦନକରିବା ମାଲିସ୍_କରିବା
knit: ମକଚିବା ଦଳିବା
knock: ବାଡେଇବା ଧକ୍କାଦେବା ଟପ୍ଟପ୍_କରିବା ନିନ୍ଦାକରିବା ଖରାପକହିବା ଖଚକହିବା ବଦନାମକରିବା ଆଙ୍ଗୁଳିଦେଖେଇବା
knock_off: ଚୋରେଇବା ଅପହରଣ_କରିବା ହାତ_ମାରିବା
know: ଜାଣିବା ଜ୍ଞାନ_ହେବା ପରିଚିତ_ହେବା ଅଭିଜ୍ଞ_ହେବା ଆସିବା ଜାଣିବା ଜାଣିବା ଚିହ୍ନିବା ଜାଣିବା ବୁଝିବା ମାନିବା ସ୍ବୀକାରକରିବା ବୁଝିବା| ରତିକରିବା ରମଣକରିବା ସମ୍ଭୋଗକରିବା ବୁଝିବା ଜାଣିବା ବୁଝିପାରିବା ଚିହ୍ନିବା ଜାଣିବା
knuckle_under: ଅଧୀନ_ହେବା ଅନୁଗତ_ହେବା
labor: ଖଟେଇବା ରଗଡିବା ଲଗେଇବା
labour: ଖଟେଇବା ରଗଡିବା ଲଗେଇବା
lade: ଲଦାଇବା ବୋଝେଇ_କରାଇବା
laden: ଲଦାଇବା ବୋଝେଇ_କରାଇବା
lag: ପଛେଇ_ଯିବା ପଛରେ_ରହିଯିବା|
lam: ପଳେଇଯିବା|
lambast: ଧିକ୍କାରିବା ଗାଳିଦେବା ଅପମାନ_କରିବା ତିରସ୍କାର_କରିବା
lambaste: ଧିକ୍କାରିବା ଗାଳିଦେବା ଅପମାନ_କରିବା ତିରସ୍କାର_କରିବା
lament: ଆର୍ତ୍ତନାଦ_କରିବା ଜୋରରେ_କାନ୍ଦିବା କ୍ରନ୍ଦନ_କରିବା
lampoon: ବ୍ୟଙ୍ଗ_କରିବା|
languish: ଲଳାୟିତ_ହେବା ଲାଳସା_କରିବା
lap: ଚାଟିବା ଲେହନ_କରିବା ଚାଟିବା ପୋଛିପାଛି_ଖାଇବା ଲେହନ_କରିବା
lap_up: ଚାଟିବା ପୋଛିପାଛି_ଖାଇବା ଲେହନ_କରିବା
lapse: ଶେଷ_ହେବା ସମାପ୍ତ_ହେବା|
lark: ଡିଆଁଡେଇଁ_କରିବା ଡିଆଁକୁଦା_କରିବା ଖେଳକୁଦ_କରିବା ଘୋ-ଘା_କରିବା
lark_about: ଡିଆଁଡେଇଁ_କରିବା ଡିଆଁକୁଦା_କରିବା ଖେଳକୁଦ_କରିବା ଘୋ-ଘା_କରିବା
larn: ଶିକ୍ଷାକରିବା ଶିଖିବା
lasso: ଫସେଇବା ଫାନ୍ଦିବା|
last: ରହିବ|
laugh: ହସିବା
laugh_at: ଉପହାସ_କରିବା ନିନ୍ଦା_କରିବା ଦୋଷ_ବାହାର_କରିବା ହସି_ଉଡାଇବା|
launch: ଚଳାଇବା
launder: ସଫା_କରିବା ଧୋଇବା କାଚିବା|
lay: ରଖିବା ଶୁଆଇବା ଗଡେଇବା
lay_in: ଗଚ୍ଛିତ_କରିବା ରଖିବା|
lay_off: ଛାଡିଦେବା
lay_out: ଯୁକ୍ତି_କରିବା ସାମନାକୁ_ଆଣିବା ତର୍କ_କରିବା ଯୁକ୍ତି_ବାଢିବା
laze: ଆଳସ୍ୟ_କରିବା ଅଳସାଇବା
lead: ଯିବା ଚାଲିବା ଗମନ_କରିବା ଦୌଡିବା ବିସ୍ତାରିତ_ହେବା ବିସ୍ତୃତ_ହେବା ପଛରେ_ପକାଇବା ଅଧିକ_ଉନ୍ନତି_କରିବା ଅଗ୍ରସର_ହେବା ଯିବା ବ୍ୟାପ୍ତ_ହେବା ପ୍ରସାରିତ_ହେବା
lead_astray: ବାଟବଣା_କରିବା ବାଟ_ଭୁଲେଇ_ଦେବା| ଧୋକାଖାଇବା ଫୁସୁଲେଇବା|
lead_off: ଉଠାଇବା ଆରମ୍ଭ_କରିବା
lead_on: ଛଳନା_କରିବା ଛଳ_କରିବା_ଧୋକାଦେବା ପ୍ରବଞ୍ଚନା_କରିବା ଆଖିରେ_ଧୂଳି_ଦେବା
lean: ନଇଁବା ବଙ୍କା_ହେବା ଝୁଙ୍କିବା
leap: ଡେଇଁବା ଲମ୍ଫପ୍ରଦାନ_କରିବା| ଡେଇଁବା ଡିଆଁ_ମାରିବା|
learn: ଶିକ୍ଷାକରିବା ଶିଖିବା ଶିକ୍ଷା_ଦେବା ଶିଖେଇବା ବତେଇବା|
lease: ଭଡାରେ_ନେବା ଭଡା_ଦେବା| ଭଡା_କରିବା ଭଡା_ନେବା|
leash: ବାନ୍ଧିବା ଗ୍ରନ୍ଥନ
leave: ଛାଡି_ଦେବା ଛାଡିବା ଦୂରେଇଦେବା ବାହାରିଯିବା ପୃଥକ_ହେବା ଅଲଗା_ହେବା ହଟିଯିବା| ଉଇଲ୍_କରିବା ଇଚ୍ଛାପତ୍ର_କରିବା ଚାଲିଯିବା ଅତିକ୍ରାନ୍ତ_ହୋଇଯିବା ପଛରେ_ରହିଯିବା
leave_off: ଛାଡିବା|
leave_out: ଛାଡିବା| ଛାଡିଦେବା ପଳେଇଲା|
lecture: ଧିକ୍କାରିବା ଗାଳିଦେବା ଅପମାନ_କରିବା ତିରସ୍କାର_କରିବା
lengthen: ଲମ୍ବାକରିବା ବଢାଇବା
lenify: ମନାଇବା ପ୍ରସନ୍ନ_କରେଇବା
lessen: କମ_ହେବା ହ୍ରାସ_ହେବା କମି_ଯିବା କ୍ଷୀଣ_ହେବା ଛାଡିବା ଓହ୍ଲାଇବା|
let: ଭଡା_ଦେବା|
let_down: ଓହ୍ଲାଇବା
let_loose: ରାବିବା_
let_on: ଖୋଲିବା ପଦାକୁବାହାରିବା ଉନ୍ମୋଚନ_ହେବା|
let_out: ରାବିବା_ ଖୋଲିବା ପଦାକୁବାହାରିବା ଉନ୍ମୋଚନ_ହେବା|
levy: ଆଦାୟ_କରିବା
liberate: ଖଲାସ_ହେବା ମୁକ୍ତ_ହେବା
librate: ମପାହେବା ମପାଇବା|
lick: ଚାଟିବା ଲେହନ_କରିବା ସମାଧାନ_କରିବା ନିରାକରଣ_କରିବା ପ୍ରତିକାର_କରିବା ମୀମାଂସା_କରିବା ଚାଟିବା ପୋଛିପାଛି_ଖାଇବା ଲେହନ_କରିବା
lie: ରହିବା ଅବସ୍ଥାନ_କରିବା ଅବସ୍ଥିତ_ହେବା ମିଛ_କହିବା ଅସତ୍ୟ_କହିବା ମିଥ୍ୟାକଥା_କହିବା ଗଡିବା ଶୋଇବା
lie_down: ଗଡିବା ଶୋଇବା
lie_in_wait: ଗୁପ୍ତ_ଆକ୍ରମଣପାଇଁ_ରହିବା
lie_with: ରତିକରିବା ରମଣକରିବା ସମ୍ଭୋଗକରିବା
lift: ଉଠେଇବା ଉଠିବା ଉଚ୍ଚା_ହେବା| ଉଠେଇବା ଉଚ୍ଛେଦକରିବା ସମାପ୍ତକରିବା ହଟେଇବା ବନ୍ଦକରିବା
lift_up: ଉଠେଇବା ଘାରିହେବା ନିଶାସକ୍ତ_ହେବା
light: ଆଲୋକିତ_ହେବା ପ୍ରକାଶିତ_ହେବା ଜଳେଇବା ଫୁଙ୍କିବା
light_up: ଆଲୋକିତ_ହେବା ପ୍ରକାଶିତ_ହେବା
like: ଇଚ୍ଛା_ହେବା ଚାହିଁବା ମନ_ହେବା ଅଭିଳାଷ_କରିବା ପସନ୍ଦ_ଆସିବା ଭଲ_ଲାଗିବା ପୋଷେଇବା
limit: ନିଷେଧ_କରିବା ମନା_କରିବା ବାରଣ_କରିବା ପ୍ରତିବନ୍ଧକ_ଲଗାଇବା
limp: ଛୋଟେଇବା|
line: ଧାଡିରେ_ରହିବା ଶ୍ରେଣୀବଦ୍ଧହେବା ପଂକ୍ତିବଦ୍ଧହେବା ଟାଣିବା ଖିଞ୍ଚିବା
link: ଜୋଡିବା ଲଗାଇବା ମିଶାଇବା_| ଯୋଡିହେବା ଲଗେଇବା ସଂଯୁକ୍ତ_କରିବା ସଂଲଗ୍ନ_କରିବା
link_up: ଯୋଡିହେବା ଲଗେଇବା ସଂଯୁକ୍ତ_କରିବା ସଂଲଗ୍ନ_କରିବା ଜୋଡିବା ଲଗାଇବା ମିଶାଇବା_|
listen: ଶୁଣିବା ମାନିବା|
listen_in: ଲୁଚିକରି_ଶୁଣିବା
live: ରହିବା ନିବାସକରିବା ବାସକରିବା ବଞ୍ଚିରହିବା ଜୀଇଁବା ଜୀବିତ_ରହିବା ଜୀବନ_ଯାପନ_କରିବା ଜୀବନ_ବିତାଇବା ଜାଣିବା ବୁଝିବା
load: ଲଦାଇବା ବୋଝେଇ_କରାଇବା ଲଦିବା ଚଢେଇବା
load_up: ଲଦାଇବା ବୋଝେଇ_କରାଇବା
locate: ବତାଇବା ନିର୍ଦ୍ଦେଶ_କରିବା ଦେଖାଇବା ରହିବା ବାସକରିବା
lodge: ରହିବା ଅଟକିବା_ ରଖିବା ଆଶ୍ରୟ_ଦେବା
log_z's: ଶୋଇବା ନିଦ୍ରାଯିବା
long: ବିକଳ_ହେବା ବ୍ୟାକୁଳ_ହେବା
look: ଦେଖିବା ନିରେଖେଇବା ଦେଖିବା ଦୃଷ୍ଟିଗୋଚର_ହେବା ମୁହଁ_କରିବା ମୁହଁ_ହେବା_ଜ୍ୟୋତିଷ ଦେଖାଇବା ଅନୁଭବ_କରାଇବା ଚାହିଁ_ବସିବା ବେକାରରେ_ଅପେକ୍ଷା_କରିବା ବ୍ୟର୍ଥ_ପ୍ରତୀକ୍ଷା_କରିବା
look_at: ନେବା
look_for: ଖୋଜିବା ପତା_ଲଗାଇବା
loose: ଖଲାସ_ହେବା ମୁକ୍ତ_ହେବା
loot: ଲୋଟିବା ଲୁଟପାଟ_କରିବା ଲୋଟିବା ଅପହରଣ_କରିବା
lop_off: କାଟିବା
lord: ମୂଖ୍ୟ_କରାଇବା ଅଧିପତି_କରାଇବା ମାଲିକ_କରାଇବା
lose: ପାଗଳହେବା ବାଇଆହେବା| ହରେଇବା ହାରିବା ପକେଇବା| ଜୀବନଦେବା ଜୀବନହରେଇବା ରହିଯିବା|
lot: ବାଣ୍ଟିବା ବିତରଣ_କରିବା
lour: କ୍ରୋଧାନ୍ବିତ_ହେବା
love: ସ୍ନେହ_କରିବା_ ରତିକରିବା ରମଣକରିବା ସମ୍ଭୋଗକରିବା
low: ହମ୍ବାଳିବା ହମ୍ବା_ରଡିକରିବା ହମାଳିବା
lower: ଓହ୍ଲାଇବା କ୍ରୋଧାନ୍ବିତ_ହେବା
lucubrate: ବ୍ୟାଖ୍ୟା_କରିବା ଅର୍ଥ_ବୁଝେଇବା ବିଶ୍ଳେଷଣ_କରିବା ବିସ୍ତାରିତ_ଭାବେ_ବର୍ଣ୍ଣନାକରିବା|
lull: କମାଇଦେବା ହ୍ରାସକରିବା ଥଣ୍ଡାକରିବା ଶାନ୍ତକରିବା ନିର୍ବାପିତକରିବା
lurch: ଟଳଟଳ_ହେବା ଟଳମଳ_ହେବା|
lure: ଲୋଭଦେଖେଇବା|
lurk: ଗୁପ୍ତ_ଆକ୍ରମଣପାଇଁ_ରହିବା
maintain: ରଖିବା ଚଳାଇବା ନିର୍ବାହ_କରିବା ସ୍ଥାପନ_କରିବା ଧାରଣ_କରିବା ସମ୍ଭାଳିବା ସୁରକ୍ଷିତ_ରଖିବା ସମ୍ଭାଳିବା ଜଗିବା ପହରାଦେବା ରକ୍ଷାକରିବା
major: ମୂଖ୍ୟବିଷୟ_ରୂପେ_ପଢିବା ମୂଖ୍ୟ_ବିଷୟ_ହେବା
make: କରିବା କରିବା ତିଆରିକରିବା ବନାଇବା| କରିବା କାରଣ_ହେବା ହେତୁ_ହେବା ନିମିତ୍ତ_ହେବା କାରଣ_ହେବା ହେତୁହେବା ନିମିତ୍ତହେବା ଗଢିବା ତିଆରିକରିବା ନିର୍ମାଣ_କରିବା ପହଞ୍ଚିବା ଉପନୀତ_ହେବା| ଉଠିବା ତିଆରି_ହେବା| କରେଇବା ନିଯୁକ୍ତ_କରିବା ପାଇବା ହାସଲ_କରିବା ପ୍ରାପ୍ତକରିବା ଆସିବା ପହଞ୍ଚିବା ଆଗମନ_କରିବା ଉପସ୍ଥିତ_ହେବା କରିବା ଜାତ_କରିବା ସୃଷ୍ଟି_କରିବା ଉତ୍ପନ୍ନ_କରିବା ଯୋଡିବା ମିଶେଇଦେବା ଯୋଗକରିବା ମିଶାଣ_କରିବା ଆୟୋଜନ_କରିବା ଆୟୋଜିତ_ହେବା ଯୋଗାଡ_କରିବା ରାନ୍ଧିବା ରୋଷେଇ_କରିବା ଖାଦ୍ୟ_ତିଆରି_କରିବା ଖାଦ୍ୟ_ରାନ୍ଧିବା ଝାଡା_ଫେରିବା ଝାଡାଯିବା ହଗିବା ମଳତ୍ୟାଗ_କରିବା ପାଇଖାନା_ଯିବା ତିଆରି_ହେବା ଗଢାହେବା ନିର୍ମାଣ_ହେବା ପ୍ରସ୍ତୁତି_ହେବା ଉପଯୁକ୍ତ_ହେବା ଆଣିବା କରିବା ବଦଳାଇବା ପରିବର୍ତ୍ତନ_କରିବା ଚିହ୍ନିବା ଜାଣିବା ଲାଗିବା ଜଣାପଡିବା ବୋଧହେବା ପ୍ରତୀତ_ହେବା ଅବଗତ_ହେବା ଜ୍ଞାତହେବା ଠିକ_ସମୟରେ_ପହଞ୍ଚିବା ଠିକ_ସମୟରେ_ଉପସ୍ଥିତ_ହେବା ଜଳାଇବା ପ୍ରଜ୍ଜ୍ବଳିତ_କରିବା| ସଫଳ_କରିବା| ଦେଖାଇହେବା ମୂଲ୍ୟାଙ୍କନ_କରିବା ମୂଲ୍ୟନିର୍ଦ୍ଧାରଣ_କରିବା ମୂଲ୍ୟାୟନ_କରିବା ଗୁଣ_ନିରୂପଣ_କରିବା ମୂଲ୍ୟାଙ୍କିତ_କରିବା ଆନନ୍ଦଦାୟକ_କରିବା ସୁଖଦାୟକ_କରିବା ସୁଖପ୍ରଦ_କରିବା ଆନନ୍ଦପ୍ରଦ_କରିବା ଆହ୍ଲାଦିତ_କରିବା ସନ୍ତୋଷପ୍ରଦ_କରିବା କରିବା ଗଢିବା ପ୍ରସ୍ତୁତ_କରିବା ପରିସ୍ରା_କରିବା ମୁତିବା
make_believe: ଦେଖାଇହେବା
make_clean: ଛଡାଇବା ସଫାକରିବା|
make_for: କରିବା କାମ_କରିବା କାର୍ଯ୍ୟ_କରିବା
make_full: ପୁରାଇବା ଭରିବା ବୋଝେଇକରିବା ଭର୍ତ୍ତିକରିବା ପୂର୍ଣ୍ଣକରିବା
make_fun: ଉପହାସ_କରିବା ନିନ୍ଦା_କରିବା ଦୋଷ_ବାହାର_କରିବା ହସି_ଉଡାଇବା|
make_happy: ହୋ_ହଲ୍ଲା_କରିବା ଘୋ-ଘା_କରିବା କୋଳାହଳ_କରିବା ଚିତ୍କାର_କରିବା ଉତ୍ପାତ_କରିବା ପାଟିତୁଣ୍ଡ_କରିବା ହୁରି_ପକାଇବା
make_headway: ଜିତିବା ଜୟ_ଜରିବା ବିଜୟୀ_ହେବା|
make_it: ବଞ୍ଚିବା ରକ୍ଷାପାଇବା ଖସିଯିବା ପାସ_କରିବା ଉତ୍ତୀର୍ଣ୍ଣହେବା
make_love: ରତିକରିବା ରମଣକରିବା ସମ୍ଭୋଗକରିବା
make_merry: ହୋ_ହଲ୍ଲା_କରିବା ଘୋ-ଘା_କରିବା କୋଳାହଳ_କରିବା ଚିତ୍କାର_କରିବା ଉତ୍ପାତ_କରିବା ପାଟିତୁଣ୍ଡ_କରିବା ହୁରି_ପକାଇବା
make_out: ରତିକରିବା ରମଣକରିବା ସମ୍ଭୋଗକରିବା
make_pure: ଶୋଧନ ବିଶୋଧନ ପରିଷ୍କାର
make_up_one's_mind: ନିର୍ଣ୍ଣୟ_ନେବା ନିଷ୍ପତ୍ତି_ନେବା
make_vibrant_sounds: ଘୁଡୁଘୁଡୁ_କରିବା
make_water: ପରିସ୍ରା_କରିବା ମୁତିବା
make_whoopie: ହୋ_ହଲ୍ଲା_କରିବା ଘୋ-ଘା_କରିବା କୋଳାହଳ_କରିବା ଚିତ୍କାର_କରିବା ଉତ୍ପାତ_କରିବା ପାଟିତୁଣ୍ଡ_କରିବା ହୁରି_ପକାଇବା
maledict: ଗାଳିଦେବା
malfunction: ଖରାପ_ହୋଇଯିବା ବିଗିଡିଯିବା କାମ_ନକରିବା ବିକୃତହେବା
manage: ସମ୍ଭାଳିହେବା|
manducate: କାମୁଡିବା ଚୋବାଇବା ଦବାଇବା
manure: ଖତ_ଦେବା ଖତ_ପକାଇବା
march: ମାର୍ଚ_କରିବା ଶୋଭାଯାତ୍ରାରେ_ଯିବା ଶୋଭାଯାତ୍ରାରେ_ସାମିଲ୍_ହେବା ମାର୍ଚ_କରାଇବା ଚଲାଇବା ପ୍ରଦର୍ଶନ_କରିବା କଦମତାଲ୍_କରିବା ମାର୍ଚ୍_କରିବା ପ୍ୟାରେଡ୍_କରିବା ଅବସ୍ଥିତ_ହେବା ସ୍ଥିତ_ହେବା ଅବସ୍ଥାନ_କରିବା
mark: ଚିହ୍ନ_କରିବା ଚିହ୍ନ_ଦେବା ଦାଗ_ଦେବା
mark_off: ଗାର_ଟାଣିବା ରେଖାଙ୍କିତ_କରିବା
mark_out: ଗାର_ଟାଣିବା ରେଖାଙ୍କିତ_କରିବା
marry: ବିବାହ_କରିବା ବାହାହେବା ପାଣିଗ୍ରହଣ_କରିବା
mash: ପେଶିବା ପେଡିବା| ଛଇ ଚତୁରୀ ଛୋପରି| ଚୂରିବା ଚୂନାକରିବା ପେଷିବା ଗୁଣ୍ଡକରିବା ଚୂର୍ଣ୍ଣକରିବା
massage: ମାଲିସ୍_କରିବା
masticate: କାମୁଡିବା ଚୋବାଇବା ଦବାଇବା
mat: ଗୁନ୍ଥିହେବା
match: ସମାସ୍କନ୍ଦ_ହେବା ସମାନ_ହେବା ପାଖାପାଖି_ହେବା ମେଳ_ଖାଇବା ମ୍ୟାଚ_କରିବା
mate: ଯୋଡି_ଲାଗିବା ବିହାର_କରିବା କ୍ରୀଡା_କରିବା
materialise: ଆସିବା ଆଗମନ_ହେବା ଘଟିବା ଆରମ୍ଭ_ହେବା ଉପସ୍ଥିତ_ହେବା
materialize: ଆସିବା ଆଗମନ_ହେବା ଘଟିବା ଆରମ୍ଭ_ହେବା ଉପସ୍ଥିତ_ହେବା
maturate: ବୁଢା_ହେବା ବୃଦ୍ଧ_ହେବା
mature: ପଚାଇବା ପାକଲା_କରାଇବା ବୁଢା_ହେବା ବୃଦ୍ଧ_ହେବା
maunder: ପ୍ରଳାପ_କରିବା ବିଳି‌ବିଳେଇବା ବାଉଳି_ଚାଉଳି_ହେବା ଅଯଥା_କଥା_କହିବା ବକ୍‌ବକ୍‌_କରିବା ବକ୍‌_ବକ୍‌_ହେବା
mean: ଅର୍ଥ_ବାହାରକରିବା
measure: ମାପିବା ମାନ_ନିର୍ଣ୍ଣୟକରିବା ମାନନିର୍ଦ୍ଧାରଣ_କରିବା ମୂଲ୍ୟାଙ୍କନ_କରିବା ମୂଲ୍ୟଧାରଣ_କରିବା ମୂଲ୍ୟ_ନିର୍ଣ୍ଣୟ_କରିବା
measure_out: ମାପିବା ମାନ_ନିର୍ଣ୍ଣୟକରିବା ମାନନିର୍ଦ୍ଧାରଣ_କରିବା
meddle: ଖରାପ_କରିବା ବିଗାଡିବା
meet: ଦେଖାହେବା ଭେଟହେବା ସାକ୍ଷାତହେବା ଘାଣ୍ଟିହେବା ହଇରାଣ_ହେବା ଛୁଆଁଇବା ଛୁଏଁଇବା ସ୍ପର୍ଶ_କରେଇବା
meld: ମିଶିବା|
meliorate: ବିକଶିତ_କରିବା ବଢେଇବା ଉନ୍ନତ_କରିବା ସୁଧୁରିବା
mellow: ତରଳି_ଯିବା ଦ୍ରବୀଭୂତ_ହେବା_
mellow_out: ତରଳି_ଯିବା ଦ୍ରବୀଭୂତ_ହେବା_
melt: ତରଳାଇବା ତରଳୀକୃତ_କରିବା ତରଳି_ଯିବା ଦ୍ରବୀଭୂତ_ହେବା_ ଉଡିଯିବା ଛାଡିଯିବା|
melt_down: ତରଳାଇବା ତରଳୀକୃତ_କରିବା
menace: ବିପଦରେ_ପକାଇବା ସଙ୍କଟରେ_ପକାଇବା ସମସ୍ୟାରେ_ପକାଇବା
mend: ମରାମତି_କରିବା ସଜାଡିବା ଠିକ_କରିବା
mensurate: ମାପିବା ମାନ_ନିର୍ଣ୍ଣୟକରିବା ମାନନିର୍ଦ୍ଧାରଣ_କରିବା
mention: ଉଲ୍ଲେଖ_କରିବା ରଚନା_କରିବା ପ୍ରସଙ୍ଗ_କରିବା ଚର୍ଚ୍ଚା_କରିବା|
merge: ମିଶିବା|
mete_out: ବାଣ୍ଟିବା ବିତରଣ_କରିବା
micturate: ପରିସ୍ରା_କରିବା ମୁତିବା
milk: ଦୁହିଁବା ଦୋହନକରିବା ଦୁଇଁବା
mind: ଧ୍ୟାନରେ_ରଖିବା ମନେ_ରଖିବା ସ୍ମରଣ_ରଖିବା
mirror: ପ୍ରତିବିମ୍ବିତ_କରିବା ପ୍ରତିଫଳିତ_କରିବା
misadvise: ଫୁସୁଲାଇବା|
miscarry: ହାରିବା ବିଫଳହେବା|
misdirect: ବାଟବଣା_କରିବା ବାଟ_ଭୁଲେଇ_ଦେବା|
misfunction: ଖରାପ_ହୋଇଯିବା ବିଗିଡିଯିବା କାମ_ନକରିବା ବିକୃତହେବା
misguide: ବାଟବଣା_କରିବା ବାଟ_ଭୁଲେଇ_ଦେବା| ଫୁସୁଲାଇବା|
mislay: ପକେଇବା|
mislead: ବାଟବଣା_କରିବା ବାଟ_ଭୁଲେଇ_ଦେବା|
misplace: ପକେଇବା|
miss: ହରେଇବା ସୁଯୋଗହରେଇବା| ଛାଡିଦେବା ପଳେଇଲା| ବ୍ୟର୍ଥ_ଯିବା ପଥ_ଭ୍ରଷ୍ଟ_ହେବା
mistake: ଭୁଲ_କରିବା ଅପରାଧକରିବା
mix: ମିଶିବା| ମିଶାଇବା ମିଳାଇବା ଏକାଠିକରିବା ଏକତ୍ରିତକରିବା ମିଶ୍ରଣକରିବା
mix_in: ମିଶାଇବା ମିଳାଇବା ଏକାଠିକରିବା ଏକତ୍ରିତକରିବା ମିଶ୍ରଣକରିବା
moan: ହୁଙ୍କାର_ମାରିବା ଶବ୍ଦକରିବା ଚିତ୍କାରକରିବା
moderate: ସମ୍ଭାଳିବା ଆୟତ୍ତ_କରିବା ସଂଯତ_କରିବା ସହିବା ସ୍ଥିର_ରହିବା
modify: କରିବା ବଦଳାଇବା ପରିବର୍ତ୍ତନ_କରିବା
moil: ଖଟେଇବା ରଗଡିବା ଲଗେଇବା
mold: ଢାଳିବା
molest: ହଇରାଣ_କରିବା ପୀଡିତ_କରିବା|
mollify: ମନାଇବା ପ୍ରସନ୍ନ_କରେଇବା ଅପେକ୍ଷାକୃତ_ଭଲ_କରିବା ଅଧିକ_ଉତ୍ତମ_କରିବା ଅଧିକ_ଉତ୍କୃଷ୍ଟ_କରିବା
monish: ଚେତାବନୀ_ଦେବା ସାବଧାନ_କରିବା ଖବରଦାର_କରିବା
moo: ହମ୍ବାଳିବା ହମ୍ବା_ରଡିକରିବା ହମାଳିବା
moon: ଦିବାସ୍ବପ୍ନ_ଦେଖିବା ଖିଆଲରେ_ବୁଡିବା
mortgage: ବନ୍ଧକ_ରଖିବା ବନ୍ଧା_ପକାଇବା
motion: ସଙ୍କେତ_ଦେବା ସଙ୍କେତ_କରିବା ଇସାରା_କରିବା ଇଙ୍ଗିତ_କରିବା ଠାର_ମାରିବା
mould: ଢାଳିବା
mount: ଚଢିବା ବସିବା ଆରୋହଣ_କରିବା ଅବସ୍ଥାନ_କରିବା ଆସୀନ_ହେବା
mount_up: ଚଢିବା ବସିବା ଆରୋହଣ_କରିବା ଅବସ୍ଥାନ_କରିବା ଆସୀନ_ହେବା
mourn: କାନ୍ଦିବା ରୋଦନକରିବା ବିଳାପକରିବା କ୍ରନ୍ଦନକରିବା ଅଶ୍ରୁବୋହାଇବା
mouse: ଖସିଯିବା
mouth: କଥା_ବାହାରିବା ଶବ୍ଦ_ବାହାରିବା
mouth_off: ହାଙ୍କିମରିବା ବଢେଇ_ଚଢେଇ_କହିବା ଫୋପାଡିବା
move: ହଟାଇବା ଚାଲିଯିବା ସ୍ଥାନ_ବଦଳାଇବା ସ୍ଥାନ_ପରିବର୍ତ୍ତନ_କରିବା ସ୍ଥାନାନ୍ତରଣ_କରିବା ଜାଣିବା ଅଙ୍ଗେ_ନିଭେଇବା ଅନୁଭବ_କରିବା ଅବଗତ_ହେବା ଉପଲବ୍ଧି_କରିବା ପ୍ରଭାବିତ_କରିବା ପ୍ରଭାବ_ପକାଇବା
move_into: ପ୍ରବେଶ_କରିବା ପଶିବା ଭିତରକୁ_ଆସିବା ଉପସ୍ଥିତ_ହେବା ଆସିବା|
muck: ଖତ_ଦେବା ଖତ_ପକାଇବା
muddle: ଅସ୍ତବ୍ୟସ୍ତ_ହେବା ହଡବଡ_ହେବା ଏପାଖ_ସେପାଖ_ହେବା
mulct: ଠକିବା
multiply: ଗୁଣନ_କରିବା ଗୁଣିବା ଗୁଣଫଳ_ବାହାର_କରିବା
mumble: ପ୍ରଳାପ_କରିବା ବିଳି‌ବିଳେଇବା ବାଉଳି_ଚାଉଳି_ହେବା
murder: ମରିବା ହତ୍ୟାକରିବା ଜୀବନନେବା ଶେଷକରିବା ଖଲାସକରିବା
murmur: ଗୁଣୁଗୁଣୁ_ହେବା ଫୁସଫୁସ_ହେବା_| ଗୁଣୁଗୁଣୁ_ହେବା
mussitate: ପ୍ରଳାପ_କରିବା ବିଳି‌ବିଳେଇବା ବାଉଳି_ଚାଉଳି_ହେବା
mutter: ପ୍ରଳାପ_କରିବା ବିଳି‌ବିଳେଇବା ବାଉଳି_ଚାଉଳି_ହେବା ଗୁଣୁଗୁଣୁ_ହେବା
nab: ବନ୍ଦୀ_ବରିବା କଏଦୀ_କରିବା ବ୍ରପ୍ତାର_କରିବା ଧରିବା|
nail: ବନ୍ଦୀ_ବରିବା କଏଦୀ_କରିବା ବ୍ରପ୍ତାର_କରିବା ଧରିବା|
name: ନାମଦେବା ନାମିତ_କରିବା ନାମ_ରଖିବା ନାମକରଣ_କରିବା ବତାଇବା କହିବା କରେଇବା ନିଯୁକ୍ତ_କରିବା ଉଲ୍ଲେଖ_କରିବା ରଚନା_କରିବା ପ୍ରସଙ୍ଗ_କରିବା ଚର୍ଚ୍ଚା_କରିବା|
narrate: ଶୁଣେଇବା
nasalise: ଅନୁନାସିକ|
nasalize: ଅନୁନାସିକ|
natter: ଆଲୋଚନା କଥାବାର୍ତ୍ତା ବାର୍ତ୍ତାଳାପ କଥା_
neaten: ସଜାଡିବା ସୁବ୍ୟବସ୍ଥିତ_କରିବା
necessitate: ଚାହିଦା_ରହିବା
need: ଚାହିଦା_ରହିବା ଆବଶ୍ୟକତା_ରହିବା ଦରକାର_ହେବା ପ୍ରୟୋଜନ_ହେବା
neglect: ଛାଡିଦେବା ପଳେଇଲା| ଛାଡିବା ଅବହେଳା_କରିବା ଧ୍ୟାନ_ନଦେବା
neigh: ରଡିଛାଡିବା ଡାକଛାଡିବା|
net: ସୁଧ_ଲାଭକରିବା ସୁଧ_ପାଇବା ସୁଧପ୍ରାପ୍ତି_କରିବା ସୁଧ_ମିଳିବା ସୁଧ_ପ୍ରାପ୍ତିହେବା ସୁଧ_ଉପାର୍ଜନ_ହେବା ଜାଲରେ_ଧରିବା ଜାଲ_ପକାଇବା
nett: ଜାଲରେ_ଧରିବା ଜାଲ_ପକାଇବା
nibble: କୁଟୁ_କୁଟୁ_କରି_କାଟିବା| ଖୁଣ୍ଟି_ଖାଇବା ଖୁଣ୍ଟିବା ଟୋକିବା
nicker: ରଡିଛାଡିବା ଡାକଛାଡିବା|
nictate: ବୁଜିବା ବନ୍ଦ_କରିବା
nictitate: ବୁଜିବା ବନ୍ଦ_କରିବା
nip: ଚିମୁଟିଦେବା ଚିମୁଟିବା ଛୋଟ_କରିବା
nip_off: ଛୋଟ_କରିବା
nobble: ଠକିବା ଅପହରଣ_କରିବା ହରଣ_କରିବା|
nominate: ନାମିତ_କରିବା ମନୋନୀତ_କରିବା ବାଛିବା ଚୟନ_କରିବା କରେଇବା ନିଯୁକ୍ତ_କରିବା
note: ଟିପି_ରଖିବା|
nourish: ପୋଷଣ_କରିବା ଆହାର_କରିବା ଭୋଜନ_କରିବା ପାଳିତ_କରିବା ପୁଷ୍ଟିକରଣ_କରିବା ବର୍ଦ୍ଧନ_କରିବା
numb: ଅଚଳହେବା ଗତିହୀନହେବା ନିଶ୍ଚଳହେବା
number: ଗଣିବା ଗଣତି_କରିବା ସଂଖ୍ୟା_ଜାଣିବା
numerate: ଗଣିବା ଗଣତି_କରିବା ସଂଖ୍ୟା_ଜାଣିବା
nurture: ରଖିବା ପାଳିବା ପୋଷିବା ପାଳନ_କରିବା ପାଳନ_ପୋଷଣ_କରିବା ପୋଷଣ_କରିବା ଆହାର_କରିବା ଭୋଜନ_କରିବା ପାଳିତ_କରିବା ପୁଷ୍ଟିକରଣ_କରିବା ବର୍ଦ୍ଧନ_କରିବା
obey: ଆଜ୍ଞା_ପାଳନ_କରିବା କଥା_ମାନିବା
observe: ଦେଖିବା ନଜର_ରଖିବା ଜଗିବା ପହରାଦେବା ରକ୍ଷାକରିବା
obstruct: ରଖିବା ରୋକିବା ଅଟକାଇବା
obturate: ରଖିବା ରୋକିବା ଅଟକାଇବା
occlude: ରଖିବା ରୋକିବା ଅଟକାଇବା
occupy: ଲାଗିବା ଜୁଟିବା କାର୍ଯ୍ୟରତ_ରହିବା କାର୍ଯ୍ୟବ୍ୟସ୍ତରହିବା ଭର୍ତ୍ତି_ହେବା ଭରା_ହେବା ପରିପୂର୍ଣ୍ଣ_ହେବା| ଚିନ୍ତାଲାଗିବା| ଆକ୍ରମଣ_କରିବା
occur: ଠିକ_ଘଟିବା ପ୍ରମାଣିତ_ହେବା ଦୃଷ୍ଟିଗୋଚର_ହେବା ମିଳିବା ପାଇବା|
off: ମରିବା ହତ୍ୟାକରିବା ଜୀବନନେବା ଶେଷକରିବା ଖଲାସକରିବା
offend: କଣ୍ଟା_ଫୋଡିବା ଖଟକା_ଲାଗିବା ଅପ୍ରିୟ_ଲାଗିବା ଖରାପ_ଲାଗିବା
offer: ପ୍ରସ୍ତୁତ_କରିବା ତିଆରି_କରିବା ମାନିବା ସ୍ବୀକାର_କରିବା ରାଜି_ହେବା ସମ୍ମତ_ହେବା ଦେବା ପ୍ରଦାନ_କରିବା ଉପଲବ୍ଧ_କରିବା ବିକ୍ରୀପାଇଁ_ରଖିବା ବିକ୍ରୀପାଇଁ_ଗଚ୍ଛିତ_କରିବା ବିକ୍ରୀପାଇଁ_ମହଜୁଦ_କରିବା ଦେବା ପ୍ରଦାନ_କରିବା ଦାନ_କରିବା ଚଢାଇବା ଅର୍ପିତ_ହେବା କରିବା ବ୍ୟବହାର_କରିବା ବିବାହ_ପ୍ରସ୍ତାବ_ଦେବା ବିବାହ_ପ୍ରସ୍ତାବ_ରଖିବା
offer_up: ଚଢାଇବା ଅର୍ପିତ_ହେବା
oink: କେଁ-କେଁ_ଶବ୍ଦ_|
omit: ଛାଡିବା| ଛାଡିଦେବା ପଳେଇଲା|
ooze: ଝରିବା ଗଳିବା ବାହାରିବା ସ୍ରାବ_ହେବା ଝାଳେଇବା_|
ooze_out: ଝାଳେଇବା_|
open: ଖୋଲିବା ଫିଟେଇବା ଖୋଲିବା| ଖୋଲିବା ଖେଳେଇ_ଦେବା ଖୋଲିବା ଚାଲୁହେବା ଆରମ୍ଭହେବା ଖୋଲିବା ଖୋଲିବା ଓପନ_କରିବା ଆରମ୍ଭ_କରିବା
open_up: ଖୋଲିବା ଫିଟେଇବା ଖୋଲିବା ଚାଲୁହେବା ଆରମ୍ଭହେବା ଖୋଲିବା| ଖୋଲିବା ମିଶିପାରିବା ସଙ୍କୋଚ_ତ୍ୟାଗକରିବା
operate: ଚଳାଇବା ଚାଲିବା ଉପଯୋଗରେ_ଆସିବା କାମ_କରିବା ଅପରେସନ୍‌_କରିବା ଶଲ୍ୟ_ଚିକିତ୍ସା_କରିବା ସର୍ଜରୀ_କରିବା
operate_on: ଅପରେସନ୍‌_କରିବା ଶଲ୍ୟ_ଚିକିତ୍ସା_କରିବା ସର୍ଜରୀ_କରିବା
oppress: ଦବେଇଦେବା|
order: କହିବା ଆଜ୍ଞା_କରିବା ଆଜ୍ଞା_ଦେବା ଆଦେଶ_ଦେବା|
organise: ସଜାଇବା ବ୍ୟବସ୍ଥିତ_କରିବା
organize: ସଜାଇବା ବ୍ୟବସ୍ଥିତ_କରିବା
originate: ସୃଷ୍ଟିହେବା ଜାତ_ହେବା ଉତ୍ପନ୍ନ_ହେବା
ornament: ସଜେଇବା ଅଳଙ୍କୃତ_କରିବା ସଜ୍ଜିତ_କରିବା
oscillate: ଢଳିବା ଆକୃଷ୍ଟ_ହେବା
osculate: ଚୁମା ଚୁମ୍ବନ
ostentate: ଅଭିମାନ_ପ୍ରଦର୍ଶନ_କରିବା ଇଜ୍ଜତ_ଦେଖେଇବା
outcry: ଚିତ୍କାର_କରାଇବା
outlast: ଅଧିକ_ବଞ୍ଚିବା ଅଧିକ_ସମୟ_ଜିଇଁବା ଅଧିକଦିନ_ବଞ୍ଚିବା ଦୀର୍ଘଜୀବୀ_ହେବା
outlive: ଅଧିକ_ବଞ୍ଚିବା ଅଧିକ_ସମୟ_ଜିଇଁବା ଅଧିକଦିନ_ବଞ୍ଚିବା ଦୀର୍ଘଜୀବୀ_ହେବା
outwear: ଥକି_ପଡିବା|
overcharge: ଲୋଟିବା ଠକିବା
overcome: ହରେଇବା ପରାଜିତ_କରିବା ପରାସ୍ତ_କରିବା
overeat: ତୃପ୍ତ_ହେବା
overgorge: ତୃପ୍ତ_ହେବା
overhang: ଝୁଙ୍କିବା ଝୁଲିବା ଓହଳିବା
overhaul: ପାରକରିବା
overindulge: ତୃପ୍ତ_ହେବା
overlap: ଚଢିବା ବୋଳିହେବା|
overleap: ଛାଡିଦେବା ପଳେଇଲା|
overlook: ଛାଡିଦେବା ପଳେଇଲା|
overspread: ବିସ୍ତାରିତ_ହେବା ଖେଳେଇ_ହେବା ପ୍ରସାରିତ_ହେବା ବ୍ୟାପ୍ତହେବା
overtake: ପାରକରିବା
overturn: ଓଲଟିଯିବା
overwhelm: ତଲ୍ଲୀନ_ହେବା ଲୀନ_ହେବା ଭାବାନ୍ବିତ_ହେବା ଆତ୍ମବିସ୍ମ୍ରୁତ_ହେବା ଧ୍ୟାନାବସ୍ଥିତ_ହେବା ବୁଡି_ଯିବା
overwork: ଶୋଷଣ_କରିବା
pacify: ମନାଇବା ପ୍ରସନ୍ନ_କରେଇବା
pack: ଗଣ୍ଠିଲିକରିବା ଜିନିଷପତ୍ର_ଏକାଠିକରିବା ଜିନିଷପତ୍ର_ବାନ୍ଧିବା ପେକ_କରିବା|
paddle: ଚାଳନକରିବା|
pain: ଦୁଃଖ_ଦେବା
paint: ଚିତ୍ର_ଆଙ୍କିବା ଚିତ୍ରିତ_କରିବା ଚିତ୍ରାଙ୍କନ_କରିବା| ରଙ୍ଗାଇବା ରଙ୍ଗେଇବା
pair: ଯୋଡି_ଲାଗିବା ବିହାର_କରିବା କ୍ରୀଡା_କରିବା
palaver: ଅଯଥା_କଥା_କହିବା ବକ୍‌ବକ୍‌_କରିବା ବକ୍‌_ବକ୍‌_ହେବା ବହଲାଇବା ଆହ୍ଲାଦିତ_କରିବା ପ୍ରବୋଧିତ_କରିବା
palisade: କାନ୍ଥଦ୍ବାରା_ଘେରାଇବା ପାଚେରୀଦ୍ବାରା_ଘେରାଇବା
pall: ଡରାଇବା ଭୟଭୀତକରାଇବା ଭୟାତୁର_କରାଇବା
palpitate: ଥରାଇବା ଡରାଇବା ଭୟଭୀତ_କରାଇବା ସ୍ପନ୍ଦିତ_କରିବା| ଡେଇଁବା କମ୍ପିତ_ହେବା ସ୍ପନ୍ଦିତ_ହେବା|
panic: ଆତଙ୍କିତ_ହେବା ଆଶଙ୍କିତ_ହେବା ହଡବଡେଇଯିବା ଡରିବା|
pant: ଧଇଁସଇଁ_ହେବା
parcel_out: ବାଣ୍ଟିବା ବିତରଣ_କରିବା
pare: ଛେଲାଇବା|
parent: ପାଳିବା ପୋଷିବା ପାଳନ_କରିବା ପାଳନ_ପୋଷଣ_କରିବା
parrot: ଡାକିବା ମୁଖସ୍ତକରିବା
parry: କଥା_ଟାଳିବା ଟାଳିବା
part: ହଜିଯିବା ଅଲଗା_ହୋଇଯିବା ଅଲଗାହେବା ପୃଥକହେବା ପ୍ରସ୍ଥାନ_କରିବା ଛାଡିବା ଚାଲିବା| ବାଣ୍ଟିହେବା ବଣ୍ଟାହେବା ଅଲଗା_କରିବା ବାଛିବା ବାହାର_କରିବା_
participate: ଭାଗ_ନେବା ସାମିଲ_ହେବା|
party: ପାର୍ଟି_କରିବା ମନୋରଞ୍ଜନ_କରିବା ମଉଜମସ୍ତି_କରିବା
pass: ଯିବା ଚାଲିବା ଧରାଇବା ରଖିବା_ ଯିବା ଚାଲିବା ଗମନ_କରିବା ଦୌଡିବା ବିସ୍ତାରିତ_ହେବା ବିସ୍ତୃତ_ହେବା ପାରକରିବା ଠିକ_ଘଟିବା ପ୍ରମାଣିତ_ହେବା କଟିବା ବ୍ୟତୀତ_ହେବା ବିତିବା ଖସିଯିବା ପାସ_କରିବା ଉତ୍ତୀର୍ଣ୍ଣହେବା ମରିବା ପରଲୋକ_ଗମନ_କରିବା ପ୍ରାଣଛାଡିଯିବା ପ୍ରାଣବାୟୁ_ଉଡିଯିବା ମହା_ନିର୍ବାଣ_ପ୍ରାପ୍ତ_ହେବା ସ୍ୱର୍ଗପ୍ରାପ୍ତି_ହେବା
pass_away: ମରିବା ପରଲୋକ_ଗମନ_କରିବା ପ୍ରାଣଛାଡିଯିବା ପ୍ରାଣବାୟୁ_ଉଡିଯିବା ମହା_ନିର୍ବାଣ_ପ୍ରାପ୍ତ_ହେବା ସ୍ୱର୍ଗପ୍ରାପ୍ତି_ହେବା ଗଡିଯିବା ଟଳିଯିବା|
pass_by: ଯିବା ଚାଲିବା
pass_off: ଠିକ_ଘଟିବା ପ୍ରମାଣିତ_ହେବା
pass_on: ଧରାଇବା ରଖିବା_
pass_over: ଥୟକରିବା ସ୍ଥିରକରିବା ନିଶ୍ଚିତ_କରିବା ନିର୍ଦ୍ଦିଷ୍ଟ_କରିବା ପୋଛିବା ସଫା_କରିବା|
pass_up: ମନା_କରିବା ନାଁ_କହିବା ନାହିଁ_କରିବା
pass_water: ପରିସ୍ରା_କରିବା ମୁତିବା
paste: ଲଗାଇବା ଚପେଇବା ଲଖେଇବା ମାରିବା
pasture: ଚରାଇବା ଚରିବା
pat: ଥାପୁଡିବା ଆଉଁଶିବା
patter: ବାଡେଇବା ପିଟିବା ବଜେଇବା
pattern: ସରଞ୍ଚନା_ହେବା ଆକାର_ହେବା ରୂପ_ହେବା ଅନୁରୂପ_ହେବା
pause: ଅଟକିଯିବା_
pay: ପରିଶୋଧ_କରିବା ଭରଣା_କରିବା ଦେବା ଭରିବା
peal: ବାଜିବା
peck: ଖୁଣ୍ଟିବା
pee: ପରିସ୍ରା_କରିବା ମୁତିବା
pee-pee: ପରିସ୍ରା_କରିବା ମୁତିବା
peel: ଛେଲାଇବା|
peel_off: ଉତାରିବା ଛାଲିବା କାଢିବା
peep: ଉଙ୍କି_ମାରିବା କଳରବ_କରିବା
pelt: ମୂଷଳଧାରାରେ_ବର୍ଷାହେବା ଯୋରରେ_ବର୍ଷାହେବା ପ୍ରବଳ_ବର୍ଷାହେବା
pen: ଲେଖିବା ରଚନା_କରିବା
penalise: ଦଣ୍ଡଦେବା ସଜାଦେବା ଦଣ୍ଡିତ_କରିବା ସଜା_ଶୁଣାଇବା ଶାସ୍ତି_ଦେବା
penalize: ଦଣ୍ଡଦେବା ସଜାଦେବା ଦଣ୍ଡିତ_କରିବା ସଜା_ଶୁଣାଇବା ଶାସ୍ତି_ଦେବା
people: ସ୍ଥାପନ_କରିବା ବସାଇବା ଆଶ୍ରୟ_ଦେବା_| ବସବାସ_କରିବା
perfect: ନିପୂଣ_କରିବା ପ୍ରବୀଣ_କରିବା ପାରଙ୍ଗମ_କରିବା ଦକ୍ଷକରିବା
perform: କରିବା ସାରିବା ସଂପାଦିତ_କରିବା କରିବା
peril: ବିପଦରେ_ପକାଇବା ସଙ୍କଟରେ_ପକାଇବା ସମସ୍ୟାରେ_ପକାଇବା
perish: ମରିବା ପରଲୋକ_ଗମନ_କରିବା ପ୍ରାଣଛାଡିଯିବା ପ୍ରାଣବାୟୁ_ଉଡିଯିବା ମହା_ନିର୍ବାଣ_ପ୍ରାପ୍ତ_ହେବା ସ୍ୱର୍ଗପ୍ରାପ୍ତି_ହେବା
perk_up: ଜାଗୃତ_କରିବା ଜଗେଇବା ସାଧନ_କରିବା
persist: ପ୍ରଚଳିତ_ହେବା ଚାଲିବା ରହିବା ରହିଯିବା
personify: ନିର୍ବାହ ସଂପାଦନ ପ୍ରତିପାଦନ
perturb: ବ୍ୟାକୁଳ_ହେବା ଅଶାନ୍ତ_ହେବା
pester: ଚିଡାଇବା ହାସ୍ୟ_ରସ_କରିବା
pestle: ଚକଟିବା ଦଳିବା|
petrify: ସ୍ତବ୍ଧ_ହୋଇଯିବା ଜଡ_ହୋଇଯିବା ନିଶ୍ଚଳ_ହୋଇଯିବା
philander: ଛଇ ଚତୁରୀ ଛୋପରି|
photograph: ଉଠାଇବା ଫୋଟୋ_ଉଠାଇବା|
pick: ଫୋପାଡିଦେବା ତ୍ୟାଗକରିବା ବର୍ଜନକରିବା ଖୁଣ୍ଟି_ଖାଇବା ଖୁଣ୍ଟିବା ଟୋକିବା
pick_apart: ନିନ୍ଦାକରିବା ଖରାପକହିବା ଖଚକହିବା ବଦନାମକରିବା ଆଙ୍ଗୁଳିଦେଖେଇବା
pick_off: ତୋଳିବା ଛିଣ୍ଡାଇବା
pick_out: ବାଛିବା ଅଲଗା_କରିବା
pick_up: ଉଠେଇବା ବନ୍ଦୀ_ବରିବା କଏଦୀ_କରିବା ବ୍ରପ୍ତାର_କରିବା ଧରିବା| ଘାରିହେବା ନିଶାସକ୍ତ_ହେବା ଖୁଣ୍ଟିବା
piddle: ପରିସ୍ରା_କରିବା ମୁତିବା
piece: ଖୁଣ୍ଟି_ଖାଇବା ଖୁଣ୍ଟିବା ଟୋକିବା
piffle: ଅଯଥା_କଥା_କହିବା ବକ୍‌ବକ୍‌_କରିବା ବକ୍‌_ବକ୍‌_ହେବା
pig_out: ତୃପ୍ତ_ହେବା
pile_up: ରୁଣ୍ଡହେବା ଏକାଠି_ହେବା ଏକତ୍ରିତ_ହେବା ଜମିବା ସଞ୍ଚୟ_କରିବା ସଂଗ୍ରହ_କରିବା ଏକାଠି_କରିବା ଏକତ୍ରିତ_କରିବା
pillage: ଲୁଟପାଟ_କରିବା ଲୋଟିବା ଅପହରଣ_କରିବା
pinch: ଚିମୁଟିଦେବା ଚିମୁଟିବା ଗୋଛାଇବା ଗୋଛା_କରି_ରଖିବା ଏକାଠି_କରି_ରଖିବା ଏକତ୍ର_କରି_ରଖିବା ସଜାଡିକି_ରଖିବା
pine: ଲଳାୟିତ_ହେବା ଲାଳସା_କରିବା
pink: ଟପ୍ଟପ୍_କରିବା
pipe_down: ମୌନ_ହେବା ଚୁପ_ହେବା|
piss: ପରିସ୍ରା_କରିବା ମୁତିବା
pitch: ଟାଣିବା ଭିଡିବା ବାନ୍ଧିବା
pitter-patter: ବାଡେଇବା ପିଟିବା ବଜେଇବା
placate: ମନାଇବା ପ୍ରସନ୍ନ_କରେଇବା
place: ରଖିବା ଲଗାଇବା ବ୍ୟବସ୍ଥା_କରିବା ଆୟୋଜନ_କରିବା ବନ୍ଦୋବସ୍ତ_କରିବା ପ୍ରବନ୍ଧ_କରିବା ମିଳିବା ପାଇବା ପ୍ରାପ୍ତହେବା ନିଶାନା_ସାଧିବା ଲକ୍ଷ୍ୟ_ସ୍ଥିର_କରିବା ଚିହ୍ନିବା ଜାଣିବା ଲଗାଇବା ଖଟାଇବା ନିବେଶ_କରିବା ଦ୍ବିତୀୟ_ସ୍ଥାନରେ_ଆସିବା
place_upright: ଉଠାଇବା
plague: ହଇରାଣ_କରିବା ପୀଡିତ_କରିବା|
plan: ଉଦ୍ଦେଶ୍ୟ_ରହିବା ଇଚ୍ଛା_କରିବା ମନହେବା ଯୋଜନା_କରିବା ଯୋଜନା_କରିବା ସଂଯୋଜନା_କରିବା ସଂଘଟନ_କରିବା ପରିକଳ୍ପନା_କରିବା
plane: ଉଡେଇବା
plank: କଚାଡିବା ଫୋପାଡିବା ଫିଙ୍ଗିବା|
plant: ରୋଇବା ପୋତିବା ସ୍ଥାପନ_କରିବା ଅଧିଷ୍ଠିତ_କରିବା|
plaster: ଥାପିବା ଲଦିବା ବୋଳିବା ଲିପିବା|
plaster_over: ଥାପିବା ଲଦିବା ବୋଳିବା ଲିପିବା|
play: ଖେଳିବା କ୍ରୀଡାରେ_ଭାଗନେବା ଭୂମିକା_ଗ୍ରହଣ_କରିବା ସଂପାଦନ_କରିବା ନିର୍ବାହ_କରିବା ଖେଳିବା କ୍ରୀଡା_କରିବା ବାଜିବା ଖେଳିବା ବେଖାତିର_କରିବା ବେପରୁଆ_ହେବା କରିବା କାମ_କରିବା କାର୍ଯ୍ୟ_କରିବା
play_a_trick_on: ଆଖିରେ_ଧୂଳି_ଦେବା ଚକମା_ଦେବା
play_hooky: ଛୁଟିରେ_ରହିବା ଛୁଟିନେବା ଅନୁପସ୍ଥିତ_ହେବା
please: ଖୁସି_ଲାଗିବା ଭଲ_ଲାଗିବା ସୁଖଦ_ଲାଗିବା
pledge: ପ୍ରତିଜ୍ଞା_କରିବା ପଣ_କରିବା|
plight: ସ୍ଥିର_କରିବା ପକ୍କା_କରିବା ପ୍ରତିଜ୍ଞା_କରିବା ପଣ_କରିବା|
plonk: କଚାଡିବା ଫୋପାଡିବା ଫିଙ୍ଗିବା|
plop: କଚାଡିବା ଫୋପାଡିବା ଫିଙ୍ଗିବା|
plot: ଷଡଯନ୍ତ୍ର_କରିବା
plough: ପାଉଁଶ_ଖେଳାଇ_ହଳ_କରିବା
plow: ପାଉଁଶ_ଖେଳାଇ_ହଳ_କରିବା
pluck: ତୋଳିବା ଛିଣ୍ଡାଇବା ଲୋଟିବା ଠକିବା
plug: ଚୁଣ୍ଟା_ଲଗାଇବା ବିଣ୍ଡା_ଲଗାଇବା ବନ୍ଦକରିବା
plumb: ଗଭୀରତାମାପିବା
plume: ଲୋଟିବା ଠକିବା
plump: କଚାଡିବା ଫୋପାଡିବା ଫିଙ୍ଗିବା|
plump_down: କଚାଡିବା ଫୋପାଡିବା ଫିଙ୍ଗିବା|
plunder: ଲୋଟିବା ଲୁଟପାଟ_କରିବା ଲୋଟିବା ଅପହରଣ_କରିବା
plunge: ବୁଡେଇବା_ଡୁବେଇବା
plunk: କଚାଡିବା ଫୋପାଡିବା ଫିଙ୍ଗିବା|
plunk_down: କଚାଡିବା ଫୋପାଡିବା ଫିଙ୍ଗିବା|
pocket: ଜବରଦଖଲ_କରିବା ହାତେଇନେବା ହଡପ_କରିନେବା|
point: ନିଶାନା_ସାଧିବା ଲକ୍ଷ୍ୟ_ସ୍ଥିର_କରିବା
poison: ବିଷ_ଦେବା ଜହର_ପିଆଇବା
poke: ଭୁସିବା କେଞ୍ଚିବା ବିନ୍ଧିବା ହାଣିବା
poke_fun: ଉପହାସ_କରିବା ନିନ୍ଦା_କରିବା ଦୋଷ_ବାହାର_କରିବା ହସି_ଉଡାଇବା|
polish: ଚମକିବା ଚମକ_ଆଣିବା ଚିକ୍କଣ_କରିବା ଉଜ୍ଜ୍ବଳ_କରିବା ଚିକ୍‌ଚିକ୍‌_କରିବା ଚକ୍‌ମକ୍‌
polish_off: ମରିବା ହତ୍ୟାକରିବା ଜୀବନନେବା ଶେଷକରିବା ଖଲାସକରିବା
pooh-pooh: ତଡି_ଦେବା ପ୍ରତ୍ୟାଖାନ_କରିବା
pool: ଦଳ_ଗଢିବା ଦଳ_ତିଆରି_କରିବା ଦଳ_ଗଠନ_କରିବା ଦଳ_ନିର୍ମାଣ_କରିବା
pop: ଫୁଲିଯାଇଛି ହଠାତ୍‌_ପହଞ୍ଚିଯିବା ସହସା_ଆସିବା ଅଚାନକ_ଆସିବା|
pop_off: ମରିବା ପରଲୋକ_ଗମନ_କରିବା ପ୍ରାଣଛାଡିଯିବା ପ୍ରାଣବାୟୁ_ଉଡିଯିବା ମହା_ନିର୍ବାଣ_ପ୍ରାପ୍ତ_ହେବା ସ୍ୱର୍ଗପ୍ରାପ୍ତି_ହେବା
pop_out: ଫାଟିଯିବା ଫୁଲିଯାଇଛି
pop_the_question: ବିବାହ_ପ୍ରସ୍ତାବ_ଦେବା ବିବାହ_ପ୍ରସ୍ତାବ_ରଖିବା
pop_up: ହଠାତ୍‌_ପହଞ୍ଚିଯିବା ସହସା_ଆସିବା ଅଚାନକ_ଆସିବା|
populate: ବସବାସ_କରିବା ସ୍ଥାପନ_କରିବା ବସାଇବା ଆଶ୍ରୟ_ଦେବା_|
pore: ଧ୍ୟାନ_କେନ୍ଦ୍ରୀଭୂତ_କରିବା ଧ୍ୟାନ_ଦେବା ଧ୍ୟାନ_ଏକାଗ୍ର_କରିବା
portray: ଅଭିନୟ_କରିବା ରୋଲ_କରିବା|
pose: ସାମନାକୁ_ଆଣିବା ଆଗକୁ_ଆଣିବା ଠିଆ_କରିବା ସମ୍ମୁଖକୁ_ଆଣିବା ରଖିବା
position: ରଖିବା
postpone: ସ୍ଥଗିତ_ରଖିବା
postulate: ଚାହିଦା_ରହିବା
pounce: ଲମ୍ଫ_ମାରିବା ଝାମ୍ପିବା କୁଦାମାରିବା
pour: ବୁହାଇଦେବା ପ୍ରବାହିତ_କରିବା ଭାଙ୍ଗିବା ଉଛୁଳି_ପଡିବା ଭାତ_ଗାଳିବା ପେଜ_ଗାଳିବା ମୂଷଳଧାରାରେ_ବର୍ଷାହେବା ଯୋରରେ_ବର୍ଷାହେବା ପ୍ରବଳ_ବର୍ଷାହେବା
pour_out: ଭାତ_ଗାଳିବା ପେଜ_ଗାଳିବା
pout: ରୁଷିବା ରୁଷ୍ଟ_ହେବା ମୁଁହ_ଫୁଲେଇବା କ୍ରୋଧିତ_ହେବା କ୍ରୁଦ୍ଧ_ହେବା କୁପିତ_ହେବା
powder: ପେଷିବା ଚୂନା_କରିବା
powderise: ଗୁଣ୍ଡହେବା ଚୂର୍ଣ୍ଣହେବା ଭଗ୍ନହେବା ପେଷିବା ଚୂନା_କରିବା
powderize: ଗୁଣ୍ଡହେବା ଚୂର୍ଣ୍ଣହେବା ଭଗ୍ନହେବା ପେଷିବା ଚୂନା_କରିବା
practice: ସାଧନା_କରିବା ଅଭ୍ୟାସ_କରିବା ସିଦ୍ଧହସ୍ତ_ହେବା ସିଦ୍ଧିଲାଭ_କରିବା ଅଭ୍ୟାସ_କରିବା ସାଧନା_କରିବା ବାରମ୍ବାର_କରିବା
practise: ଅଭ୍ୟାସ_କରିବା ସାଧନା_କରିବା ବାରମ୍ବାର_କରିବା ସାଧନା_କରିବା ଅଭ୍ୟାସ_କରିବା ସିଦ୍ଧହସ୍ତ_ହେବା ସିଦ୍ଧିଲାଭ_କରିବା
praise: ପ୍ରଶଂସା_କରିବା ସାବାସ_କରିବା|
prance: ଫୁଟାଣି_ମାରିବା ଗର୍ବରେ_ଟହଲମାରିବା
prank: ବେଶ_ହେବା ସଜ୍ଜିତ_ହେବା ବେଶବିନ୍ୟାସ_କରିବା
prate: ଅଯଥା_କଥା_କହିବା ବକ୍‌ବକ୍‌_କରିବା ବକ୍‌_ବକ୍‌_ହେବା
prattle: ଅଯଥା_କଥା_କହିବା ବକ୍‌ବକ୍‌_କରିବା ବକ୍‌_ବକ୍‌_ହେବା
predominate: ଶକ୍ତିଶାଳୀ_ହେବା ବଳବାନ_ହେବା ପ୍ରଧାନ_ହେବା ସାମର୍ଥ୍ୟସମ୍ପନ୍ନ_ହେବା
prepare: ଉଦ୍ୟତହେବା ପ୍ରସ୍ତୁତ_ହେବା ତତ୍ପର_ହେବା ରାନ୍ଧିବା ରୋଷେଇ_କରିବା ଖାଦ୍ୟ_ତିଆରି_କରିବା ଖାଦ୍ୟ_ରାନ୍ଧିବା ବ୍ୟବସ୍ଥା_କରିବା ପ୍ରସ୍ତୁତ_ହେବା ତିଆରି_କରିବା ଆୟୋଜନ_କରିବା ବନ୍ଦୋବସ୍ତ_କରିବା ପ୍ରଶିକ୍ଷିତ_କରାଯିବା ତାଲିମକରାଯିବା ଯୋଗ୍ୟକରାଯିବା|
present: ଦେଖାଇବା ପ୍ରଦର୍ଶିତ_କରିବା ଶୋ_କରିବା ପ୍ରଦର୍ଶନ_କରିବା ଯୁକ୍ତି_କରିବା ସାମନାକୁ_ଆଣିବା ତର୍କ_କରିବା ଯୁକ୍ତି_ବାଢିବା ମଞ୍ଚିତ_କରିବା| ସାମନାକୁ_ଆଣିବା ଆଗକୁ_ଆଣିବା ଠିଆ_କରିବା ସମ୍ମୁଖକୁ_ଆଣିବା ସମ୍ମାନ_ଦେବା ସମ୍ମାନିତ_କରିବା| ଉପହାର_ଦେବା ଭାଷଣଦେବା ବକ୍ତବ୍ୟପ୍ରଦାନକରିବା କହିବା_ ପରିଚୟ_କରାଇବା ଭେଟ_କରଇବା ସାକ୍ଷାତ_କରାଇବା ପ୍ରସ୍ତୁତ_କରିବା| ପରିଚୟ_ଦେବା ପରିଚିତ_କରାଇବା ଜଣାଶୁଣା_କରାଇବା ପରିଜ୍ଞାତ_କରାଇବା ସାଲ୍ୟୁଟ୍_କରିବା ସାଲ୍ୟୁଟ୍_ମାରିବା ଅଭିବାଦନ_କରିବା ଅଭିବାଦନ_ଜଣାଇବା
preserve: ବଜାୟ_ରଖିବା ଜୀବିତ_ରଖିବା ସଜୀବ_ରଖିବା ବଞ୍ଚେଇ_ରଖିବା ରକ୍ଷାକରିବା ସୁରକ୍ଷିତ_ରଖିବା ସମ୍ଭାଳିବା ସୁରକ୍ଷିତ_ରଖିବା ରହିବା ସୁରକ୍ଷିତ_ରଖିବା ବଞ୍ଚାଇବା ରକ୍ଷାକରିବା ସଂରକ୍ଷିତ_କରିବା ସୁରକ୍ଷିତ_ରଖିବା
press: ଚିପିଦେବା ଚାପିଦେବା ଚାପିହୋଇଯିବା ଚାପିଯିବା ଲଢେଇ_କରିବା ଲଢିବା ସଂଗ୍ରାମ_କରିବା ଆନ୍ଦୋଳନ_କରିବା ନିବେଦନ_କରିବା ବିନତି_କରିବା ବିନୟ_କରିବା ପ୍ରାର୍ଥନା_କରିବା ଅନୁନୟ_କରିବା ଅନୁରୋଧ_କରିବା
pretend: ଦେଖାଇହେବା
pretermit: ଛାଡିଦେବା ପଳେଇଲା|
prevail: ଶକ୍ତିଶାଳୀ_ହେବା ବଳବାନ_ହେବା ପ୍ରଧାନ_ହେବା ସାମର୍ଥ୍ୟସମ୍ପନ୍ନ_ହେବା ପ୍ରଚଳିତ_ହେବା ଚାଲିବା
price: ମୂଲ୍ୟ_ନେବା ମୂଲ୍ୟ_ରଖିବା ମୂଲ୍ୟ_ନିର୍ଦ୍ଧାରଣ_କରିବା
prick: ଫୋଡିବା କେଞ୍ଚିବା ଭୁସିବା ପଶିବା ଫୋଡିହେବା ଚୋଟ_ମାରିବା କାମୁଡିବା ଦଂଶନ_କରିବା_
prickle: ଫୋଡିବା କେଞ୍ଚିବା ଭୁସିବା
print: ଛପାଇବା ପ୍ରକାଶିତ_କରାଇବା
prise: ସମ୍ମାନ_କରିବା ଆଦର_କରିବା
prize: ସମ୍ମାନ_କରିବା ଆଦର_କରିବା
proceed: ଚାଲିବା ବଢିବା ମାଡିବା| ଜାଣିବା ଅଙ୍ଗେ_ନିଭେଇବା ଅନୁଭବ_କରିବା ଅବଗତ_ହେବା ଉପଲବ୍ଧି_କରିବା ଚାଲିବାକୁ_ଦେବା ଚଲାଇବା ପରିଚାଳିତ_କରିବା ଚାଲୁରହିବା ଜାରି_ରଖିବା
process: ତିଆରି_କରିବା କରିବା ପ୍ରସ୍ତୁତ_କରିବା ନିର୍ମାଣ_କରିବା ମାର୍ଚ_କରିବା ଶୋଭାଯାତ୍ରାରେ_ଯିବା ଶୋଭାଯାତ୍ରାରେ_ସାମିଲ୍_ହେବା
prod: ଭୁସିବା କେଞ୍ଚିବା ବିନ୍ଧିବା ହାଣିବା
produce: ଉତ୍ପାଦନ_କରିବା ଉତ୍ପନ୍ନ_କରିବା ନିଷ୍ପନ୍ନ_କରିବା ନିର୍ଣ୍ଣୟ_କରିବା ଗଢିବା ତିଆରିକରିବା ନିର୍ମାଣ_କରିବା ଉତ୍ପନ୍ନକରିବା ଉପୁଜେଇବା ଉତ୍ପାଦନକରିବା|
proffer: ପ୍ରସ୍ତୁତ_କରିବା ତିଆରି_କରିବା
profit: ଫଳିବା ଲାଭ_କରିବା ଲାଭାନ୍ବିତ_ହେବା
progress: ଉନ୍ନତି_କରିବା ଉନ୍ନତ_ହେବା ବିକାଶ_କରିବା ବଢିବା|
progress_to: ପହଞ୍ଚିବା ଉପନୀତ_ହେବା|
prohibit: ମନାକରିବା ରୋକିବା ଅବରୋଧକରିବା
promise: ପ୍ରତିଜ୍ଞାକରିବା ସତ୍ୟକରିବା କଥାଦେବା ନିୟମକରିବା ଜବାବଦେବା
promote: ପଦୋନ୍ନତି_କରିବା ପଦୋନ୍ନତି_ହେବା
propose: ପ୍ରୟୋଜନ_ହେବା ମତଲବ_ଥିବା ନାମିତ_କରିବା ମନୋନୀତ_କରିବା ବାଛିବା ଚୟନ_କରିବା ବିବାହ_ପ୍ରସ୍ତାବ_ଦେବା ବିବାହ_ପ୍ରସ୍ତାବ_ରଖିବା
prorogue: ସ୍ଥଗିତ_ରଖିବା
proscribe: ମନାକରିବା ରୋକିବା ଅବରୋଧକରିବା
prosecute: ବ୍ୟସ୍ତରହିବା ଲାଗିବା ଲାଗିରହିବା
protect: ବଞ୍ଚେଇବା ରକ୍ଷା_କରିବା
protrude: ଫୁଲିଯାଇଛି
prove: ସତ_ହେବା ପ୍ରମାଣିତ_ହେବା ସିଦ୍ଧ_ହେବା ପରୀକ୍ଷା_କରିବା ପରୀକ୍ଷଣ_କରିବା ଜାଞ୍ଚ_କରିବା|
provide: ଯୋଗାଇଦେବା ପ୍ରଦାନ_କରିବା ଉପଲବ୍ଧ_କରିବା କରିବା ବ୍ୟବହାର_କରିବା ଭରଣପୋଷଣ_କରିବା ପୋଷଣ_କରିବା ପାଳନ_କରିବା ପ୍ରତିପାଳନ_କରିବା ପରିବାର_ଚଳାଇବା
provoke: ହଇରାଣ_କରିବା ପୀଡିତ_କରିବା|
ptyalise: ଥୁକିବା ଥୁ_ଥୁ_କରି_କାଢିପକାଇବା ଛେପ_ପକାଇବା ଛେପ_କାଢିବା ଥୁକାର_କରିବା ଥୁତ୍କାର_କରିବା
ptyalize: ଥୁକିବା ଥୁ_ଥୁ_କରି_କାଢିପକାଇବା ଛେପ_ପକାଇବା ଛେପ_କାଢିବା ଥୁକାର_କରିବା ଥୁତ୍କାର_କରିବା
publish: ଛପାଇବା ପ୍ରକାଶିତ_କରାଇବା ବାହାରିବା ପ୍ରକାଶିତ_ହେବା ପ୍ରକାଶିତ_କରିବା|
pucker: ମକଚିବା ଦଳିବା
puddle: ଅସ୍ତବ୍ୟସ୍ତ_ହେବା ହଡବଡ_ହେବା ଏପାଖ_ସେପାଖ_ହେବା ପରିସ୍ରା_କରିବା ମୁତିବା
puff: ଧଇଁସଇଁ_ହେବା
puke: ଥୁକିବା ଛେପପକାଇବା
pull: ଟାଣିବା ଆକର୍ଷିତ_କରିବା ଆକୃଷ୍ଟ_କରିବା ଲୋଭାନ୍ବିତ_କରିବା ଟାଣିବା| ବାହାର_କରିବା କାଢିବା| କାଢିବା ଟାଣିବା ଚୁଷିବା|
pull_a_fast_one_on: ଆଖିରେ_ଧୂଳି_ଦେବା ଚକମା_ଦେବା
pull_ahead: ଜିତିବା ଜୟ_ଜରିବା ବିଜୟୀ_ହେବା|
pull_back: ପଛକୁ_ହଟିବା ପଶ୍ଚାତଗତି_ହେବା
pull_in: ଆକର୍ଷିତ_କରିବା ଆକୃଷ୍ଟ_କରିବା ଲୋଭାନ୍ବିତ_କରିବା ଟାଣିବା|
pull_in_one's_horns: ପଛକୁ_ହଟିବା ପଶ୍ଚାତଗତି_ହେବା
pull_off: ତୋଳିବା ଛିଣ୍ଡାଇବା
pull_out: ବାହାର_କରିବା କାଢିବା| କାଢିବା ଟାଣିବା ଚୁଷିବା|
pull_round: ବଞ୍ଚିବା ରକ୍ଷାପାଇବା
pull_through: ବଞ୍ଚିବା ରକ୍ଷାପାଇବା ମୁକ୍ତ_କରିବା ମୁକ୍ତି_ପାଇବା ଉଦ୍ଧାର_କରିବା ଉଦ୍ଧାର_ପାଇବା ନିସ୍ତାର_ପାଇବା
pull_together: ଏକାଠିକରିବା ମେଣ୍ଡେଇବା ଗଦେଇବା|
pull_up: କାଢିବା ଟାଣିବା ଚୁଷିବା|
pull_up_stakes: ବାହାରିଯିବା ପୃଥକ_ହେବା ଅଲଗା_ହେବା ହଟିଯିବା|
pullulate: ଭାଙ୍ଗିବା ଉଛୁଳି_ପଡିବା ଅଙ୍କୁର_ବାହାରିବା ଅଙ୍କୁରିତ_ହେବା ଗଜେଇବା ଗଜା_ବାହାରିବା
pulsate: ସ୍ପନ୍ଦିତ_ହେବା|
pulse: ସ୍ପନ୍ଦିତ_ହେବା|
pulverise: ଭାଙ୍ଗିବା| ଗୁଣ୍ଡହେବା ଚୂର୍ଣ୍ଣହେବା ଭଗ୍ନହେବା ପେଷିବା ଚୂନା_କରିବା
pulverize: ପେଷିବା ଚୂନା_କରିବା ଭାଙ୍ଗିବା| ଗୁଣ୍ଡହେବା ଚୂର୍ଣ୍ଣହେବା ଭଗ୍ନହେବା
punish: ଦଣ୍ଡଦେବା ସଜାଦେବା ଦଣ୍ଡିତ_କରିବା ସଜା_ଶୁଣାଇବା ଶାସ୍ତି_ଦେବା
purge: ଥୁକିବା ଛେପପକାଇବା
purify: ଶୋଧନ ବିଶୋଧନ ପରିଷ୍କାର
purport: ପ୍ରୟୋଜନ_ହେବା ମତଲବ_ଥିବା
purpose: ପ୍ରୟୋଜନ_ହେବା ମତଲବ_ଥିବା
purr: ଘଡଘଡ_ହେବା ଘରଘର_ହେବା ଚଡଚଡ_ହେବା| ଘୁଡୁଘୁଡୁ_କରିବା
pursue: ବ୍ୟସ୍ତରହିବା ଲାଗିବା ଲାଗିରହିବା ପିଛା_କରିବା ଅନୁସରଣ_କରିବା|
push: ଧକ୍କାଦେବା ଠେଲାପେଲା_ହେବା ଲଢେଇ_କରିବା ଲଢିବା ସଂଗ୍ରାମ_କରିବା ଆନ୍ଦୋଳନ_କରିବା
push_aside: ରଦ୍ଦ_କରିବା ରଦ୍ଦ_କରି_ଦେବା ଖାରିଜ_କରିବା|
pussyfoot: ଖସିଯିବା
put: ରଖିବା ଲଗାଇବା ଖଟାଇବା ନିବେଶ_କରିବା
put_away: ପକେଇବା ଫୋପାଡିବା
put_down: ଶୁଆଇବା ଗଡେଇବା ତାଲିକାଭୁକ୍ତ_କରାଇବା ସୂଚୀଭୁକ୍ତ_କରାଇବା
put_in: ଗଚ୍ଛିତ_କରିବା ରଖିବା|
put_off: ସ୍ଥଗିତ_ରଖିବା କଥା_ଟାଳିବା ଟାଳିବା
put_on: ଲିପିବା
put_out: ଅସୁବିଧାରେ_ପକାଇବା ଝଞ୍ଜଟରେ_ପକାଇବା ଜଞ୍ଜାଳରେ_ପକାଇବା ଗୋଳମାଳରେ_ପକାଇବା ସମସ୍ୟାରେ_ପକାଇବା ହଇରାଣ_କରିବା ଲିଭାଇବା ଲିଭେଇବା ନିଭାଇବା ନିର୍ବାପିତ_କରିବା ବାହାରିବା ପ୍ରକାଶିତ_ହେବା
put_over: ସ୍ଥଗିତ_ରଖିବା
put_to_work: କରାଇବା
put_up: କରିବା ବ୍ୟବହାର_କରିବା ଅପମାନ_ସହିବା ବରଦାସ୍ତ_କରିବା ଘର_ଦେବା ଜାଗାଦେବା
puzzle_out: ସମାଧାନ_କରିବା ନିରାକରଣ_କରିବା ପ୍ରତିକାର_କରିବା ମୀମାଂସା_କରିବା
quake: ଡେଇଁବା
quarrel: କଳି_କରିବା ଝଗଡା_କରିବା ଲଢିବା ଲଢେଇକରିବା ଗଣ୍ଡଗୋଳ_କରିବା
quash: ଅଧୀନ_କରିବା କରଗତ_କରିବା ବଶକୁ_ଆଣିବା|
quaver: ଅସ୍ପଷ୍ଟ_ଭାବେ_କହିବା
quell: ଦବେଇଦେବା ଚାପି_ଦେବା ବନ୍ଦ_କରିଦେବା
quench: ମେଣ୍ଟିବା ଲିଭେଇବା ପ୍ରସମିତକରିବା| ଲିଭାଇବା ବନ୍ଦ_କରିବା ନିର୍ବାପିତ_କରିବା ନିଶ୍ଚିହ୍ନ_କରିବା ଦବେଇଦେବା ଚାପି_ଦେବା ବନ୍ଦ_କରିଦେବା
quest: ମାଗିବା
question: ଉଖୁରେଇବା
quiesce: ମୌନ_ହେବା ଚୁପ_ହେବା|
quiet: ମୌନ_ହେବା ଚୁପ_ହେବା| କମାଇଦେବା ହ୍ରାସକରିବା ଥଣ୍ଡାକରିବା ଶାନ୍ତକରିବା ନିର୍ବାପିତକରିବା
quiet_down: ମୌନ_ହେବା ଚୁପ_ହେବା|
quieten: ମୌନ_ହେବା ଚୁପ_ହେବା| କମାଇଦେବା ହ୍ରାସକରିବା ଥଣ୍ଡାକରିବା ଶାନ୍ତକରିବା ନିର୍ବାପିତକରିବା
quilt: ଗଦି_ତିଆରି_କରିବା
quit: ଛାଡିଦେବା
quiver: ଡେଇଁବା
quiz: ପରୀକ୍ଷା_କରାଇବା ପରୀକ୍ଷା_ନେବା ପରଖିବା ଗୁଣ_ନିର୍ଦ୍ଧାରଣ_କରିବା
rabbit_on: ହାଙ୍କିମରିବା ବଢେଇ_ଚଢେଇ_କହିବା ଫୋପାଡିବା
race: ଦୌଡ_ଲଗାଇବା କ୍ଷୀପ୍ରବେଗରେ_କାମ_କରିବା ଦ୍ରୁତଗତିରେ_କାର୍ଯ୍ୟ_କରିବା
rack: ଠକିନେବା
racket: ହୋ_ହଲ୍ଲା_କରିବା ଘୋ-ଘା_କରିବା କୋଳାହଳ_କରିବା ଚିତ୍କାର_କରିବା ଉତ୍ପାତ_କରିବା ପାଟିତୁଣ୍ଡ_କରିବା ହୁରି_ପକାଇବା ଚିତ୍କାରକଲା ଚିଲେଇଲା ପାଟିକରିବା ରଡିଛାଦିବା ହାଲାକରିବା ଚିତ୍କାରକରିବା ର୍ୟାକେଟରେ_ମାରିବା
radiate: ଚମକିବା ଝଲମଲ_କରିବା ଦମକିବା
rag: ବିରକ୍ତ_କରିବା ଚିଡେଇବା ରଗାଇବା କଷ୍ଟ_ଦେବା ଧିକ୍କାରିବା ଗାଳିଦେବା ଅପମାନ_କରିବା ତିରସ୍କାର_କରିବା
rail: ରେଲିଙ୍ଗ୍_ଲଗାଇବା
raiment: ପିନ୍ଧାଇବା|
rain: ବର୍ଷା_ହେବା ପାଣି_ବରଷିବା
rain_buckets: ମୂଷଳଧାରାରେ_ବର୍ଷାହେବା ଯୋରରେ_ବର୍ଷାହେବା ପ୍ରବଳ_ବର୍ଷାହେବା
rain_cats_and_dogs: ମୂଷଳଧାରାରେ_ବର୍ଷାହେବା ଯୋରରେ_ବର୍ଷାହେବା ପ୍ରବଳ_ବର୍ଷାହେବା
rain_down: ବର୍ଷା_ହେବା ପାଣି_ବରଷିବା
raise: ଉଠେଇବା ଉତ୍ପନ୍ନକରିବା ଉପୁଜେଇବା ଉତ୍ପାଦନକରିବା| ପାଳିବା ପୋଷିବା ପାଳନ_କରିବା ପାଳନ_ପୋଷଣ_କରିବା ପଦୋନ୍ନତି_କରିବା ପଦୋନ୍ନତି_ହେବା ଉଠେଇବା ଉଚ୍ଛେଦକରିବା ସମାପ୍ତକରିବା ହଟେଇବା ବନ୍ଦକରିବା
raise_up: ହଲେଇବା ଦୋହଲେଇବା
rally: ରକ୍ଷା_ପାଇବା ସମ୍ଭାଳି_ଯିବା ବିରକ୍ତ_କରିବା ଚିଡେଇବା ରଗାଇବା କଷ୍ଟ_ଦେବା
ramble: ଏଣେତେଣେ_ବୁଲିବା ଇତସ୍ତତଃ_ଭ୍ରମଣ_କରିବା
range: ଏଣେତେଣେ_ବୁଲିବା ଇତସ୍ତତଃ_ଭ୍ରମଣ_କରିବା ଚରିବା
ransack: ଲୁଟପାଟ_କରିବା ଲୋଟିବା ଅପହରଣ_କରିବା
rant: ହାଙ୍କିମରିବା ବଢେଇ_ଚଢେଇ_କହିବା ଫୋପାଡିବା
rap: ଟପ୍ଟପ୍_କରିବା
rattle: ଠକଠକ_କରିବା ଧଡଧଡ_କରିବା ଧକ୍କା_ମାରିବା ବାଡେଇବା
rave: ହାଙ୍କିମରିବା ବଢେଇ_ଚଢେଇ_କହିବା ଫୋପାଡିବା
razz: ବିରକ୍ତ_କରିବା ଚିଡେଇବା ରଗାଇବା କଷ୍ଟ_ଦେବା
re-create: ନକଲକରିବା ପ୍ରତିରୂପକରିବା ଉତାରିବା
reach: ଆସିବା ପହଞ୍ଚିବା ଆଗମନ_କରିବା ଉପସ୍ଥିତ_ହେବା ପହଞ୍ଚିବା ପହଞ୍ଚିବା ଉପନୀତ_ହେବା| ଧରାଇବା ରଖିବା_
read: ପଢିବା ଉଚ୍ଚାରଣ_କରିବା ପଢିବା ବୁଝିବା
ready: ରାନ୍ଧିବା ରୋଷେଇ_କରିବା ଖାଦ୍ୟ_ତିଆରି_କରିବା ଖାଦ୍ୟ_ରାନ୍ଧିବା ଉଦ୍ୟତହେବା ପ୍ରସ୍ତୁତ_ହେବା ତତ୍ପର_ହେବା
reap: ଫସଲ_କାଟିବା ଫସଲ_କଟାଇବା
rear: ପାଳିବା ପୋଷିବା ପାଳନ_କରିବା ପାଳନ_ପୋଷଣ_କରିବା ଉଠିବା ଉଚ୍ଚା_ହେବା|
reave: ଲୁଟପାଟ_କରିବା ଲୋଟିବା ଅପହରଣ_କରିବା
rebound: ରକ୍ଷା_ପାଇବା ସମ୍ଭାଳି_ଯିବା
rebuke: ଧିକ୍କାରିବା ଗାଳିଦେବା ଅପମାନ_କରିବା ତିରସ୍କାର_କରିବା
rebut: ଖଣ୍ଡନ_କରିବା କାଟିବା|
recall: ମନେ_ପଡିବା ସ୍ମରଣ_ହେବା
recite: ଆବୃତ୍ତି_କରିବା ଶୁଣେଇବା
recognise: ମାନିବା ସ୍ବୀକାରକରିବା ବୁଝିବା|
recognize: ମାନିବା ସ୍ବୀକାରକରିବା ବୁଝିବା|
recollect: ମନେ_ପଡିବା ସ୍ମରଣ_ହେବା
recompense: କ୍ଷତିପୂରଣ_କରିବା
reconstruct: ଆଣିବା ପୂର୍ବରୁ_ହେଲାଭଳି_କରିବା ମୂଳ_ସ୍ଥିତିକୁ_ଆଣିବା ପୂର୍ବାବସ୍ଥାକୁ_ଆଣିବା
record: ତାଲିକାଭୁକ୍ତ_କରାଇବା ସୂଚୀଭୁକ୍ତ_କରାଇବା ଟେପ_କରିବା ରେକର୍ଡ_କରିବା ଅଭିଲେଖନ_କରିବା
recount: ଶୁଣେଇବା
recover: ପୁଣି_ପ୍ରାପ୍ତ_କରିବା ପୁଣି_ଲାଭ_କରିବା ପୁଣି_ପ୍ରାପ୍ତ_କରିବା ପୁନର୍ବାର_ପାଇବା
recruit: ନିଯୁକ୍ତି_ଦେବା ନିଯୁକ୍ତ_କରିବା କାମ_ଦେବା ଚାକିରି_ଦେବା ଭର୍ତ୍ତି_କରିବା ରଖିବା|
recycle: ପୁନର୍ଚକ୍ରଣ_କରିବା ପୁନଃଚକ୍ରିତ_କରିବା ରି-ସାଇକ୍ଲ_କରିବା ରିସାଇକ୍ଲ_କରିବା
redden: ଲଜ୍ଜିତହେବା ଲାଜେଇବା ଲାଲ_କରିଦେବା ଲାଲ_ପଡିଯିବା
rede: ପରାମର୍ଶ_ଦେବା ଉପଦେଶ_ଦେବା
rediscover: ପୁଣି_ପାଇବା ପୁଣି_ମିଳିବା ପୁନଃ_ପ୍ରାପ୍ତହେବା
reduce: ଛାଡ_କରିବା ଋଣ_ଛାଡ_କରିବା| ଅଧୀନ_କରିବା କରଗତ_କରିବା ବଶକୁ_ଆଣିବା| ବହଳିଆ_କରିବା ଗାଢା_କରିବା
reef: ତଳୁଆ_କରିବା ନୀଚା_କରିବା ନିମ୍ନମୂଖୀ_କରିବା ପାଲ_ଗୁଡାଇବା ପାଲ_ଗୁଡେଇବା କମ୍_କରିବା କମେଇବା କମାଇବା
reel: ଟଳଟଳ_ହେବା ଟଳମଳ_ହେବା| ଘୁରିବା ଚକକର_ମାରିବା ଚକରି_ଖାଇବା ଭଉଁରି_କାଟିବା ନାଚିବା|
refer: ଉଲ୍ଲେଖ_କରିବା ରଚନା_କରିବା ପ୍ରସଙ୍ଗ_କରିବା ଚର୍ଚ୍ଚା_କରିବା|
reflect: ଚମକିବା
refund: ଚୁକ୍ତି_ହେବା
refuse: ମନା_କରିବା ନାଁ_କହିବା ନାହିଁ_କରିବା
refute: ଖଣ୍ଡନ_କରିବା କାଟିବା|
regain: ପୁଣି_ପ୍ରାପ୍ତ_କରିବା ପୁଣି_ଲାଭ_କରିବା ପୁଣି_ପ୍ରାପ୍ତ_କରିବା ପୁନର୍ବାର_ପାଇବା
regard: ମାନିବା ସ୍ନେହ_କରିବା ଆଦର_କରିବା
register: ପଞ୍ଜୀକରଣ_କରାଇବା ପଞ୍ଜୀକୃତ_କରାଇବା ରେଜିଷ୍ଟର_କରାଇବା ଦାଏର_କରିବା ଦାଖଲ_କରିବା ଉପସ୍ଥାପନା_କରିବା ପେଶ_କରିବା
regorge: ଥୁକିବା ଛେପପକାଇବା
regret: ଅନୁତାପ_କରିବା ପଶ୍ଚାତାପ_କରିବା ଅବଶୋଷ_କରିବା ବାଧିବା ଅପମାନିତ_ଲାଗିବା ଖରାପ_ଲାଗିବା
regurgitate: ଥୁକିବା ଛେପପକାଇବା
rehearse: ଅଭ୍ୟାସ_କରିବା ସାଧନା_କରିବା ବାରମ୍ବାର_କରିବା
reign: ଶକ୍ତିଶାଳୀ_ହେବା ବଳବାନ_ହେବା ପ୍ରଧାନ_ହେବା ସାମର୍ଥ୍ୟସମ୍ପନ୍ନ_ହେବା
reject: ମନା_କରିବା ନାଁ_କହିବା ନାହିଁ_କରିବା ତଡି_ଦେବା ପ୍ରତ୍ୟାଖାନ_କରିବା
rejoice: ପ୍ରସନ୍ନହେବା ପରିତୃପ୍ତହେବା ପରିତୁଷ୍ଟହେବା ସନ୍ତୁଷ୍ଟହେବା ତୃପ୍ତହେବା ପରିତୋଷହେବା ଖୁସିହେବା ସନ୍ତୋଷହେବା ପ୍ରୀତହେବା ଖୁସିରେ_ନାଚିବା ଅତି_ଆନନ୍ଦିତ_ହେବା ଖୁସିରେ_କୁରୁଳିବା
release: ଖଲାସ_ହେବା ମୁକ୍ତ_ହେବା ବାହାରିବା ପ୍ରକାଶିତ_ହେବା ପ୍ରଚଳନ_କରିବା ଜାରି_କରିବା ବାହାର_କରିବା
relieve_oneself: ପରିସ୍ରା_କରିବା ମୁତିବା
relish: ଆନନ୍ଦ_ନେବା ମଜା_ନେବା ସୁଖଲାଭ_କରିବା ସନ୍ତୋଷଲାଭ_କରିବା ସନ୍ତୁଷ୍ଟ_ହେବା
rely: ବିଶ୍ୱାସ_କରିବା ଠିକ_ମାନିନେବା ଭରସା_କରିବା
remain: ରୋକିଯିବା ଅଟକି_ଯିବା ରହିଯିବା ରହିବା ରହିଯିବା
remainder: ହରେଇବା|
remember: ମନେ_ପଡିବା ସ୍ମରଣ_ହେବା
remind: ସ୍ମରଣ_କରାଇବା
remit: ସ୍ଥଗିତ_ରଖିବା
remonstrate: ଧିକ୍କାରିବା ଗାଳିଦେବା ଅପମାନ_କରିବା ତିରସ୍କାର_କରିବା
remove: ତୁଟାଇବା ଦୂର_କରିବା ଅଲଗା_କରିବା_ ବାହାର_ହେବା ଅଲଗା_ହେବା ମରିବା ହତ୍ୟାକରିବା ଜୀବନନେବା ଶେଷକରିବା ଖଲାସକରିବା ହରଣକରିବା ଦୂର_କରିବା ମେଣ୍ଟାଇବା
render: ଯୋଗାଇଦେବା ପ୍ରଦାନ_କରିବା ଉପଲବ୍ଧ_କରିବା ଫେରେଇବା ଲେଉଟେଇବା ଅନୁବାଦ_କରିବା ଭାଷାନ୍ତର_କରିବା ଭାଷାନ୍ତରଣ_କରିବା ରୂପାନ୍ତର_କରିବା ତର୍ଜମା_କରିବା
renounce: ପରିତ୍ୟାଗ_କରିବା ଦୂରେଇଯିବା ଛାଡିଦେବା ହଟିଯିବା
renovate: ନବୀକରଣ_କରିବା ନୂଆକରିବା
rent: ଭଡା_ଦେବା| ଭଡା_କରିବା ଭଡା_ନେବା| ଭଡାରେ_ନେବା
repair: ମରାମତି_କରିବା ସଜାଡିବା ଠିକ_କରିବା କ୍ଷତିପୂରଣ_କରିବା
repay: ଚୁକ୍ତି_ହେବା
repeat: ପୁନରାବୃତ୍ତିକରିବା ଦୋହରେଇବା
repent: ଅନୁତାପ_କରିବା ପଶ୍ଚାତାପ_କରିବା ଅବଶୋଷ_କରିବା
replace: ବଦଳିଯିବା ବଦଳିବା
replete: ତୁଷ୍ଟ_ହେବା ତୃପ୍ତ_ହେବା ସନ୍ତୁଷ୍ଟ_ହେବା
reply: ଉତ୍ତର_ଦେବା ଜବାବ୍‌_ଦେବା
report: ଟାଣିବା ଆଙ୍କିବା
repose: ଶୁଆଇବା ଗଡେଇବା
reposition: ଘୁଞ୍ଚାଇବା ହଟେଇବା
repossess: ନେଇଯିବା ଫେରସ୍ତ_ନେବା ଫେରସ୍ତ_ନେଇଯିବା|
represent: ସମାନ_ହେବା ସମତୁଲ୍ୟ_ହେବା| ମଞ୍ଚିତ_କରିବା| ଯୁକ୍ତି_କରିବା ସାମନାକୁ_ଆଣିବା ତର୍କ_କରିବା ଯୁକ୍ତି_ବାଢିବା
repress: ଅଧୀନ_କରିବା କରଗତ_କରିବା ବଶକୁ_ଆଣିବା|
reprimand: ଧିକ୍କାରିବା ଗାଳିଦେବା ଅପମାନ_କରିବା ତିରସ୍କାର_କରିବା
reprocess: ପୁନର୍ଚକ୍ରଣ_କରିବା ପୁନଃଚକ୍ରିତ_କରିବା ରି-ସାଇକ୍ଲ_କରିବା ରିସାଇକ୍ଲ_କରିବା
reproof: ଧିକ୍କାରିବା ଗାଳିଦେବା ଅପମାନ_କରିବା ତିରସ୍କାର_କରିବା
repudiate: ପରିତ୍ୟାଗ_କରିବା ଦୂରେଇଯିବା ଛାଡିଦେବା ହଟିଯିବା
request: ମାଗିବା
require: ଚାହିଦା_ରହିବା ଆବଶ୍ୟକତା_ରହିବା ଦରକାର_ହେବା ପ୍ରୟୋଜନ_ହେବା
resemble: ପରିହେବା|
reserve: ଅଲଗା_ରଖିବା ପୃଥକ_ରଖିବା ସଂରକ୍ଷିତ_ରଖିବା ଅଲଗା_ରଖିବା ପୃଥକ_ରଖିବା ସଂରକ୍ଷିତ_ରଖିବା ସଂରକ୍ଷଣ_କରିବା ଆରକ୍ଷିତ_କରିବା
resist: ଅଟକାଇଦେବା ରୋକିଦେବା ଅଡିବସିବା ଅଡିବା ଜିଦକରିବା ଅଝଟକରିବା
resolve: ମୀମାଂସା_କରିବା ବୁଝାଶୁଝା_କରିବା ସମାଧାନ_କରିବା ସମାଧାନ_ହେବା ସମାଧାନ_କରିବା ନିର୍ଣ୍ଣିତ_ହେବା ମୀମାଂସିତ_ହେବା ଗୋଳାଇବା ମିଶେଇବା ମିଶ୍ରିତ_କରିବା
resound: ପ୍ରତିଧ୍ବନିତ_ହେବା ବାଡେଇହେବା
respect: ସମ୍ମାନ_କରିବା ଆଦର_କରିବା
respire: ଶ୍ବାସପ୍ରଶ୍ବାସ_ନେବା ଶ୍ବାସଗ୍ରହଣ_କରିବା
respond: ଉତ୍ତର_ଦେବା ଜବାବ୍‌_ଦେବା
rest: ବିଶ୍ରାମକରିବା ଆରାମ_କରିବା ଥକ୍କାମାରିବା ଟେକିବା ଉଠାଇବା
restitute: ନବୀକରଣ_କରିବା ନୂଆକରିବା
restore: ଆଣିବା ପୂର୍ବରୁ_ହେଲାଭଳି_କରିବା ମୂଳ_ସ୍ଥିତିକୁ_ଆଣିବା ପୂର୍ବାବସ୍ଥାକୁ_ଆଣିବା ମରାମତି_କରିବା ସଜାଡିବା ଠିକ_କରିବା
restrain: ମନମାରିବା
retaliate: ପ୍ରତିଶୋଧ_ନେବା ହିସାବ_ବରାବର_କରିବା ବଦଲା_ନେବା
retch: ଥୁକିବା ଛେପପକାଇବା ବାନ୍ତି_ଲାଗିବା ଓକାର_ଦେଖେଇବା|
retell: ଆବୃତ୍ତି_କରିବା
retool: ଦୋହରାଇବା ପୁନାରାବୃତ୍ତି_କରିବା ପୁଣି_ଦେଖିବା|
retreat: ପଛକୁ_ହଟିବା ପଶ୍ଚାତଗତି_ହେବା
retrieve: ପୁଣି_ପ୍ରାପ୍ତ_କରିବା ପୁଣି_ଲାଭ_କରିବା ପୁଣି_ପ୍ରାପ୍ତ_କରିବା ପୁନର୍ବାର_ପାଇବା ମନେ_ପଡିବା ସ୍ମରଣ_ହେବା
return: ଫେରିବା ଆସିବା ଲେଉଟିବା ଫେରେଇବା ଲେଉଟେଇବା ଲେଉଟାଇଆଣିବା ଫେରାଇଆଣିବା ଚୁକ୍ତି_ହେବା
reuse: ପୁନର୍ଚକ୍ରଣ_କରିବା ପୁନଃଚକ୍ରିତ_କରିବା ରି-ସାଇକ୍ଲ_କରିବା ରିସାଇକ୍ଲ_କରିବା
reveal: ଖୋଲିବା ପ୍ରକାଶ_କରିବା ପର୍ଦାଫାଶ_କରିବା ଉନ୍ମୋଚିତ_କରିବା ଖୋଲିବା ପଦାକୁବାହାରିବା ଉନ୍ମୋଚନ_ହେବା|
revel: ହୋ_ହଲ୍ଲା_କରିବା ଘୋ-ଘା_କରିବା କୋଳାହଳ_କରିବା ଚିତ୍କାର_କରିବା ଉତ୍ପାତ_କରିବା ପାଟିତୁଣ୍ଡ_କରିବା ହୁରି_ପକାଇବା
revenge: ପ୍ରତିଶୋଧ_ନେବା ହିସାବ_ବରାବର_କରିବା ବଦଲା_ନେବା
reverberate: ପ୍ରତିଧ୍ବନିତ_ହେବା ବାଡେଇହେବା ଠୋଠାହୋଇ_ଫୁଟିବା ଢୋଢାହୋଇଫୁଟିବା|
reverse: ଓଲଟି_ଯିବା
revise: ଦୋହରାଇବା ପୁନାରାବୃତ୍ତି_କରିବା ପୁଣି_ଦେଖିବା|
revolt: ବିଦ୍ରୋହ_କରିବା ଦ୍ରୋହ_କରିବା ଆନ୍ଦୋଳନ_କରିବା
revolve: ପରିକ୍ରମା_କରିବା ବୁଲିବା ଘୁରିବା ଚକକର_ମାରିବା
rhyme: ଯତିପାତ_କରିବା ମିତ୍ରାକ୍ଷର_କରିବା
rib: ଉପହାସ_କରିବା ନିନ୍ଦା_କରିବା ଦୋଷ_ବାହାର_କରିବା ହସି_ଉଡାଇବା|
rid: ମୁକାଳିବା ମୁକୁଳେଇବା ୱାପସଆଣିବା|
ride: ବିରକ୍ତ_କରିବା ଚିଡେଇବା ରଗାଇବା କଷ୍ଟ_ଦେବା
ridicule: ଉପହାସ_କରିବା ନିନ୍ଦା_କରିବା ଦୋଷ_ବାହାର_କରିବା ହସି_ଉଡାଇବା|
rifle: ଲୁଟପାଟ_କରିବା ଲୋଟିବା ଅପହରଣ_କରିବା
rime: ଯତିପାତ_କରିବା ମିତ୍ରାକ୍ଷର_କରିବା
ring: ବାଜିବା ପ୍ରତିଧ୍ବନିତ_ହେବା ବାଡେଇହେବା ଚକ୍କର_ମାରିବା ଚକ୍କର_କାଟିବା
rinse: ସଫାକରିବା
rinse_off: ସଫାକରିବା
rip_off: ଠକେଇଯିବା ଧୋକାଖାଇବା|
ripen: ପଚାଇବା ପାକଲା_କରାଇବା ପାଚିବା ପାକଲାହେବା ପକ୍ବହେବା
rise: ଉଠିବା ଉଚ୍ଚା_ହେବା| ଭାସିବା| ସୃଷ୍ଟିହେବା ଜାତ_ହେବା ଉତ୍ପନ୍ନ_ହେବା ଉଠିବା ଉଠିବା ଉଇଁବା ଉଦୟ_ହେବା|
rise_up: ଭାସିବା|
rival: ସମାସ୍କନ୍ଦ_ହେବା ସମାନ_ହେବା ପାଖାପାଖି_ହେବା
rivet: ଧ୍ୟାନ_କେନ୍ଦ୍ରୀଭୂତ_କରିବା ଧ୍ୟାନ_ଦେବା ଧ୍ୟାନ_ଏକାଗ୍ର_କରିବା
roam: ଏଣେତେଣେ_ବୁଲିବା ଇତସ୍ତତଃ_ଭ୍ରମଣ_କରିବା
roar: ଗର୍ଜନକରିବା ଚିଲ୍ଲେଇବା ରଡି_କରିବା ଗର୍ଜନ_କରିବା ଗରଜିବା|
roast: ପୋଡି_ହେବା ଉପହାସ_କରିବା ନିନ୍ଦା_କରିବା ଦୋଷ_ବାହାର_କରିବା ହସି_ଉଡାଇବା|
rob: ଲୋଟିବା ଠକିବା
rock: ହଲିବା ଦୋହଲିବ ଝୁମାଇବା
roll: ଗଡାଇବା ବେଲିବା ଗୁଡାଇବା ଘେରାଇବା ଦୋଳାୟମାନ_ହେବା ଲହରେଇବା ପଡିବା_ଉଠିବା ତ୍ବରଣ_ହେବା ଏଣେତେଣେ_ବୁଲିବା ଇତସ୍ତତଃ_ଭ୍ରମଣ_କରିବା
roll_in_the_hay: ରତିକରିବା ରମଣକରିବା ସମ୍ଭୋଗକରିବା
roll_out: ବେଲିବା
roll_up: ସଞ୍ଚୟ_କରିବା ସଂଗ୍ରହ_କରିବା ଏକାଠି_କରିବା ଏକତ୍ରିତ_କରିବା
rollick: ଡିଆଁଡେଇଁ_କରିବା ଡିଆଁକୁଦା_କରିବା ଖେଳକୁଦ_କରିବା ଘୋ-ଘା_କରିବା
romance: ଛଇ ଚତୁରୀ ଛୋପରି|
romp: ଡିଆଁଡେଇଁ_କରିବା ଡିଆଁକୁଦା_କରିବା ଖେଳକୁଦ_କରିବା ଘୋ-ଘା_କରିବା
rook: ଠକିବା
root: ଚାଲିବା|
rope: ଫସେଇବା ଫାନ୍ଦିବା| ବାନ୍ଧିବା ଗ୍ରନ୍ଥନ
rot: ଘାଣ୍ଟିହେବା କଷ୍ଟଭୋଗିବା
rotate: ପରିକ୍ରମା_କରିବା ବୁଲିବା ଘୁରିବା ଚକକର_ମାରିବା
round: ଚକ୍କର_ମାରିବା ଚକ୍କର_କାଟିବା
rouse: ଟିହାଇବା ଉସକେଇବା ଚିଡେଇବା ଉତ୍ତେଜିତକରିବା| ଜଗେଇବା ସଚେତ_କରିବା
rout: ଘଉଡାଇବା ତଡିବା
rout_out: ଘଉଡାଇବା ତଡିବା
rove: ଏଣେତେଣେ_ବୁଲିବା ଇତସ୍ତତଃ_ଭ୍ରମଣ_କରିବା
row: ନୌକା_ଚଳାଇବା ଡଙ୍ଗା_ବାହିବା ନୌଚାଳନ_କରିବା
rub: ଘୋରିବା ଘଷିବା_ କୁଣ୍ଡେଇବା
rub_down: ମାଲିସ୍_କରିବା
rub_out: ଲିଭାଇବା
rue: ଅନୁତାପ_କରିବା ପଶ୍ଚାତାପ_କରିବା ଅବଶୋଷ_କରିବା
ruffle: ଫୁଟାଣି_ମାରିବା ଗର୍ବରେ_ଟହଲମାରିବା
ruin: କ୍ଷୟ_କରିବା ନାଶ_କରିବା ଦେବାଳିଆ_କରିବା ଦେବାଲିଆ_କରିବା
rule: ଶକ୍ତିଶାଳୀ_ହେବା ବଳବାନ_ହେବା ପ୍ରଧାନ_ହେବା ସାମର୍ଥ୍ୟସମ୍ପନ୍ନ_ହେବା
rumble: ଘଡଘଡି_ମାରିବା ଗର୍ଜ୍ଜିବା
ruminate: ପାକୁଳି_କରିବା
rumple: ମକଚିବା ଦଳିବା ଭାଙ୍ଗ_ପଡିବା କୁଞ୍ଚ_ପଡିବା ଜାକିଜୁକିହେବା
run: ଦୌଡିବା ପଳେଇଯିବା| ଯିବା ଚାଲିବା ଗମନ_କରିବା ଦୌଡିବା ବିସ୍ତାରିତ_ହେବା ବିସ୍ତୃତ_ହେବା ଚଳାଇବା ବୋହିବା ବାହାରିବା ଚାଲିବା ଉପଯୋଗରେ_ଆସିବା କାମ_କରିବା ଚଳାଇବା ଚାଳିତକରିବା ଚାଲୁକରିବା_ ପ୍ରଚଳିତ_ହେବା ଚାଲିବା ଚାଲିଆସିବା ବେଆଇନ_କାରବାର_କରିବା ଅବୈଧ_କାରବାର_କରିବା ଅବୈଧାନିକ_କାରବାର_କରିବା ଚରିବାପାଇଁ_ଛାଡିବା ଚରିବାନିମନ୍ତେ_ଛାଡିବା ଚାରଣପାଇଁ_ଛାଡିବା ଶିକାର_କରିବା| ତରଳାଇବା ତରଳୀକୃତ_କରିବା
run_along: ଧାଡିରେ_ରହିବା ଶ୍ରେଣୀବଦ୍ଧହେବା ପଂକ୍ତିବଦ୍ଧହେବା
run_around: ଡିଆଁଡେଇଁ_କରିବା ଡିଆଁକୁଦା_କରିବା ଖେଳକୁଦ_କରିବା ଘୋ-ଘା_କରିବା
run_away: ପଳେଇଯିବା|
run_into: ଧକକା_ହେବା ବାଡେଇହେବା
run_off: ହଟେଦେବା ଭଗେଇଦେବା ତଡିଦେବା ପଳେଇବା
run_out: ଉଛୁଳିବା|
run_through: ଲାଗିବା ଖର୍ଚ୍ଚହେବା
run_up: ହଲାଇବା ଲହରାଇବା ସିଲାଇକରିବା ଲଗେଇବା_
rupture: ଚିରିବା ବିଦାରିବା ଫାଡିବା
rustle: ମଡମଡହେବା
sack: ବାହାରକରିଦେବା ସୁଧ_ଲାଭକରିବା ସୁଧ_ପାଇବା ସୁଧପ୍ରାପ୍ତି_କରିବା
sack_up: ସୁଧ_ଲାଭକରିବା ସୁଧ_ପାଇବା ସୁଧପ୍ରାପ୍ତି_କରିବା
sacrifice: ବଳିଦେବା
saddle: ଦାୟିତ୍ବଦେବା ଲଦିବା|
sag: ଦବିବା|
salt_away: ଗଚ୍ଛିତ_କରିବା ରଖିବା|
salute: ସାଲ୍ୟୁଟ୍_କରିବା ସାଲ୍ୟୁଟ୍_ମାରିବା ଅଭିବାଦନ_କରିବା ଅଭିବାଦନ_ଜଣାଇବା
sanctify: ଅଭିମନ୍ତ୍ରଣ_କରିବା
sashay: ଫୁଟାଣି_ମାରିବା ଗର୍ବରେ_ଟହଲମାରିବା
sate: ତୁଷ୍ଟ_ହେବା ତୃପ୍ତ_ହେବା ସନ୍ତୁଷ୍ଟ_ହେବା
satiate: ତୁଷ୍ଟ_ହେବା ତୃପ୍ତ_ହେବା ସନ୍ତୁଷ୍ଟ_ହେବା ତୃପ୍ତ_ହେବା
satirise: ବ୍ୟଙ୍ଗ_କରିବା|
satirize: ବ୍ୟଙ୍ଗ_କରିବା|
satisfy: ସନ୍ତୁଷ୍ଟ_କରିବା ତୃପ୍ତ_କରିବା
save: ମୁକ୍ତ_କରିବା ମୁକ୍ତି_ପାଇବା ଉଦ୍ଧାର_କରିବା ଉଦ୍ଧାର_ପାଇବା ନିସ୍ତାର_ପାଇବା ବଞ୍ଚାଇବା ରଖିବା_
savor: ଆନନ୍ଦ_ନେବା ମଜା_ନେବା ସୁଖଲାଭ_କରିବା ସନ୍ତୋଷଲାଭ_କରିବା ସନ୍ତୁଷ୍ଟ_ହେବା ଚୁଚୁମିବା
savour: ଚୁଚୁମିବା ଆନନ୍ଦ_ନେବା ମଜା_ନେବା ସୁଖଲାଭ_କରିବା ସନ୍ତୋଷଲାଭ_କରିବା ସନ୍ତୁଷ୍ଟ_ହେବା
savvy: ବୁଝେଇବା ଧରିବା
saw: କରତ_ଚଳେଇବା
saw_logs: ଘୁଙ୍ଗୁଡି
saw_wood: ଘୁଙ୍ଗୁଡି
say: କହିବା ଆଜ୍ଞା_କରିବା ଆଜ୍ଞା_ଦେବା ଆଦେଶ_ଦେବା|
scam: ଠକିବା
scare: ଡରେଇବା ଭୟଭୀତ_କରିବା ଭୟ_ସୃଷ୍ଟି_କରିବା ଡରାଇବା ଭୟଭୀତକରାଇବା ଭୟାତୁର_କରାଇବା
scare_away: ଡରାଇବା ଭୟଭୀତକରାଇବା ଭୟାତୁର_କରାଇବା
scare_off: ଡରାଇବା ଭୟଭୀତକରାଇବା ଭୟାତୁର_କରାଇବା
scarf_out: ତୃପ୍ତ_ହେବା
scarper: ପଳେଇଯିବା|
scat: ପଳେଇଯିବା|
scatter: ବୁଣିବା ଖେଳେଇବା ଛିଞ୍ଚିବା ବିକୀର୍ଣ୍ଣ_କରିବା ବୁଣିବା ଛାଟିବା ବପନକରିବା ବିକ୍ଷିପ୍ତକରିବା ଖେଳେଇ_ହେବା ଛିନ୍ଛତ୍ର_ହୋଇଯିବା
schedule: ବ୍ୟବସ୍ଥା_କରିବା ବନ୍ଦୋବସ୍ତ_କରିବା ଆୟୋଜନ_କରିବା ଯୋଜନା_କରିବା
school: ପଢିବା ପାଠ_ପଢିବା ଶିକ୍ଷାଗ୍ରହଣ_କରିବା
scintillate: ଚକମକ_କରିବା ଚକଚକ_କରିବା ଜକଜକ_କରିବା
scold: ଧିକ୍କାରିବା ଗାଳିଦେବା ଅପମାନ_କରିବା ତିରସ୍କାର_କରିବା
scorch: ଜଳିଯିବା ଗମହୋଇଯିବା| ଜଳିଯିବା ମରିଯିବା
score_out: ଲିଭାଇବା
scorn: ତଡି_ଦେବା ପ୍ରତ୍ୟାଖାନ_କରିବା
scour: ମାଜିବା ମାଜ_କରିବା|
scrabble: ଅଣ୍ଡାଳିବା ଦରାଣ୍ଡିବା ଖୋଜିବା ବଢେଇଦେବା ସାରିଦେବା
scramble: ଫେଣ୍ଟିବା
scranch: ଖସଖସ_ହେବା ଚୁଡୁମୁଡୁ_ହେବା
scrap: କଳି_କରିବା ଝଗଡା_କରିବା ଲଢିବା ଲଢେଇକରିବା ଗଣ୍ଡଗୋଳ_କରିବା
scrape: ଝୁଣିବା ବିଦାରିବା ଟାଣିବା ଭିଡିବା
scratch: ଝୁଣିବା ବିଦାରିବା ଟାଣିବା ଭିଡିବା କୁଣ୍ଡେଇବା
scratch_up: ଝୁଣିବା ବିଦାରିବା ଟାଣିବା ଭିଡିବା
scraunch: ଖସଖସ_ହେବା ଚୁଡୁମୁଡୁ_ହେବା
screak: ମଚମଚ_ହେବା
scream: ଚିଲ୍ଲାଇବା ରଡି_କରିବା ଚିତ୍କାର_କରିବା ଗର୍ଜନ_କରିବା
screech: ମଚମଚ_ହେବା
screen: ପରୀକ୍ଷା_କରିବା ଯାଞ୍ଚ_କରିବା
screw: ରତିକରିବା ରମଣକରିବା ସମ୍ଭୋଗକରିବା ମୋଡିବା ଘୁରାଇବା ଦୃଢ_କରିବା କସିବା|
scribble: ବଢେଇଦେବା ସାରିଦେବା
scrutinise: ପରୀକ୍ଷା_କରିବା ପରୀକ୍ଷଣ_କରିବା ପରଖିବା ଦେଖିବା ଅବଲୋକନ_କରିବା ଯାଞ୍ଚ୍_କରିବା ତଦାରଖ_କରିବା
scrutinize: ପରୀକ୍ଷା_କରିବା ପରୀକ୍ଷଣ_କରିବା ପରଖିବା ଦେଖିବା ଅବଲୋକନ_କରିବା ଯାଞ୍ଚ୍_କରିବା ତଦାରଖ_କରିବା
sculpt: ତିଆରି_କରିବା ଗଢିବା ନିର୍ମାଣ_କରିବା ବନେଇବା ସର୍ଜନା_କରିବା ଆକାର_ଦେବା ରୂପ_ପ୍ରଦାନ_କରିବା
sculpture: ତିଆରି_କରିବା ଗଢିବା ନିର୍ମାଣ_କରିବା ବନେଇବା ସର୍ଜନା_କରିବା ଆକାର_ଦେବା ରୂପ_ପ୍ରଦାନ_କରିବା
scupper: ଗୁପ୍ତ_ଆକ୍ରମଣପାଇଁ_ରହିବା
sear: ଜଳିଯିବା ଗମହୋଇଯିବା|
search: ଖୋଜିବା ପତା_ଲଗାଇବା
season: ଛୁଙ୍କ_କରିବା ବଘାରିବା ନୀରୋଗ_କରିବା ସୁସ୍ଥକରିବା ରୋଗଶୂନ୍ୟ_କରିବା ସ୍ବାସ୍ଥ୍ୟବାନ୍_କରିବା ସୁସ୍ଥସବଳ_କରିବା ସ୍ବାସ୍ଥ୍ୟଯୁକ୍ତ_କରିବା ଅପେକ୍ଷାକୃତ_ଭଲ_କରିବା ଅଧିକ_ଉତ୍ତମ_କରିବା ଅଧିକ_ଉତ୍କୃଷ୍ଟ_କରିବା
seat: ବସାଇବା ବସେଇବା ବସାଇବା ଆସୀନ_କରିବା|
secern: ଅଲଗା_କରିବା ଅନ୍ତର_କରିବା ବିଭେଦ_କରିବା ବିଚ୍ଛିନ୍ନ_କରିବା ପୃଥକ_କରିବା ପାର୍ଥକ୍ୟ_କରିବା ବିଭିନ୍ନତା_ଦର୍ଶାଇବା
secernate: ଅଲଗା_କରିବା ଅନ୍ତର_କରିବା ବିଭେଦ_କରିବା ବିଚ୍ଛିନ୍ନ_କରିବା ପୃଥକ_କରିବା ପାର୍ଥକ୍ୟ_କରିବା ବିଭିନ୍ନତା_ଦର୍ଶାଇବା
second: ନିଯୁକ୍ତ_କରିବା
secure: ଅଟକାଇବା ଚୁଣ୍ଟା_ଲଗାଇବା ବିଣ୍ଡା_ଲଗାଇବା ବନ୍ଦକରିବା
see: ଦେଖିବା ଦର୍ଶନ_କରିବା ଭେଟିବା ଦେଖାକରିବା| ମିଶିବା ଦେଖାହେବା ସାକ୍ଷାତ_କରିବା ଭେଟିବା ଏକତ୍ର_ହେବା ସଙ୍ଗୀହେବା ସଂସର୍ଗରେ_ରହିବା ସମୀକ୍ଷା_କରିବା| ଭୋଗିବା ପାଇବା
see_red: ରାଗିବା ଗରମ_ହେବା କ୍ରୋଧ_କରିବା ଉତ୍ତେଜିତ_ହେବା|
seed: ବୁଣିବା ବପନ_କରିବା ବେଙ୍ଗଳା_ପକାଇବା ବେଙ୍ଗଳାଇବା ବେଙ୍ଗୁଳିବା
seek: ଖୋଜିବା ପତା_ଲଗାଇବା
seem: ଜଣାପଡିବା ଲାଗିବା ଅନୁଭବହେବା|
seep: ଝରିବା ଗଳିବା ବାହାରିବା ସ୍ରାବ_ହେବା
seize_with_teeth: କାମୁଡିବା
select: ବାଛିବା ଅଲଗା_କରିବା
sell: ବିକିବା ବିକ୍ରୟ_କରିବା ବିକ୍ରି_ହେବା ବିକ୍ରି_ହୋଇଯିବା
send: ପଠାଇବା
send_away: ବାହାରକରିଦେବା
senesce: ବୁଢା_ହେବା ବୃଦ୍ଧ_ହେବା
sense: ଅନୁଭବ_କରିବା ବୋଧ_କରିବା ଜ୍ଞାନ_କରିବା ଅନୁଭୂତ_ହେବା
separate: ଅଲଗା_କରିବା ବାଛିବା ବାହାର_କରିବା_ ଅଲଗା_କରିବା ଅନ୍ତର_କରିବା ବିଭେଦ_କରିବା ବିଚ୍ଛିନ୍ନ_କରିବା ପୃଥକ_କରିବା ପାର୍ଥକ୍ୟ_କରିବା ବିଭିନ୍ନତା_ଦର୍ଶାଇବା ଅଧା_କରିବା ଅଧା_ଅଧା_ବାଣ୍ଟିବା ବାଣ୍ଟିହେବା ବଣ୍ଟାହେବା ବାଛିବା ଫାଟିବା| ଅଲଗାହେବା ପୃଥକହେବା ହଜିଯିବା ଅଲଗା_ହୋଇଯିବା
separate_out: ସ୍ଥିର_ହୋଇଯିବା ବସିଯିବା
serve: ପରଷିବା ବାଢିବା ସେବାକରିବା ପରିଚର୍ଯ୍ୟା_କରିବା
set: ରଖିବା ଜଡାଇବା ବସାଇବା ଉଦ୍ୟତହେବା ପ୍ରସ୍ତୁତ_ହେବା ତତ୍ପର_ହେବା ଅସ୍ତ_ହେବା ବୁଡିବା ଡୁବିବା ରୋଇବା ଚଢାଇବା|
set_about: ଉଠାଇବା ଆରମ୍ଭ_କରିବା ବାହାର_କରିବା
set_aside: ଅଲଗା_ରଖିବା ପୃଥକ_ରଖିବା ସଂରକ୍ଷିତ_ରଖିବା
set_back: ସ୍ଥଗିତ_ରଖିବା
set_forth: ପ୍ରସ୍ଥାନ_କରିବା ଛାଡିବା ଚାଲିବା|
set_off: ପ୍ରସ୍ଥାନ_କରିବା ଛାଡିବା ଚାଲିବା| ଫୁଟାଇବା
set_out: ଉଠାଇବା ଆରମ୍ଭ_କରିବା ବାହାର_କରିବା ପ୍ରସ୍ଥାନ_କରିବା ଛାଡିବା ଚାଲିବା|
set_up: ଚଳାଇବା ଟାଣିବା ଭିଡିବା ବାନ୍ଧିବା ଉଦ୍ୟତହେବା ପ୍ରସ୍ତୁତ_ହେବା ତତ୍ପର_ହେବା
settle: ବସିବା ମୀମାଂସା_କରିବା ବୁଝାଶୁଝା_କରିବା ସମାଧାନ_କରିବା ରହିବା ବାସକରିବା ପଶିବା ପଶିଯିବା ଚାଲିବା| ଠିକ_ହେବା ନିରୂପିତ_ହେବା ପକ୍କା_ହେବା ପଟାଇବା ଠିକ_କରିବା ନିଗାଡିବା| ଲାଖିବା ଅଟକିବା ନିବିଷ୍ଟ_ହୋଇ_ରହିବା
settle_down: ବସିବା ଚାଲିବା| ଆପଣେଇ_ନେବା
severalise: ଅଲଗା_କରିବା ଅନ୍ତର_କରିବା ବିଭେଦ_କରିବା ବିଚ୍ଛିନ୍ନ_କରିବା ପୃଥକ_କରିବା ପାର୍ଥକ୍ୟ_କରିବା ବିଭିନ୍ନତା_ଦର୍ଶାଇବା
severalize: ଅଲଗା_କରିବା ଅନ୍ତର_କରିବା ବିଭେଦ_କରିବା ବିଚ୍ଛିନ୍ନ_କରିବା ପୃଥକ_କରିବା ପାର୍ଥକ୍ୟ_କରିବା ବିଭିନ୍ନତା_ଦର୍ଶାଇବା
sew: ସିଲାଇକରିବା ଲଗେଇବା_ ସିଲେଇ ସିଇଁବା ଟାଙ୍କିବା
sew_together: ସିଲାଇକରିବା ଲଗେଇବା_
shake: ଝୁଲାଇବା ଝୁମାଇବା ହଲାଇବା ହଲିବା| ହଲିବା ଦୋହଲିବ
shake_hands: ହାତ_ମିଳାଇବା କରମର୍ଦ୍ଦନ_କରିବା
shake_up: ହଲେଇବା ଦୋହଲେଇବା
shape_up: ଉନ୍ନତି_କରିବା ଉନ୍ନତ_ହେବା ବିକାଶ_କରିବା ବଢିବା|
share: ଭାଗକରିବା ବାଣ୍ଟିବା ଭାଗବାଣ୍ଟିବା
sharpen: ଶାଣଦେବା ଧାରଦେବା|
shave: ମୁଣ୍ଡନ_କରେଇବା ଲଣ୍ଡା_ହେବା ନଣ୍ଡାହେବା ଉଡେଇବା
shell_out: ବାଣ୍ଟିବା ବିତରଣ_କରିବା
shelter: ଆଶ୍ରୟ_ଦେବା ଶରଣ_ଦେବା|
shelve: ସ୍ଥଗିତ_ରଖିବା
shift: ଘୁଞ୍ଚାଇବା ହଟେଇବା ହଲିବା ହଟିବା
shine: ଚମକିବା ଉଜ୍ଜ୍ବଳ_କରିବା ଦୀପ୍ତିମାନ_କରିବା ବିଖ୍ୟାତ_କରିବା ଚମକିବା ଝଲମଲ_କରିବା ଦମକିବା ଚମକିବା ଚମକ_ଆଣିବା ଚିକ୍କଣ_କରିବା ଉଜ୍ଜ୍ବଳ_କରିବା ଚିକ୍‌ଚିକ୍‌_କରିବା ଚକ୍‌ମକ୍‌
ship: ପଠାଇବା
shipwreck: ଉଡେଇ_ଦେବା ହରେଇବା ହାରିବା ବରବାଦକରିବା ନଷ୍ଟକରିବା କ୍ଷତିହେବା ହାନିହେବା ନାଶହେବା ଅପଚୟ_ହେବା ନଷ୍ଟହେବା ଦୁର୍ଘଟଣାଗ୍ରସ୍ତ_ହେବା
shirk: ପଛେଇବା ଡରିବା ମନଛଡେଇବା|
shit: ଝାଡା_ଫେରିବା ଝାଡାଯିବା ହଗିବା ମଳତ୍ୟାଗ_କରିବା ପାଇଖାନା_ଯିବା
shiver: କମ୍ପିତ_ହେବା କମ୍ପିବା ଥରି_ଉଠିବା ଥରିବା| କମ୍ପିବା ଥରିବା କମ୍ପିତହେବା ଥରଥରହେବା ଶିହରୀତହେବା
shock: ଆଶ୍ଚର୍ଯ୍ୟାନ୍ବିତ_ହେବା ବିସ୍ମିତ_ହେବା ଚକିତ_ହେବା ଚମକିପଡିବା ଚିହିଙ୍କିଉଠିବା
shoot: ଉଠାଇବା ଫୋଟୋ_ଉଠାଇବା| ଅପବ୍ୟୟ_କରିବା ପଇସା_ଉଡାଇବା ଅଙ୍କୁର_ବାହାରିବା ଅଙ୍କୁରିତ_ହେବା ଗଜେଇବା ଗଜା_ବାହାରିବା ଟୀକା_ଲଗାଇବା ଟୀଙ୍କା_ଲଗାଇବା ଇଞ୍ଜେସନ_ଲଗାଇବା|
shoot_a_line: ଫୁଟାଣି_ମାରିବା ବଡିମା_ଦେଖାଇବା ଆସ୍ଫାଳନ_କରିବା
shoot_the_breeze: ଆଲୋଚନା କଥାବାର୍ତ୍ତା ବାର୍ତ୍ତାଳାପ କଥା_
short-change: ଠକିବା
shoulder: କାନ୍ଧେଇବା କାନ୍ଧରେ_ବୋହିବା
shout: ଚିଲ୍ଲାଇବା ରଡି_କରିବା ଚିତ୍କାର_କରିବା ଗର୍ଜନ_କରିବା ଚିତ୍କାର_କରାଇବା ଗାଳି_ଦେବା ଖରାପ_ଶବ୍ଦ_କହିବା ବକିବା
shout_out: ଚିଲ୍ଲାଇବା ରଡି_କରିବା ଚିତ୍କାର_କରିବା ଗର୍ଜନ_କରିବା
show: ଦେଖାଇବା ପ୍ରଦର୍ଶିତ_କରିବା ଶୋ_କରିବା ପ୍ରଦର୍ଶନ_କରିବା ଦେଖାଇବା ଦର୍ଶାଇବା ଜଣାଇବା ସୂଚନାଦେବା ସୂଚିତକରିବା ଜ୍ଞାତ_କରିବା ସତର୍କ_କରିବା
show_off: ଅଭିମାନ_ପ୍ରଦର୍ଶନ_କରିବା ଇଜ୍ଜତ_ଦେଖେଇବା
show_up: ଆସିବା ଧରିବା|
shower: ବର୍ଷା_କରିବା ବର୍ଷେଇବା ବରଷିବା ବର୍ଷିବା ବର୍ଷାହେବା
shower_down: ବରଷିବା ବର୍ଷିବା ବର୍ଷାହେବା
shrink: ସଂକୁଚିତ_କରିବା| କୁଞ୍ଚିତ_ହେବା ଛୋଟ_ହେବା ସାଙ୍କୁଡିବା ସାଙ୍କୁଚିବା ଜାକିହେବା ସଙ୍କୁଚିତ_ହେବା
shrivel: ସଂକୁଚିତ_କରିବା| ସାଙ୍କୁଡିବା ସାଙ୍କୁଚିବା ଜାକିହେବା ସଙ୍କୁଚିତ_ହେବା
shrivel_up: ସଂକୁଚିତ_କରିବା|
shudder: କମ୍ପିବା ଥରିବା କମ୍ପିତହେବା ଥରଥରହେବା ଶିହରୀତହେବା କମ୍ପିତ_ହେବା କମ୍ପିବା ଥରି_ଉଠିବା ଥରିବା|
shun: ବଞ୍ଚିତ_ରହିବ ଦୂରେଇ_ରହିବା|
shut: ବୁଜିବା ମୁଦିବା ବନ୍ଦ_କରିବା
shut_down: ବନ୍ଦ_କରିବା ଛୁଟି_କରିବା ଆବଦ୍ଧ_କରିବା
sibilate: ଫଁ_ଫଁ_ହେବା ଫଁ_ଫଁ_କରିବା ଫୁଫୁକାର_କରିବା ଗର୍ଜନ_କରିବା ଫୁତ୍କାର_କରିବା
sick: ଥୁକିବା ଛେପପକାଇବା
sidestep: କଥା_ଟାଳିବା ଟାଳିବା
sieve: ଛାଣିବା
sift: ଛାଣିବା
sign: ଦସ୍ତଖତ_କରିବା ହସ୍ତାକ୍ଷର_କରିବା
signify: ଅର୍ଥ_ବାହାରକରିବା
simmer_down: ଆପଣେଇ_ନେବା
simulate: ଅନୁକରଣ_କରିବା ନକଲ୍_କରିବା
sing: ଗାଇବା ଗାନକରିବା ସାଇଁ_ସାଇଁ_ବହିବା
singe: ଜଳିଯିବା ଗମହୋଇଯିବା|
sink: ଚପେଇବା ଦାବିବା| ପଶିବା ପଶିଯିବା
siss: ଫଁ_ଫଁ_ହେବା ଫଁ_ଫଁ_କରିବା ଫୁଫୁକାର_କରିବା ଗର୍ଜନ_କରିବା ଫୁତ୍କାର_କରିବା
sit: ବସିବା ଆସନ_ଗ୍ରହଣ_କରିବା ଆସିନ_ହେବା ବିରାଜ_କରିବା ବସାଇବା ବସେଇବା
sit_down: ବସାଇବା ବସେଇବା ବସିବା ଆସନ_ଗ୍ରହଣ_କରିବା ଆସିନ_ହେବା ବିରାଜ_କରିବା
situate: ବତାଇବା ନିର୍ଦ୍ଦେଶ_କରିବା ଦେଖାଇବା
size_up: ପରୀକ୍ଷା_କରିବା ପରୀକ୍ଷଣ_କରିବା ପରଖିବା ଦେଖିବା ଅବଲୋକନ_କରିବା
sizz: ଫଁ_ଫଁ_ହେବା ଫଁ_ଫଁ_କରିବା ଫୁଫୁକାର_କରିବା ଗର୍ଜନ_କରିବା ଫୁତ୍କାର_କରିବା
skid: ଖସିଯିବା ପଡିଯିବା ଖସରି_ପଡିବା
skim_off: ବଛାଇବା ଅଲଗା_କରାଇବା
skin: ଛେଲାଇବା|
skip: ଡେଇବା କୁଦାମାରିବା ଦୁମ୍_ଦୁମ୍_କରିବା|
skirt: କଥା_ଟାଳିବା ଟାଳିବା
skreak: ମଚମଚ_ହେବା
skylark: ଡିଆଁଡେଇଁ_କରିବା ଡିଆଁକୁଦା_କରିବା ଖେଳକୁଦ_କରିବା ଘୋ-ଘା_କରିବା
slack: ମନ୍ଥର_ହେବା ଧୀର_ହେବା ଶିଥିଳ_ହେବା ଲିଭାଇବା ନିର୍ବାପିତ_କରାଇବା
slacken: ମନ୍ଥର_ହେବା ଧୀର_ହେବା ଶିଥିଳ_ହେବା
slake: ମେଣ୍ଟିବା ଲିଭାଇବା ନିର୍ବାପିତ_କରାଇବା
slander: ଚୁଗୁଲି_କରିବା ଫୋଡିବା|
slant: ନଇଁବା ବଙ୍କା_ହେବା ଝୁଙ୍କିବା
slap: ଥାପଡ_ମାରିବା ଚଟକଣା_ମାରିବା ଚାପୁଡା_ମାରିବା
slay: ମରିବା ହତ୍ୟାକରିବା ଜୀବନନେବା ଶେଷକରିବା ଖଲାସକରିବା
sleep: ଶୋଇବା ନିଦ୍ରାଯିବା
sleep_with: ରତିକରିବା ରମଣକରିବା ସମ୍ଭୋଗକରିବା
slew: ଖସିଯିବା ପଡିଯିବା ଖସରି_ପଡିବା
slide: ଖସିଯିବା ପଡିଯିବା ଖସରି_ପଡିବା ଘୋସାଡି_ନେବା|
slip: ଖସିଯିବା ପଡିଯିବା ଖସରି_ପଡିବା ଭୁଲ_କରିବା ଅପରାଧକରିବା
slop: ଚହଲାଇବା
slow: ମନ୍ଥର_ହେବା ଧୀର_ହେବା ଶିଥିଳ_ହେବା
slow_down: ମନ୍ଥର_ହେବା ଧୀର_ହେବା ଶିଥିଳ_ହେବା
slow_up: ମନ୍ଥର_ହେବା ଧୀର_ହେବା ଶିଥିଳ_ହେବା
slue: ଖସିଯିବା ପଡିଯିବା ଖସରି_ପଡିବା
slug: ଆଳସ୍ୟ_କରିବା ଅଳସାଇବା
slumber: ଶୋଇବା ନିଦ୍ରାଯିବା
slurp: ସୁରୁକିବା
smart: ବିନ୍ଧିବା ଯନ୍ତ୍ରଣା_ହେବା ପୀଡାଦେବା
smash: ଦେବାଳିଆ_କରିବା ଦେବାଲିଆ_କରିବା
smear: ଲିପାଇବା ଚୁଗୁଲି_କରିବା ଫୋଡିବା|
smell: ଶୁଙ୍ଘିବା ଗନ୍ଧ_ଶୁଙ୍ଘିବା ବାସ_ନେବା ମହକିବା ସୁଗନ୍ଧ_କରିବା ସୁଗନ୍ଧିତ_ହେବା| ଦୁର୍ଗନ୍ଧ_ଛାଡିବା ଗନ୍ଧେଇବା
smile: ମୁଚୁକି_ମୁଚୁକି_ହସିବା ଧୀରେ_ହସିବା
smirch: ଚୁଗୁଲି_କରିବା ଫୋଡିବା|
smoke: ଧୂମ୍ରପାନ_କରିବା ଧୂଆଁ_ଟାଣିବା
smooth: ଚମକିବା ଚମକ_ଆଣିବା ଚିକ୍କଣ_କରିବା ଉଜ୍ଜ୍ବଳ_କରିବା ଚିକ୍‌ଚିକ୍‌_କରିବା ଚକ୍‌ମକ୍‌
smoothen: ଚମକିବା ଚମକ_ଆଣିବା ଚିକ୍କଣ_କରିବା ଉଜ୍ଜ୍ବଳ_କରିବା ଚିକ୍‌ଚିକ୍‌_କରିବା ଚକ୍‌ମକ୍‌
smother: ଅଣନିଶ୍ବାସୀ_ହେବା ଶ୍ବାସ_ଅଟକିବା ଶ୍ବାସରୋଧ_ହେବା|
snaffle: କ୍ଷୀପ୍ର_ଗତିରେ_କାବୁ_କରିବା ଫୂର୍ତ୍ତିରେ_ଅକ୍ତିଆର_କରିବା ଶୀଘ୍ର_ଆଗକୁ_ବଢି_ଧରିବା
snap: ଗର୍ଜନ ଚିରିବା ବିଦାରିବା ଫାଡିବା ଉଠାଇବା ଫୋଟୋ_ଉଠାଇବା|
snap_off: ଖଣ୍ଡ_କରିବା ଭାଙ୍ଗିବା ଗଡକରିବା ଭାଗକରିବା|
snap_up: କ୍ଷୀପ୍ର_ଗତିରେ_କାବୁ_କରିବା ଫୂର୍ତ୍ତିରେ_ଅକ୍ତିଆର_କରିବା ଶୀଘ୍ର_ଆଗକୁ_ବଢି_ଧରିବା
snare: ଫାନ୍ଦିବା ଫାଶରେପକାଇବା|
snarl: ଗର୍ଜନ ଗୁନ୍ଥିହେବା
snatch: ଅପହରଣ_କରିବା ହରଣ_କରିବା|
sneak: ଖସିଯିବା
sneeze: ଛିଙ୍କିବା
sniff: ସୁଡୁକିବା
sniffle: ନାକରେ_କାନ୍ଦିବା_ ସୁଡୁକିବା
snip: ଛୋଟ_କରିବା
snip_off: ଛୋଟ_କରିବା
snitch: ଚୋରେଇବା ଅପହରଣ_କରିବା ହାତ_ମାରିବା
snivel: ନାକରେ_କାନ୍ଦିବା_
snooze: ଢୋଳେଇ_ପଡିବା
snore: ଘୁଙ୍ଗୁଡି
snub: ଅବମାନନା_କରିବା ଉପେକ୍ଷା_କରିବା
snuff_it: ମରିବା ପରଲୋକ_ଗମନ_କରିବା ପ୍ରାଣଛାଡିଯିବା ପ୍ରାଣବାୟୁ_ଉଡିଯିବା ମହା_ନିର୍ବାଣ_ପ୍ରାପ୍ତ_ହେବା ସ୍ୱର୍ଗପ୍ରାପ୍ତି_ହେବା
snuff_out: ଲିଭେଇବା ପ୍ରସମିତକରିବା|
snuffle: ନାକରେ_କାନ୍ଦିବା_
soak: ଭିଜାଇବା ଭିଜେଇବା ପାଣିରେ_ବୁଡାଇ_ରଖିବା ଆର୍ଦ୍ର_କରିବା ଲୋଟିବା ଠକିବା ନିଶା_ଖାଇବା ନିଶାପାଣି_କରିବା
soak_up: ଶୋଷଣ_କରିବା ଅବଶୋଷିତ_କରିବା ଟାଣିବା ପିଇବା|
sob: ସକେଇବା ସକସକ_ହେବା
soil: ଗୋଳିଆ_କରିବା ମଇଳା_କରିବା ଅପରିଷ୍କାର_କରିବା
solace: ସାନ୍ତ୍ବନା_ଦେବା ବୁଝାଇବା
solve: ସମାଧାନ_କରିବା ନିରାକରଣ_କରିବା ପ୍ରତିକାର_କରିବା ମୀମାଂସା_କରିବା
soothe: ସାନ୍ତ୍ବନା_ଦେବା ବୁଝାଇବା
sop_up: ଶୋଷଣ_କରିବା ଅବଶୋଷିତ_କରିବା ଟାଣିବା ପିଇବା|
sorrow: ଚିନ୍ତା_କରିବା ଭାବିବା ଦୁଃଖିତ_ହେବା ପୀଡିତ_ହେବା
sough: ବୁଣିବା ବପନ_କରିବା ହୁଙ୍କାର_ମାରିବା ଶବ୍ଦକରିବା ଚିତ୍କାରକରିବା ବୁଣିବା|
sound: ବଜାଇବା
sour: ଆମ୍ବିଳା_ହୋଇଯିବା ଖଟା_ହୋଇଯିବା
souse: ବୁଡେଇବା_ଡୁବେଇବା
sow: ବୁଣିବା ବପନ_କରିବା ବୁଣିବା|
sparge: ଛିଞ୍ଚିବା ଛିଟିକାଇବା ଛିଡିକାଇବା ସିଞ୍ଚିବା ସେଚନକରିବା
speak: କଥା_ବାହାରିବା ଶବ୍ଦ_ବାହାରିବା କଥା_ହେବା କହିବା ଉଚ୍ଚାରଣ_କରିବା ଉଚ୍ଚାରିବା ବୋଲିବା ବାଜିବା ଶବ୍ଦ_କରିବା_
spend: କଟିବା ବ୍ୟତୀତ_ହେବା ବିତିବା ଲଗେଇବା ଖର୍ଚ୍ଚ_କରିବା ବ୍ୟୟ_କରିବା
spend_a_penny: ପରିସ୍ରା_କରିବା ମୁତିବା
spew: ଥୁକିବା ଥୁ_ଥୁ_କରି_କାଢିପକାଇବା ଛେପ_ପକାଇବା ଛେପ_କାଢିବା ଥୁକାର_କରିବା ଥୁତ୍କାର_କରିବା ଥୁକିବା ଛେପପକାଇବା
spill: ଚହଲାଇବା ଉଛୁଳିବା| କହିପକେଇବା ବାହାର_କରିବା ବାନ୍ତି_କରିଦେବା
spin: ଘୁରିବା ଚକକର_ମାରିବା ଚକରି_ଖାଇବା ଭଉଁରି_କାଟିବା ନାଚିବା| କାଟିବା
spin_around: ଘୁରିବା ଚକକର_ମାରିବା ଚକରି_ଖାଇବା ଭଉଁରି_କାଟିବା ନାଚିବା|
spit: ଥୁକିବା ଥୁ_ଥୁ_କରି_କାଢିପକାଇବା ଛେପ_ପକାଇବା ଛେପ_କାଢିବା ଥୁକାର_କରିବା ଥୁତ୍କାର_କରିବା
spit_out: ଥୁ_ଥୁ_କରିବା ଛେପ_ପକାଇବା ଥୁକାର_କରିବା ଖଙ୍କାରିବା|
spit_up: ଖଙ୍କାରିବା|
spite: କଣ୍ଟା_ଫୋଡିବା ଖଟକା_ଲାଗିବା ଅପ୍ରିୟ_ଲାଗିବା ଖରାପ_ଲାଗିବା
splash: ଛିଞ୍ଚିବା
splatter: ଚହଲାଇବା
split: ଅଧା_କରିବା ଅଧା_ଅଧା_ବାଣ୍ଟିବା ଅଲଗାହେବା ପୃଥକହେବା ହଜିଯିବା ଅଲଗା_ହୋଇଯିବା
split_up: ଛାଡପତ୍ର ବିବାହ_ବିଛେଦ_କରିବା ଅଧା_କରିବା ଅଧା_ଅଧା_ବାଣ୍ଟିବା ଅଲଗାହେବା ପୃଥକହେବା ଫାଟିବା|
splosh: ଛିଞ୍ଚିବା
splutter: ଥୁ_ଥୁ_କରିବା ଛେପ_ପକାଇବା ଥୁକାର_କରିବା
spoil: ସଢିବା ପଚିବା ଦବିବା| ଖରାପ_କରିବା ବିଗାଡିବା
sport: ଦେଖାଇବା ପ୍ରଦର୍ଶନ_କରିବା ପ୍ରଦର୍ଶିତ_କରିବା ଉପସ୍ଥାପନ_କରିବା ପ୍ରତ୍ୟକ୍ଷ_କରାଇବା ଡିଆଁଡେଇଁ_କରିବା ଡିଆଁକୁଦା_କରିବା ଖେଳକୁଦ_କରିବା ଘୋ-ଘା_କରିବା
spout: ହାଙ୍କିମରିବା ବଢେଇ_ଚଢେଇ_କହିବା ଫୋପାଡିବା
spread: ପ୍ରସାରିତ_କରିବା ବିସ୍ତୃତ_କରିବା ପ୍ରସାର_କରିବା ବଢେଇବା| ବିସ୍ତାରିତ_ହେବା ଖେଳେଇ_ହେବା ପ୍ରସାରିତ_ହେବା ବ୍ୟାପ୍ତହେବା ଖେଳେଇ_ଦେବା ପ୍ରଘଟ_କରିବ| ଖେଳେଇ_ହେବା ଛିନ୍ଛତ୍ର_ହୋଇଯିବା ବିଛାଇବା ବିସ୍ତାର_କରିବା
spread_out: ଖେଳେଇ_ହେବା ଛିନ୍ଛତ୍ର_ହୋଇଯିବା ଖେଳେଇ_ଦେବା
spring: ଡେଇଁବା ଲମ୍ଫପ୍ରଦାନ_କରିବା|
spring_to_mind: ଉଠିବା ଉଇଁଲା ଉଙ୍କିମାରିବା|
spring_up: ସୃଷ୍ଟିହେବା ଜାତ_ହେବା ଉତ୍ପନ୍ନ_ହେବା
sprinkle: ବୁଣିବା ଖେଳେଇବା ଛିଞ୍ଚିବା ବିକୀର୍ଣ୍ଣ_କରିବା ଛିଞ୍ଚିବା ଛିଞ୍ଚିବା ଛିଟିକାଇବା ଛିଡିକାଇବା ସିଞ୍ଚିବା ସେଚନକରିବା
sprout: ଅଙ୍କୁର_ବାହାରିବା ଅଙ୍କୁରିତ_ହେବା ଗଜେଇବା ଗଜା_ବାହାରିବା
spud: ଅଙ୍କୁର_ବାହାରିବା ଅଙ୍କୁରିତ_ହେବା ଗଜେଇବା ଗଜା_ବାହାରିବା
spue: ଥୁକିବା ଥୁ_ଥୁ_କରି_କାଢିପକାଇବା ଛେପ_ପକାଇବା ଛେପ_କାଢିବା ଥୁକାର_କରିବା ଥୁତ୍କାର_କରିବା ଥୁକିବା ଛେପପକାଇବା
spurn: ତଡି_ଦେବା ପ୍ରତ୍ୟାଖାନ_କରିବା
sputter: ଥୁ_ଥୁ_କରିବା ଛେପ_ପକାଇବା ଥୁକାର_କରିବା
squall: ଚିତ୍କାର_କରିବା| ଚିଲ୍ଲାଇବା ରଡି_କରିବା ଚିତ୍କାର_କରିବା ଗର୍ଜନ_କରିବା
squander: ବ୍ୟୟକରିବା ଖର୍ଚ୍ଚ_କରିବା|
square: ବର୍ଗଫଳ_ବାହାରକରିବା ଚାରିକୋଣିଆ_କରିବା ବର୍ଗାକାର_କରିବା ମଙ୍ଗୁଆଳ_ମୋଡିବା ମଙ୍ଗୁଆଳ_ଘୁରାଇବା ମଙ୍ଗଧରା_ମୋଡିବା ମଙ୍ଗଧରା_ଘୁରାଇବା
square_away: ସଜାଡିବା ସୁବ୍ୟବସ୍ଥିତ_କରିବା
squash: ପେଶିବା ପେଡିବା|
squeak: ମଚମଚ_ହେବା
squeal: କେଁ-କେଁ_ଶବ୍ଦ_|
squeeze: ପେଶିବା ପେଡିବା| ଠକିନେବା ଚିମୁଟିଦେବା ଚିମୁଟିବା କୁଣ୍ଢେଇ_ପକାଇବା ଆଲିଙ୍ଗନ_କରିବା
squelch: ଦବେଇଦେବା ଚାପି_ଦେବା ବନ୍ଦ_କରିଦେବା ପେଶିବା ପେଡିବା|
squirm: ହଲଚଲହେବା|
stab: ଭୁସିବା କେଞ୍ଚିବା ବିନ୍ଧିବା ହାଣିବା
stack_away: ଗଚ୍ଛିତ_କରିବା ରଖିବା|
stage: ମଞ୍ଚିତ_କରିବା| ପରିଚାଳନା_କରିବା ସଞ୍ଚାଳିତ_କରିବା
stagger: ଟଳଟଳ_ହେବା ଟଳମଳ_ହେବା|
stagnate: ଆଳସ୍ୟ_କରିବା ଅଳସାଇବା
stain: ଲାଗିରହିବା
stammer: ଥଙ୍ଗେଇବା ଅଟକିବା|
stamp: ଷ୍ଟାମ୍ପମାରିବା ମୋହରମାରିବା
stamp_down: ହରେଇବା ହାଲିଆ_କରିଦେବା|
stand: ଉଠିବା ଠିଆହେବା ଛିଡାହେବା ରହିବା ହେବା ଠିଆ_ହେବା ଛିଡା_ହେବା ଉଭା_ହେବା ଦଣ୍ଡାୟମାନ_ହେବା ଅପମାନ_ସହିବା ବରଦାସ୍ତ_କରିବା ଉଠାଇବା
stand_firm: ଅଟକାଇଦେବା ରୋକିଦେବା
stand_for: ଅର୍ଥ_ବାହାରକରିବା ସମାନ_ହେବା ସମତୁଲ୍ୟ_ହେବା|
stand_up: ଉଠାଇବା ଉଠିବା ଠିଆହେବା ଛିଡାହେବା
stare: ଆଖିପକାଇବା ନଜର_ଲଗାଇବା
start: ଉଠାଇବା ଆରମ୍ଭ_କରିବା ବାହାର_କରିବା ଉଠାଇବା ଆରମ୍ଭ_କରିବା ପ୍ରସ୍ଥାନ_କରିବା ଛାଡିବା ଚାଲିବା| ଆରମ୍ଭ_କରିବା ପ୍ରାରମ୍ଭ_କରିବା ଉଛୁଳି_ଉଠିବା ଚମକି_ପଡିବା ଖୋଲିବା| ଫୁଲିଯାଇଛି
start_out: ଉଠାଇବା ଆରମ୍ଭ_କରିବା ବାହାର_କରିବା ପ୍ରସ୍ଥାନ_କରିବା ଛାଡିବା ଚାଲିବା|
startle: ଉଛୁଳି_ଉଠିବା ଚମକି_ପଡିବା
stash_away: ଗଚ୍ଛିତ_କରିବା ରଖିବା|
state: ବତାଇବା ଜଣାଇବା ଜ୍ଞାତ_କରାଇବା
stay: ରହିବା ବାସକରିବା ଅବସ୍ଥାନକରିବା ରୋକିଯିବା ଅଟକି_ଯିବା ରହିଯିବା ସମ୍ଭାଳିବା ରହିବା ଆଶ୍ରୟ_ନେବା ସମ୍ଭାଳି_ହେବା_ ରହିବା ରହିଯିବା
stay_on: ରୋକିଯିବା ଅଟକି_ଯିବା ରହିଯିବା
steady_down: ଚାଲିବା|
steal: ଚୋରାଇବା|
steam: ରାଗରେ_ନିଆଁବାଣ_ହେବା
step: ପାଦ_ରଖିବା ଗୋଡ_ରଖିବା ପଦସ୍ଥାପନ_କରିବା
step_in: ପଡିବା ଆସିବା|
stick: ଜଡିଯିବା ଲାଗିଯିବ ଯୋଡିଯିବା ଜାବୁଡି_ଧରିବା ମିଶିଯିବା ଲାଗିବା ଯୋଡିହେବା
stick_on: ଥାପିବା ଲଦିବା ବୋଳିବା ଲିପିବା|
stick_out: ଅପମାନ_ସହିବା ବରଦାସ୍ତ_କରିବା
stick_to: ଜଡିଯିବା ଲାଗିଯିବ ଯୋଡିଯିବା
stiffen: ରକା_ଧରିବା ପବନ_ଅଟକିବା
still: କମାଇଦେବା ହ୍ରାସକରିବା ଥଣ୍ଡାକରିବା ଶାନ୍ତକରିବା ନିର୍ବାପିତକରିବା
stimulate: ଉସ୍କେଇବା ମତେଇବା ମତାଇବା ଉତ୍ସାହିତ_କରିବା ପ୍ରବର୍ତ୍ତେଇବା ପ୍ରବର୍ତ୍ତାଇବା ଜାଗୃତ_କରିବା ଜଗେଇବା ସାଧନ_କରିବା
sting: ପୋଡିବା ଜଳିବା ଚୋଟ_ମାରିବା କାମୁଡିବା ଦଂଶନ_କରିବା_ ପଶିବା ଫୋଡିହେବା
stir: ଘୋଟିବା ମନ୍ଥିବା ଘୋଳିବା ଫେଣ୍ଟିବା| ହଲିବା ହଟିବା
stir_up: ଜଳେଇବା ଇର୍ଷାନ୍ବିତ_କରାଇବା ଚିଡେଇବା ହଲେଇବା ଦୋହଲେଇବା
stitch: ସିଲାଇକରିବା ଲଗେଇବା_
stoke: ପୁରେଇବା ଭର୍ତ୍ତିକରିବା|
stomach: ଅପମାନ_ସହିବା ବରଦାସ୍ତ_କରିବା
stonewall: ପ୍ରତିବନ୍ଧକ_ଲଗାଇବା ବାଧା_ଦେବା ଅବରୋଧ_କରିବା
stool: ଝାଡା_ଫେରିବା ଝାଡାଯିବା ହଗିବା ମଳତ୍ୟାଗ_କରିବା ପାଇଖାନା_ଯିବା
stop: ଅଟକିବା ବନ୍ଦହେବା ଗତିରୋଧ_ହେବା ଛାଡିଦେବା ରହିଯିବା ଅଟକିବା ରୋକିବା| ଛୁଟିହେବା ସମାପ୍ତ_ହେବା| ବନ୍ଦ_କରିବା ସିଲ୍_କରିବା ବ୍ଲକ୍_କରିବା ବଂଦ_କରିବା
stop_up: ଚୁଣ୍ଟା_ଲଗାଇବା ବିଣ୍ଡା_ଲଗାଇବା ବନ୍ଦକରିବା
store: ଗଚ୍ଛିତ_କରିବା ରଖିବା|
straighten: ସଜାଡିବା ସୁବ୍ୟବସ୍ଥିତ_କରିବା
straighten_out: ସଜାଡିବା ସୁବ୍ୟବସ୍ଥିତ_କରିବା
strain: ଛାଣିବା ସ୍ଥିର_ହୋଇଯିବା ବସିଯିବା
stray: ଏଣେତେଣେ_ବୁଲିବା ଇତସ୍ତତଃ_ଭ୍ରମଣ_କରିବା ଏଣେ_ତେଣେ_ବୁଲିବା ପଥ_ହୁଡିବା ଇତସ୍ତତଃ_ବୁଲିବା
stream: ଲହରିବା ଝୁଲିବା ହଲିବା| ଭାଙ୍ଗିବା ଉଛୁଳି_ପଡିବା ମୂଷଳଧାରାରେ_ବର୍ଷାହେବା ଯୋରରେ_ବର୍ଷାହେବା ପ୍ରବଳ_ବର୍ଷାହେବା ବହିବା ପ୍ରବାହିତ_ହେବା
stretch: ଅଳସ_ଭାଙ୍ଗିବା ଭିଡିମୋଡିହେବା ଟଣାଇବା ପ୍ରସାରିତ_କରାଇବା ବିସ୍ତାରିତ_କରାଇବା ଢଳିପଡିବା ଆଉଜିବସିବା ଆଉଜିପଡିବା
stretch_out: ଢଳିପଡିବା ଆଉଜିବସିବା ଆଉଜିପଡିବା
stride: ଲଙ୍ଘଂନ_କରିବା ଡେଇଁବା| ପାରିହେବା ଲଙ୍ଘିବା ଲଙ୍ଘନକରିବା
strike: ଧକକା_ହେବା ବାଡେଇହେବା ପ୍ରଭାବିତ_କରିବା ପ୍ରଭାବ_ପକାଇବା ବାଜିବା
strike_down: ପକାଇଦେବା
string: ଗୁନ୍ଥିବା ଗୁନ୍ଥିବା
string_up: ଗୁନ୍ଥିବା
strip: ଉଲଗ୍ନ_କରାଇବା ଲୁଟପାଟ_କରିବା ଲୋଟିବା ଅପହରଣ_କରିବା ଖୋଲିବା ବଦଳିବା ବାହାର_କରିବା
strive: ପ୍ରଯତ୍ନ_କରିବା ପ୍ରୟାସ_କରିବା ଚେଷ୍ଟା_କରିବା ଉଦ୍ୟମ_କରିବା ଉଦଯୋଗ_କରିବା ଯତ୍ନ_କରିବା କଷ୍ଟ_କରିବା
stroke: ଆଉଁଷିବା|
struggle: ସଂଘର୍ଷ_କରିବା ପ୍ରତିଦ୍ବନ୍ଦିତା_କରିବା ଲଢିବା_
strut: ଫୁଟାଣି_ମାରିବା ଗର୍ବରେ_ଟହଲମାରିବା
stub: ଓପାଡିବା ଉତ୍ପାଟନ_କରିବା
study: ପଢିବା ଅଧ୍ୟୟନ_କରିବା
stuff: ଭର୍ତ୍ତି_କରିବା ତୃପ୍ତ_ହେବା
stun: ଆଶ୍ଚର୍ଯ୍ୟାନ୍ବିତ_ହେବା ବିସ୍ମିତ_ହେବା ଚକିତ_ହେବା
stutter: ଥଙ୍ଗେଇବା ଅଟକିବା|
style: ଷ୍ଟାଇଲରେ_କରିବା ଷ୍ଟାଇଲ_କରିବା ଷ୍ଟାଇଲ_କରିବା ଷ୍ଟାଇଲରେ_କରିବା ଶୈଳୀଗତ_କରିବା
subdue: ଅଧୀନ_କରିବା କରଗତ_କରିବା ବଶକୁ_ଆଣିବା| ହରେଇବା ହାଲିଆ_କରିଦେବା|
subjugate: ଅଧୀନ_କରିବା କରଗତ_କରିବା ବଶକୁ_ଆଣିବା|
sublimate: ଶୋଧନ ବିଶୋଧନ ପରିଷ୍କାର
submerge: ତଲ୍ଲୀନ_ହେବା ଲୀନ_ହେବା ଭାବାନ୍ବିତ_ହେବା ଆତ୍ମବିସ୍ମ୍ରୁତ_ହେବା ଧ୍ୟାନାବସ୍ଥିତ_ହେବା ବୁଡି_ଯିବା
subscribe: ଦସ୍ତଖତ_କରିବା ହସ୍ତାକ୍ଷର_କରିବା ଅଗ୍ରୀମ_ଦେବା ସଂରକ୍ଷଣ_କରିବା
subscribe_to: ଅଗ୍ରୀମ_ଦେବା ସଂରକ୍ଷଣ_କରିବା
subside: ଛାଡିବା ଓହ୍ଲାଇବା|
substitute: ବଦଳିଯିବା ବଦଳିବା
subtract: ବିୟୋଗକରିବା ବିଯୁକ୍ତ_କରିବା ଫେଡିବା ହଟେଇବା
succumb: ଅଧୀନ_ହେବା ଅନୁଗତ_ହେବା
suck: ଶୋଷିବା ଚୁହିଁବା ଶୋଷଣ_କରିବା ଅବଶୋଷିତ_କରିବା ଟାଣିବା ପିଇବା|
suck_up: ଶୋଷଣ_କରିବା ଅବଶୋଷିତ_କରିବା ଟାଣିବା ପିଇବା|
suffer: ଅପମାନ_ସହିବା ବରଦାସ୍ତ_କରିବା କଷ୍ଟ_ସହିବା ଦୁଃଖ_ସହିବା କଷ୍ଟ_ଭୋଗିବା ପୀଡାହେବା ଯନ୍ତ୍ରଣାହେବା| ଘାଣ୍ଟିହେବା ହଇରାଣ_ହେବା
suffocate: ଅଣନିଶ୍ବାସୀ_ହେବା ଶ୍ବାସ_ଅଟକିବା ଶ୍ବାସରୋଧ_ହେବା|
suit: ମାନିବା ଶୋଭିତ_ହେବା ଭଲ_ଲାଗିବା|
sulk: ରୁଷିବା ରୁଷ୍ଟ_ହେବା ମୁଁହ_ଫୁଲେଇବା କ୍ରୋଧିତ_ହେବା କ୍ରୁଦ୍ଧ_ହେବା କୁପିତ_ହେବା
sully: ଚୁଗୁଲି_କରିବା ଫୋଡିବା|
summon: ଡାକିବା
sunburn: ଟାଇଁଟାଇଁ_ଖରା_ମାରିବା ଟାଣଖରା_ହେବା
supercharge: ବଢାଇବା ତୀବ୍ର_କରିବା
supply: ଯୋଗାଇଦେବା ପ୍ରଦାନ_କରିବା ଉପଲବ୍ଧ_କରିବା
support: ଅଟକେଇବା ସମ୍ଭାଳିବା ଧରିବା ରଖିବା ଅପମାନ_ସହିବା ବରଦାସ୍ତ_କରିବା
suppress: ହରେଇବା ହାଲିଆ_କରିଦେବା| ଦବେଇଦେବା| ମନମାରିବା
surcharge: ଲୋଟିବା ଠକିବା
surface: ଭାସିବା| ଆସିବା ଧରିବା|
surfeit: ପୂରିବା ଭରିବା ଫୁଲିବା ସ୍ଫୀତହେବା ତୃପ୍ତହେବା
surpass: ଯିବା ଚାଲିବା
surprise: ଆଶ୍ଚର୍ଯ୍ୟହେବା ତାଜୁବହେବା ବିସ୍ମୟହେବା ଚକିତହେବା
surrender: ଦାୟିତ୍ବ_ଦେବା ନ୍ୟସ୍ତ_କରିବା ଜିମା_କରିବା
surround: ଚକ୍କର_ମାରିବା ଚକ୍କର_କାଟିବା କାନ୍ଥଦ୍ବାରା_ଘେରାଇବା ପାଚେରୀଦ୍ବାରା_ଘେରାଇବା
survive: ବଞ୍ଚିବା ରକ୍ଷାପାଇବା ଅଧିକ_ବଞ୍ଚିବା ଅଧିକ_ସମୟ_ଜିଇଁବା ଅଧିକଦିନ_ବଞ୍ଚିବା ଦୀର୍ଘଜୀବୀ_ହେବା
suspend: ଲଟକାଇବା ଝୁଲାଇବା
suspire: ଶ୍ବାସପ୍ରଶ୍ବାସ_ନେବା ଶ୍ବାସଗ୍ରହଣ_କରିବା
sustain: ପୋଷଣ_କରିବା ଆହାର_କରିବା ଭୋଜନ_କରିବା ପାଳିତ_କରିବା ପୁଷ୍ଟିକରଣ_କରିବା ବର୍ଦ୍ଧନ_କରିବା ସମ୍ଭାଳିବା ଅଟକେଇବା ସମ୍ଭାଳିବା ଧରିବା ରଖିବା
swag: ଦବିବା| ଟଳଟଳ_ହେବା ଟଳମଳ_ହେବା|
swagger: ଫୁଟାଣି_ମାରିବା ଗର୍ବରେ_ଟହଲମାରିବା ଧମକେଇବା ଦମକଦେବା ଡରେଇବା
swallow: ଗିଳିବା
swan: ରାଣ_ଖାଇବା ରାଣ_ପକାଇବା ଶପଥ_କରିବା ଦୁହାଇ_କରିବା ପ୍ରତିଜ୍ଞା_କରିବା ଏଣେତେଣେ_ବୁଲିବା ଇତସ୍ତତଃ_ଭ୍ରମଣ_କରିବା
swank: ଅଭିମାନ_ପ୍ରଦର୍ଶନ_କରିବା ଇଜ୍ଜତ_ଦେଖେଇବା
swarm: ଭାଙ୍ଗିବା ଉଛୁଳି_ପଡିବା
swash: ଫୁଟାଣି_ମାରିବା ବଡିମା_ଦେଖାଇବା ଆସ୍ଫାଳନ_କରିବା
sway: ହଲିବା ଦୋହଲିବ ଝୁମାଇବା
swear: ରାଣ_ଖାଇବା ରାଣ_ପକାଇବା ଶପଥ_କରିବା ଦୁହାଇ_କରିବା ପ୍ରତିଜ୍ଞା_କରିବା ବିଶ୍ୱାସ_କରିବା ଠିକ_ମାନିନେବା ଭରସା_କରିବା
sweep: ଝାଡି_ସଫା_କରିବା ଝାଡୁ_କରିବା ଝାଡୁ_ଲଗାଇବା ଟାଣିବା ଜବରଦସ୍ତି_କରିବା| ଘୋଟିଯିବା ଖେଳିଯିବା ବିସ୍ତାର_କରିବା ଆଛାଦିତ_କରିବା
sweep_up: ଟାଣିବା ଜବରଦସ୍ତି_କରିବା|
sweet-talk: ବହଲାଇବା ଆହ୍ଲାଦିତ_କରିବା ପ୍ରବୋଧିତ_କରିବା
swell: ଫୁଲିବା ସ୍ଫୀତ_ହେବା
swell_up: ଫୁଲିବା ସ୍ଫୀତ_ହେବା
swim: ପହଁରିବା ଭାସିବା|
swindle: ଠକିବା
swing: ଝୁଲିବା ଲଟକିବା ସାମାଜିକ_ହେବା
switch_off: ଲିଭାଇବା
swoop: ଲମ୍ଫ_ମାରିବା ଝାମ୍ପିବା କୁଦାମାରିବା
table: ସ୍ଥଗିତ_ରଖିବା
tack: ସିଲେଇ_କରିବା ସିଇଁବା ସୀବନକରିବା
tackle: ଦାୟିତ୍ବ_ନେବା ଦାୟିତ୍ବ_ଗ୍ରହଣ_କରିବା_ ଯୋଚିବା ଯୋଡିବା
tag: ଦୌଡେଇବା
tail: ଦୌଡେଇବା ଲାଞ୍ଜ_କାଟିବା ଲାଙ୍ଗୁଡ_କାଟିବା ପୁଚ୍ଛ_କାଟିବା
tailor: ସିଲେଇ ସିଇଁବା ଟାଙ୍କିବା
tailor-make: ସିଲେଇ ସିଇଁବା ଟାଙ୍କିବା
take: ଆଣିବା ନେଇଆସିବା ଚାହିଦା_ରହିବା ବାଛିବା ଅଲଗା_କରିବା ନେବା ଧରିବା ଚଢିବା| ନେବା ଗ୍ରହଣ_କରିବା ପ୍ରାପ୍ତ_କରିବା ପାଇବା ଗ୍ରହଣ_କରିବା ନେବା ସ୍ବୀକାର_କରିବା ନେବା ତୁଟାଇବା ଦୂର_କରିବା ଅଲଗା_କରିବା_ କାବୁ_କରିବା କବ୍ଜା_କରିବା ଅଧିକାର_କରିନେବା| ଅଙ୍ଗୀକାରକରିବା ଆପଣେଇନେବା ସ୍ବୀକାରକରିବା ଭଡା_କରିବା ଭଡା_ନେବା| ଅଗ୍ରୀମ_ଦେବା ସଂରକ୍ଷଣ_କରିବା କିଣିବା କ୍ରୟକରିବା ନେବା ଗ୍ରହଣ_କରିବା ଧାରଣ_କରିବା ଯାପନ_କରିବା ଭର୍ତ୍ତିକରିବା ଭରିବା ପୂରେଇବା
take_a_breath: ଶ୍ବାସପ୍ରଶ୍ବାସ_ନେବା ଶ୍ବାସଗ୍ରହଣ_କରିବା
take_a_breather: ବିଶ୍ରାମକରିବା ଆରାମ_କରିବା ଥକ୍କାମାରିବା
take_a_crap: ଝାଡା_ଫେରିବା ଝାଡାଯିବା ହଗିବା ମଳତ୍ୟାଗ_କରିବା ପାଇଖାନା_ଯିବା
take_a_leak: ପରିସ୍ରା_କରିବା ମୁତିବା
take_a_shit: ଝାଡା_ଫେରିବା ଝାଡାଯିବା ହଗିବା ମଳତ୍ୟାଗ_କରିବା ପାଇଖାନା_ଯିବା
take_aback: ଆଶ୍ଚର୍ଯ୍ୟାନ୍ବିତ_ହେବା ବିସ୍ମିତ_ହେବା ଚକିତ_ହେବା
take_away: ତୁଟାଇବା ଦୂର_କରିବା ଅଲଗା_କରିବା_ ବାହାରକରିବା| ହରଣକରିବା ଦୂର_କରିବା ମେଣ୍ଟାଇବା
take_back: ଲେଉଟାଇଆଣିବା ଫେରାଇଆଣିବା ନେଇଯିବା ଫେରସ୍ତ_ନେବା ଫେରସ୍ତ_ନେଇଯିବା|
take_care: ଜଗିକି_ରହିବା ସମ୍ଭାଳିକି_ରହିବା ସମ୍ଭାଳି_ହେବା
take_down: ଓହ୍ଲାଇବା ଟିପି_ରଖିବା|
take_fire: ଜଳିବା ଦଗ୍ଦହେବା
take_for: ରଖିବା
take_heed: ଶୁଣିବା ମାନିବା|
take_hold: ଧରିବା
take_in: ଦେଖିବା ଦର୍ଶନ_କରିବା ଶୋଷଣ_କରିବା ଅବଶୋଷିତ_କରିବା ଟାଣିବା ପିଇବା| କୋଳେଇ_ନେବା ସନ୍ତାନରୂପେ_ଗ୍ରହଣ_କରିବା
take_issue: ଅସହମତ_ହେବା ଅମତ_ହେବା ଅମାନ୍ୟ_କରିବା
take_off: ପ୍ରସ୍ଥାନ_କରିବା ଛାଡିବା ଚାଲିବା| ବିୟୋଗକରିବା ବିଯୁକ୍ତ_କରିବା ଫେଡିବା ହଟେଇବା
take_on: ଦାୟିତ୍ବ_ନେବା ଦାୟିତ୍ବ_ଗ୍ରହଣ_କରିବା_ ଅଙ୍ଗୀକାରକରିବା ଆପଣେଇନେବା ସ୍ବୀକାରକରିବା
take_out: ବାହାର_କରିବା କାଢିବା| କାଢିବା ଟାଣିବା ଚୁଷିବା| ଛାଡିବା|
take_over: ପୁନରାବୃତ୍ତିକରିବା ଦୋହରେଇବା
take_place: ଠିକ_ଘଟିବା ପ୍ରମାଣିତ_ହେବା
take_root: ଚାଲିବା|
take_stock: ପରୀକ୍ଷା_କରିବା ପରୀକ୍ଷଣ_କରିବା ପରଖିବା ଦେଖିବା ଅବଲୋକନ_କରିବା
take_the_air: ବୁଲାବୁଲି_କରିବା ବିଚରଣ_କରିବା ଟହଲିବା
take_to_task: ଧିକ୍କାରିବା ଗାଳିଦେବା ଅପମାନ_କରିବା ତିରସ୍କାର_କରିବା
take_to_the_woods: ପଳେଇଯିବା|
take_up: ଶୋଷଣ_କରିବା ଅବଶୋଷିତ_କରିବା ଟାଣିବା ପିଇବା|
talk: କଥା_ହେବା କଥା_ବାହାରିବା ଶବ୍ଦ_ବାହାରିବା କହିବା ଉଚ୍ଚାରଣ_କରିବା ଉଚ୍ଚାରିବା ବୋଲିବା କହିପକେଇବା ବାହାର_କରିବା ବାନ୍ତି_କରିଦେବା
talk_over: ଯୁକ୍ତିତର୍କ ବାଦବିବାଦ ତର୍କବିତର୍କ ବିତଣ୍ଡା
tamper: ଖରାପ_କରିବା ବିଗାଡିବା
tan: କଷିବା
tangle: ଟାଣିବା ଜବରଦସ୍ତି_କରିବା| ଗୁନ୍ଥିହେବା
tantalise: ବିରକ୍ତ_କରିବା ଚିଡେଇବା ରଗାଇବା କଷ୍ଟ_ଦେବା
tantalize: ବିରକ୍ତ_କରିବା ଚିଡେଇବା ରଗାଇବା କଷ୍ଟ_ଦେବା
tap: ଟପ୍ଟପ୍_କରିବା
tape: ଟେପ_କରିବା ରେକର୍ଡ_କରିବା ଅଭିଲେଖନ_କରିବା
target: ନିଶାନା_ସାଧିବା ଲକ୍ଷ୍ୟ_ସ୍ଥିର_କରିବା
taste: ଚୁଚୁମିବା
tattle: ଅଯଥା_କଥା_କହିବା ବକ୍‌ବକ୍‌_କରିବା ବକ୍‌_ବକ୍‌_ହେବା
tattoo: ଚିତାକୁଟାଇବା|
taunt: ବିରକ୍ତ_କରିବା ଚିଡେଇବା ରଗାଇବା କଷ୍ଟ_ଦେବା
teach: ଶିକ୍ଷା_ଦେବା ଶିଖେଇବା ବତେଇବା|
tear: ଚିରିବା ବିଦାରିବା ଫାଡିବା ଲୋହବୋହିବା ଆଶ୍ରୁପାତ
tease: ଚିଡାଇବା ହାସ୍ୟ_ରସ_କରିବା ବିରକ୍ତ_କରିବା ଚିଡେଇବା ରଗାଇବା କଷ୍ଟ_ଦେବା ଭିଣିବା| ଚିଡେଇବା
teem: ଭାଙ୍ଗିବା ଉଛୁଳି_ପଡିବା
tell: କହିବା ବତେଇବା ସୂଚନା_ଦେବା ସୂଚିତ_କରିବା ଶୁଣେଇବା କହିବା ଆଜ୍ଞା_କରିବା ଆଜ୍ଞା_ଦେବା ଆଦେଶ_ଦେବା| କହିବା ବ୍ୟକ୍ତକରିବା ବିବରଣୀଦେବା ସ୍ପଷ୍ଟକରିବା ଅଲଗା_କରିବା ଅନ୍ତର_କରିବା ବିଭେଦ_କରିବା ବିଚ୍ଛିନ୍ନ_କରିବା ପୃଥକ_କରିବା ପାର୍ଥକ୍ୟ_କରିବା ବିଭିନ୍ନତା_ଦର୍ଶାଇବା
tell_apart: ଅଲଗା_କରିବା ଅନ୍ତର_କରିବା ବିଭେଦ_କରିବା ବିଚ୍ଛିନ୍ନ_କରିବା ପୃଥକ_କରିବା ପାର୍ଥକ୍ୟ_କରିବା ବିଭିନ୍ନତା_ଦର୍ଶାଇବା
temper: ଅପେକ୍ଷାକୃତ_ଭଲ_କରିବା ଅଧିକ_ଉତ୍ତମ_କରିବା ଅଧିକ_ଉତ୍କୃଷ୍ଟ_କରିବା
tempt: ଲୋଭଦେଖେଇବା| ଲୋଭାଇବା ଲାଳସେଇବା|
tend: ସମ୍ଭାଳିବା ଯତ୍ନନେବା ଦେଖିବା
tender: ଦେବା ପ୍ରଦାନ_କରିବା ଦାନ_କରିବା
terminate: ଶେଷ_କରିବା ସମାପ୍ତ_କରିବା ପୂରା_କରିବା ପୂର୍ଣ୍ଣକରିବା ଛୁଟିହେବା ସମାପ୍ତ_ହେବା| ବାହାରକରିଦେବା
terrify: ଥରହର_କରିବା ଭୟଭୀତ_କରିବା ଆତଙ୍କିତ_କରିବା|
terrorise: ଥରହର_କରିବା ଭୟଭୀତ_କରିବା ଆତଙ୍କିତ_କରିବା|
terrorize: ଥରହର_କରିବା ଭୟଭୀତ_କରିବା ଆତଙ୍କିତ_କରିବା|
test: ପରୀକ୍ଷା_କରିବା ପରୀକ୍ଷଣ_କରିବା ଜାଞ୍ଚ_କରିବା| ପରୀକ୍ଷା_କରିବା ଯାଞ୍ଚ_କରିବା ପରୀକ୍ଷା_କରାଇବା ପରୀକ୍ଷା_ନେବା ପରଖିବା ଗୁଣ_ନିର୍ଦ୍ଧାରଣ_କରିବା ପରୀକ୍ଷଣର_ପରିଣାମ_ବାହାରିବା ପରୀକ୍ଷଣର_ପରିଣାମ_ମିଳିବା ଯାଞ୍ଚର_ପରିଣାମ_ବାହାରିବା ରଖିବା ମିଳିବା ପାଇବା ପ୍ରାପ୍ତହେବା ପରୀକ୍ଷା_କରାଇବା ଯାଞ୍ଚ_କରାଇବା ଟେଷ୍ଟ_କରାଇବା
thicken: ବହଳିଆ_ହେବା ଗାଢା_ହେବା
thieve: ଚୋରେଇବା ଅପହରଣ_କରିବା ହାତ_ମାରିବା
think: ବୁଝିବା ଚିନ୍ତାକରିବା ଭାବିବା ବିଚାରକରିବା ଅନ୍ବେଷଣ_କରିବା ଅନୁସନ୍ଧାନ_କରିବା ମନେ_ପଡିବା ସ୍ମରଣ_ହେବା
thrash: ଅମଳ_କରିବା
thread: ପୁରାଇବା ଭର୍ତ୍ତିକରିବା ଗୁନ୍ଥିବା
threaten: ବିପଦରେ_ପକାଇବା ସଙ୍କଟରେ_ପକାଇବା ସମସ୍ୟାରେ_ପକାଇବା
thresh: ଅମଳ_କରିବା
thrill: କମ୍ପିତ_ହେବା କମ୍ପିବା ଥରି_ଉଠିବା ଥରିବା|
throb: ସ୍ପନ୍ଦିତ_ହେବା| କମ୍ପିତ_ହେବା କମ୍ପିବା ଥରି_ଉଠିବା ଥରିବା|
throw: ପକେଇବା ଫୋପାଡିବା ଆୟୋଜନ_କରିବା ଆୟୋଜିତ_ହେବା ଯୋଗାଡ_କରିବା ଭ୍ରମିତ_ହେବା ଭ୍ରମ_ହେବା ଅକଲ_ଗୁଡୁମ_ହେବା|
throw_away: ପକେଇବା ଫୋପାଡିବା
throw_out: ପକେଇବା ଫୋପାଡିବା ବାହାର_କରିଦେବା
throw_up: ଥୁକିବା ଛେପପକାଇବା
thud: ଦମ୍ଦମ୍_ହେବା
thump: ଦମ୍ଦମ୍_ହେବା
thunder: ଗର୍ଜନକରିବା ଚିଲ୍ଲେଇବା ରଡି_କରିବା ଗରଜିବା ଗର୍ଜନ_କରିବା_
tickle: କୁତୁକୁତୁ_କରିବା
tidy: ସଜାଡିବା ସୁବ୍ୟବସ୍ଥିତ_କରିବା
tidy_up: ସଜାଡିବା ସୁବ୍ୟବସ୍ଥିତ_କରିବା
tie: ବାନ୍ଧିହେବା ଛନ୍ଦିହେବା| ଜୋଡିବା ଲଗାଇବା ମିଶାଇବା_|
tighten: ଟାଣିବା ଚଢା_ଯାଇଛି କଷା_ଯାଇଛି|
tile: ଟାଇଲ_ଛପର_କରିବା ଟାଇଲରେ_ଆଚ୍ଛାଦିତ_କରିବା ଟାଇଲରେ_ଢାଙ୍କିବା ଟାଇଲ_ଲଗାଇବା
tilt: ନଇଁବା ବଙ୍କା_ହେବା ଝୁଙ୍କିବା
time: ସମୟାବଧି_ମାପିବା ସମୟ_ମାପିବା କାଳ_ମାପିବା ସମୟ_ସ୍ଥିର_କରିବା ସମୟ_ନିଶ୍ଚିତ_କରିବା ସମୟ_ଥୟ_କରିବା ସମୟ_ନିର୍ଦ୍ଧାରଣ_କରିବା ସମୟ_ଠିକ_କରିବା ଘଡି_ମିଳାଇବା ସମୟ_ସେଟ୍_କରିବା ସମୟ_ନିର୍ଦ୍ଧାରଣ_କରିବା ସମୟ_ସ୍ଥିର_କରିବା ସମୟ_ଥୟ_କରିବା
tink: ଟଣଟଣ_କରିବା ଠଣଠଣ_କରିବା
tinkle: ଟଣଟଣ_କରିବା ଠଣଠଣ_କରିବା
tip: ନଇଁବା ବଙ୍କା_ହେବା ଝୁଙ୍କିବା
tip_over: ଓଲଟିଯିବା
tire: ଥକି_ପଡିବା|
tire_out: ଥକି_ପଡିବା|
tissue: ବୁଣିବା
titillate: କୁତୁକୁତୁ_କରିବା କୁତୁକୁତୁ_କରିବା
titter: ଖିଲ୍‌ଖିଲ୍‌_ହସ
tittle-tattle: ଅଯଥା_କଥା_କହିବା ବକ୍‌ବକ୍‌_କରିବା ବକ୍‌_ବକ୍‌_ହେବା
tittup: ଫୁଟାଣି_ମାରିବା ଗର୍ବରେ_ଟହଲମାରିବା
toast: ସେକିହେବା
toddle: ଚାଳନକରିବା|
tog: ପିନ୍ଧାଇବା|
toil: ଖଟେଇବା ରଗଡିବା ଲଗେଇବା
tolerate: ଅପମାନ_ସହିବା ବରଦାସ୍ତ_କରିବା
top: ପଛରେ_ପକାଇବା ଅଧିକ_ଉନ୍ନତି_କରିବା ଅଗ୍ରସର_ହେବା
tope: ମଦ_ପିଇବା ମଦ_ଚଢାଇବା|
toss: ଟସ୍_କରିବା କଏନ୍_ପକାଇବା ପକେଇବା ଫୋପାଡିବା
toss_away: ପକେଇବା ଫୋପାଡିବା
toss_out: ପକେଇବା ଫୋପାଡିବା
totter: ଚାଳନକରିବା|
touch: ଛୁଇଁବା ସ୍ପର୍ଶ_କରିବା ଛୁଆଁଇବା ଛୁଏଁଇବା ସ୍ପର୍ଶ_କରେଇବା ସମାସ୍କନ୍ଦ_ହେବା ସମାନ_ହେବା ପାଖାପାଖି_ହେବା
touch_on: ମରାମତି_କରିବା ସଜାଡିବା ଠିକ_କରିବା
tour: ଭ୍ରମଣ_କରିବା ବୁଲିବା ପର୍ୟଟନ_କରିବା ବୁଲାବୁଲି_କରିବା
tout: ଫୁଟାଣି_ମାରିବା ବଡିମା_ଦେଖାଇବା ଆସ୍ଫାଳନ_କରିବା
towel: ପୋଛିଦେବା ସଫା_କରିବା
toy: ଖେଳିବା ବେଖାତିର_କରିବା ବେପରୁଆ_ହେବା
trace: ଟାଣିବା ଖିଞ୍ଚିବା
track: ଦୌଡେଇବା ଥୟକରିବା ସ୍ଥିରକରିବା ନିଶ୍ଚିତ_କରିବା ନିର୍ଦ୍ଦିଷ୍ଟ_କରିବା
track_down: ଶିକାର_କରିବା|
trail: ଦୌଡେଇବା ଘୋଷାରି_ହେବା
train: ପ୍ରଶିକ୍ଷିତ_କରାଯିବା ତାଲିମକରାଯିବା ଯୋଗ୍ୟକରାଯିବା| ବ୍ୟବସ୍ଥା_କରିବା ପ୍ରସ୍ତୁତ_ହେବା ତିଆରି_କରିବା ଆୟୋଜନ_କରିବା ବନ୍ଦୋବସ୍ତ_କରିବା ଅନୁବର୍ଦ୍ଧନ_କରିବା ବଢାଇବା ଦାୟିତ୍ବନେବା ବର୍ଦ୍ଧିତ_କରାଇବା ରକ୍ଷଣାବେକ୍ଷଣ_କରିବା ଘୋଷାରି_ହେବା
trammel: ଫାନ୍ଦିବା ଫାଶରେପକାଇବା|
tramp: ଏଣେତେଣେ_ବୁଲିବା ଇତସ୍ତତଃ_ଭ୍ରମଣ_କରିବା
tramp_down: ଦଳାଚକଟା_କରିବା ବେଙ୍ଗେଳା_କରୁଛି|
trample: ଦଳାଚକଟା_କରିବା ବେଙ୍ଗେଳା_କରୁଛି|
trance: ମୋହିତ_କରିବା ମୋହେଇବା ସମ୍ମୋହନ_କରିବା|
tranquilize: କମାଇଦେବା ହ୍ରାସକରିବା ଥଣ୍ଡାକରିବା ଶାନ୍ତକରିବା ନିର୍ବାପିତକରିବା
tranquillise: କମାଇଦେବା ହ୍ରାସକରିବା ଥଣ୍ଡାକରିବା ଶାନ୍ତକରିବା ନିର୍ବାପିତକରିବା
tranquillize: କମାଇଦେବା ହ୍ରାସକରିବା ଥଣ୍ଡାକରିବା ଶାନ୍ତକରିବା ନିର୍ବାପିତକରିବା
transfer: ସ୍ଥାନାନ୍ତରିତ_କରିବା ସ୍ଥାନାନ୍ତର_କରିବା
translate: ଅନୁବାଦ_କରିବା ଭାଷାନ୍ତର_କରିବା ଭାଷାନ୍ତରଣ_କରିବା ରୂପାନ୍ତର_କରିବା ତର୍ଜମା_କରିବା ବୁଝିବା
transport: ବୋହିନେବା ବୋହିବା ପଠାଇବା
transude: ଝାଳେଇବା_|
trap: ଫସିବା ଅଡୁଆ_ମାମଲରେ_ପଡିଯିବା ଫାନ୍ଦିବା ଫାଶରେପକାଇବା|
travail: ଖଟେଇବା ରଗଡିବା ଲଗେଇବା
travel_by: ଯିବା ଚାଲିବା
travel_to: ଯିବା ବୁଲିଯିବା ଯାତ୍ରା_କରିବା ଭ୍ରମଣ_କରିବା
traverse: ଥୟକରିବା ସ୍ଥିରକରିବା ନିଶ୍ଚିତ_କରିବା ନିର୍ଦ୍ଦିଷ୍ଟ_କରିବା
tread: ପାଦ_ରଖିବା ଗୋଡ_ରଖିବା ପଦସ୍ଥାପନ_କରିବା
tread_down: ଦଳାଚକଟା_କରିବା ବେଙ୍ଗେଳା_କରୁଛି|
treat: ବ୍ୟବହାର_କରିବା ଆଚରଣ_କରିବା ବେଭାରକରିବା
trek: କଷ୍ଟପୂର୍ଣ୍ଣ_ଦୀର୍ଘ_ଯାତ୍ରା_କରିବା ଦୁଃସାହାସିକ_ଦୀର୍ଘ_ଯାତ୍ରା_କରିବା ଟ୍ରେକିଂ_କରିବା
trespass: ପଶିବା ଅନୁପ୍ରବେଶ_କରିବା ପ୍ରବେଶ_କରିବା ପଶିଯିବା|
trick: ଆଖିରେ_ଧୂଳି_ଦେବା ଚକମା_ଦେବା
trickle: ଟପ_ଟପ_କରିବା
trim: ଛାଡ_କରିବା ଋଣ_ଛାଡ_କରିବା|
trim_back: ଛାଡ_କରିବା ଋଣ_ଛାଡ_କରିବା|
trim_down: ଛାଡ_କରିବା ଋଣ_ଛାଡ_କରିବା|
trip_the_light_fantastic: ପାଦ_ତାଳଦେଇ_ନାଚିବା
trip_the_light_fantastic_toe: ପାଦ_ତାଳଦେଇ_ନାଚିବା
triumph: ଖୁସିରେ_ନାଚିବା ଅତି_ଆନନ୍ଦିତ_ହେବା ଖୁସିରେ_କୁରୁଳିବା
trouble: ଅସୁବିଧାରେ_ପକାଇବା ଝଞ୍ଜଟରେ_ପକାଇବା ଜଞ୍ଜାଳରେ_ପକାଇବା ଗୋଳମାଳରେ_ପକାଇବା ସମସ୍ୟାରେ_ପକାଇବା ହଇରାଣ_କରିବା ବ୍ୟାକୁଳ_ହେବା ଅଶାନ୍ତ_ହେବା
trounce: ଧିକ୍କାରିବା ଗାଳିଦେବା ଅପମାନ_କରିବା ତିରସ୍କାର_କରିବା
trumpet: ଦୀର୍ଘ_ଚିତ୍କାର_କରିବା ଗର୍ଜନ_କରିବା
trust: ବିଶ୍ୱାସ_କରିବା ଠିକ_ମାନିନେବା ଭରସା_କରିବା
try: ପରୀକ୍ଷା_କରିବା ପରୀକ୍ଷଣ_କରିବା ଜାଞ୍ଚ_କରିବା| ଶୁଣିବା
try_out: ପରୀକ୍ଷା_କରିବା ପରୀକ୍ଷଣ_କରିବା ଜାଞ୍ଚ_କରିବା|
tumefy: ଫୁଲିବା ସ୍ଫୀତ_ହେବା
tumesce: ଫୁଲିବା ସ୍ଫୀତ_ହେବା
tump_over: ଓଲଟିଯିବା
turf_out: ବାହାର_କରିଦେବା
turn: ଭୁଲାଇଦେବା ମୋଡିବା ମୋଡିଦେବା_ ଓଲଟି_ଯିବା ପାଉଁଶ_ଖେଳାଇ_ହଳ_କରିବା ଶାଣ_ଦେବା ଆମ୍ବିଳା_ହୋଇଯିବା ଖଟା_ହୋଇଯିବା ନୁଆଁଇବା ଝୁଙ୍କାଇବା ତଳକୁକରିବା|
turn_a_loss: ରହିଯିବା|
turn_a_profit: ଲାଭ_କରିବା ଲାଭାନ୍ବିତ_ହେବା
turn_back: ହଟେଦେବା ଭଗେଇଦେବା ତଡିଦେବା
turn_down: ମନା_କରିବା ନାଁ_କହିବା ନାହିଁ_କରିବା ତଡି_ଦେବା ପ୍ରତ୍ୟାଖାନ_କରିବା
turn_off: ଲିଭାଇବା
turn_on: ଟିହାଇବା ଉସକେଇବା ଚିଡେଇବା ଉତ୍ତେଜିତକରିବା|
turn_out: ସତ_ହେବା ପ୍ରମାଣିତ_ହେବା ସିଦ୍ଧ_ହେବା ବାହାର_କରିଦେବା ଲିଭାଇବା
turn_over: ଧରାଇବା ରଖିବା_ ଗଡାଇବା ଓଲଟିଯିବା
turn_tail: ପଳେଇଯିବା|
turn_to: ସମ୍ବୋଧିତ_କରିବା ସମ୍ବୋଧନ_କରିବା|
turn_up: ଆସିବା ଧରିବା| ଚଉତିବା ସତ_ହେବା ପ୍ରମାଣିତ_ହେବା ସିଦ୍ଧ_ହେବା
twaddle: ଅଯଥା_କଥା_କହିବା ବକ୍‌ବକ୍‌_କରିବା ବକ୍‌_ବକ୍‌_ହେବା
twang: ଟଙ୍କାରିବା
tweak: ତୋଳିବା ଛିଣ୍ଡାଇବା
tweet: ଚିମୁଟିଦେବା ଚିମୁଟିବା
twine: ଗୁଡାଇବା ଘେରାଇବା ରସି_ବୋଳିବା ଦଉଡି_ବୋଳିବା ଦଉଡି_ଭାଙ୍ଗିବା
twinge: ପଶିବା ଫୋଡିହେବା ଚିମୁଟିଦେବା ଚିମୁଟିବା
twinkle: ଚକମକ_କରିବା ଚକଚକ_କରିବା ଜକଜକ_କରିବା
twirp: କଳରବ_କରିବା
twist: ହଲଚଲହେବା| ନୁଆଁଇବା ଝୁଙ୍କାଇବା ତଳକୁକରିବା| ଲେଉଟିବା ବୁଲିବା ରସି_ବୋଳିବା ଦଉଡି_ବୋଳିବା ଦଉଡି_ଭାଙ୍ଗିବା
twit: ବିରକ୍ତ_କରିବା ଚିଡେଇବା ରଗାଇବା କଷ୍ଟ_ଦେବା
twitch: ଚିମୁଟିଦେବା ଚିମୁଟିବା ଟାଣିବା ବାହାର_କରିବା
twitter: କୁରୁଳିବା
uncover: ଖୋଲିବା ପ୍ରକାଶ_କରିବା ପର୍ଦାଫାଶ_କରିବା ଉନ୍ମୋଚିତ_କରିବା
undergo: ଭୋଗିବା ପାଇବା
understand: ବୁଝିବା
undertake: ଦାୟିତ୍ବ_ନେବା ଦାୟିତ୍ବ_ଗ୍ରହଣ_କରିବା_
undress: ଖୋଲିବା ବଦଳିବା ବାହାର_କରିବା
undulate: ଦୋଳାୟମାନ_ହେବା ଲହରେଇବା ପଡିବା_ଉଠିବା ତ୍ବରଣ_ହେବା
unfasten: ଖୋଲିଯିବା ଖୋଲିବା
unfold: ଖେଳେଇ_ଦେବା
unhinge: ବ୍ୟାକୁଳ_ହେବା ଅଶାନ୍ତ_ହେବା
unite: ଯୋଡିହେବା ଲଗେଇବା ସଂଯୁକ୍ତ_କରିବା ସଂଲଗ୍ନ_କରିବା
unknot: ସଜାଡିବା
unlash: ଖୋଲିବା
unloose: ଖଲାସ_ହେବା ମୁକ୍ତ_ହେବା
unloosen: ଖଲାସ_ହେବା ମୁକ୍ତ_ହେବା
unpick: ସଜାଡିବା
unravel: ସଜାଡିବା
unscramble: ସଜାଡିବା
unscrew: ଖୋଲିବା
untangle: ସମାଧାନ_ହେବା ଉତ୍ତର_ମିଳିବା ସଜାଡିବା
unveil: ଖୋଲିବା ପ୍ରକାଶ_କରିବା ପର୍ଦାଫାଶ_କରିବା ଉନ୍ମୋଚିତ_କରିବା
unwrap: ଖୋଲିବା ପଦାକୁବାହାରିବା ଉନ୍ମୋଚନ_ହେବା|
upchuck: ଥୁକିବା ଛେପପକାଇବା
upgrade: ପଦୋନ୍ନତି_କରିବା ପଦୋନ୍ନତି_ହେବା
uphold: ବଜାୟ_ରଖିବା ଜୀବିତ_ରଖିବା ସଜୀବ_ରଖିବା ବଞ୍ଚେଇ_ରଖିବା ରକ୍ଷାକରିବା ସୁରକ୍ଷିତ_ରଖିବା
uplift: ଘାରିହେବା ନିଶାସକ୍ତ_ହେବା
uprise: ସୃଷ୍ଟିହେବା ଜାତ_ହେବା ଉତ୍ପନ୍ନ_ହେବା ଉଠିବା ଉଇଁବା ଉଦୟ_ହେବା|
urinate: ପରିସ୍ରା_କରିବା ମୁତିବା
use: ଅନୁକୂଳ_କରିବା ସେବନକରିବା ଉପଭୋଗକରିବା କରିବା କାମ_କରିବା କାର୍ଯ୍ୟ_କରିବା
use_up: ଲାଗିବା ଖର୍ଚ୍ଚହେବା
utilise: ଅନୁକୂଳ_କରିବା
utilize: ଅନୁକୂଳ_କରିବା
utter: ବ୍ୟକ୍ତକରିବା ଉପସ୍ଥାପିତକରିବା ଅଭିବ୍ୟକ୍ତକରିବା ରାବିବା_ କଥା_ବାହାରିବା ଶବ୍ଦ_ବାହାରିବା
vacate: ସ୍ଥାନ_ତ୍ୟାଗ_କରିବା ଜାଗା_ଛାଡିବା ଜାଗା_ଖାଲି_କରିବା ସ୍ଥାନ_ଖାଲି_କରିବା
vacillate: ଢଳିବା ଆକୃଷ୍ଟ_ହେବା ହଲିବା ଝୁଲିବା|
vagabond: ଏଣେତେଣେ_ବୁଲିବା ଇତସ୍ତତଃ_ଭ୍ରମଣ_କରିବା
valuate: ମୂଲ୍ୟାଙ୍କନ_କରିବା ମୂଲ୍ୟଧାରଣ_କରିବା ମୂଲ୍ୟ_ନିର୍ଣ୍ଣୟ_କରିବା
value: ସମ୍ମାନ_କରିବା ଆଦର_କରିବା ମୂଲ୍ୟାଙ୍କନ_କରିବା ମୂଲ୍ୟଧାରଣ_କରିବା ମୂଲ୍ୟ_ନିର୍ଣ୍ଣୟ_କରିବା
vanish: ଉଡିଯିବା ହଜିଯିବା ଛୁ_ମନ୍ତର_ହୋଇଯିବା| ନ_ଦିଶିବା ହଜିଯିବା
vaporise: ଫୁଟାଇବା ବମ୍ଫେଇବା ଜଳିବା ବାଷ୍ପିତହେବା
vary: ପରିବର୍ତ୍ତନ ପରିବର୍ତ୍ତନ_ହେବା ବଦଳେଇବା ପରିବର୍ତ୍ତନ_ଆଣିବା ବଦଳିଯିବା ପଥ_ହୁଡିବା
vaunt: ଫୁଟାଣି_ମାରିବା ବଡିମା_ଦେଖାଇବା ଆସ୍ଫାଳନ_କରିବା
vellicate: କୁତୁକୁତୁ_କରିବା
verbalise: କଥା_ବାହାରିବା ଶବ୍ଦ_ବାହାରିବା ବ୍ୟକ୍ତକରିବା ଉପସ୍ଥାପିତକରିବା ଅଭିବ୍ୟକ୍ତକରିବା
verbalize: କଥା_ବାହାରିବା ଶବ୍ଦ_ବାହାରିବା ବ୍ୟକ୍ତକରିବା ଉପସ୍ଥାପିତକରିବା ଅଭିବ୍ୟକ୍ତକରିବା
verify: ଯାଞ୍ଚ୍_କରିବା ପରିକ୍ଷାନିରୀକ୍ଷା_କରିବା ରାଣ_ଖାଇବା ରାଣ_ପକାଇବା ଶପଥ_କରିବା ଦୁହାଇ_କରିବା ପ୍ରତିଜ୍ଞା_କରିବା
veto: ମନାକରିବା ରୋକିବା ଅବରୋଧକରିବା
vex: ହଲେଇବା ଦୋହଲେଇବା
vibrate: ଢଳିବା ଆକୃଷ୍ଟ_ହେବା
victimize: ଠକିବା
vie: ପ୍ରତିଯୋଗିତା_କରିବା ପ୍ରତିଦ୍ବନ୍ଦିତା_କରିବା ପ୍ରତିସ୍ପର୍ଦ୍ଧା_କରିବା
view: ଦେଖିବା ଦର୍ଶନ_କରିବା
view_as: ରଖିବା
visit: ଯିବା ବୁଲିଯିବା ଯାତ୍ରା_କରିବା ଭ୍ରମଣ_କରିବା ଦେଖିବା ଆଲୋଚନା କଥାବାର୍ତ୍ତା ବାର୍ତ୍ତାଳାପ କଥା_ ପ୍ରକୋପ_ପଡିବା ପ୍ରକୋପ_ହେବା କୁପ୍ରଭାବ_ପଡିବା ଆକ୍ରମଣ_ହେବା ବ୍ୟାପିବା
volunteer: ମାନିବା ସ୍ବୀକାର_କରିବା ରାଜି_ହେବା ସମ୍ମତ_ହେବା
vomit: ଥୁକିବା ଛେପପକାଇବା
vomit_up: ଥୁକିବା ଛେପପକାଇବା
vow: ମାନସିକ_କରିବା ଯାଚିବା ଯାଚଜ୍ଞା_କରିବା
waddle: ଚାଳନକରିବା|
wait: ଅପେକ୍ଷା_କରିବା ପ୍ରତୀକ୍ଷା_କରିବା ଚାହିଁରହିବା ଚାହିଁ_ବସିବା ବେକାରରେ_ଅପେକ୍ଷା_କରିବା ବ୍ୟର୍ଥ_ପ୍ରତୀକ୍ଷା_କରିବା
wait_on: ସେବାକରିବା ପରିଚର୍ଯ୍ୟା_କରିବା
wake: ଜାଗ୍ରତ_ରହିବା ସାବଧାନ_ରହିବା ସଜାଗ_ରହିବା ଉଠିବା ଜାଗିବା ଆଖି_ଖୋଲିବା ଶୋଇକି_ଉଠିବା ଜଳେଇବା ଇର୍ଷାନ୍ବିତ_କରାଇବା ଚିଡେଇବା ଜଗେଇବା ସଚେତ_କରିବା
wake_up: ଜଗେଇବା ସଚେତ_କରିବା ଉଠିବା ଜାଗିବା ଆଖି_ଖୋଲିବା ଶୋଇକି_ଉଠିବା
waken: ଜଗେଇବା ସଚେତ_କରିବା ଉଠିବା ଜାଗିବା ଆଖି_ଖୋଲିବା ଶୋଇକି_ଉଠିବା
walk: ଚାଲିବା ବୁଲାବୁଲି_କରିବା ବିଚରଣ_କରିବା ଟହଲିବା ଚାଲବୁଲ_କରାଇବା ଟହଲାଇବା ପଦଚାରଣ_କରାଇବା
wall: କାନ୍ଥଦ୍ବାରା_ଘେରାଇବା ପାଚେରୀଦ୍ବାରା_ଘେରାଇବା
wallow: ଲୋଟିବା ଗଡିଯିବା
wander: ଏଣେତେଣେ_ବୁଲିବା ଇତସ୍ତତଃ_ଭ୍ରମଣ_କରିବା
want: ଇଚ୍ଛା_କରିବା ଇଚ୍ଛା_ହେବା ମନ_କରିବା ମନହେବା କାମନା‌_କରିବା ବାଞ୍ଛା_କରିବା ଆବଶ୍ୟକତା_ରହିବା ଦରକାର_ହେବା ପ୍ରୟୋଜନ_ହେବା
war: ଯୁଦ୍ଧ_କରିବା ଲଢାଇ_କରିବା
ware: ବ୍ୟୟକରିବା ଖର୍ଚ୍ଚ_କରିବା|
warm: ଗରମ_ହେବା ତାତିବା ତପ୍ତ_ହେବା ତତାଇବା ଗରମ_କରିବା ତପ୍ତ_କରିବା
warm_up: ଗରମ_ହେବା ତାତିବା ତପ୍ତ_ହେବା
warn: ଚେତେଇବା ସାବଧାନ_କରିବା ସଚେତ_କରିବା ଚେତାବନୀ_ଦେବା ସାବଧାନ_କରିବା ଖବରଦାର_କରିବା
warp: ମିଛ_କରିଦେବା
wash: ସଫା_କରିବା ଧୋଇବା କାଚିବା|
wassail: ହୋ_ହଲ୍ଲା_କରିବା ଘୋ-ଘା_କରିବା କୋଳାହଳ_କରିବା ଚିତ୍କାର_କରିବା ଉତ୍ପାତ_କରିବା ପାଟିତୁଣ୍ଡ_କରିବା ହୁରି_ପକାଇବା
waste: ବ୍ୟୟକରିବା ଖର୍ଚ୍ଚ_କରିବା| ଘାଣ୍ଟିହେବା କଷ୍ଟଭୋଗିବା
watch: ଦେଖିବା ଦେଖିବା ନଜର_ରଖିବା ଦେଖିବା ଦର୍ଶନ_କରିବା
watch_over: ଦେଖିବା ନଜର_ରଖିବା
water: ମଡାଇବା ବଳେଇବା ପାଣି_ଦେଖାଇବା ପାଣି_ପିଆଇବା ପାଣିଦେବା ପାଣି_ଆସିବା ଭରିଯିବା ଢଳଢଳ_ହେବା ଲୁହରେ_ଭରିଯିବା ଲୁହ_ଆସିବା
waul: ଚିତ୍କାର_କରିବା|
wave: ବୁଲାଇବା ଚଲାଇବା_ ଦୋଳାୟମାନ_ହେବା ଲହରେଇବା ପଡିବା_ଉଠିବା ତ୍ବରଣ_ହେବା ଗୁଡାଇବା ଗୁଡେଇବା
waver: ହଲିବା ଝୁଲିବା| ଅସ୍ପଷ୍ଟ_ଭାବେ_କହିବା
wawl: ଚିତ୍କାର_କରିବା|
waylay: ଗୁପ୍ତ_ଆକ୍ରମଣପାଇଁ_ରହିବା
weaken: ଦୁର୍ବଳହେବା କ୍ଷୀଣହେବା ଭାଙ୍ଗିବା ଅଶକ୍ତ_ହେବା ଶକ୍ତିହୀନହେବା
wear: ପିନ୍ଧିବା ପରିଧାନ_କରିବା ଧାରଣ_କରିବା ଚାଲିବା ରହିବା| ଫୁଟିବା ଭଗ୍ନ_ହେବା ଥକି_ପଡିବା|
wear_down: ଥକି_ପଡିବା|
wear_out: ଥକି_ପଡିବା| ଫୁଟିବା ଭଗ୍ନ_ହେବା
wear_upon: ଥକି_ପଡିବା|
weary: ଥକି_ପଡିବା|
weave: ବୁଣିବା
wed: ବିବାହ_କରିବା ବାହାହେବା ପାଣିଗ୍ରହଣ_କରିବା
wee: ପରିସ୍ରା_କରିବା ମୁତିବା
wee-wee: ପରିସ୍ରା_କରିବା ମୁତିବା
weed: ସଫା_କରିବା_
weep: କାନ୍ଦିବା ରୋଦନ_କରିବା କ୍ରନ୍ଦନ_କରିବା ଲୁହ_ଗଡାଇବା ଅଶ୍ରୁପାତ_କରିବା
weigh: ମପାହେବା ମପାଇବା|
weight: ଭାରି_ହେବା
weight_down: ଭାରି_ହେବା
weld: ଝାଳିବା
well_out: ବହିବା ପ୍ରବାହିତ_ହେବା
welter: ଲୋଟିବା ଗଡିଯିବା
wet: ଭିଜିବା ଓଦା_ହୋଇଯିବା
wheedle: ବହଲାଇବା ଆହ୍ଲାଦିତ_କରିବା ପ୍ରବୋଧିତ_କରିବା
whicker: ରଡିଛାଡିବା ଡାକଛାଡିବା|
whinny: ରଡିଛାଡିବା ଡାକଛାଡିବା|
whir: ଘଡଘଡ_ହେବା ଘରଘର_ହେବା ଚଡଚଡ_ହେବା|
whirl: ଘୁରିବା ଚକକର_ମାରିବା ଚକରି_ଖାଇବା ଭଉଁରି_କାଟିବା ନାଚିବା|
whirr: ଘଡଘଡ_ହେବା ଘରଘର_ହେବା ଚଡଚଡ_ହେବା|
whisper: ଫୁସୁରୁଫାସର_ହେବା ଫୁସଫୁସ୍‌_ହେବା
whistle: ସାଇଁ_ସାଇଁ_ବହିବା
whiz: ଘଡଘଡ_ହେବା ଘରଘର_ହେବା ଚଡଚଡ_ହେବା|
whizz: ଘଡଘଡ_ହେବା ଘରଘର_ହେବା ଚଡଚଡ_ହେବା|
whoop: ହୁଙ୍କାରିବା ହାଙ୍କିବା କାଶିବା
whoop_it_up: ହୋ_ହଲ୍ଲା_କରିବା ଘୋ-ଘା_କରିବା କୋଳାହଳ_କରିବା ଚିତ୍କାର_କରିବା ଉତ୍ପାତ_କରିବା ପାଟିତୁଣ୍ଡ_କରିବା ହୁରି_ପକାଇବା
will: ଉଇଲ୍_କରିବା ଇଚ୍ଛାପତ୍ର_କରିବା
win: ଜିତିବା ବିଜୟଲାଭ_କରିବା ବିଜୟପ୍ରାପ୍ତ_କରିବା ସଫଳତା_ପ୍ରାପ୍ତ_କରିବା| ଜିତିବା ଜୟ_ଜରିବା ବିଜୟୀ_ହେବା|
win_over: ବୁଝାଇବା
wind: ଗୁଡାଇବା ଘେରାଇବା ଚାବିଦେବା
wind_up: ଚାବିଦେବା
wing: ଉଡିବା
wink: ବୁଜିବା ବନ୍ଦ_କରିବା
winkle: ଚକମକ_କରିବା ଚକଚକ_କରିବା ଜକଜକ_କରିବା
winnow: ଉଡାଇବା ପାଛୁରିବା ଓଛାରିବା|
wipe: ପୋଛିବା ସଫା_କରିବା|
wipe_off: ଲିଭାଇବା
wipe_out: ଲାଗିବା ଖର୍ଚ୍ଚହେବା ହଟାଇବା ମୂଳପୋଛ_କରିବା ଦୂରେଇବା
wish: ଇଚ୍ଛା_ହେବା ଚାହିଁବା ମନ_ହେବା ଅଭିଳାଷ_କରିବା ଆଶା_କରିବା ଭାବିବା| ଶୁଭକାମନା_ଜଣାଇବା
withdraw: ତୁଟାଇବା ଦୂର_କରିବା ଅଲଗା_କରିବା_ ପଛକୁ_ହଟିବା ପଶ୍ଚାତଗତି_ହେବା
wither: ସଂକୁଚିତ_କରିବା| ମଉଳିଯିବା ମ୍ଳାନ_ପଡିଯିବା ମ୍ଳାନ_ହେବା
withhold: ରୋକିବା ରୋକିଦେବା ବନ୍ଦକରିବା|
withstand: ଅଟକାଇଦେବା ରୋକିଦେବା
work: ପରିଶ୍ରମ_କରିବା ଶ୍ରମ_କରିବା ଉଦ୍ୟମ_କରିବା କାମରେ_ଲାଗି_ରହିବା| ଚାକିରୀ_କରିବା କାମ_କରିବା କାମ_କରିବା କାମ_ଦେବା ଫଳପ୍ରଦ_ହେବା ଫଳପ୍ରସୂ_ହେବା ଚାଲିବା ଉପଯୋଗରେ_ଆସିବା କାମ_କରିବା ତିଆରି_କରିବା କରିବା ପ୍ରସ୍ତୁତ_କରିବା ନିର୍ମାଣ_କରିବା କସରତ_କରାଇବା ବ୍ୟାୟାମ_କରାଇବା| କରିବା କାମ_କରିବା କାର୍ଯ୍ୟ_କରିବା କରାଇବା କୃଷିଯୋଗ୍ୟ_କରିବା ଚାଷଯୋଗ୍ୟ_କରିବା କାମ_କରିବା କାମ_ଦେବା ବ୍ୟବହୃତ_ହେବା ସଞ୍ଚାଳନ_କରିବା ଚଲାଇବା ଚଳାଇବା ପ୍ରବର୍ତ୍ତନ_କରିବା ଚଲାଇବା ପରିଚାଳିତ_କରାଇବା ଗତିଶୀଳ_କରାଇବା ଗତିଯୁକ୍ତ_କରାଇବା କାର୍ଯ୍ୟକ୍ଷମ_କରାଇବା ଉତ୍ତେଜିତ_କରିବା| ଚକଟିବା ଦଳିବା ମର୍ଦ୍ଦନକରିବା ଶୋଷିତ_କରିବା ଚୂଷିବା ଲୋଟିବା ସମାଧାନ_କରିବା ନିରାକରଣ_କରିବା ପ୍ରତିକାର_କରିବା ମୀମାଂସା_କରିବା କିଣ୍ବନ_କରିବା ଆମ୍ବିଳା_ହୋଇଯିବା ଖଟା_ହୋଇଯିବା ହେବା ଘଟିବା ପରିଣତ_ହେବା ସଂପାଦିତ_ହେବା ଉତ୍ପନ୍ନ_ହେବା
work_on: ତିଆରି_କରିବା କରିବା ପ୍ରସ୍ତୁତ_କରିବା ନିର୍ମାଣ_କରିବା
work_out: ସମାଧାନ_କରିବା ନିରାକରଣ_କରିବା ପ୍ରତିକାର_କରିବା ମୀମାଂସା_କରିବା କସରତ_କରାଇବା ବ୍ୟାୟାମ_କରାଇବା|
work_over: ପିଟିବା ମାରିବା ଚଟକଣି_ପକେଇବା ଚଟକଣି_ଦେବା ପ୍ରହାର_କରିବା ବାଡେଇବା ଧୁଲେଇକରିବା
worm: ହଲଚଲହେବା|
worry: ଚିନ୍ତା_କରିବା ଭାବିବା| ଚିନ୍ତା_ହେବା ଚିନ୍ତାଲାଗିବା|
worsen: ପତନ_ହେବା
worship: ପୂଜା_କରିବା ଅର୍ଚ୍ଚନା_କରିବା ଆରାଧନା_କରିବା ଉପାସନା_କରିବା ପୂଜିବା
wound: କଷ୍ଟ_ଦେବା| କଣ୍ଟା_ଫୋଡିବା ଖଟକା_ଲାଗିବା ଅପ୍ରିୟ_ଲାଗିବା ଖରାପ_ଲାଗିବା
wrap: ଗୁଡାଇବା ଚାପିଦେବା ଗୁଡାଇବା ଘେରାଇବା ପୂରାପୂରି_ଭାବେ_ଢାଙ୍କିବା ପୂରାପୂରିଭାବେ_ଘୋଡେଇବା ପୂରାପୂରିଭାବେ_ଆବୃତ୍ତ_କରିବା ସମ୍ପୂର୍ଣ୍ଣଭାବେ_ଆଚ୍ଛାଦିତ_କରିବା ପୂରାପୂରିଭାବେ_ଲୁଚାଇବା
wrap_up: ଗୁଡାଇବା ଚାପିଦେବା
wreak: କରିବା କାମ_କରିବା କାର୍ଯ୍ୟ_କରିବା
wrestle: ହଲଚଲହେବା| କୁସ୍ତିକରିବା
wriggle: ହଲଚଲହେବା|
wring: ଠକିନେବା ଚିପୁଡିବା
wrinkle: ଭାଙ୍ଗ_ପଡିବା କୁଞ୍ଚ_ପଡିବା ଜାକିଜୁକିହେବା
write: ଲେଖିବା ରଚନା_କରିବା ଲେଖିବା ଚିଠି_ଲେଖିବା ପତ୍ର_ପ୍ରେରଣ_କରିବା ବାର୍ତ୍ତାପ୍ରେରଣ_କରିବା ପ୍ରକାଶିତ_କରିବା| ସଂଗୀତ_ରଚନା_କରିବା ଲେଖିବା ଅଙ୍କିତ_କରିବା ଚିହ୍ନିତ_କରିବା ଲେଖିବା ଲିପିବଦ୍ଧ_କରିବା
writhe: ହଲଚଲହେବା|
yawn: ହାଇମାରିବା
yearn: ବିକଳ_ହେବା ବ୍ୟାକୁଳ_ହେବା ଲଳାୟିତ_ହେବା ଲାଳସା_କରିବା
yell: ଚିଲ୍ଲାଇବା ରଡି_କରିବା ଚିତ୍କାର_କରିବା ଗର୍ଜନ_କରିବା
yen: ଲଳାୟିତ_ହେବା ଲାଳସା_କରିବା
yield: ହାର_ମାନିବା ଅସ୍ତ୍ରସମର୍ପଣ_କରିବା ନଇଁବା ଅଧୀନ_ହେବା ଅନୁଗତ_ହେବା
yoke: ଗୁନ୍ଥିବା ଗ୍ରନ୍ଥନ_କରିବା
