अँडोराचा: एन्डोरी
अंकित: पराधीन गुलाम परतन्त्र अधीन अन्याधीन छापिएको चित्रित
अंकुर_आलेला: अङ्कुरित उम्रिएको
अंकुरित: अङ्कुरित उम्रिएको
अंगठेबहाद्दर: अशिक्षित अनपढ निरक्षर
अंगहीन: अपाङ्ग अङ्गहीन अपांग
अंगीकृत: अङ्गीकृत स्वकृत परिग्रहीत गृहीत स्वीकृत स्वाङ्गीकृत अभ्युपगत
अंडज: अण्डज डिंबज द्विज अण्डज डिम्बज
अंतःस्थ: गुप्त अप्रत्यक्ष अप्रकाश अप्रकाशित अप्रकाशमान अप्रथित अभिगुप्त आन्तरिक भित्री अन्तः अन्तरङ्ग अन्तर्वर्ती अंतर्वर्ती आंतरिक अन्तः अन्तरंग अन्तरित
अंतःस्थित: आन्तरिक भित्री अन्तः अन्तरङ्ग अन्तर्वर्ती अंतर्वर्ती आंतरिक अन्तः अन्तरंग अन्तरित
अंतरराज्य: अन्तर्प्रदेशीय अन्तर्प्रांतीय अन्तर्प्रदेश_स्तरीय अन्तर्राज्यीय अन्तर्राज्यिक
अंतरावरचा: दूर दूरवर्ती दूरस्थ
अंतरावरील: दूर दूरवर्ती दूरस्थ
अंतरिम: अन्तरिम
अंतर्गत: आन्तरिक भित्री अन्तः अन्तरङ्ग अन्तर्वर्ती अंतर्वर्ती आंतरिक अन्तः अन्तरंग अन्तरित
अंतर्देशीय: अन्तर्देशीय देशान्तर्गत
अंतर्भूत: समाविष्ट समाहित अङ्गभूत समन्वित
अंतस्थ: गुप्त अप्रत्यक्ष अप्रकाश अप्रकाशित अप्रकाशमान अप्रथित अभिगुप्त
अंतहीन: अनन्त असमाप्य अन्त्यहीन अनंत अंतहीन
अंतिम: अन्तिम अंतिम आखिरी अन्त्य अंत्य
अंत्य: अन्तिम अंतिम आखिरी अन्त्य अंत्य
अंध: अन्धो नेत्रहीन
अंधळा: अन्धो नेत्रहीन
अंधविश्वासू: मतान्ध कट्टरवादी कट्टरपन्थी
अंधश्रद्ध: मतान्ध कट्टरवादी कट्टरपन्थी
अंधारा: अन्धकारपूर्ण अँध्यारो अंधकारपूर्ण अन्धेरा अन्धियारा अन्धकारपूर्ण तमोमय तमस्वी अप्रकाशित अप्रकाशमान
अंधूक: धमिलो अस्पष्ट
अंबट: अमिलो तित्री कागती
अंशकालीक: अङ्शकालिक पार्टटाइम
अंशविषयक: आंशिक
अंशाविषयीचा: आंशिक
अंशाशी_संबंधित: आंशिक
अंशासंबंधी: आंशिक
अंशासंबंधीचा: आंशिक
अकडू: अकडो
अकरा: एघार एकादश ११
अकरावा: एघारौं एघार
अकर्ता: अकर्ता अकर्तार
अकल्पनीय: कल्पनातीत अकल्पनीय अकल्पित अचिन्त्य
अकल्पित: अनपेक्षित अप्रत्याशित निरपेक्षित आकस्मिक अनपेक्षित अप्रत्याशित अचानक दैवी दैविक दैवागत
अकल्याणकारक: अकल्याणकारी अनिष्टकर अमङ्गलकारी अमाङ्गलिक अकुशल अशुभकारी अनभीष्ट अहितकारी
अकल्याणकारी: असमृद्धिप्रद अनैश्वर्यप्रद
अकारण: बिनासित्ति अकारण
अकार्यक्षम: अयोग्य अनुपयुक्त नालायक ना-लायक अनलायक अपारग अप्रभु अयथा अयुक्त अयुक्तरूप अयोग
अकालज: सामन्तकालीन अकालजात अकाल_प्रसूत
अकालिक: असामयिक कुयामको बेमौकाको अकालिक अवसर_प्रतिकूल
अकिंचन: निर्धन गरीब दरिद्र
अकुतोभय: निडर अभय निर्भय निर्भीक बेडर भयहीन निर्भीत अपभय अपभीति निःशंक अपशंक अभीत अभीरु
अकुशल: अप्रवीण अनाडी अकुशल अदक्ष अनिपुण अधकचरा अनाप्त अनारी अनैपुण अपटु अपाटव अपात्र
अक्कडबाज: अकडो
अक्कलवान: बुद्धिमानी ज्ञानी प्राज्ञ समझदार दिमागदार दिमागी बुझक्की मेधावी
अक्लांत: नथाक्ने अक्लान्त अक्लांत
अक्षत: अनाहत अक्षत क्षतिहीन अनुपहत
अक्षम: क्षमताहीन अक्षम अशक्त शक्तिहीन असमर्थ बेदम
अक्षम्य: अक्षम्य क्षमाशून्य
अक्षय: अमर अक्षय अनश्वर शाश्वत अक्षुण्ण अक्षुण अनष्ट अविनाशी अविनासी अक्षय्य अच्युत अभङ्ग अनाश अनाश्य अनाशवान अभङ्गुर अखय अक्षुण्य
अक्षर: अमर अक्षय अनश्वर शाश्वत अक्षुण्ण अक्षुण अनष्ट अविनाशी अविनासी अक्षय्य अच्युत अभङ्ग अनाश अनाश्य अनाशवान अभङ्गुर अखय अक्षुण्य
अक्षरशत्रू: अशिक्षित अनपढ निरक्षर
अक्षरशून्य: अशिक्षित अनपढ निरक्षर
अक्षुण्ण: अभन्जित अक्षत अखण्डित अखंडित खंडहीन खण्डहीन अनवच्छिन्न
अखंड: अभन्जित अक्षत अखण्डित अखंडित खंडहीन खण्डहीन अनवच्छिन्न अक्षुण्ण अक्षुण अविभाजित अखंड अखण्ड अभग्न अविभक्त अखण्डित अखंडित अटूट अभिन्न अजस्र अनन्तरित अनंतरित अनन्तर्हित अनंतर्हित अनवच्छिन्न अभङ्ग अभंग अभङ्गी अभंगी अभञ्जन अभंजन अभेदनीय सम्पूर्ण जम्मै
अखंडनीय: अखण्डनीय अखंडनीय अखण्ड्य अखंड्य
अखाद्य: अनाहार्य अखाद्य अभोज्य अभक्ष्य अग्राह्य अभक्ष अभोज
अखिल: जम्मा सारा सबै समस्त सम्पूर्ण तमाम
अखेरचा: अन्तिम अंतिम आखिरी अन्त्य अंत्य
अख्खा: सम्पूर्ण जम्मै सारा सबै पूरा सम्पूर्ण जम्मा सारा सबै समस्त सम्पूर्ण तमाम
अगडबंब: महाकाय अतिकाय बृहत्काय विशालकाय भीमकाय विकराल
अगणित: असङ्ख्य अगणनीय अनगन्ती अगण्य अगणित
अगण्य: असङ्ख्य अगणनीय अनगन्ती अगण्य अगणित
अगतिक: असहाय निस्सहाय बेसहारा निराश्रित निराश्रय अनाश्रित आश्रयहीन अपाश्रय निरवलम्ब अवलम्बहीन अवलम्बनहीन  अनवस्थित अनाथ निरवलम्ब अनाश्रित निःसहाय विवश बाध्य लाचार
अगाध: अथाह अगाध अपार अगाध्य अनवगाह अनवगाह्य अगाह
अगोचर: अतीन्द्रिय अप्रत्यक्ष परोक्ष अभौतिक
अग्निशामक: आगो_निभाउने
अग्रज: दाजु अग्रज
अग्रभागीचा: अग्रगामी पुरोगामी पूर्वगामी
अग्रहणीय: अग्राह्य अग्रहणीय
अग्राह्य: अग्राह्य अग्रहणीय
अग्रेसर: प्रगत अग्रगत
अघटित: अघटित नघटेको
अचकट_विचकट: अश्लील कामुकतापूर्ण
अचपळ: चञ्चल चकचके अधीर
अचल: अचल गतिहीन स्थावर अग अगतिक अचर स्थिर थिर दृढ अचल अविचल निश्चल गतिहीन अविचलित अटल अचल स्थावर
अचानक: आकस्मिक अनपेक्षित अप्रत्याशित अचानक दैवी दैविक दैवागत
अचेतन: निर्जीव निष्प्राण अजीवित जीवनहीन अजीव अप्राण अप्राणी जड अचैतन्य जडत्वयुक्त स्थूल अजैव भौतिक अचेतन चेतनारहित अजीव अनात्म आत्मारहित
अच्युत: अपतित अच्युत
अजब: चमत्कारी चमत्कारपूर्ण चामत्कारिक तिलस्मी
अजस्त्र: महाकाय अतिकाय बृहत्काय विशालकाय भीमकाय विकराल
अजस्र: महाकाय अतिकाय बृहत्काय विशालकाय भीमकाय विकराल
अजातशत्रू: शत्रुहीन अजातशत्रु शत्रुविहीन अरिहीन अभूतशत्रु
अजिंक्य: अजेय अजय अजित अपराजेय दुर्जेय अजीत अयुध्य
अजिज्ञासू: अनुत्सुक निरुत्सुक अनुत्क जिज्ञासाहीन अजिज्ञासु उत्सुक्ताहीन निरुत्सुक
अजित: अपराजित अपरास्त अविजित अनभिभूत अप्रतिहत
अजेय: अजेय अजय अजित अपराजेय दुर्जेय अजीत अयुध्य
अजोड: अनुपम अतुलनीय अद्वितीय असाधारण बेजोड न्यारो अप्रतिम अद्वैत एकल सर्वोकृष्ट अनुत्तम उपमारहित अनुपमित अनुपमेय अपूर्व अप्रतिमान अप्रतिरूप अभूत अतुलनीय अतुल्य अतुल अप्रतुल
अज्ञात: अज्ञात नजानेको अविदित अनवगत अपरिचित अपरिगत अनधिगत अनभिज्ञ अज्ञ अपरिचित नजानेको नचिनेको अज्ञात अपरिगत अनभिज्ञ
अज्ञानी: मूर्ख अज्ञानी बुद्धु ज्ञानहीन अज्ञानपूर्ण
अज्ञेय: अज्ञेय अगम्य ज्ञानातीत बोधातीत अगम आगम अमेय अमेव
अटळ: अवश्यम्भावी अटल तय अटलनीय अनिवार्य अबाध्य अमिट
अठरा: अठार
अठरावा: अठारौं १८_औ 18औं
अठ्ठावन्न: अन्ठाउवन्न अन्ठाउन
अठ्ठावन्नावा: अन्ठाउन्नौं अन्ठाउनौं
अठ्ठाविसावा: अट्ठाइसौँ
अठ्ठावीस: अट्ठाइस २८
अठ्ठेचाळिसावा: अठचालीसौँ
अठ्ठ्याण्णव: अन्ठानब्बे अन्ठानबे
अडकलेला: अढकिनु अल्झिनु फँस्नु उल्झिनु उल्झनु
अडतिसावा: अडतीसौँ
अडतीस: अडतीस
अडस: साँगुरो छोटो
अडाणी: मूर्ख अज्ञानी बुद्धु ज्ञानहीन अज्ञानपूर्ण अशिक्षित अनपढ निरक्षर
अडीच: अढाई
अडुसष्ट: अडसठ अडसठ्टी_६८
अडेलतट्टू: दुराग्रही
अढळ: अविचलित अडिग अविचल स्थिर थिर दृढ अचल अविचल निश्चल गतिहीन अविचलित अटल दृढ़ अटल अडिग अविचल स्थिर कायम
अणकुचीदार: तिखो
अतर्क्य: तर्कातीत अतर्क्य तर्कागम्य अप्रतर्क्य
अतांत्रिक: गैर-प्रविधि प्रविधिहीन
अतिरिक्त: अतिरिक्‍त बाहेक
अतिशय: अत्यधिक धेरै औधि प्रचुर अत्याधिक भारी भीषण घनघोर अत्याधिक
अतींद्रिय: अतीन्द्रिय अप्रत्यक्ष परोक्ष अभौतिक
अतीच_धाडसी: दुस्साहसी ढीठ दुःसाहसी
अतीच_साहसी: दुस्साहसी ढीठ दुःसाहसी
अतुल: अतुलनीय अतुल्य अतुल अप्रतुल
अतुलनीय: अनुपम अतुलनीय अद्वितीय असाधारण बेजोड न्यारो अप्रतिम अद्वैत एकल सर्वोकृष्ट अनुत्तम उपमारहित अनुपमित अनुपमेय अपूर्व अप्रतिमान अप्रतिरूप अभूत अतुलनीय अतुल्य अतुल अप्रतुल
अतुल्य: अतुलनीय अतुल्य अतुल अप्रतुल
अतृप्त: अतृप्त असन्तुष्ट अतुष्ट
अतोनात: अत्यधिक धेरै औधि प्रचुर अत्याधिक भारी भीषण घनघोर अत्याधिक
अत्यंत_सुंदर: सुचारु
अत्यल्प: अत्यल्प अलिकति छ्यास्स
अत्याचारी: अत्याचारी अनाचारी आततायी बर्बर नृशंस अतिचारी अनीतिमान् उत्पीडक
अत्यावश्यक: अत्यावश्यक अति_आवश्यक अपरिहार्य
अथक: अथक नथाक्ने अश्रान्त
अथांग: अथाह अगाध अपार अगाध्य अनवगाह अनवगाह्य अगाह
अदंडनीय: अदण्ड अदण्डनीय अदण्ड्य
अदंडित: अदण्डित अदण्ड
अदंड्य: अदण्ड अदण्डनीय अदण्ड्य
अदक्ष: अप्रवीण अनाडी अकुशल अदक्ष अनिपुण अधकचरा अनाप्त अनारी अनैपुण अपटु अपाटव अपात्र
अदम्य: अदम्य
अदहनीय: काहिराइ
अदाह्य: काहिराइ
अदूरदर्शी: अदूरदर्शी अल्पदर्शी
अदूरदृष्टी: अदूरदर्शी अल्पदर्शी
अदृश्य: अदृश्य अदृष्टिगोचर लोचनातीत अदृश्यमान विलीन अन्तर्हित दक्षिणी दक्खिनी
अदृष्ट: अदृश्य अदृष्टिगोचर लोचनातीत अदृश्यमान विलीन अन्तर्हित दक्षिणी दक्खिनी
अद्भुत: चमत्कारी चमत्कारपूर्ण चामत्कारिक तिलस्मी
अद्रावणीय: नघोलिने
अद्राव्य: नघोलिने
अद्वितीय: अनुपम अतुलनीय अद्वितीय असाधारण बेजोड न्यारो अप्रतिम अद्वैत एकल सर्वोकृष्ट अनुत्तम उपमारहित अनुपमित अनुपमेय अपूर्व अप्रतिमान अप्रतिरूप अभूत
अद्वैती: अद्वैत परमतत्त्‍व ब्रह्‍म।
अधम: घटिया निकृष्ट नीच अधम क्षुद्र पापी अधम अनाचारी पतित पातकी नीच पापकर्मी पापात्मा अधर्मी अधर्मिष्ट अधार्मिक म्लेच्छ अपकृष्ट कुमार्गी अपमार्गी अपाचारी दुष्ट निकृष्टतम अधमाधम तुच्छातितुच्छ
अधर्मी: अन्यायी अन्याय_कर्ता
अधार्मिक: धर्महीन अधर्मी
अधाशी: पेटु खन्चुवा घिचासे घिचुवा भाते
अधिक: धेरै बहुत अधिक ज्यादा अतिशय अति अगाध अतीव बहुल
अधिकाधिक: धेरैजसो प्राय
अधिकार_नसलेला: अनधिकारी स्वत्वहीन
अधिकारयुक्त: अधिकारपूर्ण साधिकार
अधिकाराचा: अधिकारपूर्ण साधिकार
अधिकारात_असलेला: अधिकृत
अधिकारी: अधिकारपूर्ण साधिकार अधिकारी अधिकार_प्राप्त अधिकारयुक्त अधिकारिक हकदार अधिकारक
अधिकार्‍याचा: अफसरी
अधिकार्‍यासारखा: अफसरी
अधिकृत: अधिकृत
अधिशासित: शासित प्रशासित
अधीन: अधीन अधीनस्थ अधीन मातहत अधस्तन अमुख्य
अधीन_असलेला: अधीनस्थ अधीन मातहत अधस्तन अमुख्य
अधीर: आतुर अधीर कातर व्याकुल बेचैन विकल अधैर्य अधैर्यवान् अधैर्यवान अधैर्यवान् अभिभूत क्षुब्ध हतारे
अधुपा: नधोइएको
अधुरा: अपूर्ण अपरिपूर्ण अधुरो
अधुवा: नधोइएको
अधू: विकलाङ्ग अपाहिज अंगहीन अपंग अपाहज निपंग
अधोगत: अवनत अधोगत अधोपतित झरेको पतित अनुपतित अपकृष्ट अपभ्रंशित
अधोगामी: अधोगामी ओह्रालो
अधोमुख: निहुरिनु घोसेमुन्टो
अधोमुखी: निहुरिनु घोसेमुन्टो
अधोवदन: निहुरिनु घोसेमुन्टो
अध्ययनशील: अध्यायी अध्ययनशील
अनंत: अनन्त असमाप्य अन्त्यहीन अनंत अंतहीन असीम अनंत अनन्त अनादि अपरंपार अपरम्पार अपरिमित अपार असीमित अगाध अमित अनंता अनन्ता अनन्त्य अनंत्य अनधिक अनवधि अनिर्दिष्ट अपरिच्छिन्न अप्रमाण अबाध सीमारहित अमर्याद अमात्र मात्रारहित अमान अमाप अमित
अनघ: पापहीन निष्पाप पापरहित निष्कलङ्क
अनधिकृत: अनधिकृत स्वत्वहीन अनधिकार अधिकारशून्य अप्रमाणिक
अननुभवी: अनुभवहीन काँचो कच्चा अल्हरे स्वाँठ
अनन्यसाधारण: विलक्षण अद्भुत अनौठो अचम्भको विचित्र आश्चर्यजनक आश्चर्यभूत अभूतपूर्व अपूर्व
अनन्वित: असीम अनंत अनन्त अनादि अपरंपार अपरम्पार अपरिमित अपार असीमित अगाध अमित अनंता अनन्ता अनन्त्य अनंत्य अनधिक अनवधि अनिर्दिष्ट अपरिच्छिन्न अप्रमाण अबाध सीमारहित अमर्याद अमात्र मात्रारहित अमान अमाप अमित
अनपेक्षित: अनपेक्षित अप्रत्याशित निरपेक्षित अप्रत्याशित आशातीत प्रत्याशातीत अनुमानातीत
अनभिप्रेत: अनभिप्रेत अभिप्रायविरुद्ध अनभिमत
अनभ्यस्त: अनभ्यस्त अभ्यासहीन अभ्यासरहित अनभ्यसित
अनमोल: बहुमूल्य मूल्यवान अमूल्य अनमोल दामी अमूल्य अनमोल अमोल अमोलक मूल्यातीत
अनम्र: अभिमानी अहङ्कारी घमण्डी
अनर्थकारक: अनर्थकारी
अनर्थकारी: अनर्थकारी
अनलंकृत: अनलङ्कृत नसजिएको अमण्डित अलङ्कारहीन अविभूषित
अनलमुख: अनलमुख
अनलस: जावगरिलो मिहिनेती परिश्रमी_आलस्यहीन
अनवरत: अनवरत लगातार निरन्तर
अनश्वर: अमर अक्षय अनश्वर शाश्वत अक्षुण्ण अक्षुण अनष्ट अविनाशी अविनासी अक्षय्य अच्युत अभङ्ग अनाश अनाश्य अनाशवान अभङ्गुर अखय अक्षुण्य
अनहितकारी: अकल्याणकारी अनिष्टकर अमङ्गलकारी अमाङ्गलिक अकुशल अशुभकारी अनभीष्ट अहितकारी
अनाकलनीय: अबुझ अबुझ
अनाघ्रात: अप्रतिघात अविकृत नबिग्रेको
अनाचारी: अत्याचारी अनाचारी आततायी बर्बर नृशंस अतिचारी अनीतिमान् उत्पीडक दुष्कर्मी अकृत्यकारी अपकर्मी खल अकर्मी
अनाच्छादित: खुला उघारो उदाङ्गो
अनात्म: अनात्म आत्मरहित अनात्मीय अनाप्त
अनाथ: टुहुरो अनाथ यतीम लावारिस अनाथ टुहुरो पराश्रित पराश्रय पराधीन निराश्रित
अनादर_करणारा: जुवाडी जुवारी
अनादृत: अनादृत अनादरित
अनाधराधार: निराधार
अनाम: अख्यात अप्रसिद्ध अनाम अविख्यात बेनाम अनामक
अनावर्ती: अनावृत्त
अनावश्यक: अनावश्यक अनपेक्षित फाल्टु नचाँहिदो जथाभावी अवाञ्छनीय गैरजरूरी निष्प्रयोजन
अनावृत: नाङ्गो नग्न निर्वस्त्र खुला उघारो उदाङ्गो
अनावृत्त: अनावृत्त अनावृत्त
अनाश्रमी: आश्रमहीन
अनासक्त: अनासक्त अलिप्त निर्लिप्त मायारहित मायाशून्य अमुग्ध विरक्त विमुख बैरागी वैरागी विरागी सन्यासी सन्यासी सन्नासी रागहीन
अनाहत: अनाहत अक्षत क्षतिहीन अनुपहत
अनाहारी: अनाहार
अनाहूत: अनपेक्षित अप्रत्याशित निरपेक्षित
अनिंद्य: अनिन्दनीय निर्दोष निष्कलङ्क अनिन्दित बदनाम_नभएको निन्दा_नगरिएको कलङ्क_नलागेको निन्दारहित निष्कलङ्क अनिन्द्य
अनिकेत: आवासहीन आश्रयहीन गृहहीन गृहविहीन बेघर बेघरवार
अनिच्छ: अनिच्छुक अनभिलाषी निस्पृही अनिच्छु निराकाङ्क्षी अभिलाषारहित
अनिच्छित: अनिच्छित अचाहा अनपेक्षित अवाञ्छित नचिताएको अनिष्ट अनभिलषित अनीप्सित
अनिच्छुक: अनिच्छुक अनभिलाषी निस्पृही अनिच्छु निराकाङ्क्षी अभिलाषारहित
अनित्य: नश्वर अशाश्वत क्षणजीवी क्षयशील नाशवान भंगुर विनाशी अनित्य मेटिने नाशुक अनित
अनिद्रिस्त: उन्निद्र निद्रा_रहित
अनियंत्रित: बेकाबु अनियन्त्रित
अनियत: अनियत अनिश्चित अनियमित अनिर्दिष्ट अध्रुव
अनियमित: अनियत अनिश्चित अनियमित अनिर्दिष्ट अध्रुव अनियमित नियमरहित बेफाइदा
अनिर्जन: एकान्तरहित सुनसानहीन एकान्तहीन
अनिर्णीत: अनिर्णय बेनिधो अनिर्णित
अनिर्वचनीय: अवर्णनीय अकथनीय वर्णनातीत शब्दातीत अकथ अकथ्य अनभिधेय अनिर्वचनीय अनिर्वाच्य
अनिर्वाच्य: अवर्णनीय अकथनीय वर्णनातीत शब्दातीत अकथ अकथ्य अनभिधेय अनिर्वचनीय अनिर्वाच्य
अनिवार्य: अनिवार्य परमावश्यक जरूरी
अनिश्चित: अनियत अनिश्चित अनियमित अनिर्दिष्ट अध्रुव अनिर्धारित अनिश्चित वैकल्पिक अप्रतिपन्न अप्रतीयमान
अनिष्ट: अकल्याणकारी अनिष्टकर अमङ्गलकारी अमाङ्गलिक अकुशल अशुभकारी अनभीष्ट अहितकारी
अनीतिचा: अन्यायी अन्याय_कर्ता
अनीश: अनीश्वर
अनुकरणकरू: अनुयायी अनुचर अनुगामी
अनुकरणशील: अनुकर्ता अनुकरणकर्ता अनुकारी
अनुकरणीय: आदर्श अनुकरणीय
अनुकूल: अनुकूल अनुसार अनुरूप मुताबिक अनुकूल अनुकूलित
अनुक्रमाने_असणारा: धारावाहिक धारावाही धाराप्रवाह निरन्तर एकोहोरो
अनुक्रमाने_येणारा: धारावाहिक धारावाही धाराप्रवाह निरन्तर एकोहोरो
अनुगृहित: अनुगृहीत अनुकम्पित उपकृत
अनुचित: मना मना_गरिएको निषिद्ध वर्जित प्रतिबन्धित प्रतिबंधित निषेधित वर्ज्य व्याहत अनुचित खराब बेठिक
अनुच्चारित: अकथनीय अकथ्य
अनुज: साना_भाइ भाइ
अनुज्ञा_मिळालेला: स्वीकृत अनुमति_दत्त अनुमति_प्रदत्त
अनुतप्त: पश्चात्तापी
अनुतराईशील: अप्रतिकार
अनुतापी: पश्चात्तापी
अनुत्तीर्ण: अनुत्तीर्ण फेल
अनुत्साही: स्फूर्तिहीन अस्फूर्त उत्साहहीन अनुत्साही निरुत्साह हतोत्साहित निरुत्साहित
अनुद्विग्न: शान्त शांत प्रशान्त निरुद्विग्न अविकल अव्याकुल प्रशांत निभृत अनाकुल अव्यग्र विश्रब्ध
अनुपम: अनुपम अतुलनीय अद्वितीय असाधारण बेजोड न्यारो अप्रतिम अद्वैत एकल सर्वोकृष्ट अनुत्तम उपमारहित अनुपमित अनुपमेय अपूर्व अप्रतिमान अप्रतिरूप अभूत
अनुपयोग: अनुपयोगी अनावश्यक उपयोगहीन निरर्थक व्यर्थ फालतू रद्दी अनर्थक
अनुपयोगी: अनुपयोगी अनावश्यक उपयोगहीन निरर्थक व्यर्थ फालतू रद्दी अनर्थक
अनुपलब्ध: अनुपलब्ध अप्राप्य अलभ्य अनधिगम्य अनमिलता अप्राप्त अमिल
अनुपस्थित: अनुपस्थित गैरहाजिर अविद्यमान अप्रस्तुत अप्राप्त
अनुपाय: उपायहीन विकल्पहीन अप्रतिकार
अनुभवी: अनुभवी जानकार परिपक्व खारिएको
अनुमती_मिळालेला: स्वीकृत अनुमति_दत्त अनुमति_प्रदत्त
अनुमानित: अनुमानित अनुमित
अनुमित: अनुमानित अनुमित
अनुयायी: अनुयायी अनुगामी
अनुरक्त: आसक्त मुग्ध मोहित प्रेमासक्त अनुरक्त अनुरागी आसक्त लसपसिएको
अनुरागी: प्रेमासक्त अनुरक्त अनुरागी आसक्त लसपसिएको
अनुरूप: अनुकूल अनुसार अनुरूप मुताबिक उचित उपयुक्‍त ठिक
अनुवाद_करण्याजोगा: अनुवाद्य
अनुवादित: अनूदित अनुवादित अनुदित भाषांतरित भाषान्तरित
अनुवाद्य: अनुवाद्य अनुवाद्य अनुवाद_गर्न_योग्य
अनुशास्ता: अनुशासक अनुशासी
अनृणी: ऋणमुक्‍त
अनेक: अनेक कैयौं विविध नाना एकाधिक अनेकानेक तमाम
अनेकांपैकी_एक: अन्यतम विशेष
अनैतिक: अनैतिक नैतिकताहीन अनीतिपूर्ण अनुचित गलत नीतिविरुद्ध
अनैसर्गिक: अप्राकृतिक अप्राकृत
अनोखा: अभूतपूर्व अपूर्व
अनोळखी: अपरिचित नजानेको नचिनेको अज्ञात अपरिगत अनभिज्ञ
अनौपचारिक: अनौपचारिक
अन्य: अरू अर्को अन्य अर्को इतर अर्कै
अन्यायविषयक: अनैयायिक अन्याय_विषयक
अन्यायी: अत्याचारी अनाचारी आततायी बर्बर नृशंस अतिचारी अनीतिमान् उत्पीडक अन्यायी अन्याय_कर्ता
अन्याय्य: न्यायहीन अन्यायपूर्ण
अन्यासक्त: अन्यासक्त
अन्वर्थक: अन्वर्थ
अन्वेषक: शोधकर्ता अनुसन्धान_कर्ता
अपंग: विकलाङ्ग अपाहिज अंगहीन अपंग अपाहज निपंग अपाङ्ग अङ्गहीन अपांग लङ्गडो लंगडो खोरन्डो
अपकर्षक: अपकर्षक
अपकारक: अपकारी अपकर्ता अपकर्त्ता अपकारक अनर्थकारी अनिष्टकारी अपकार_कर्ता अपकार_कर्त्ता अनहित अनुपकारी हानिकारक क्षतिकारी हानिकर हानिप्रद अनर्थकारी क्षतिकर
अपकारी: अपकारी अपकर्ता अपकर्त्ता अपकारक अनर्थकारी अनिष्टकारी अपकार_कर्ता अपकार_कर्त्ता अनहित अनुपकारी
अपक्व: काँचो नपाकेको अशोधित अपरिशोधित अशुद्ध असंशोधित
अपक्ष: पखेटाहीन पङ्खहीन पक्षरहित अपक्ष
अपतित: अपतित अच्युत
अपभ्रंशित: अपभ्रंश अपभ्रंशित अपभ्रष्ट
अपभ्रष्ट: अपभ्रंश अपभ्रंशित अपभ्रष्ट
अपमान_करण्याजोगा: अपमानजनक
अपमानकर्ता: अपकर्षक अपकर्ष_गर्ने अपकर्ष_भएको अपमानकर्त्ता
अपमानकारक: अपमानजनक
अपयशी: असफल विफल निष्फल
अपरंपार: अनन्त असमाप्य अन्त्यहीन अनंत अंतहीन
अपरतावाशील: अप्रतिकार
अपराजित: अपराजित अपरास्त अविजित अनभिभूत अप्रतिहत
अपराधमुक्त: रिहा आरोप_मुक्‍त
अपराधी: अपराधी दोषी कसुरवार अपराधी अपराधशील
अपरावर्ती: अपरावर्ती
अपरिचित: अपरिचित नजानेको नचिनेको अज्ञात अपरिगत अनभिज्ञ
अपरिपक्व: काँचो नपाकेको अधकल्चो अपरिपक्व काँचो
अपरिपूर्ण: अपूर्ण अपरिपूर्ण अधुरो
अपरिमित: अनन्त असमाप्य अन्त्यहीन अनंत अंतहीन असङ्ख्य अगणनीय अनगन्ती अगण्य अगणित अत्यधिक धेरै औधि प्रचुर अत्याधिक अनगन्ती असङ्ख्य अपरिमित सीमारहित असीम अगणित भारी भीषण घनघोर अत्याधिक
अपरिवर्तनीय: अपरिवर्तनीय अपरिवर्तनशील
अपरिष्कृत: अपरिष्कृत अमार्जित असंस्कृत
अपरिहार्य: अनिवार्य परमावश्यक जरूरी
अपरोक्ष_उच्चारला_गेलेला: अकथित नभनिएको अनुक्त नबताइएको नकहिएको
अपरोक्ष_बोलला_गेलेला: अकथित नभनिएको अनुक्त नबताइएको नकहिएको
अपरोक्ष_म्हटला_गेलेला: अकथित नभनिएको अनुक्त नबताइएको नकहिएको
अपवित्र: अपवित्र अपावन अपुण्य अशुद्ध अशुचि अपुनीत दुषित अमेध्य
अपव्ययी: अपव्ययी खर्चिलो फिजुलखर्ची व्ययशील अतिव्ययी अति-व्ययी व्ययी अपव्ययी खर्चालु फिजुलखर्ची
अपहरण_केलेला: अपहृत अपहारित थुनिएको
अपहृत: अपहृत अपहारित थुनिएको
अपात्र: अयोग्य अनुपयुक्त नालायक ना-लायक अनलायक अपारग अप्रभु अयथा अयुक्त अयुक्तरूप अयोग कुपात्र अपात्र अनधिकारी अभाजन
अपायकारक: हानिकारक क्षतिकारी हानिकर हानिप्रद अनर्थकारी क्षतिकर
अपार: अनन्त असमाप्य अन्त्यहीन अनंत अंतहीन असीम अनंत अनन्त अनादि अपरंपार अपरम्पार अपरिमित अपार असीमित अगाध अमित अनंता अनन्ता अनन्त्य अनंत्य अनधिक अनवधि अनिर्दिष्ट अपरिच्छिन्न अप्रमाण अबाध सीमारहित अमर्याद अमात्र मात्रारहित अमान अमाप अमित अवर्णनीय अवर्ण्य
अपुरा: अपूर्ण अपरिपूर्ण अधुरो अधुरो बाँकी शेष असमाप्त अनिष्पादित असम्पादित अपूर्ण असम्पन्न असिद्ध अनिष्पन्न अपर्याप्त अपूर्ण अपरिपूर्ण विस्मृत बिर्सिएको
अपुरा_रचलेला: विस्मृत बिर्सिएको
अपुष्प: पुष्पहीन अपुष्पित पुष्परहित अपुष्प कुसुमरहित
अपुष्पित: अपुष्पित अविकसित मुकुलित अस्मित
अपूर्ण: अपूर्ण अपरिपूर्ण अधुरो अधुरो बाँकी शेष असमाप्त अनिष्पादित असम्पादित अपूर्ण असम्पन्न असिद्ध अनिष्पन्न
अपूर्व: अभूतपूर्व अपूर्व
अपेक्षणीय: अपेक्षणीय
अपेक्षाविरहित: निष्काम निरपेक्ष
अपेक्षित: प्रत्याशित प्रयाशानुकूल यथावांछित आशानुकूल
अप्रकाशित: अप्रकाशित गुप्त नदेखिएको
अप्रगल्भ: अधकल्चो अपरिपक्व काँचो
अप्रचलित: अप्रचलित अप्रचरित अव्यवहृत अप्रयुक्त आउटडेटेड आउट_आफ_डेट
अप्रतिम: अनुपम अतुलनीय अद्वितीय असाधारण बेजोड न्यारो अप्रतिम अद्वैत एकल सर्वोकृष्ट अनुत्तम उपमारहित अनुपमित अनुपमेय अपूर्व अप्रतिमान अप्रतिरूप अभूत
अप्रतिष्ठित: अप्रतिष्ठित अप्रतिष्ठ प्रतिष्ठारहित अमर्याद
अप्रत्यक्ष: असमक्ष
अप्रमेय: अनगन्ती असङ्ख्य अपरिमित सीमारहित असीम अगणित अप्रमाणित अप्रमित अप्रमेय असिद्ध
अप्रयोजक: अप्रासाङ्गिक अप्रासंगिक प्रसङ्गहीन प्रसंगहीन अनुपयुक्त नमिल्दो
अप्रवाही: अप्रवाहित जमेको प्रवाहहीन स्थिर गतिहीन
अप्रवीण: अप्रवीण अनाडी अकुशल अदक्ष अनिपुण अधकचरा अनाप्त अनारी अनैपुण अपटु अपाटव अपात्र
अप्रवेश्य: अप्रवेश्य अगम्य अगत अगम आगम
अप्रशस्त: अनुचित खराब बेठिक
अप्रसन्न: अप्रसन्न नाराज रुष्ट खिन्न अप्रतीत
अप्रसिद्ध: अख्यात अप्रसिद्ध अनाम अविख्यात बेनाम अनामक
अप्राप्त: अप्राप्त
अप्राप्य: अप्राप्त अलब्ध अनवाप्त अनापन्न अनाप्त अलभ्य
अप्रासंगिक: अप्रासाङ्गिक अप्रासंगिक प्रसङ्गहीन प्रसंगहीन अनुपयुक्त नमिल्दो अप्रासङ्गिक अप्रासाङ्गिक
अप्रिय: मन_नपर्दो अप्रिय अनभीष्ठ अनभिमत अमनोनीत अप्रिय अप्रीतिकर नमिठो नचाहिँदो
अफगाणी: अफगानी अफगानी
अफूचा: अफीमी
अबला: अबला
अबाध्य: अबाध्य अरोक
अबोधनीय: कठिन गाह्रो अप्ठयारो मुस्किल कडा कठोर साह्रो
अबोध्य: कठिन गाह्रो अप्ठयारो मुस्किल कडा कठोर साह्रो
अबोल: नबोल्ने अल्पभाषी मितभाषी अल्पवादी
अब्ज: अरब
अभंग: अभन्जित अक्षत अखण्डित अखंडित खंडहीन खण्डहीन अनवच्छिन्न पूर्ण अभङ्ग अखण्ड
अभंजनशील: भञ्जनशील अभञ्जनीय
अभंजनीय: अखण्डनीय अखंडनीय अखण्ड्य अखंड्य
अभक्ष्य: अनाहार्य अखाद्य अभोज्य अभक्ष्य अग्राह्य अभक्ष अभोज
अभद्र: असभ्य अभद्र अशिष्ट
अभागी: दुर्भाग्यशाली अभागी भाग्यहीन
अभिजात: अभिजात अभिजात्य उच्च_वंशीय उच्च_कुलीन
अभिज्ञ: अनुभवी जानकार परिपक्व खारिएको
अभिज्ञात: अभिज्ञात पूर्व_परिचित
अभितप्त: पाकेको पकाएको
अभिनंदनीय: अभिनन्दनीय
अभिनव: नयाँ नौलो नवीन हालैको
अभिप्राय_नसलेला: अनभिप्रेत अभिप्रायविरुद्ध अनभिमत
अभिप्राव_नसलेला: अनभिप्रेत अभिप्रायविरुद्ध अनभिमत
अभिप्रेत_नसलेला: अनभिप्रेत अभिप्रायविरुद्ध अनभिमत
अभिमंत्रित: अभिमन्त्रित
अभिमानी: गर्विलो गर्वी अभिमानी अहङ्कारी घमण्डी
अभिलाषित: इच्छित अभिलषित अभिलाषित अभीष्ट आकाङ्क्षित वाञ्छित इष्ट अपेक्षित अभिप्रेत मनोवाञ्छित वाञ्छनीय कमनीय अनुकाङ्क्षित अभिकाङ्क्षित अभिमत अभिवांछित अभिवाञ्छित अभीप्सित
अभिलाषी: इच्छुक अनुकाङ्क्षी अभिलाषी आकांक्षी अभिलाषुक अभिलाषक इच्छालु
अभिवृद्धिकारक: उन्नतिकारी उत्कर्षकारी उन्नायक उन्नतकारी
अभिशासित: शासित प्रशासित
अभीप्सित: इच्छित अभिलषित अभिलाषित अभीष्ट आकाङ्क्षित वाञ्छित इष्ट अपेक्षित अभिप्रेत मनोवाञ्छित वाञ्छनीय कमनीय अनुकाङ्क्षित अभिकाङ्क्षित अभिमत अभिवांछित अभिवाञ्छित अभीप्सित
अभीष्ट: इच्छित अभिलषित अभिलाषित अभीष्ट आकाङ्क्षित वाञ्छित इष्ट अपेक्षित अभिप्रेत मनोवाञ्छित वाञ्छनीय कमनीय अनुकाङ्क्षित अभिकाङ्क्षित अभिमत अभिवांछित अभिवाञ्छित अभीप्सित
अभूतपूर्व: अभूतपूर्व अपूर्व
अभेदनीय: अवेध्य अभेद अभेद्य दुर्भेद्य अभेदनीय अछेद्य अछेद अपरिच्छिन्न
अभेद्य: अवेध्य अभेद अभेद्य दुर्भेद्य अभेदनीय अछेद्य अछेद अपरिच्छिन्न
अभोज्य: अनाहार्य अखाद्य अभोज्य अभक्ष्य अग्राह्य अभक्ष अभोज
अभ्यस्त: अभ्यस्त अभ्यसित
अभ्यासात_व्यग्र: अध्यायी अध्ययनशील
अभ्यासी: अध्यायी अध्ययनशील
अभ्ररहित: स्वच्छ मेघहीन निरभ्र अनभ्र मेघरहित अनाकाश अमेघ
अभ्रांत: अभ्रमित भ्रमरहित अभ्रान्त अभरम अप्रमाद भ्रान्तिशून्य
अमंगल: अपवित्र अपावन अपुण्य अशुद्ध अशुचि अपुनीत दुषित अमेध्य
अमंगळ: अपवित्र अपावन अपुण्य अशुद्ध अशुचि अपुनीत दुषित अमेध्य
अमर: अमर अक्षय अनश्वर शाश्वत अक्षुण्ण अक्षुण अनष्ट अविनाशी अविनासी अक्षय्य अच्युत अभङ्ग अनाश अनाश्य अनाशवान अभङ्गुर अखय अक्षुण्य अमर मृत्यु_कालजयी चिरञ्जीवी
अमर्याद: अनन्त असमाप्य अन्त्यहीन अनंत अंतहीन असीम अनंत अनन्त अनादि अपरंपार अपरम्पार अपरिमित अपार असीमित अगाध अमित अनंता अनन्ता अनन्त्य अनंत्य अनधिक अनवधि अनिर्दिष्ट अपरिच्छिन्न अप्रमाण अबाध सीमारहित अमर्याद अमात्र मात्रारहित अमान अमाप अमित अनगन्ती असङ्ख्य अपरिमित सीमारहित असीम अगणित असीमाङ्कित
अमर्यादीत: असीमाङ्कित
अमानुष: अमानवीय अमानुषिक पाशविक पशुवत
अमाप: असङ्ख्य अतुल अतुलित
अमिश्र: अमिश्रित विशुद्ध अमिश्र
अमिश्रित: अमिश्रित विशुद्ध अमिश्र
अमूर्त: निराकार अमूर्त निरङ्कार आकारविहीन अनवाय अनवय निरवयव अनाकार अपिरच्छन्न अमूर्त्त अमूर्त्ति अमूर्ति आकृतिहीन अमूर्तमान अमूर्तिमान अमूर्त्तिमान मूर्तिरहित अरूप अरूपक
अमूल्य: अमूल्य अनमोल अमोल अमोलक मूल्यातीत
अमेय: असङ्ख्य अगणनीय अनगन्ती अगण्य अगणित
अमेरिकी: अमेरिकी अमरिकाको
अमोल: बहुमूल्य मूल्यवान अमूल्य अनमोल दामी अमूल्य अनमोल अमोल अमोलक मूल्यातीत
अम्लान: आलो ताजा
अयशस्वी: असफल विफल निष्फल
अयोग्य: अयोग्य अनुपयुक्त नालायक ना-लायक अनलायक अपारग अप्रभु अयथा अयुक्त अयुक्तरूप अयोग अनुचित खराब बेठिक
अरचित: अरचित अकृत नरचेको अनिर्मित
अरबी: अरबी
अराजक: अराजक राजाहीन अराज
अराजकी: अराजक
अराजपत्रित: अराजपत्रित
अरुंद: साँघुरो साँगुरो साङ्ग्रो
अरुच: अरूचिकर रुचि_नभएको
अरूवार: नरम कमलो कोमल
अर्क: छक्याउने
अर्जदार: आवेदक आवेदन_कर्ता
अर्थपूर्ण: सार्थक अर्थयुक्‍त अर्थपूर्ण
अर्थशास्त्रीय: अर्थशास्त्रीय
अर्थशून्य: अर्थहीन निरर्थक
अर्थहीन: अर्थहीन निरर्थक
अर्थानुसारी: अन्वर्थ
अर्धकच्चा: कटमिरो आधा_पाकेको अधकल्चो
अर्धमेला: आधामरो अर्ध_मृत
अर्धवट: मूर्ख अज्ञानी बुद्धु अपूर्ण अपरिपूर्ण अधुरो अधुरो बाँकी शेष असमाप्त अनिष्पादित असम्पादित अपूर्ण असम्पन्न असिद्ध अनिष्पन्न ज्ञानहीन अज्ञानपूर्ण
अर्धवेळ: अङ्शकालिक पार्टटाइम
अर्धा: अपूर्ण अपरिपूर्ण अधुरो आधा अर्द्ध पचास_प्रतिशत अर्ध अद्ध
अर्धोन्मीलित: आधा_खोलिएको अर्ध_मुकुलित
अर्पित: समर्पित
अलंकृत: अलङ्कृत अलंकृत आभूषित भूषित सज्जित विभूषित अलंकारिक अलंकारपूर्ण अभिलमंडित अभिलमण्डित
अलग: अलग छुट्टै पृथक् फरक
अलग_न_राहणारा: मिलेको अभिन्न अपृथक अभेद
अलभ्य: अनुपलब्ध अप्राप्य अलभ्य अनधिगम्य अनमिलता अप्राप्त अमिल
अलिखित: अलिपिबद्ध अलिखित
अलौकिक: विलक्षण अद्भुत अनौठो अचम्भको विचित्र आश्चर्यजनक आश्चर्यभूत अभूतपूर्व अपूर्व अलौकिक अनौठो अद्‍भुत लोकोत्तर
अल्प: कम्ती अलिकति अल्प
अल्पभाष: अल्पभाषी मितभाषी अल्पवादी
अल्पभाषी: अल्पभाषी मितभाषी अल्पवादी
अल्पवयस्क: अवयस्क नाबालिग अल्पवयस्क अप्रौढ़ अप्राप्तयौवन
अल्पवयीन: अवयस्क नाबालिग अल्पवयस्क अप्रौढ़ अप्राप्तयौवन
अल्पसंख्य: अल्पसङ्ख्यक अल्पसंख्य
अल्पसंख्याक: अल्पसङ्ख्यक अल्पसंख्य
अल्पसा: कम्ती अलिकति अल्प
अल्पस्वल्प: कम्ती अलिकति अल्प
अल्पायु: अल्पायु स्वल्पायु अल्प_जीवी
अल्पायुष: अल्पायु स्वल्पायु अल्प_जीवी
अल्पायुषी: अल्पायु स्वल्पायु अल्प_जीवी
अल्पाहारी: अल्पाहारी अल्पहारी अल्पभोजी मिताहारी स्वल्पाहारी
अल्बेनियन: अलबानियाई अल्बानियन अल्बेनियन अलबानियन अलबेनियन अलबानियाई अलवेनियाई अलबेनियाई अल्बानियाई
अल्बेनियाई: योजक संयोजक संयोगी
अवखळ: चकचके चञ्‍चल चुलबुले
अवगत: थाहा ज्ञात विदित अवगत विज्ञात अवबुद्ध परिचित
अवगुणी: दुर्गुणी बैगुनी अगुणी अपगुणी
अवघड: दुष्कर दुःसाध्य दुःखसाध्य कष्‍टसाध्य कठिन विकट मुश्‍किल सारो कठिन गाह्रो अप्ठयारो मुस्किल कडा कठोर साह्रो
अवघा: जम्मा सारा सबै समस्त सम्पूर्ण तमाम
अवजड: भारी गरुङ्गो वजनदार
अवधनीय: अबध्य अबधार्ह
अवध्य: अबध्य अबध्य अबधार्ह
अवनत: निहुरिएको नत
अवरुद्ध: बन्द थुनिएको रोकिएको
अवर्णनीय: अवर्णनीय अकथनीय वर्णनातीत शब्दातीत अकथ अकथ्य अनभिधेय अनिर्वचनीय अनिर्वाच्य
अवर्ण्य: अवर्णनीय अकथनीय वर्णनातीत शब्दातीत अकथ अकथ्य अनभिधेय अनिर्वचनीय अनिर्वाच्य
अवलंबून_असलेला: अधीनस्थ अधीन मातहत अधस्तन अमुख्य
अवलोकित: अवलोकित दृष्टिगत विलोकित
अवशिष्ट: उब्रेको बचेको बचेखुचेको
अवसानयुक्त: जोशीलो जोशपूर्ण
अवांतर: अन्य अर्को इतर अर्कै
अवाचनीय: अपठनीय अपठ्य
अवाढव्य: महाकाय अतिकाय बृहत्काय विशालकाय भीमकाय विकराल
अवास्तविक: काल्पनिक कल्पित अवास्तविक अयथार्थ अनात्मक अप्रकृत अयथातथ अयाथार्थिक
अविघटनशील: नघोलिने
अविचल: अविचलित अडिग अविचल स्थिर थिर दृढ अचल अविचल निश्चल गतिहीन अविचलित अटल दृढ़ अटल अडिग अविचल स्थिर कायम
अविचारित: अविचारित अचिन्तित अचिंतित नसोचिएको
अविचारी: अविवेकी विवेकहीन अबोध अबुझ
अविद्य: अशिक्षित अनपढ निरक्षर
अविद्राव्य: नघोलिने
अविनयशील: धृष्ट उच्छृङ्खल ढीठ निडर उद्धत अभिमानी अहङ्कारी घमण्डी
अविनाशी: अमर अक्षय अनश्वर शाश्वत अक्षुण्ण अक्षुण अनष्ट अविनाशी अविनासी अक्षय्य अच्युत अभङ्ग अनाश अनाश्य अनाशवान अभङ्गुर अखय अक्षुण्य
अविभक्त: अक्षुण्ण अक्षुण अविभाजित अखंड अखण्ड अभग्न अविभक्त अखण्डित अखंडित अटूट अभिन्न अजस्र अनन्तरित अनंतरित अनन्तर्हित अनंतर्हित अनवच्छिन्न अभङ्ग अभंग अभङ्गी अभंगी अभञ्जन अभंजन अभेदनीय
अविभाजित: अक्षुण्ण अक्षुण अविभाजित अखंड अखण्ड अभग्न अविभक्त अखण्डित अखंडित अटूट अभिन्न अजस्र अनन्तरित अनंतरित अनन्तर्हित अनंतर्हित अनवच्छिन्न अभङ्ग अभंग अभङ्गी अभंगी अभञ्जन अभंजन अभेदनीय
अविरत: अनवरत लगातार निरन्तर
अविवाहित: अविवाहित कुमार बिहे_नभएको
अविवेकी: अविवेकी विवेकहीन अबोध अबुझ
अविश्रांत: अनवरत लगातार निरन्तर
अविश्वसनीय: अविश्वसनीय अप्त्यारिलो अविश्वस्त अविश्वासी
अविश्वासी: अविश्वासी अपत्यारिलो
अविश्वासू: अविश्वासी अपत्यारिलो अविश्वसनीय अप्त्यारिलो अविश्वस्त अविश्वासी
अविश्वासूक: अविश्वासी अपत्यारिलो
अविहित: मना मना_गरिएको निषिद्ध वर्जित प्रतिबन्धित प्रतिबंधित निषेधित वर्ज्य व्याहत
अवैज्ञानिक: अवैज्ञानिक विज्ञान_विरूद्ध अवैज्ञानिक अविज्ञानीय
अवैध: अनैतिक नैतिकताहीन अनीतिपूर्ण अनुचित गलत नीतिविरुद्ध
अव्यक्त: अव्यक्त अप्रकट अप्रकटित अनभिव्यक्त
अव्यवस्थित: अव्यवस्थित व्यवस्थाहीन लथालिङ्ग छरप्रस्ट
अव्यवहारी: अव्यवहारिक व्यवहार_अकुशल
अव्हेरी: अछुतो अभोग
अशक्त: हड्डीछाला अस्थिमय
अशक्य: असम्भव असंभव नघट्नु_पर्ने असंभावित
अशरीर: विदेह अशरीरी अकाय शरीरहीन अगात्र अतनु अदेह शरीरविहीन अपाङ्ग अपिण्डी पिण्डरहित
अशांत: उद्विग्न हताश_भएको डराएको
अशारीर: अशरीरी अशारीरिक
अशाश्वत: नश्वर अशाश्वत क्षणजीवी क्षयशील नाशवान भंगुर विनाशी अनित्य मेटिने नाशुक अनित
अशास्त्र: शास्त्रविरुद्ध शास्त्र-विरुद्ध
अशास्त्रीय: शास्त्रविरुद्ध शास्त्र-विरुद्ध
अशिक्षित: अशिक्षित अनपढ निरक्षर
अशिष्ट: अनुचित खराब बेठिक असभ्य अभद्र अशिष्ट धृष्ट उच्छृङ्खल ढीठ निडर उद्धत
अशुद्ध: अशुद्ध भूल गलत मैलो फहोर अशुद्ध
अशुभ: अकल्याणकारी अनिष्टकर अमङ्गलकारी अमाङ्गलिक अकुशल अशुभकारी अनभीष्ट अहितकारी अशुभ नराम्रो अमङ्गल अमाङ्गलिक अनिष्‍‍टसूचक अरिष्ट
अशोभनीय: अनुचित खराब बेठिक
अश्रांत: अथक नथाक्ने अश्रान्त
अश्रुत: नसुनेको अश्रुत
अश्लील: अश्लील कामुकतापूर्ण
अश्वेत: अश्‍वेत कालो
अष्टम: आठ आठौं ८ 8 आठौँ अष्टम
असंख्य: असङ्ख्य अगणनीय अनगन्ती अगण्य अगणित
असंघटित: एकताहीन असङ्गठित सङ्गठनहीन छरपटिएको भताभुङ्ग_भएको
असंतुष्ट: अतृप्त असन्तुष्ट अतुष्ट अप्रसन्न नाराज रुष्ट खिन्न अप्रतीत
असंदिग्ध: असन्दिग्ध संदेहहीन असन्दिग्ध सन्देहहीन
असंबद्ध: असम्बन्धित असम्बद्ध सम्बन्धरहित अनन्वित अप्रसङ्ग असम्बन्धित असम्बद्ध सम्बन्धरहित अमेल अयुक्त
असंभवनीय: असम्भव असंभव नघट्नु_पर्ने असंभावित
असंभाव्य: असम्भव असंभव नघट्नु_पर्ने असंभावित
असंयत: असंयत
असंयमित: असंयत
असंशायात्मक: सन्देहहीन शङ्काहीन
असत्य: असत्य झूटो
असफल: असफल विफल निष्फल
असभ्य: असभ्य अभद्र अशिष्ट
असमंजस: अविवेकी विवेकहीन अबोध अबुझ सामञ्जस्यहीन असामञ्जस्य अनमेल असामञ्जस्यपूर्ण
असमर्थ: अपाङ्ग बिकलाङ्ग
असमाधानकारक: असन्तोषजनक असन्तोषप्रद
असमाधानी: अतृप्त असन्तुष्ट अतुष्ट
असमृद्धीप्रद: असमृद्धिप्रद अनैश्वर्यप्रद
असहमत: असहमत असम्मत नामन्जुर अमत
असहाय: टुहुरो अनाथ यतीम लावारिस असहाय निस्सहाय बेसहारा निराश्रित निराश्रय अनाश्रित आश्रयहीन अपाश्रय निरवलम्ब अवलम्बहीन अवलम्बनहीन  अनवस्थित अनाथ निरवलम्ब अनाश्रित निःसहाय
असहाय्य: विवश बाध्य लाचार पराश्रित पराश्रय पराधीन निराश्रित
असाधारण: विलक्षण अद्भुत अनौठो अचम्भको विचित्र आश्चर्यजनक आश्चर्यभूत अभूतपूर्व अपूर्व असामान्य असाधारण खास विशेष यस्तो-उस्तो जस्तो-त्यस्तो अपसामान्य स्पेसल
असाधू: दुष्ट दुर्जन अधम खल शठ हरामी पाजी अमति कुमति पामर अशील असज्जन असाधु असित
असाध्नीय: असाध्य
असाध्य: असाध्य असाध्य अचिकित्स्य चिकित्सातीत दुस्साध्य दुःसाध्य
असामाजिक: असामाजिक
असामान्य: विलक्षण अद्भुत अनौठो अचम्भको विचित्र आश्चर्यजनक आश्चर्यभूत अभूतपूर्व अपूर्व अस्वाभाविक अप्राकृतिक अनैसर्गिक अप्राकृत अप्रकृत अनौठो असामान्य असाधारण खास विशेष यस्तो-उस्तो जस्तो-त्यस्तो अपसामान्य स्पेसल
असार: अरोचक अरुचिकर नीरस रसहीन रुचिहीन फीका असार
असावध: असावधान लापरवाह हेलचेक्राइँ अचेत असजग अनचित अमनोयोगी
असिद्ध: अप्रमाणित अप्रमित अप्रमेय असिद्ध
असीम: अनन्त असमाप्य अन्त्यहीन अनंत अंतहीन असीम अनंत अनन्त अनादि अपरंपार अपरम्पार अपरिमित अपार असीमित अगाध अमित अनंता अनन्ता अनन्त्य अनंत्य अनधिक अनवधि अनिर्दिष्ट अपरिच्छिन्न अप्रमाण अबाध सीमारहित अमर्याद अमात्र मात्रारहित अमान अमाप अमित असीमाङ्कित
असुखी: शोकपूर्ण शोकाकुल शोकग्रस्त
अस्त: अस्तगत अस्त डुब्दो
अस्तंगत: अस्तगत अस्त डुब्दो
अस्ताजवळचा: निभृत
अस्तानिकटचा: निभृत
अस्ताव्यस्त: अव्यवस्थित व्यवस्थाहीन लथालिङ्ग छरप्रस्ट ध्वस्त बिग्रेको भत्केको नष्‍टभ्रष्‍ट
अस्तासमीपचा: निभृत
अस्थिचा: अस्थिमय अस्थिनिर्मित अस्थि_निर्मित
अस्थिमय: अस्थिमय अस्थिनिर्मित अस्थि_निर्मित
अस्थिर: चञ्चल चकचके अधीर अशान्त अशांत चंचल अस्थिरचित्त उत्कंठित उत्कण्ठित विचलित अस्थिर अनुपशांत अनेकांत अनेकान्त क्षुब्ध
अस्पर्शित: नछोइएको नछोएको अस्पर्शित
अस्पष्ट: अस्पष्ट अप्रतीत धमिलो अस्पष्ट
अस्पृश्य: अस्पृश्य अछुत पानि_नचल्ने
अस्पृष्ट: अछुत अस्पृष्ट अपरस नछोइएको नछोएको अस्पर्शित
अस्वच्छ: मैलो फहोर अशुद्ध
अस्वस्थ: उद्विग्न हताश_भएको डराएको
अस्वाभाविक: अस्वाभाविक अप्राकृतिक अनैसर्गिक अप्राकृत अप्रकृत अनौठो
अस्वास्थ्यकारक: कुपथ्य अपथ्य अहितकर
अस्वीकृत: अस्वीकृत नामंजूर सहमतिहीन सहमति_अप्राप्त
अस्सल: राम्रो शुद्ध चोखो असल खारिएको असली शुद्ध राम्रो खोटहीन विशुद्ध
अहंकारी: गर्विलो गर्वी अभिमानी अहङ्कारी घमण्डी
अहंमन्य: गर्विलो गर्वी अभिमानी अहङ्कारी घमण्डी
अहिंसक: अहिंसक अहिंस्र
अहिंस्र: अहिंसक अहिंस्र
अहितकर: कुपथ्य अपथ्य अहितकर
अहितकारी: अकल्याणकारी अनिष्टकर अमङ्गलकारी अमाङ्गलिक अकुशल अशुभकारी अनभीष्ट अहितकारी
आंतर: आन्तरिक भित्री अन्तः अन्तरङ्ग अन्तर्वर्ती अंतर्वर्ती आंतरिक अन्तः अन्तरंग अन्तरित
आंतरजातीय: विजातीय परजातीय भिन्न_जातीय विजाति अर्को_जातिको
आंतरराष्ट्रीय: अन्तर्राष्ट्रीय अंतर्राष्ट्रीय अन्तराष्ट्रीय बहुदेशीय बहुराष्ट्रीय अन्तर्राष्ट्रीय अन्तर्देशीय
आंधळा: अन्धो नेत्रहीन
आंबट: अमिलो तित्री कागती
आंबटगोड: अमिलो-पिरो
आंशिक: आंशिक
आकर्षक: आकर्षक मनोहर राम्रो सुन्दर
आकर्षित: आकर्षित आकृष्ट
आकस्मिक: अनपेक्षित अप्रत्याशित निरपेक्षित आकस्मिक अनपेक्षित अप्रत्याशित अचानक दैवी दैविक दैवागत
आकांशित: इच्छित अभिलषित अभिलाषित अभीष्ट आकाङ्क्षित वाञ्छित इष्ट अपेक्षित अभिप्रेत मनोवाञ्छित वाञ्छनीय कमनीय अनुकाङ्क्षित अभिकाङ्क्षित अभिमत अभिवांछित अभिवाञ्छित अभीप्सित
आकाररहित: निराकार अमूर्त निरङ्कार आकारविहीन अनवाय अनवय निरवयव अनाकार अपिरच्छन्न अमूर्त्त अमूर्त्ति अमूर्ति आकृतिहीन अमूर्तमान अमूर्तिमान अमूर्त्तिमान मूर्तिरहित अरूप अरूपक
आकुंचित: खुम्चिएको संकुचित निकुंचित निकुञ्चित
आकृष्ट: आसक्त मुग्ध मोहित आकर्षित आकृष्ट
आक्रमक: आक्रामक आक्रामकतापूर्ण अभिधावक
आक्रमणकारी: आक्रमणकारी आक्रामक आक्रान्ता आक्रमण_कर्ता आक्रमण_कर्त्ता अभिसारी
आक्रांत: पराजित आक्रान्त
आख्खा: जम्मा सारा सबै समस्त सम्पूर्ण तमाम
आगत: आएका समागत
आगळा: अलग छुट्टै पृथक् फरक
आगामी: आगामी भविष्य_कालीन सम्भावित भविष्णु भाविता भावी भव्य अगत्तर भवितव्य अनागत आउँदो आगामी भावी आउनेवाला आइन्दा
आगीत_शिजलेला: भुटेका
आग्रही: अनुरोधी आग्रही अनुरोधक
आघाडीचा: अग्रगामी पुरोगामी पूर्वगामी
आच्छादित: आच्छादित ढाकिएको आवृत्त आवृत अपिबद्ध अपिनद्ध अपिहित आच्छन्न
आच्छ्न्न: आच्छादित ढाकिएको आवृत्त आवृत अपिबद्ध अपिनद्ध अपिहित आच्छन्न
आजारी: रोगी बिमारी बिरामी पन्थे रुग्न
आज्ञाधारक: आज्ञाकारी आज्ञापालक
आझरबैजानी: अजरबैजानी अजरबैजानी
आटीव: पोटिलो खँदिलो भरिलो मोटो दह्रो;
आठ: आठ आठौं ८ 8
आठपट: आठगुना
आठवा: आठौँ अष्टम
आडवा: फराक चौडा विस्तीर्ण
आणखी: अरू अर्को
आतचा: आन्तरिक भित्री अन्तः अन्तरङ्ग अन्तर्वर्ती अंतर्वर्ती आंतरिक अन्तः अन्तरंग अन्तरित
आततायी: अविवेकी विवेकहीन अबोध अबुझ
आतला: आन्तरिक भित्री अन्तः अन्तरङ्ग अन्तर्वर्ती अंतर्वर्ती आंतरिक अन्तः अन्तरंग अन्तरित
आताचा: वर्तमानकालीन सामयिक आधुनिक वर्तमान हाल
आतील: आन्तरिक भित्री अन्तः अन्तरङ्ग अन्तर्वर्ती अंतर्वर्ती आंतरिक अन्तः अन्तरंग अन्तरित
आतुर: आतुर अधीर कातर व्याकुल बेचैन विकल अधैर्य अधैर्यवान् अधैर्यवान अधैर्यवान् अभिभूत क्षुब्ध
आतोनात: अत्यधिक धेरै औधि प्रचुर अत्याधिक भारी भीषण घनघोर अत्याधिक
आत्ताचा: वर्तमानकालीन सामयिक आधुनिक वर्तमान हाल
आत्मनिर्भर: स्वावलम्बी आत्मावलम्बी
आत्मविश्वासू: आत्मविश्वासी
आत्यंतिक: अत्यधिक धेरै औधि प्रचुर अत्याधिक भारी भीषण घनघोर अत्याधिक
आदरणीय: प्रतिष्ठित अग्रगण्य इज्जतदार गणमान्य नामी सम्मानित मान्य माननीय गौरवान्वित सम्भ्रान्त संभ्रांत सम्ब्रांत अजीज अपचायित सुर्खरू विशिष्ट विशेष आदरणीय सम्माननीय समादरणीय सम्मान्य मान्य माननीय
आदरार्ह: आदरणीय सम्माननीय समादरणीय सम्मान्य मान्य माननीय
आदर्श: आदर्श
आधिकारिक: आधिकारिक अधिकारिक अधिकार_विषयको
आधीन: अधीन अधीनस्थ अधीन मातहत अधस्तन अमुख्य
आधुनिक: आधुनिक अद्यतन आजको अर्वाचीन अधुनातन नया अप्राचीन अकालातीत अपूरातन अपूर्वकालीन नवीन अपूराण साम्प्रतिक
आनंददायक: रमाइलो आनन्दप्रद आनन्दप्रद आनन्द-दायक आह्लादक सुखप्रद खुशनुमा प्रसन्नतादायक आनंददायक आनन्ददायक आनन्ददायी आनन्दकारी आनंदकारी आह्लादी अनंद अनन्द नंदक नन्दक रमन रमण सुखद सुखदायक सुखकारी सुखदायी सुखप्रद
आनंददायी: रमाइलो आनन्दप्रद आनन्दप्रद आनन्द-दायक आह्लादक सुखप्रद खुशनुमा प्रसन्नतादायक आनंददायक आनन्ददायक आनन्ददायी आनन्दकारी आनंदकारी आह्लादी अनंद अनन्द नंदक नन्दक रमन रमण सुखद सुखदायक सुखकारी सुखदायी सुखप्रद
आनंदपूर्ण: आनन्दपूर्ण आनन्दमय उल्लासपूर्ण सानन्द
आनंदमय: आनन्दपूर्ण आनन्दमय उल्लासपूर्ण सानन्द
आनंदित: प्रसन्न खुसी खुश आनन्दित पुलकित हर्षित विह्वल आह्लादित प्रफुल्ल परितुष्ट प्रफुल्लित प्रफुलित उल्लसित उल्लासित उल्लासी आनन्दी विनोदित पुलकित तुष्ट
आनंदी: प्रसन्न खुसी खुश आनन्दित पुलकित हर्षित विह्वल आह्लादित प्रफुल्ल परितुष्ट प्रफुल्लित प्रफुलित उल्लसित उल्लासित उल्लासी आनन्दी विनोदित पुलकित तुष्ट पुरै पूर्ण पक्का प्रसन्नचित्त
आनुवंशिक: आनुवंशिक वंशागत वंशानुक्रमिक पैतृक आनुवांशिक अनुवांशिक पुर्ख्यौली
आपमतलबी: स्वार्थी मतलबी स्वार्थपर तनपोषक अपस्वार्थी अपरता स्वार्थपरायण
आपला: तपाईंको यहाँको हजुरको स्वजनीय आत्मजनीय
आपल्यासाठी: स्वेच्छार्थ
आप्पलपोटा: स्वार्थी मतलबी स्वार्थपर तनपोषक अपस्वार्थी अपरता स्वार्थपरायण
आप्पलपोट्या: स्वार्थी मतलबी स्वार्थपर तनपोषक अपस्वार्थी अपरता स्वार्थपरायण
आफूचा: अफीमी
आफ्रिकी: अफ्रिकी
आभारी: कृतज्ञ आभारी धन्यवादी उपकृत अनुगृहीत
आभूषित: अलङ्कृत अलंकृत आभूषित भूषित सज्जित विभूषित अलंकारिक अलंकारपूर्ण अभिलमंडित अभिलमण्डित
आमंत्रित: निमन्त्रित आमनत्रित निम्त्याइएको बोलाइएको निम्तो_गरिएको
आम्लीय: तेजाबवाला तेजाबी
आयताकार: आयताकार
आयताकृती: आयताकार
आयरिश: आयरल्यान्डी
आयात_केलेला: आयातित इम्पोर्टेड
आयातित: आयातित इम्पोर्टेड
आयुष्यमान: चिरञ्जीव चिरञ्जीवी चिरजीवी दीर्घजीवी दीर्घायु आयुष्मान चिरायु
आयोजित: आयोजित
आरक्षित: आरक्षित व्याससिद्ध
आरूढ: चढेको बसेको
आरोग्यकर: स्वास्थ्यप्रद आरोग्यप्रद निरोगकर
आरोग्यदायी: स्वास्थ्यप्रद आरोग्यप्रद निरोगकर
आरोग्यप्रद: स्वास्थ्यप्रद आरोग्यप्रद निरोगकर
आरोपित: अधिरोपित
आरोपी: दोषी दागी अधिरोपित
आर्त: दुखी पीड़ित व्यथित दुःखी आर्त दुखित
आर्थिक: आर्थिक वित्तीय रुपिया
आर्द्र: भिजेको
आर्मेनियन: अरमेनियाई अर्मेनियाई अरमेनियाई अर्मेनियाई
आर्ष: प्राचीन पूराकालीन पूरातन पुराना प्राक्कालीन आदिम प्राच्य आदिकालीन
आलिशान: भव्य ठुलो सानदार विशाल
आलेला: आएका समागत
आल्हादक: रमाइलो आनन्दप्रद आनन्दप्रद आनन्द-दायक आह्लादक सुखप्रद खुशनुमा प्रसन्नतादायक आनंददायक आनन्ददायक आनन्ददायी आनन्दकारी आनंदकारी आह्लादी अनंद अनन्द नंदक नन्दक रमन रमण
आल्हादकारक: रमाइलो आनन्दप्रद आनन्दप्रद आनन्द-दायक आह्लादक सुखप्रद खुशनुमा प्रसन्नतादायक आनंददायक आनन्ददायक आनन्ददायी आनन्दकारी आनंदकारी आह्लादी अनंद अनन्द नंदक नन्दक रमन रमण
आल्हादित: प्रसन्न खुसी खुश आनन्दित पुलकित हर्षित विह्वल आह्लादित प्रफुल्ल परितुष्ट प्रफुल्लित प्रफुलित उल्लसित उल्लासित उल्लासी आनन्दी विनोदित पुलकित तुष्ट
आळशी: अल्छी सुस्त ढिलो
आळसट: अल्छी सुस्त ढिलो
आवडता: प्रिय प्यारो मन-पर्ने मनपर्दो प्रिय रुचिकर अभीष्ट प्यारो प्रिय
आवडीचा: मनपर्दो प्रिय रुचिकर अभीष्ट
आवरणहीन: बोक्रो_नभएको कवचहीन आवरणहीन
आवर्ती: आवर्तक सावधि अवधियुक्त सावधिक
आवळ: साँगुरो छोटो
आवश्यक: आवश्यक जरूरी अपेक्षित अपेक्ष्य
आविष्कारक: आविष्कारक आविष्कर्त्ता प्रकाशक आविष्कार्ता अविष्कारकर्त्ता अविष्कारकर्ता
आवेशपूर्ण: जोशीलो जोशपूर्ण आविष्ट आवेशपूर्ण आवेशग्रस्त
आवेशयुक्त: जोशीलो जोशपूर्ण
आशक: आसक्त मुग्ध मोहित
आशयाविरुद्ध: अनभिमत
आशावंत: आशान्वित आशांवित आशावान आशापूर्ण
आशावादी: आशान्वित आशांवित आशावान आशापूर्ण
आशियाई: एसियाली
आश्चर्यकारक: चमत्कारी चमत्कारपूर्ण चामत्कारिक तिलस्मी
आश्रमहीन: आश्रमहीन
आश्रित: आश्रित अवलम्बित आलंबित अवलम्बित आलम्बित निर्भर आधारित अवलंबी
आश्वासित: आश्‍वस्त आशा_प्राप्‍त
आश्विनी: असोजे असोजको असोजे
आसक्त: आसक्त मुग्ध मोहित प्रेमासक्त अनुरक्त अनुरागी आसक्त लसपसिएको
आसन्न: आसन्न सन्निकट छेउको नजिकको
आसामचा: असमिया असमीया
आसामबाबतचा: असमिया असमीया
आसामविषयक: असमिया असमीया
आसामविषयीचा: असमिया असमीया
आसामशी_संबंधित: असमिया असमीया
आसामसंबंधीचा: असमिया असमीया
आसामी: असमीया असमिया आसामी असमिया असमीया
आस्वादक: रसिक
इंग्रजी: अङ्ग्रेजी अङ्ग्रेजी इङ्गलिस्तानी
इंग्लंडविषयक: अङ्ग्रेजी इङ्गलिस्तानी
इंग्लंडाविषयीचा: अङ्ग्रेजी इङ्गलिस्तानी
इंग्लंडाशी_संबंधित: अङ्ग्रेजी इङ्गलिस्तानी
इंग्लंडासंबंधीचा: अङ्ग्रेजी इङ्गलिस्तानी
इंग्लिश: अङ्ग्रेजी
इंद्रियगम्य: इन्द्रियगम्य इंद्रिय_गोचर गोचर इंद्रियग्राह्य इन्द्रियगोचर इंद्रियगोचर प्रत्यक्ष अपरोक्ष
इंद्रियगोचर: इन्द्रियगम्य इंद्रिय_गोचर गोचर इंद्रियग्राह्य इन्द्रियगोचर इंद्रियगोचर प्रत्यक्ष अपरोक्ष
इंद्रियग्राह्य: इन्द्रियगम्य इंद्रिय_गोचर गोचर इंद्रियग्राह्य इन्द्रियगोचर इंद्रियगोचर प्रत्यक्ष अपरोक्ष
इंद्रियसंवेद्य: इन्द्रियगम्य इंद्रिय_गोचर गोचर इंद्रियग्राह्य इन्द्रियगोचर इंद्रियगोचर प्रत्यक्ष अपरोक्ष
इच्छारहित: इच्छाहीन अकाम आकाङ्क्षाहीन निष्काम अनभिलाषा
इच्छित: प्रत्याशित प्रयाशानुकूल यथावांछित आशानुकूल इच्छित अभिलषित अभिलाषित अभीष्ट आकाङ्क्षित वाञ्छित इष्ट अपेक्षित अभिप्रेत मनोवाञ्छित वाञ्छनीय कमनीय अनुकाङ्क्षित अभिकाङ्क्षित अभिमत अभिवांछित अभिवाञ्छित अभीप्सित
इच्छिलेला: इच्छित अभिलषित अभिलाषित अभीष्ट आकाङ्क्षित वाञ्छित इष्ट अपेक्षित अभिप्रेत मनोवाञ्छित वाञ्छनीय कमनीय अनुकाङ्क्षित अभिकाङ्क्षित अभिमत अभिवांछित अभिवाञ्छित अभीप्सित
इच्छुक: इच्छुक अनुकाङ्क्षी अभिलाषी आकांक्षी अभिलाषुक अभिलाषक इच्छालु
इजा_न_झालेला: अप्रतिघात
इटलीय: इटालेली इटालियन
इटलीयाई: इटालेली इटालियन
इटालियन: इटालेली इटालियन
इतका: यत्रो
इतर: अरू अर्को पराई बिरानो परचक्री अन्य अर्को इतर अर्कै
इतरांवर_विश्वास_ठेवणारा: अन्याधीन
इत्यादी: आदि इत्यादि
इमानदार: निष्कपट विश्‍वासी
इराणी: इरानी इरानेली इरानी इरानेली
इष्ट: कल्याणकारी मङ्गलकारी कल्याणप्रद मङ्गलकारक मङ्गलदायक मङ्गलप्रद हितकारी हितकर हितकारक कल्याणमय अनुकूल
इहलोकातील: इहलौकिक सांसारिक लौकिक
इहलोकीय: इहलौकिक सांसारिक लौकिक
इहलौकिक: इहलौकिक सांसारिक लौकिक
ईप्सित: इच्छित अभिलषित अभिलाषित अभीष्ट आकाङ्क्षित वाञ्छित इष्ट अपेक्षित अभिप्रेत मनोवाञ्छित वाञ्छनीय कमनीय अनुकाङ्क्षित अभिकाङ्क्षित अभिमत अभिवांछित अभिवाञ्छित अभीप्सित
ईशार्पित: देवदत्त
ईश्वरदत्त: देवदत्त
ईश्वरार्पित: देवदत्त
ईश्वराला_अर्पित: देवदत्त
ईश्वराला_अर्पिलेला: देवदत्त
ईश्वराला_वाहिलेला: देवदत्त
ईश्वरी: ईश्वरीय ईश्वरी दैवी परमेश्वरी
ईसाई: ईसा_विषयक ईसाई मसीही
ईसाविषयक: ईसा_विषयक ईसाई मसीही
उंच: अग्लो उच्च
उंचसखल: असमतल असम अग्लो_होचो
उक्त: उक्‍त भनिएको बताइएको वर्णन_गरिएको
उगा: बिनासित्ति अकारण
उघड_झालेला: प्रकट उजागर प्रस्फुटित प्रस्फुट
उघडा: खुला उघारो उदाङ्गो खुल्ला मुक्त
उघडानागडा: नाङ्गो नग्न निर्वस्त्र
उचित: उचित उपयुक्‍त ठिक उचित समुचित उपयुक्त ठिक सही विहित विहित अनिषिद्ध अप्रतिबन्धित अप्रतिबंधित अवर्जित निषेधहीन अटोक अप्रतिसिद्ध अबाध
उच्च: अग्लो उच्च
उच्चकुलीन: अभिजात अभिजात्य उच्च_वंशीय उच्च_कुलीन
उच्चारित: उच्चारित उच्चरित
उच्छिष्ट: जुठो उचछिष्ट
उजळ: तेजोमण्डित तेजपूर्ण कान्तिमान जाज्वल्यमान प्रकाशमान दिव्य चम्किलो उज्ज्वल उज्जवल सफा स्वच्छ गोरो श्वेत
उजवा: दाहिने दायाँ
उजाड: वनस्पतिहीन शस्यहीन
उज्ज्वल: तेजोमण्डित तेजपूर्ण कान्तिमान जाज्वल्यमान प्रकाशमान दिव्य चम्किलो प्रकाशित उज्यालो चहकिलो
उज्ज्वलित: तेजोमण्डित तेजपूर्ण कान्तिमान जाज्वल्यमान प्रकाशमान दिव्य चम्किलो प्रकाशित उज्यालो चहकिलो
उज्वल: उज्ज्वल उज्जवल सफा स्वच्छ
उडाऊ: अपव्ययी खर्चिलो फिजुलखर्ची व्ययशील अतिव्ययी अति-व्ययी व्ययी
उडाणटप्पू: घुमक्कड घुमन्ते पर्यटनप्रिय यायावर घुम्ने भ्रमणशील भ्रमणीय अतिचारी अध्वगामी गश्ती भ्रमणप्रेमी भ्रमण-प्रेमी अकर्मण्य निकम्मा बेकार फालतू अकर्मा नालायक ना-लायक अनलायक_नालायक ना-लायक
उतराई: ऋणमुक्‍त
उताणा: सिधा सीधा उत्तानो सोझो
उतावळा: हतारे
उतावीळ: आतुर अधीर कातर व्याकुल बेचैन विकल अधैर्य अधैर्यवान् अधैर्यवान अधैर्यवान् अभिभूत क्षुब्ध हतारे
उत्कंठित: आतुर अधीर कातर व्याकुल बेचैन विकल अधैर्य अधैर्यवान् अधैर्यवान अधैर्यवान् अभिभूत क्षुब्ध
उत्कर्षप्रद: उन्नतिकारी उत्कर्षकारी उन्नायक उन्नतकारी
उत्कृष्ट: उत्तम उत्कृष्ट अनमोल श्रेष्ठ प्रशस्त
उत्खनक: उत्खनक
उत्खाता: उत्खनक
उत्तम: उत्तम उत्कृष्ट अनमोल श्रेष्ठ प्रशस्त
उत्तरकालीन: उत्तर_कालीन उत्त्रवर्ती
उत्तरदायी: उत्तरदायी उत्तरदायक जवाबदेह ज़िम्मेदार जिम्मेदार
उत्तीर्ण: उत्तीर्ण पास
उत्तुंग: अग्लो उच्च
उत्तेजक: उत्तेजक उत्तेजनाप्रद भडकाउ भडकदार
उत्पादक: उत्पादन_गर्ने उत्पादक
उत्पादित: उत्पन्न उत्पादित पैदा-भएको
उत्सर्जित: त्यागिएको उत्सर्जित
उत्साहपूर्ण: उत्साहपूर्ण उमङ्गपूर्ण
उत्साही: उत्साहपूर्ण उमङ्गपूर्ण
उत्सुक: आतुर अधीर कातर व्याकुल बेचैन विकल अधैर्य अधैर्यवान् अधैर्यवान अधैर्यवान् अभिभूत क्षुब्ध
उथळ: छिपछिपे
उदरीय: पेटको पेटे उदरीय भुँडीको
उदात्त: महान ठुला श्रेष्ठ
उदार: दानी दाता दानशील
उदास: हताश निराश खिन्न उद्विग्न हताश_भएको डराएको उदास खिन्न म्लान अन्यमनस्क अन्यमन विरक्त अप्रसन्न अभितप्त
उदासीन: अनासक्त अलिप्त निर्लिप्त मायारहित मायाशून्य अमुग्ध उदास खिन्न म्लान अन्यमनस्क अन्यमन विरक्त अप्रसन्न अभितप्त विरक्त विमुख बैरागी वैरागी विरागी सन्यासी सन्यासी सन्नासी रागहीन
उदित: उदित झुल्किएको
उद्दाम: धृष्ट उच्छृङ्खल ढीठ निडर उद्धत
उद्दिष्ट: सम्बोधित सम्बोध्य
उद्देशिलेले: सम्बोधित सम्बोध्य
उद्धट: धृष्ट उच्छृङ्खल ढीठ निडर उद्धत
उद्धृत: अभिदिष्ट
उद्ध्वस्त: नष्ट चौपट तहस-नहस ध्वस्त समाप्त बरबाद बर्बाद ध्वंसित अपध्वस्त विनष्ट निकंदन चकनाचुर
उद्भवित: परिणामी
उद्यमशील: प्रयत्नशील प्रयासशील प्रयासी प्रयत्नी प्रयत्नवान उद्यमी उद्यमशील उद्योगी
उद्यमी: प्रयत्नशील प्रयासशील प्रयासी प्रयत्नी प्रयत्नवान उद्यमी उद्यमशील उद्योगी
उद्योगशील: प्रयत्नशील प्रयासशील प्रयासी प्रयत्नी प्रयत्नवान उद्यमी उद्यमशील उद्योगी
उद्योगी: प्रयत्नशील प्रयासशील प्रयासी प्रयत्नी प्रयत्नवान उद्यमी उद्यमशील उद्योगी
उद्विग्न: उद्विग्न हताश_भएको डराएको
उधळखोर: अपव्ययी खर्चिलो फिजुलखर्ची व्ययशील अतिव्ययी अति-व्ययी व्ययी
उधळमांडक्या: अपव्ययी खर्चिलो फिजुलखर्ची व्ययशील अतिव्ययी अति-व्ययी व्ययी
उधळलेला: ध्वस्त बिग्रेको भत्केको नष्‍टभ्रष्‍ट बर्बाद बिनष्ट नाश
उधळ्या: अपव्ययी खर्चिलो फिजुलखर्ची व्ययशील अतिव्ययी अति-व्ययी व्ययी अपव्ययी खर्चालु फिजुलखर्ची
उध्वस्त: ध्वस्त बिग्रेको भत्केको नष्‍टभ्रष्‍ट
उनाड: घुमक्कड घुमन्ते पर्यटनप्रिय यायावर घुम्ने भ्रमणशील भ्रमणीय अतिचारी अध्वगामी गश्ती भ्रमणप्रेमी भ्रमण-प्रेमी
उनाडटप्पू: घुमक्कड घुमन्ते पर्यटनप्रिय यायावर घुम्ने भ्रमणशील भ्रमणीय अतिचारी अध्वगामी गश्ती भ्रमणप्रेमी भ्रमण-प्रेमी
उन्नत: अग्लो उच्च
उन्नतिकारक: उन्नतिकारी उत्कर्षकारी उन्नायक उन्नतकारी
उन्मत्त: गर्विलो गर्वी अभिमानी अहङ्कारी घमण्डी
उन्मळून_पडणारा: उत्खाता
उन्हात_शिजवलेला: आफताबी
उपकर्ता: उपकारी उपकर्ता उपकर्त्ता उपकारक उपकार_कर्त्ता उपकार_कर्ता अनुग्राहक अनुग्राही सहयोगी मदतगार सहायक
उपकारक: कल्याणकारी मङ्गलकारी कल्याणप्रद मङ्गलकारक मङ्गलदायक मङ्गलप्रद हितकारी हितकर हितकारक कल्याणमय अनुकूल सहयोगी मदतगार सहायक
उपकारकर्ता: उपकारी उपकर्ता उपकर्त्ता उपकारक उपकार_कर्त्ता उपकार_कर्ता अनुग्राहक अनुग्राही
उपजत: स्वाभाविक स्वभावगत
उपडा: उल्टो अधोमुख
उपद्रवी: उपद्र्याहा बदमाश छुचो
उपभोग्य: सेवनीय सेव्य सेवित उपभोग्य उपभोज्य
उपयुक्त: उपयोगी लाभदायक फाइदाकारी प्रभावशाली प्रभावकारी
उपयोगी: उपयोगी लाभदायक फाइदाकारी
उपलब्ध: उपलब्ध प्राप्त लब्ध अधिगत
उपस्थित: उपस्थित हाजिर विद्यमान प्रस्तुत
उपाय_नसलेला: उपायहीन विकल्पहीन
उपायरहित: विकल्पहीन उपायहीन निरुपाय विवश अनन्यगति अनन्यगतिक
उपायशून्य: अप्रतिकार
उपेक्षणीय: उपेक्ष्य उपेक्षणीय
उपेक्षित: उपेक्षित तिरस्कृत अनादृत अनादरित उपेक्षित
उपेक्ष्य: उपेक्ष्य उपेक्षणीय
उफराटा: विपरीत उल्टो विरुद्ध
उबदार: तातो न्यानो
उभयचर: उभयचर जल-स्थलचर जलथली
उभा: सोझो सीधा जम्मा सारा सबै समस्त सम्पूर्ण तमाम
उमललेला: पुष्पित फुलेको कुसुमित खिला प्रफुल्लित प्रफुलित स्मित विकसित
उरलेला: उब्रेको बचेको बचेखुचेको
उरलेली: रहल शेष बाँकी
उर्मट: धृष्ट उच्छृङ्खल ढीठ निडर उद्धत
उर्वरित: उब्रेको बचेको बचेखुचेको रहल शेष बाँकी
उलटा: उल्टो अधोमुख
उलथा: सिधा सीधा उत्तानो सोझो
उल्लंघित: उल्लङ्घित
उल्लेखनीय: उल्लेखनीय उल्लेखयोग्य उल्लेख्य
उल्लेखित: उल्लेखित कथित लिखित
उल्हासपूर्ण: आनन्दपूर्ण आनन्दमय उल्लासपूर्ण सानन्द
उल्हासमय: आनन्दपूर्ण आनन्दमय उल्लासपूर्ण सानन्द
उष्टा: जुठो उचछिष्ट
उष्ण: तातो गर्मी उष्ण
उष्म: तातो गर्मी उष्ण
ऊन: तातो गर्मी उष्ण
ऋण: ऋणात्मक
ऋणबांधी: अप्रतिकार
ऋणमुक्त: ऋणमुक्‍त
ऋणात्मक: ऋणात्मक
ऋणी: कृतज्ञ आभारी धन्यवादी उपकृत अनुगृहीत ऋणी कर्जदार ऋणकर्ता
ऋतुमती: रजस्वला ऋतुमती रजवती पुष्पवती
ऋतुस्नात: रजस्वला ऋतुमती रजवती पुष्पवती
एक: एक १
एक_तृतीयांश: तीनभाग
एक_दोन: एक_दुई एक्का_दुक्का
एककालीन: समसामयिक
एकचएक: एकमात्र एउटा_मात्र
एकटा: एक्लो एक्लै
एकटादुकटा: एक_दुई एक्का_दुक्का
एकतर्फी: एक_तर्फफो एकपक्षीय एकतर्फी एकपक्षको एकलकाटे
एकतिसावा: एक्काइसौँ
एकतीस: एकतीस ३१
एकत्र: एकत्रित एकट्ठा एकत्र जमा समग्रीकृत
एकत्रित: एकत्रित एकट्ठा एकत्र जमा समग्रीकृत
एकदिशीय: एकतर्फी वान_वे
एकद्वितीयांश: आधा अर्द्ध पचास_प्रतिशत अर्ध अद्ध
एकनिष्ठ: अनन्य एकनिष्ठ
एकरूप: समान तुल्य सदृश बराबर एकनासे समान तुल्य
एकलकोंडा: अमिलनसार बाउँठे एकलकाटे
एकवंशीय: वंशीय
एकविसावा: एक्काइसौँ २१
एकवीस: एक्काइस २१
एकसंध: एकतापूर्ण सौहार्दपूर्ण संगठित सङ्गठित
एकसमान: प्रतिरूपी अनुरूपी समरूपी
एकसष्ठ: एकसट्ठी एकसठ
एकसष्ठावा: एकसट्ठीऔं
एकसारखा: प्रतिरूपी अनुरूपी समरूपी एकनासे समान तुल्य
एकाकी: एक्लो एक्लै
एकादश: एघार एकादश ११
एकावंशांतील: वंशीय
एकावन्न: एकाउन्न एकाउन
एकावन्नावा: एकाउन्नौं
एकाहत्तर: एकहत्तर
एकाहत्तरावा: एकहत्तरौं
एकीकृत: एकीकृत एकीकरण
एकीभूत: एकीकृत एकीकरण
एकुणअशी: उनासी उन्यासी ७९
एकुणऐंशी: उनासी उन्यासी ७९
एकुणैशी: उनासी उन्यासी ७९
एकुलता: एकमात्र एउटा_मात्र
एकुलताएक: एकमात्र एउटा_मात्र
एकेक: प्रत्येक सबै
एकेचाळ: एकचालीस
एकेचाळावा: एकचालीसौँ
एकेचाळिसावा: एकचालीसौँ
एकेचाळीस: एकचालीस
एकेताळ: एकचालीस
एकेताळीस: एकचालीस
एकेरी: एकसरो
एकेहत्तर: एकहत्तर
एकेहात्तर: एकहत्तर
एकोणचाळिसावा: उनन्चालीसौँ
एकोणचाळीस: उनन्चालीस
एकोणतिसावा: उनन्तीसौँ
एकोणतीस: उनन्तीस २९
एकोणनव्वद: उनासी
एकोणनव्वदावा: उनानब्बेऔं
एकोणपन्नास: उनन्चास ४९
एकोणपन्नासावा: उनञ्चासौँ
एकोणसत्तर: उनन्सत्तरी ६९
एकोणसाठ: उनसट्ठी ५९
एकोणसाठावा: उन्साठीऔं उनन्साठीऔं
एकोणिसावा: उन्नाइसौँ १९_औं 19औं
एकोणीस: उन्नाइस १९
एक्याण्णव: एकानब्बे
एक्याण्णवावा: एकानब्बेऔं
एवढा: यत्रो
ऐंशी: असी ८०
ऐंशीवा: अस्सीऔं असिऔं
ऐच्छिक: वैकल्पिक विकल्पयुक्त विकल्पी ऐच्छिक ऐच्छिक
ऐटबाज: अकडो
ऐश्वर्यदायी: समृद्धिप्रद ऐश्वर्यप्रद समृद्धिदायक ऐश्वर्यप्रदायक
ऐश्वर्यपूर्ण: धाकिलो धाके
ऐश्वर्यप्रद: समृद्धिप्रद ऐश्वर्यप्रद समृद्धिदायक ऐश्वर्यप्रदायक
ऐश्वर्यसंपन्न: धाकिलो धाके
ऐहिक: इहलौकिक सांसारिक लौकिक
ऑस्ट्रियन: आस्ट्रियाई आस्ट्रिआई आस्ट्रियन आस्ट्रियाई आस्ट्रिआई
ऑस्ट्रेलियाई: अस्ट्रेलियाई
ऑस्ट्रेलियायी: अस्ट्रेलियाई
ओजस्वी: तेजस्वी ओजस्वी तेजवन्त तेजवान कान्तिवान्
ओडिसी: उडिया उडिया ओडिया
ओणवा: निहुरिएको नत
ओतीव: ढलुवा
ओबडधोबड: कुगठित कुडौल बान्की_नपरेको
ओरिसी: उडिया उडिया ओडिया
ओला: भिजेको
ओळखीचा: परिचित चिनेजानेको जानपहिचान_भएको परिचय_भएको
औक्षवंत: चिरञ्जीव चिरञ्जीवी चिरजीवी दीर्घजीवी दीर्घायु आयुष्मान चिरायु
औक्षवान: चिरञ्जीव चिरञ्जीवी चिरजीवी दीर्घजीवी दीर्घायु आयुष्मान चिरायु
औपचारिक: देखावटी बनावटी बोक्रे बनौटी घोरेलको
कंजूष: लोभी कन्जुस कन्चुस
कंजूस: लोभी कन्जुस कन्चुस
कंटाळवाणा: अरोचक अरुचिकर नीरस रसहीन रुचिहीन फीका असार
कंठगत: कण्ठस्थ मुखाग्र
कंठस्थ: कण्ठस्थ मुखाग्र
कंपायमान: थर्किइरहेको कम्पित कम्पायमान
कंपित: थर्किइरहेको कम्पित कम्पायमान
कःपदार्थ: नगण्य यस्तो-उस्तो अगण्य अनुदात्त
कच्चा: सिकारू काँचो कच्चा नव_प्रशिक्षित नयाँ असिद्ध अनभ्यस्त अपक्व अपरिपक्क काँचो नपाकेको अनुभवहीन काँचो कच्चा अल्हरे स्वाँठ कमजोर दुर्बल निम्छरो काँचो अधकल्चो आधा_पाकेको अशोधित अपरिशोधित अशुद्ध असंशोधित काँचो
कजाग: कर्कशा रिसाहा उग्रा झगडालु चण्डी चण्डिका
कटू: तितो दुखद दुखदायी दुखप्रद
कठीण: कठिन दुर्गम अगम्य अगम दुरूह दुर्गम्य अगत आगम दुष्कर दुःसाध्य दुःखसाध्य कष्‍टसाध्य कठिन विकट मुश्‍किल सारो कठिन गाह्रो अप्ठयारो मुस्किल कडा कठोर साह्रो
कठोर: क्रूर निर्दय कठोर निर्दयी निष्ठुर नृशंस करुणाहीन दयारहित दयाहीन उग्र करुणाविहीन अदयालु
कडक: कडा उग्र
कडवट: तितो
कडवा: तितो
कडा_असलेला: किनारा_भएको
कडू: तितो
कडूजहर: धेरै_तितो अति_कटु
कडूविख: धेरै_तितो अति_कटु
कडूविख्ख: धेरै_तितो अति_कटु
कणदार: कनिका मोटो
कथित: उल्लेखित कथित लिखित
कथ्य: भनिने कथनीय कथ्य वाच्य अभिभाष्य वक्तव्य
कद्रू: लोभी कन्जुस कन्चुस
कनवाळू: स्नेही दयालु
कनिष्ठ: कनिष्ठ कान्छो कान्छी
कन्नड: कन्नड
कपटयुक्त: कपटपूर्ण छलपूर्ण कपटमय छलमय छद्मपूर्ण धूर्ततापूर्ण कुटिल वक्र टेढा अरालटेढो बाङ्गो बाउँठो
कपटी: दुराशय कुविचारी आरिसे धोकाबाज बेइमानी_गर्ने धूर्त कपटी छली कपटपूर्ण छलपूर्ण कपटमय छलमय छद्मपूर्ण धूर्ततापूर्ण कुटिल वक्र टेढा अरालटेढो बाङ्गो बाउँठो
कपडे_घातलेला: वस्त्रधारी वस्त्र-धारी
कपोलकल्पित: कपोल_कल्पित मनगढन्त हावा कपोलकल्पित
कमअस्सल: अकुलीन पानी_नचल्ने अछुत निम्न_वंशीय
कमकुवत: कमजोर दुर्बल अशक्‍त
कमजात: अकुलीन पानी_नचल्ने अछुत निम्न_वंशीय
कमजोर: कमजोर दुर्बल निम्छरो
कमनशिबी: दुर्भाग्यशाली अभागी भाग्यहीन
कमनीय: सुडौल सुगठित बान्की_परेको
कमाल: अधिकतम सर्वाधिक सबैभन्दा_बढी
कमावलेला: अर्जित कमाएको व्यायामी
कमी: अपर्याप्त अपूर्ण अपरिपूर्ण कम्ती अलिकति अल्प
कम्युनिस्ट: साम्यवादी कम्युनिस्ट
करंटा: दुर्भाग्यशाली अभागी भाग्यहीन
करपात्र: कराधीन करयुक्त
करमुक्त: कर_मुक्त अकर_शुल्क_मुक्त
करोड: कडोर कोटी_१००००००० 10000000
कर्जमुक्त: ऋणमुक्‍त
कर्णबधिर: बहिरो बैह्रो बधिर
कर्ता: कर्त्ता कर्ता कर्तार सृजनकर्ता सर्जक सृजक रचयिता स्रष्टा
कर्नाटक: कन्नड
कर्नाटकी: कन्नड
कर्मठ: कर्मठ कर्मनिष्ठ कर्मी
कर्मनिष्ठ: कर्मठ कर्मनिष्ठ कर्मी
कलंकित: लाञ्छित कलङ्कित कलुषित दागी बदनामी
कलंकी: लाञ्छित कलङ्कित कलुषित दागी बदनामी
कलमी: कलमी कलम_काटेको
कलात्मक: कलापूर्ण कलात्मक कलामय
कल्पित: काल्पनिक कल्पित अवास्तविक अयथार्थ अनात्मक अप्रकृत अयथातथ अयाथार्थिक
कल्याणकारी: कल्याणकारी मङ्गलकारी कल्याणप्रद मङ्गलकारक मङ्गलदायक मङ्गलप्रद हितकारी हितकर हितकारक कल्याणमय अनुकूल
कळाहीन: म्लान न्याउरो न्यास्रो रगतहीन निस्तेज आभाहीन कांतिहीन ओजहीन प्रभाहीन बेरौनक अप्रभ प्रभारहित श्रीहत
कवचधारी: कवचधारी कवचयुक्‍त आवरणयुक्‍त
कवचहीन: कवचहीन
कवडीचुंबक: लोभी कन्जुस कन्चुस
कश्मीरी: कश्मीरी
कष्टाळू: परिश्रमी मेहनती उद्यमी कर्मशील पुरूषार्थी
कष्टी: दुखी पीड़ित व्यथित दुःखी आर्त दुखित
कसबी: सिपालु प्रवीण निपुण पारङ्गत दक्ष माहिर अभ्यस्त कुशल होशियार पक्का सिद्धहस्त शातिर पटु पका निष्णात परिपक्व कार्यकुशल विचक्षण अभिज्ञ अभ्यासी आप्त
कसलेला: पोटिलो खँदिलो भरिलो मोटो दह्रो;
कांतिमान: तेजोमण्डित तेजपूर्ण कान्तिमान जाज्वल्यमान प्रकाशमान दिव्य चम्किलो प्रकाशपूर्ण दीप्तिपूर्ण प्रकाशमान आलोकित ज्योतित
कांतिहीन: रगतहीन निस्तेज आभाहीन कांतिहीन ओजहीन प्रभाहीन बेरौनक अप्रभ प्रभारहित श्रीहत
कागदाचा: कागजको
कागदी: कागजको
काटकसरी: मितव्ययी
काटकुळा: दुब्लो सिकुटे खिनाउटे
काटेरी: काँढे कण्टकयुक्त कंटकित
काठ_असलेला: किनारा_भएको
काडीपैलवान: अति_क्षीणकाय
कातर: आतङ्कित त्रस्त सन्त्रस्त
कानडी: कन्नड
कापरा: थर्किइरहेको कम्पित कम्पायमान
कापराचा: कपुरे कपुरी
कापराच्या_रंगाचा: कपुरी कपुरे
कापराच्या_वासासारखा: कपुरी
कापलेला: छिनेको काटिएको टुक्रिएको
काबील: योग्य उपयुक्‍त समर्थ सक्षम खाइलाग्दो
काबुली: काबुली काबुली
कामचुकवू: अल्छी जाँगरहीन
कामचुकव्या: अल्छी जाँगरहीन
कामचुकार: अल्छी जाँगरहीन
कामचुकारू: अल्छी जाँगरहीन
कामचोर: अल्छी जाँगरहीन
कामरहित: कामहीन वासनाहीन निष्काम निर्मम
कामसू: कर्मनिष्ठ कर्मठ कर्मी परिश्रमी मेहनती उद्यमी कर्मशील पुरूषार्थी कर्मी कामकाजी काम-काजी कारबारी उद्योगी अभिक्रान्ती
कामहीन: कामहीन वासनाहीन निष्काम निर्मम
कामाचा: उपयोगी लाभदायक फाइदाकारी
कामी: कामुक विलासी विषयी भोगी कामचारी इन्द्रियलोलुप व्यभिचारी कामुक दुश्चरित
कामुक: कामुक विलासी विषयी भोगी कामचारी इन्द्रियलोलुप व्यभिचारी कामुक दुश्चरित
कायदेविषयक: कानुनी
कायदेशीर: वैध कानूनी ऐन_अनुसार
कायमचा: स्थायी
कायमची: स्थायी स्थाइ
कायमस्वरुपी: अमिट नमेटिने
कार्यभूत_झालेला: परिणामी
कार्यरत: जुटेको लागेको_कार्यरत
कार्यालयीन: कार्यालयीय
काल्पनिक: काल्पनिक कल्पित अवास्तविक अयथार्थ अनात्मक अप्रकृत अयथातथ अयाथार्थिक
काळजीमुक्त: निश्चिन्त चिन्तारहित चिन्ताहीन चिन्तामुक्त
काळा: कालो अध्याँरो कृष्ण श्याम अश्‍वेत कालो
काळाकभिन्न: कालो-डिङ्गर अति_श्याम गहिरो_कालो
काळाकिट्ट: कालो-डिङ्गर अति_श्याम गहिरो_कालो
काळाकुट्ट: कालो-डिङ्गर अति_श्याम गहिरो_कालो
काळाकुळकुळीत: कालो-डिङ्गर अति_श्याम गहिरो_कालो
काळाजर्द: कालो-डिङ्गर अति_श्याम गहिरो_कालो
काळाजहर: कालो-डिङ्गर अति_श्याम गहिरो_कालो
काळाठिक्कर: कालो-डिङ्गर अति_श्याम गहिरो_कालो
काळाढुस्स: कालो-डिङ्गर अति_श्याम गहिरो_कालो
काळाढोंण: कालो-डिङ्गर अति_श्याम गहिरो_कालो
काळाभोर: कालो-डिङ्गर अति_श्याम गहिरो_कालो
काळाशार: कालो-डिङ्गर अति_श्याम गहिरो_कालो
कावेबाज: दुराशय कुविचारी आरिसे
काव्यात्मक: काव्यात्मक कवित्वपूर्ण रसात्मक
काश्मीरी: कश्मीरी कश्मीरी
काही: अलिकति केही थोरै
किंचित: कम्ती अलिकति अल्प
किंचितसा: कम्ती अलिकति अल्प
किंमती: बहुमूल्य मूल्यवान अमूल्य अनमोल दामी महँगो मङ्गो दामी मूल्यवान
किडकिडीत: दुब्लो लुते क्षीण
किती: कति
कितीतरी: अनेक कैयौं विविध नाना एकाधिक अनेकानेक तमाम
कित्येक: अनेक कैयौं विविध नाना एकाधिक अनेकानेक तमाम
किफायतशीर: लाभदायक लाभप्रद लाभकर लाभकारी लाभजनक गुणकारी उपयोगी हितकारी अर्थकर
किमती: बहुमूल्य मूल्यवान अमूल्य अनमोल दामी
किरकोळ: दुब्लो सिकुटे खिनाउटे छिटपुट छुटपुट छिट-पुट छुट-पुट हल्का-फुल्का खुद्रा_सामान फुटकर_सामान
किसमिशी: किसमिसे किसमिसी
किसमिशीची: किसमिसे किसमिसी
कुख्यात: कुख्यात बदनाम दुर्नाम
कुजका: कुहिएको गलेको सडेको
कुटुंब_नसलेला: परिवारहीन कुटुम्बहीन
कुटुंबवत्सल: परिवारयुक्त कुटुम्बयुक्त
कुटुंबविषयक: पारिवारिक घरेलु
कुटुंबहीन: परिवारहीन कुटुम्बहीन
कुटुंबाचा: पारिवारिक घरेलु
कुटुंबाविषयीचा: पारिवारिक घरेलु
कुटुंबाशी_संबंधित: पारिवारिक घरेलु
कुटुंबासंबंधीचा: पारिवारिक घरेलु
कुत्सिक: घटिया निकृष्ट नीच अधम क्षुद्र निकृष्टतम अधमाधम तुच्छातितुच्छ
कुपथ्य: नपच्ने कुपथ्य अपच्य
कुपित: रिसाएको झोकिएको क्रुद्ध
कुपोषित: कुपोषित
कुप्रसिद्ध: कुख्यात बदनाम दुर्नाम
कुबडा: कुँजो कुब्ज
कुबड्या: कुँजो कुब्ज
कुरूप: कुरूप नराम्रो विरूप
कुर्रेबाज: अकडो
कुलवंत: कुलीन घरानियाँ खानदानी
कुलवान: कुलीन घरानियाँ खानदानी
कुलहीन: अकुलीन पानी_नचल्ने अछुत निम्न_वंशीय
कुलीन: अभिजात अभिजात्य उच्च_वंशीय उच्च_कुलीन कुलीन घरानियाँ खानदानी
कुविचारी: दुराशय कुविचारी आरिसे
कुशल: सिपालु प्रवीण निपुण पारङ्गत दक्ष माहिर अभ्यस्त कुशल होशियार पक्का सिद्धहस्त शातिर पटु पका निष्णात परिपक्व कार्यकुशल विचक्षण अभिज्ञ अभ्यासी आप्त
कुशाग्र: तीक्ष्ण तीव्र कुशाग्र प्रखर तेज अकुण्ठ अकुंठित अकुन्ठित विषम
कुशाग्रबुद्धी: तीक्ष्णबुद्धि तीखो_बुद्धि प्रखरबुद्धि
कुशाग्रमती: तीक्ष्णबुद्धि तीखो_बुद्धि प्रखरबुद्धि
कूट: अप्ठ्यारो कठिन सारो मुश्किल
कृत: निर्मित रचित विरचित सृष्ट कृत सर्जित सृजित संरचित पर्णीत प्रकृत प्रणीत
कृतकृत्य: कृतार्थ कृतकृत्य
कृतघ्न: कृतघ्न अकृतज्ञ
कृतज्ञ: कृतज्ञ आभारी धन्यवादी उपकृत अनुगृहीत
कृतार्थ: कृतार्थ कृतकृत्य
कृत्रिम: देखावटी नकली बनावटी बनौटी कृत्रिम अप्रकृत अयाथार्थिक मानवकृत मानव-रचित मानव-कृत मानवनिर्मित मानव-निर्मित मानव_निर्मित कृत्रिम
कृपण: लोभी कन्जुस कन्चुस
कृपाळू: दयालु कृपालु दयावन
कृपावंत: दयालु कृपालु दयावन
कृश: दुब्लो लुते क्षीण
कृष्ण: कालो अध्याँरो कृष्ण श्याम
कॅथलिक: केथोलिक
केंद्रित: केन्द्रित केन्द्रिभूत
केरळचा: मलयाली
केरळाचा: मलयाली
केरळी: मलयाली
केरळीय: मलयाली
केलेला: कृत निष्पन्न निष्पादित
केवढा: कति
कैक: अनेक कैयौं विविध नाना एकाधिक अनेकानेक तमाम
कैवारी: पक्षधर पक्षपाती समर्थक अनुमोदक
कोंकणी: कोङ्कणी कोङ्कनी
कोकणी: कोङ्कणी कोङ्कनी कोङ्कणी कोङ्कनी कोङ्कणी कोङ्कनी
कोटी: कडोर कोटी_१००००००० 10000000
कोठोर: अनम्य अनमनीय कठोर दृढ
कोडगा: निर्लज्ज लज्जाहीन छाडा
कोपायमान: रिसाएको झोकिएको क्रुद्ध
कोपाविष्ट: रिसाएको झोकिएको क्रुद्ध
कोपित: रिसाएको झोकिएको क्रुद्ध
कोमल: नरम कमलो कोमल
कोमल_स्वभावाचा: सौम्य कोमल_स्वभावी सौम
कोमलांगी: कोमलाङ्गिनी कोमलांगना कोमलाङ्गी
कोमेजलेला: म्लान न्याउरो न्यास्रो ओइलाएका
कोरडा: पञ्चभुज पञ्चभुजा सुक्खा सुकेको निर्जल अजल जलहीन जलरहित
कोरा: सादा सेतो कोरा अप्रयुक्त अव्यवहृत
कोरियन: कोरियाको कोरियन कोरियाई कोरियन
कोरियाई: कोरियाको कोरियन कोरियाई कोरियन
कोरीव: नक्कासीदार
कोलंबियाई: कोलम्बी
कोलंबियायी: कोलम्बी
कौटुंबिक: पारिवारिक घरेलु
क्रमवार: क्रमिक अनुक्रमिक क्रमबद्ध विन्यस्त क्रमानुसार क्रमानुकूल शृङ्खलाबद्ध अनुपूर्व
क्रमानुवर्ती: धारावाहिक धारावाही धाराप्रवाह निरन्तर एकोहोरो
क्रमाने_येणारा: धारावाहिक धारावाही धाराप्रवाह निरन्तर एकोहोरो
क्रमाने_लगेचचा: धारावाहिक धारावाही धाराप्रवाह निरन्तर एकोहोरो
क्रमाने_शेजारचा: धारावाहिक धारावाही धाराप्रवाह निरन्तर एकोहोरो
क्रमिक: धारावाहिक धारावाही धाराप्रवाह निरन्तर एकोहोरो
क्रुद्ध: रिसाएको झोकिएको क्रुद्ध
क्रूर: क्रूर निर्दय कठोर निर्दयी निष्ठुर नृशंस करुणाहीन दयारहित दयाहीन उग्र करुणाविहीन अदयालु
क्रोएशियन: क्रोएसियाई क्रोएशिआई क्रोएशियन क्रोएसियाई क्रोएसिआई
क्रोएशियाई: क्रोएसियाई क्रोएशिआई क्रोएशियन क्रोएसियाई क्रोएसिआई
क्रोधायमान: रिसाएको झोकिएको क्रुद्ध
क्लांत: थाकेको थकित क्लान्त क्लांत परिश्रांत
क्लिष्ट: दुर्ग्राह्य दुर्ग्रह दुर्ग्राही दुर्ज्ञेय दुर्बोध
क्षम्य: माफ माफी क्षमा छुट मिनाहा क्षम्य क्षमा_योग्य मर्षणीय
क्षयरोगी: क्षयी
क्षर: नश्वर अशाश्वत क्षणजीवी क्षयशील नाशवान भंगुर विनाशी अनित्य मेटिने नाशुक अनित
क्षीण: हड्डीछाला अस्थिमय
क्षुद्र: नगण्य यस्तो-उस्तो अगण्य अनुदात्त
क्षुधित: भोको भोकाएको
क्षुल्लक: नगण्य यस्तो-उस्तो अगण्य अनुदात्त
क्षेपक: क्षेपक
क्षेप्ता: क्षेपक
खंक: निर्धन गरीब दरिद्र
खंडन_करणारा: खण्डक खण्डनकर्ता
खटारा: थोत्रो पूरानो
खट्याळ: चकचके चञ्‍चल चुलबुले
खडकाळ: सङ्गीन पत्थर_निर्मित
खडतर: कठिन दुर्गम अगम्य अगम दुरूह दुर्गम्य अगत आगम
खडबडीत: खस्रो रूखो असमान असमतल
खणक: उत्खनक
खणणारा: उत्खनक
खनिज: खनिज
खपती: परिश्रमी मेहनती उद्यमी कर्मशील पुरूषार्थी
खरखरीत: खस्रो रूखो असमान असमतल
खरबरीत: खस्रो रूखो असमान असमतल
खरा: राम्रो शुद्ध चोखो असल वास्तविक यथार्थ साँचो सही असली वास्तव अकाल्पनिक अकल्पित प्रकृत प्राकृतिक साँचो सत्य यथार्थ
खराखुरा: वास्तविक यथार्थ साँचो सही असली वास्तव अकाल्पनिक अकल्पित प्रकृत प्राकृतिक
खराब: नराम्रो खराब निकृष्ट अनुचित दूषित दोषयुक्त ख़राब
खरे: खारिएको असली शुद्ध राम्रो खोटहीन विशुद्ध
खरेदी_केलेला: किनेको
खरोखरीचा: वास्तविक यथार्थ साँचो सही असली वास्तव अकाल्पनिक अकल्पित प्रकृत प्राकृतिक
खर्चक: अपव्ययी खर्चिलो फिजुलखर्ची व्ययशील अतिव्ययी अति-व्ययी व्ययी
खर्चाळू: अपव्ययी खर्चिलो फिजुलखर्ची व्ययशील अतिव्ययी अति-व्ययी व्ययी
खर्चीक: अपव्ययी खर्चिलो फिजुलखर्ची व्ययशील अतिव्ययी अति-व्ययी व्ययी
खल: दुष्ट दुर्जन अधम खल शठ हरामी पाजी अमति कुमति पामर अशील असज्जन असाधु असित
खलास: समाप्त सम्पूर्ण निष्पादित पूरा सम्पादित संपादित पूर्ण सम्पन्न संपन्न सम्पन्न
खवय्या: स्वादे चखुवा
खवळलेला: धेरै_क्रुद्ध अत्युग्र
खाकी: माटो_रङ खाकी खैरो
खाजगी: निजी आफ्नो स्वकीय स्वायत्त आत्म वैयक्तिक व्यक्तिगत निजी आफ्नो व्यक्तिगत गुप्त अप्रत्यक्ष अप्रकाश अप्रकाशित अप्रकाशमान अप्रथित अभिगुप्त
खाण्याजोगा: खाद्य भोज्य आहार्य ग्राह्य भक्ष्य अशनीय
खात्रीलायक: विश्वासिलो विश्वसनीय विश्वासपात्र विश्वस्त विश्वासी पत्याउरो
खादाड: पेटु खन्चुवा घिचासे घिचुवा भाते
खाद्य: खाद्य भोज्य आहार्य ग्राह्य भक्ष्य अशनीय
खानदानी: अभिजात अभिजात्य उच्च_वंशीय उच्च_कुलीन
खाबडखुबड: असमतल असम अग्लो_होचो
खारट: नुनीलो
खारे: नुनीलो
खालचा: निम्न तल्लो
खालच्या_वर्गाचा: निम्न_कुलीन निम्न_वंशीय
खालील: निम्नलिखित
खाल्लेला: खाएको भक्षित
खास: विशेष खास खासा असामान्य असाधारण खास विशेष यस्तो-उस्तो जस्तो-त्यस्तो अपसामान्य स्पेसल
खासगी: निजी आफ्नो स्वकीय स्वायत्त आत्म वैयक्तिक व्यक्तिगत निजी आफ्नो व्यक्तिगत गुप्त अप्रत्यक्ष अप्रकाश अप्रकाशित अप्रकाशमान अप्रथित अभिगुप्त
खिन्न: हताश निराश खिन्न उद्विग्न हताश_भएको डराएको उदास खिन्न म्लान अन्यमनस्क अन्यमन विरक्त अप्रसन्न अभितप्त
खिसमिशी: किसमिसे किसमिसी
खिसमिशीची: किसमिसे किसमिसी
खुजा: पुडके होचो
खुनशी: सराप हाय
खुला: खुल्ला मुक्त अगोपनीय अगोप्य प्रकट्य कथ्य प्रकाश्य
खुळचट: बौलाहा बहुला पागल
खुळा: बौलाहा बहुला पागल
खुश: प्रसन्न खुसी खुश आनन्दित पुलकित हर्षित विह्वल आह्लादित प्रफुल्ल परितुष्ट प्रफुल्लित प्रफुलित उल्लसित उल्लासित उल्लासी आनन्दी विनोदित पुलकित तुष्ट
खुशमिजाज: प्रसन्नचित्त
खुशालचेंडू: मस्त मत्त चिन्तामुक्त जवान पट्ठो आनन्दित हर्षित
खूप: अत्यधिक धेरै औधि प्रचुर अत्याधिक अनगन्ती थुप्रो भरपूर सम्पूर्ण सकेसम्म भारी भीषण घनघोर अत्याधिक
खूप_खुश: हर्षित
खूप_मोठा: भारी
खेचर: नभचर नभश्‍चर अकासगामी
खेदजनक: दुखद दुखदायी दुखप्रद
खोटा: खोटो नकली असत्य झूटो
खोटारडा: टाँट असत्यवादी अनृतभाषी असत्यभाषी मिथ्याभाषी अन्यवादी मिथ्यावादी असत्य झूटो
खोडकर: चकचके चञ्‍चल चुलबुले
खोदक: उत्खनक
खोदणारा: उत्खनक
खोल: गहिरो गहन गहिरो
ख्मेर: कम्बोडियाई कम्पुचियाई कम्बोडियन कम्पुचियन
ख्यात: प्रसिद्ध प्रख्यात ख्याति_प्राप्‍त
ख्यातनाम: प्रसिद्ध प्रख्यात ख्याति_प्राप्‍त
गंभीर: गम्भीर शान्त धीर
गगनचुंबित: गगनचुम्बी गगनभेदी अकासभेदी
गगनचुंबी: गगनचुम्बी गगनभेदी अकासभेदी
गगनभेदी: गगनभेदी आकाशभेदी
गचाळ: मैलो फहोर अशुद्ध
गच्च: सघन घना गहन सङ्घात
गजबजलेला: एकान्तरहित सुनसानहीन एकान्तहीन
गडगंज: अत्यधिक धेरै औधि प्रचुर अत्याधिक भारी भीषण घनघोर अत्याधिक
गडद: कढा चहक
गडबडलेला: सम्भ्रान्त
गढलेला: तल्लीन अनुरत निमग्न लीन तन्मय मग्न मगन दत्तचित्त लिप्त रत निरत अनुरक्त अनुसंरक्त अभिनिविष्ट
गणनीय: गणनीय गण्य
गतकालीन: प्राचीन पुरानो पूर्व-कालीन बितेको भूतकालीन अतीत_कालीन पूर्व_कालीन भूत_कालीन
गतप्राण: मरेको मृत
गतिमान: गतिशील गतिपूर्ण गतिमान चल चालू चलायमान अविराम अस्थिर अथिर अध्रुव संचारी सञ्चारी
गतिशील: गतिशील गतिपूर्ण गतिमान चल चालू चलायमान अविराम अस्थिर अथिर अध्रुव संचारी सञ्चारी
गतिहीन: गतिहीन स्थिर अचल
गदळ: मैलो फहोर अशुद्ध
गन्तव्य: गन्तव्य
गपाड्या: बकबके
गप्पिष्ट: बकबके
गप्पी: बकबके
गमतीचा: रोचक रमाइलो मजाको रङ्गीन
गमत्या: हँस्यौली विनोदी ठट्यौली
गरजवंत: अपेक्षी अपेक्षक खाँचो आवश्यक प्रयोज औचित्य अभाव
गरजू: अपेक्षी अपेक्षक खाँचो आवश्यक प्रयोज औचित्य अभाव
गरजेचा: आवश्यक जरूरी अपेक्षित अपेक्ष्य
गरजेपुरता: पर्याप्त काफी यथेष्ट चाहिएजति मनग्य पर्याप्‍त प्रशस्त
गरम: तातो न्यानो तातो गर्मी उष्ण तातो गरम
गरीब: निर्धन गरीब दरिद्र
गर्क: तल्लीन अनुरत निमग्न लीन तन्मय मग्न मगन दत्तचित्त लिप्त रत निरत अनुरक्त अनुसंरक्त अभिनिविष्ट
गर्द: सघन घना गहन सङ्घात कढा चहक
गर्विष्ठ: गर्विलो गर्वी अभिमानी अहङ्कारी घमण्डी
गर्हणीय: निन्दनीय निंदनीय निद्य निंदात्मक
गर्ह्य: निन्दनीय निंदनीय निद्य निंदात्मक
गलिच्छ: मैलो फहोर अशुद्ध
गहन: कठिन दुर्गम अगम्य अगम दुरूह दुर्गम्य अगत आगम अथाह अगाध अपार अगाध्य अनवगाह अनवगाह्य अगाह गहन गहिरो दुर्बोध्य अति_गूढ दुरूह गम्भीर अप्ठ्यारो जटिल गाह्रो
गहिरा: कढा चहक
गांजलेला: पीडित ग्रस्त ग्रसित व्यथित
गाढ: घनिष्ठ आत्मीय अन्तरङ्ग अन्तरंग गाढा अनन्य अभिन्न प्रगाढ अङ्गरङ्गी अन्तरंगी इष्ट अन्यतम
गार: चिसो ठन्डा चिसो शीतल ठण्डा अनुष्ण
गारट: चिसो शीतल ठण्डा अनुष्ण
गिड्डा: पुडके होचो
गुंग: तल्लीन अनुरत निमग्न लीन तन्मय मग्न मगन दत्तचित्त लिप्त रत निरत अनुरक्त अनुसंरक्त अभिनिविष्ट
गुंजारवयुक्त: गुञ्जित
गुंतलेला: उल्झिनु उल्झनु
गुंतागुंतीचा: उल्झिनु उल्झनु
गुजरातचा: गुजराती
गुजरातविषयक: गुजराती
गुजरातविषयीचा: गुजराती
गुजरातशी_संबंधित: गुजराती
गुजरातसंबंधीचा: गुजराती
गुजराती: गुजराती गुजराती
गुजराथी: गुजराती
गुडूप: सघन घना गहन सङ्घात
गुणगुणारा: गुञ्जित स्वरित
गुणवंत: सद्‍गुणी गुणी गुणवन्त गुणवान गुणशाली
गुणवत्तायुक्त: गुणवत्तायुक्त राम्रो गतिलो गजबको गुणयुक्त गुणान्वित
गुणवान: सद्‍गुणी गुणी गुणवन्त गुणवान गुणशाली
गुणविरहित: गुणरहित गुणहीन अगुणी
गुणहीन: गुणरहित गुणहीन अगुणी
गुणी: सद्‍गुणी गुणी गुणवन्त गुणवान गुणशाली
गुन्हेगार: अपराधी दोषी कसुरवार अपराधशील आपराधिक
गुन्हेगारी: अपराधी अपराधशील अपराघमूलक
गुन्हेगारीविषयक: अपराधमूलक
गुन्हेगारीविषयीचा: अपराधमूलक
गुन्हेगारीसंबंधित: अपराधमूलक
गुन्हेगारीसंबंधीचा: अपराधमूलक
गुप्त: गुप्त अप्रत्यक्ष अप्रकाश अप्रकाशित अप्रकाशमान अप्रथित अभिगुप्त
गुलाबी: गुलाबी
गुलाम: पराधीन गुलाम परतन्त्र अधीन अन्याधीन
गुळगुळीत: चिल्लो चिप्लो
गूढ: रहस्यपूर्ण रहस्यमय रहस्यात्मक गूढ
गृहहीन: आवासहीन आश्रयहीन गृहहीन गृहविहीन बेघर बेघरवार
गेलेला: अतीत गत भूत व्यतीत बितेको गएको पछिल्लो पुरानो
गैर: अनुचित खराब बेठिक अनैतिक नैतिकताहीन अनीतिपूर्ण अनुचित गलत नीतिविरुद्ध
गैरहजर: अनुपस्थित गैरहाजिर अविद्यमान अप्रस्तुत अप्राप्त
गोंडस: आकर्षक मनोहर राम्रो सुन्दर
गोचर: इन्द्रियगम्य इंद्रिय_गोचर गोचर इंद्रियग्राह्य इन्द्रियगोचर इंद्रियगोचर प्रत्यक्ष अपरोक्ष
गोठवलेला: जमेको
गोड: गुलियो मिठो रमाइलो मधुर मन_पर्ने प्रिय राम्रो_लाग्ने
गोपनीय: गोपनीय अप्रकट्य गोप्य अपहरणीय अप्रकाश्य
गोप्य: गोपनीय अप्रकट्य गोप्य अपहरणीय अप्रकाश्य
गोरटा: गोरो श्वेत
गोरा: गोरो श्वेत
गोल: गोलो वृत्ताकार गोलाकार बाटुलो गोलो डोलो डल्लो गोल
गोलाकार: गोलो वृत्ताकार गोलाकार
गोलाकृती: गोलो वृत्ताकार गोलाकार
गोळा: एकत्रित एकट्ठा एकत्र जमा समग्रीकृत
गोळीरोधी: बुलेट_प्रुफ
गोळे_असेलेला: गुजुल्टिएक गुजुल्टो_परेको गुजमुजिएको
गौण: अप्रधान अप्रमुख आनुषङ्गिक गौण अमुख्य
गौप्य: गोपनीय अप्रकट्य गोप्य अपहरणीय अप्रकाश्य
गौर: गोरो श्वेत
गौरवपूर्ण: गौरवपूर्ण गौरवयुक्त गरिमापूर्ण गरिमायुक्त गौरवशाली गौरवमयी गौरवान्वित
ग्राम्य: असभ्य अभद्र अशिष्ट
ग्राह्य: खाद्य भोज्य आहार्य ग्राह्य भक्ष्य अशनीय
ग्रीक: युनानी ग्रिक युनानी ग्रीक
ग्रीनलँडिक: ग्रिनल्यान्डी ग्रोनल्यान्डी
ग्रीसी: युनानी ग्रिक
घट्ट: साँगुरो छोटो बाक्लो
घडलेला: घटित घटेको भएको
घडीव: बनाएको आकार_दिइएको
घन: ठोस खँदिलो
घनघोर: सघन घना गहन सङ्घात
घनदाट: सघन घना गहन सङ्घात
घनिष्ठ: घनिष्ठ आत्मीय अन्तरङ्ग अन्तरंग गाढा अनन्य अभिन्न प्रगाढ अङ्गरङ्गी अन्तरंगी इष्ट अन्यतम
घमेंडखोर: गर्विलो गर्वी अभिमानी अहङ्कारी घमण्डी
घमेंडी: गर्विलो गर्वी अभिमानी अहङ्कारी घमण्डी
घरंदाज: अभिजात अभिजात्य उच्च_वंशीय उच्च_कुलीन
घरगुती: पारिवारिक घरेलु
घरचा: पारिवारिक घरेलु
घसरडा: चिप्लो
घाईचा: त्वरित
घाटदार: सुडौल सुगठित बान्की_परेको
घाण: मैलो फहोर अशुद्ध
घाणेरडा: मैलो फहोर अशुद्ध अश्लील कामुकतापूर्ण
घाणेरा: दुर्गंधपूर्ण दुर्गंधयुक्त दुर्गंधित
घातक: हानिकारक क्षतिकारी हानिकर हानिप्रद अनर्थकारी क्षतिकर
घाबरलेला: आतङ्कित त्रस्त सन्त्रस्त
घाबरा: आतङ्कित त्रस्त सन्त्रस्त
घाबराघुबरा: आतङ्कित त्रस्त सन्त्रस्त
घाम_आणणारा: स्वेदक प्रस्वेदित
घायकुत्या: हतारे
घायाळ: घायल घाइते जख्मी जखमी आहत क्षत अभिप्रहत अभ्याहत
घालण्याजोगा: परिधानयोग्य
घासकटाऊ: भुत्ते बोधो नलाग्ने
घासकाटू: भुत्ते बोधो नलाग्ने
घुळलेला: विलीन अदृश्य लुप्‍त
घुसलेला: प्रविष्ट आगत प्रवेशित अभिनिवेशित
घृणा_करणारा: जुगुप्सु
घृणास्पद: घृणित घिनौलो कुत्सित वीभत्स बीभत्स जघन्य घृणास्पद अपकृष्ट
घोटाळलेला: सम्भ्रान्त
घोडेस्वार: अश्‍वारोही
घोर: प्रचण्ड डरलाग्दो भयानक विकट रौद्र_रूप सघन घना गहन सङ्घात
घोषित: घोषित
चंचल: चञ्चल चकचके अधीर अशान्त अशांत चंचल अस्थिरचित्त उत्कंठित उत्कण्ठित विचलित अस्थिर अनुपशांत अनेकांत अनेकान्त क्षुब्ध
चंचलचित्त: अशान्त अशांत चंचल अस्थिरचित्त उत्कंठित उत्कण्ठित विचलित अस्थिर अनुपशांत अनेकांत अनेकान्त क्षुब्ध
चंचळ: चञ्चल चकचके अधीर अशान्त अशांत चंचल अस्थिरचित्त उत्कंठित उत्कण्ठित विचलित अस्थिर अनुपशांत अनेकांत अनेकान्त क्षुब्ध
चकचकणारा: चम्किलो आलोकित उज्ज्वलित कान्तिमान ज्योतित दीप्त जगमग प्रकाशवान प्रदीप्त द्युतिमान्
चकटफू: निःशुल्क मुफ्त निशुल्क
चक्रीय: चक्रको_जस्तो
चखोट: पवित्र शुद्ध निर्मल सफा
चटपटीत: फुर्तिलो छिटो जाँगरिलो
चढलेला: चढदो अधिरूढ
चढेल: धृष्ट उच्छृङ्खल ढीठ निडर उद्धत
चतुर: चलाख चतुर बुद्धिमान
चतुर्थ: चार चौथो ४ 4
चपखल: ठीक उचित सठीक अन्वर्थ
चपळ: फुर्तिलो छिटो जाँगरिलो
चमकणारा: चम्किलो आलोकित उज्ज्वलित कान्तिमान ज्योतित दीप्त जगमग प्रकाशवान प्रदीप्त द्युतिमान्
चमकदार: चम्किलो चहकिलो चहकदार
चमचमणारा: चम्किलो आलोकित उज्ज्वलित कान्तिमान ज्योतित दीप्त जगमग प्रकाशवान प्रदीप्त द्युतिमान्
चमत्कारिक: चमत्कारी चमत्कारपूर्ण चामत्कारिक तिलस्मी
चमत्कारी: चमत्कारी चमत्कारपूर्ण चामत्कारिक तिलस्मी
चमत्कृत: चमत्कारी चमत्कारपूर्ण चामत्कारिक तिलस्मी
चरबट: खस्रो रूखो असमान असमतल
चरम: अन्तिम अंतिम आखिरी अन्त्य अंत्य
चराचर: चराचर चलाचल चल_अचल
चलनात_नसलेला: अप्रचलित अप्रचरित अव्यवहृत अप्रयुक्त आउटडेटेड आउट_आफ_डेट
चलाख: चलाख चतुर बुद्धिमान
चलितचित्त: अशान्त अशांत चंचल अस्थिरचित्त उत्कंठित उत्कण्ठित विचलित अस्थिर अनुपशांत अनेकांत अनेकान्त क्षुब्ध
चळलेला: विचलित हटेको भ्रष्ट पतित दूषित
चवडा: फराक चौडा विस्तीर्ण
चवदार: स्वादिष्ट मिठो स्वादिष्ठ राम्रो रुचिकर मनपर्दो
चविष्ट: स्वादिष्ट मिठो स्वादिष्ठ राम्रो
चवेचाळिसावा: चवालीसौँ
चवेताळिसावा: चवालीसौँ
चव्वेचाळिसावा: चवालीसौँ
चव्वेचाळीस: चवालीस
चव्वेताळिसावा: चवालीसौँ
चांगला: राम्रो सही_मान्छे गतिलो राम्रो ठीकठाक‍
चांदणी: चाँदनी जुनेली
चांदीचा: चाँदीको रजत
चांदीतला: चाँदीको रजत
चांदीतील: चाँदीको रजत
चांद्र: चान्द्र
चाणाक्ष: चलाख चतुर बुद्धिमान
चार: चार ४ 4
चारपट: चौगुणा चार_गुना
चारित्र्यवान: चरित्रवान सच्चरित्र
चारित्र्यसंपन्न: चरित्रवान सच्चरित्र
चालू: धोकाबाज बेइमानी_गर्ने धूर्त कपटी छली
चालू_असलेला: चालित परिचालित प्रचालित
चाळिसावा: चालीसौँ
चाळीस: चाल्लीस चालिस
चिंचोळा: साँघुरो साँगुरो साङ्ग्रो
चिंतनशील: मननशील चिन्तनशील विचारशील।
चिंतनीय: विचारणीय विचार्य चिन्तनीय चिंतनीय चिंत्य अनुशीलनीय विचारणीय लक्ष्य अभिलक्ष्य
चिंताकुल: चिन्तित चिंतित चिन्तायुक्त चिन्ताग्रस्त
चिंताक्रांत: चिन्तित चिंतित चिन्तायुक्त चिन्ताग्रस्त
चिंताग्रस्त: चिन्तित चिंतित चिन्तायुक्त चिन्ताग्रस्त
चिंतातुर: चिन्तित चिंतित चिन्तायुक्त चिन्ताग्रस्त
चिंतामग्न: चिन्तित चिंतित चिन्तायुक्त चिन्ताग्रस्त
चिंतामुक्त: निश्चिन्त चिन्तारहित चिन्ताहीन चिन्तामुक्त
चिंतारहित: निश्चिन्त चिन्तारहित चिन्ताहीन चिन्तामुक्त
चिंतावलेला: चिन्तित चिंतित चिन्तायुक्त चिन्ताग्रस्त
चिंतित: चिन्तित चिंतित चिन्तायुक्त चिन्ताग्रस्त
चिंत्य: विचारणीय विचार्य चिन्तनीय चिंतनीय चिंत्य अनुशीलनीय विचारणीय लक्ष्य अभिलक्ष्य
चिंब: लतपत
चिकचिकित: लयालो
चिकचिकीत: लयालो
चिकट: लोभी कन्जुस कन्चुस लयालो
चिकार: अत्यधिक धेरै औधि प्रचुर अत्याधिक भारी भीषण घनघोर अत्याधिक
चिक्कार: अत्यधिक धेरै औधि प्रचुर अत्याधिक अनगन्ती थुप्रो भारी भीषण घनघोर अत्याधिक
चिक्कू: लोभी कन्जुस कन्चुस
चिडलेला: रिसाएको झोकिएको क्रुद्ध
चित्ताकर्षक: आकर्षक मनोहर राम्रो सुन्दर
चित्रांकित: चित्राङ्कित
चिमणा: भुराभुरि केटाकेटी नानी शिशु बच्चा
चिमुकला: भुराभुरि केटाकेटी नानी शिशु बच्चा
चिरंजीव: अमर अक्षय अनश्वर शाश्वत अक्षुण्ण अक्षुण अनष्ट अविनाशी अविनासी अक्षय्य अच्युत अभङ्ग अनाश अनाश्य अनाशवान अभङ्गुर अखय अक्षुण्य चिरञ्जीव चिरञ्जीवी चिरजीवी दीर्घजीवी दीर्घायु आयुष्मान चिरायु अमर मृत्यु_कालजयी चिरञ्जीवी
चिरंजीवी: चिरञ्जीव चिरञ्जीवी चिरजीवी दीर्घजीवी दीर्घायु आयुष्मान चिरायु
चिरंतन: अमर अक्षय अनश्वर शाश्वत अक्षुण्ण अक्षुण अनष्ट अविनाशी अविनासी अक्षय्य अच्युत अभङ्ग अनाश अनाश्य अनाशवान अभङ्गुर अखय अक्षुण्य अमिट नमेटिने
चिरस्थायी: अमिट नमेटिने
चिरायु: चिरञ्जीव चिरञ्जीवी चिरजीवी दीर्घजीवी दीर्घायु आयुष्मान चिरायु
चिलखतधारी: कवचधारी कवची
चीनचा: चिनी
चीनी: चिनी चिनी
चुकार: अल्छी जाँगरहीन
चुकारतट्टु: अल्छी जाँगरहीन
चुकीचा: अनुचित खराब बेठिक असत्य झूटो
चूक: अशुद्ध भूल गलत
चूर: तल्लीन अनुरत निमग्न लीन तन्मय मग्न मगन दत्तचित्त लिप्त रत निरत अनुरक्त अनुसंरक्त अभिनिविष्ट
चेक: चेक
चेकोस्लोवाकियाई: चेक
चेतन: चेतनायुक्त चेतन संज्ञायुक्त
चैतन्यपूर्ण: जीवन्त जिउँदो
चोख: राम्रो शुद्ध चोखो असल निष्कपट विश्‍वासी
चोखट: राम्रो शुद्ध चोखो असल
चोविसावा: चौबीसौँ
चोवीस: चौबीस २४
चौकोणी: चारकुने चौकुने
चौकोनी: चारकुने चौकुने
चौघे: चार ४ 4
चौतिसावा: चौतीसौँ
चौतीस: चौतीस ३४
चौथा: चार चौथो ४ 4
चौदावा: चौधौ १४औं 14_औं
चौपट: चौगुणा चार_गुना
चौपन्न: चौवन चौवन्न
चौपन्नावा: चौवन्नौं
चौर्‍याऐंशी: चौरासी
चौर्‍याण्णव: चौरानब्बे
चौर्‍याण्णवावा: चौरानब्बेऔं
चौर्‍याहत्तर: चौहत्तर
चौसष्ट: चौसट्ठी
चौसष्टावा: चौंसट्ठीऔं
च्युत: च्युत बञ्चित अपगत
छंदोबद्ध: पद्यात्मक छन्दात्मक छन्दोबद्ध छन्दबद्ध
छत्तिसावा: छत्तीसौँ
छप्पन्न: छपन्न
छिद्रमय: छिद्रयुक्त रन्ध्रयुक्त रन्ध्रयुक्त सछिद्र दुलोयुक्त
छिद्रान्वेषी: छिद्रान्वेषक छिद्रान्वेषी
छोटा: भुराभुरि केटाकेटी नानी शिशु बच्चा सानो सानु
जंगली: वन्य जङ्गली आरण्य आरण्यक जङ्गली वन्य बनैया जङ्गली वन_भएको
जखमी: घायल घाइते जख्मी जखमी आहत क्षत अभिप्रहत अभ्याहत
जखमी_न_झालेला: चोट_नलागेको अचोट अप्रहत
जगजाहीर: सर्वसंज्ञात सर्वज्ञात सर्वजनविदित
जगज्जेता: विश्व_विजेता जगजयी दिग्विजयी विश्वविजयी
जगद्विख्यात: विश्वविख्यात जगत_प्रसिद्ध विश्वप्रसिद्ध
जगप्रसिद्ध: विश्वविख्यात जगत_प्रसिद्ध विश्वप्रसिद्ध
जड: मूर्ख अज्ञानी बुद्धु जड अचैतन्य जडत्वयुक्त स्थूल अजैव भौतिक अचेतन चेतनारहित अजीव अनात्म आत्मारहित भारी गरुङ्गो वजनदार ज्ञानहीन अज्ञानपूर्ण
जनजातीय: जनजातीय
जन्मजात: जन्मसिद्ध जन्मजात
जन्मलेला: जन्मेको जन्मिएको उत्पन्न_भएको
जन्मसिद्ध: जन्मसिद्ध जन्मजात जन्मजात जन्मगत
जन्मांध: जन्मान्ध जात्यन्ध
जपानी: जापानी मिहिनती मिहेनती मेहेनती जापानी जापानको
जप्त: कुर्की_भएको
जबाबदार: उत्तरदायी उत्तरदायक जवाबदेह ज़िम्मेदार जिम्मेदार
जमा: एकत्रित एकट्ठा एकत्र जमा समग्रीकृत
जमिनदोस्त: चकनाचुर
जमीनदोस्त: नष्ट चौपट तहस-नहस ध्वस्त समाप्त बरबाद बर्बाद ध्वंसित अपध्वस्त विनष्ट निकंदन
जरतारी: जरतारी जरकशी जरकसी जरकस
जरा: कम्ती अलिकति अल्प
जरायुज: जरायुज गर्भज पिंडज पिण्डज
जरासा: कम्ती अलिकति अल्प
जरुरीचा: आवश्यक जरूरी अपेक्षित अपेक्ष्य
जर्जर: जीर्ण जर्जर
जर्मन: जर्मन जर्मन
जलगत: जलमग्न प्लावित
जलचर: जलचर जल-चर
जलद: त्वरित शीघ्रगामी छिटो_हिँड्ने वेगवान् फुर्तिलो
जलाच्छादित: जलमग्न प्लावित
जलीय: पानीमा_उम्रिने जलीय जलज
जळता: प्रज्वलित
जवळचा: निकटस्थ छेउको निकटको समिपको निकटवर्ती समीपी सन्निकट समीपवर्ती समीपस्थ
जवान: तन्नेरी जवान युवा तरुण
जहाजाचा: जहाजी
जहाल_विष_उतरवणारा: मारक मार्ने विनाशकर्ता
जागता: जागृत जाग्रत जाग्रत् अनिद्रित
जागतिक: सार्वभौमिक सार्वभौम सार्वदेशिक सर्वदेशीय सार्वजनी सार्वभौमिक सार्वभौम सार्वजनीन
जागरूक: सचेत सावधान सतर्क
जागा: जागृत जाग्रत जाग्रत् अनिद्रित सचेत सावधान सतर्क
जागृत: जागृत जाग्रत जाग्रत् अनिद्रित
जाड: मोटो बलियो स्थुलकाय
जाडजूड: मोटो बलियो स्थुलकाय
जाडा: मोटो बलियो स्थुलकाय
जाणकार: सिपालु प्रवीण निपुण पारङ्गत दक्ष माहिर अभ्यस्त कुशल होशियार पक्का सिद्धहस्त शातिर पटु पका निष्णात परिपक्व कार्यकुशल विचक्षण अभिज्ञ अभ्यासी आप्त सिपालु प्रवीण ज्ञानी जान्ने
जाणणारा: सिपालु प्रवीण ज्ञानी जान्ने
जाणता: सिपालु प्रवीण निपुण पारङ्गत दक्ष माहिर अभ्यस्त कुशल होशियार पक्का सिद्धहस्त शातिर पटु पका निष्णात परिपक्व कार्यकुशल विचक्षण अभिज्ञ अभ्यासी आप्त अनुभवी जानकार परिपक्व खारिएको
जाणलेला: थाहा ज्ञात विदित अवगत विज्ञात अवबुद्ध परिचित
जाण्याचे_ठिकाण: गन्तव्य
जाण्याजोगा: गम्य गमनीय
जातिवंत: अभिजात अभिजात्य उच्च_वंशीय उच्च_कुलीन
जातीय: जातीय
जायबंदी: घायल घाइते जख्मी जखमी आहत क्षत अभिप्रहत अभ्याहत
जाळीदार: छिद्रयुक्त रन्ध्रयुक्त रन्ध्रयुक्त सछिद्र दुलोयुक्त जालीदार
जाळीवाला: जालीदार
जावळा: जम्ल्याहा
जावानीज: जावाई जावाई
जास्त: धेरै बहुत अधिक ज्यादा अतिशय अति अगाध अतीव बहुल
जास्तच_धाडसी: दुस्साहसी ढीठ दुःसाहसी
जास्तच_साहसी: दुस्साहसी ढीठ दुःसाहसी
जास्ती: धेरै बहुत अधिक ज्यादा अतिशय अति अगाध अतीव बहुल
जास्तीत_जास्त: धेरैजसो प्राय
जिंकण्याजोगा: जेय जय_योग्य जित्य
जिगरी: घनिष्ठ आत्मीय अन्तरङ्ग अन्तरंग गाढा अनन्य अभिन्न प्रगाढ अङ्गरङ्गी अन्तरंगी इष्ट अन्यतम
जिज्ञासाजनक: विचित्र विलक्षण विस्मयकारी विस्मयजनक कुतुहलजनक जिज्ञासाजनक अद्भुत अनागत
जिज्ञासाहीन: अनुत्सुक निरुत्सुक अनुत्क जिज्ञासाहीन अजिज्ञासु उत्सुक्ताहीन निरुत्सुक
जित: पराजित परास्त अपध्वस्त
जितका: जति जतिमात्रा
जितखोर: हठी जिद्धी जिद्दीवाल
जितपत: जति जतिमात्रा
जिता: जिउँदो नमरेको जीवित प्राणवान् प्रण_भएको
जितेंद्रिय: जितेन्द्रिय
जिद्दी: हठी जिद्धी जिद्दीवाल
जिवंत: जिउँदो नमरेको जीवित प्राणवान् प्रण_भएको
जिवलग: घनिष्ठ आत्मीय अन्तरङ्ग अन्तरंग गाढा अनन्य अभिन्न प्रगाढ अङ्गरङ्गी अन्तरंगी इष्ट अन्यतम
जिवाभावाचा: घनिष्ठ आत्मीय अन्तरङ्ग अन्तरंग गाढा अनन्य अभिन्न प्रगाढ अङ्गरङ्गी अन्तरंगी इष्ट अन्यतम
जीर्ण: जीर्ण जर्जर जीर्ण पुरानो थोत्रो भाँचिएको
जीवंत: जीवन्त जिउँदो
जीवश्चकंठश्च: घनिष्ठ आत्मीय अन्तरङ्ग अन्तरंग गाढा अनन्य अभिन्न प्रगाढ अङ्गरङ्गी अन्तरंगी इष्ट अन्यतम
जीवित: जिउँदो नमरेको जीवित प्राणवान् प्रण_भएको
जुना: प्राचीन पूराकालीन पूरातन पुराना प्राक्कालीन आदिम प्राच्य आदिकालीन
जुनाट: प्राचीन पूराकालीन पूरातन पुराना प्राक्कालीन आदिम प्राच्य आदिकालीन
जुलमी: अत्याचारी अनाचारी आततायी बर्बर नृशंस अतिचारी अनीतिमान् उत्पीडक
जुळा: जम्ल्याहा जुम्ल्याहा जम्ल्याहा
जुवळ: जम्ल्याहा
जेता: विजेता विजयी
जेय: जेय जय_योग्य जित्य
जेवढा: जति जतिमात्रा
जेव्हढा: जति जतिमात्रा
जैव: जिउँदो नमरेको जीवित प्राणवान् प्रण_भएको
जैविक: जैव जैविक
जोमदार: जोशीलो जोशपूर्ण
जोरदार: जोरदार जोशीलो जोशपूर्ण
ज्ञात: थाहा ज्ञात विदित अवगत विज्ञात अवबुद्ध परिचित अभिज्ञात पूर्व_परिचित
ज्ञाता: सिपालु प्रवीण ज्ञानी जान्ने
ज्ञानी: विद्वान् ज्ञानी प्राज्ञ पण्डित विज्ञ
ज्ञेय: ज्ञेय ज्ञानगम्य बोधगम्य बोध्य ज्ञातव्य अभिमन्तव्य अभिमंतव्य ग्राह्य
ज्याला_कळले_नाही_असा: नबुझ्ने अकडो
ज्याला_समजले_नाही_असा: नबुझ्ने अकडो
ज्येष्ठ: जेठा ज्येष्ठ ठुला
ज्वलंत: ज्वलन्त प्रज्वलित
झकास: उत्तम उत्कृष्ट अनमोल श्रेष्ठ प्रशस्त
झाकलेले: आच्छादित ढाकिएको आवृत्त आवृत अपिबद्ध अपिनद्ध अपिहित आच्छन्न
झाडीसम: झाडी_भएको
झाडीसारखा: झाडी_भएको
झाडोर्‍यासम: झाडी_भएको
झाडौलीसारखा: झाडी_भएको
झालेला: घटित घटेको भएको
झिरझिरीत: जीर्ण जर्जर
झुंजार: रणवीर युद्धवीर
झुडपासम: झाडी_भएको
झोपलेला: निद्रामग्न सुतेको निद्रित निद्रागत स्वप्निल सुप्त सुप्तविग्रह सुप्तस्थ
झोपाड: निदाएको निद्रालु निद्राग्रस्त
झोपाळू: निदाएको निद्रालु निद्राग्रस्त
टंकलिखित: टङ्कित टाइप_गरिएको
टवटवीत: आलो ताजा
टाकाऊ: अनुपयोगी अनावश्यक उपयोगहीन निरर्थक व्यर्थ फालतू रद्दी अनर्थक
टाकोटाकचा: त्वरित
टेक_आणणारा: थकाइ
टोकदार: तिखो
ट्युनिस: ट्युनिसियाई ट्युनिसियन
ट्यूनीशियाचा: ट्युनिसियाई
ठक: छक्याउने
ठकबाज: छक्याउने
ठकसेन: छक्याउने
ठरलेला: निश्चित निर्धारित नियत नियमित ठिक निर्दिष्ट निर्धारित सीमित नियत
ठरवलेला: अनुबद्ध अनुबन्धित अनुबंधित
ठरविलेला: सङ्कल्पित
ठराविक: निश्चित निर्धारित नियत नियमित ठिक निर्दिष्ट फलानो अमुक ढिस्कानो
ठरावीक: निर्धारित सीमित नियत
ठळक: मूल खास मुख्य प्रमुख प्रधान
ठाऊक: थाहा ज्ञात विदित अवगत विज्ञात अवबुद्ध परिचित
ठाम: अविचलित अडिग अविचल दृढ़ अटल अडिग अविचल स्थिर कायम दुविधाहीन दुबिधाहीन सन्देहहीन संशयहीन
ठिसूळ: भङ्गुर नाशवान बुरबुरे
ठीक: सामान्य आम साधारण कामचलाउ अविशिष्ट राम्रो ठीकठाक‍
ठीकठाक: फिट
ठेंगणा: पुडके होचो
ठेंगू: पुडके होचो
ठोंब्या: मूर्ख अज्ञानी बुद्धु ज्ञानहीन अज्ञानपूर्ण
ठोक: थोक मोठ
डगळ: खुकुलो ढीला
डच: डच डच
डबल: दुई_गुणा
डागरहित: बेदाग दागरहित अदाग अदागी
डागलेला: दागी
डागाळलेला: लाञ्छित कलङ्कित कलुषित दागी बदनामी
डागील: दागी
डागेल: दागी
डाळिंबी: अनारे
डावा: देब्रे बायाँ बाउँ बाम
डॅनिश: डेनमार्की डेनिश डेनमार्की
डोंगरकरी: पहाडी पर्वत-वासी पर्वत_वासी पर्वतीय पर्वती
डोंगरट: पहाडी पर्वतीय पर्वती
डोंगरवट: पहाडी पर्वतीय पर्वती
डोंगराळ: पहाडी पर्वतीय पर्वती
डोंगरी: पहाडी पर्वत-वासी पर्वत_वासी पर्वतीय पर्वती
डोळस: दृष्टियुक्त दृष्टिवान दृष्टिवंत
डोळ्यादेखतचा: प्रत्यक्ष साक्षात् साक्षात
डोळ्यासमोरील: प्रत्यक्ष साक्षात् साक्षात
डौलदार: सुडौल सुगठित बान्की_परेको
ढ: मूर्ख अज्ञानी बुद्धु ज्ञानहीन अज्ञानपूर्ण
ढगळ: खुकुलो ढीला
ढम्म: अल्छी सुस्त ढिलो
ढळलेला: भ्रष्ट पतित दूषित
ढिला: खुकुलो ढीला खुकुलो ढीला अल्छी सुस्त ढिलो
तंग: साँगुरो छोटो
तंतुमय: रेसा_भएका रेसायुक्‍त
तंतोतंत_सारखे: प्रतिरूपी अनुरूपी समरूपी
तंत्रविषयक: प्रविधि तकनीक_विषयक प्राविधिक
तंत्राचा: प्रविधि तकनीक_विषयक प्राविधिक
तंत्राविषयीचा: प्रविधि तकनीक_विषयक प्राविधिक
तंत्राशी_संबंधित: प्रविधि तकनीक_विषयक प्राविधिक
तंत्रासंबंधीचा: प्रविधि तकनीक_विषयक प्राविधिक
तंदुरी: तन्दुरी
तंदुरूस्त: फिट
तकलादू: कमजोर दुर्बल निम्छरो कमजोर दुर्बल निम्छरो
तज्ज्ञ: सिपालु प्रवीण निपुण पारङ्गत दक्ष माहिर अभ्यस्त कुशल होशियार पक्का सिद्धहस्त शातिर पटु पका निष्णात परिपक्व कार्यकुशल विचक्षण अभिज्ञ अभ्यासी आप्त
तज्ञ: सिपालु प्रवीण निपुण पारङ्गत दक्ष माहिर अभ्यस्त कुशल होशियार पक्का सिद्धहस्त शातिर पटु पका निष्णात परिपक्व कार्यकुशल विचक्षण अभिज्ञ अभ्यासी आप्त
तटस्छ: किनार तीर छेउ
तटस्त: किनार तीर छेउ
तटस्थ: तटस्थ निरपेक्ष उदासीन पक्षपातरहित अपक्षपाती निर्पेक्ष अनपेक्ष किनार तीर छेउ
तत्कालीन: तत्कालीन
तत्काळचा: तत्कालिक
तत्त्वज्ञानी: दार्शनिक तत्वज्ञानी
तत्पर: तयार तत्पर उद्यत्
तथ्यहीन: निराधार अप्रामाणिक तथ्यहीन आधारहीन सारहीन निर्मूल यथार्थहीन अनाधार आधाररहित
तदनुरूप: तदनुरूप दुरूस्तै
तद्रूप: तल्लीन अनुरत निमग्न लीन तन्मय मग्न मगन दत्तचित्त लिप्त रत निरत अनुरक्त अनुसंरक्त अभिनिविष्ट
तन्मय: तल्लीन अनुरत निमग्न लीन तन्मय मग्न मगन दत्तचित्त लिप्त रत निरत अनुरक्त अनुसंरक्त अभिनिविष्ट
तपासलेला: परीक्षित अनुभूत
तप्त: तातो गर्मी उष्ण पाकेको पकाएको तातो गरम धेरै_क्रुद्ध अत्युग्र
तमाम: जम्मा सारा सबै समस्त सम्पूर्ण तमाम
तमिळ: तमिल तमिल
तयार: उत्पन्न उत्पादित पैदा-भएको तयार तयार तत्पर उद्यत् पाकेको
तय्यार: तयार तयार तत्पर उद्यत्
तरणपटू: पौडिने
तरणा: तन्नेरी जवान युवा तरुण
तरतरीत: फुर्तिलो छिटो जाँगरिलो
तरबेज: सिपालु प्रवीण निपुण पारङ्गत दक्ष माहिर अभ्यस्त कुशल होशियार पक्का सिद्धहस्त शातिर पटु पका निष्णात परिपक्व कार्यकुशल विचक्षण अभिज्ञ अभ्यासी आप्त
तरुण: तन्नेरी जवान युवा तरुण
तर्कगम्य: तर्कगम्य तर्काधीन तर्कसङ्गत
तर्कशुद्ध: तर्कगम्य तर्काधीन तर्कसङ्गत
तर्कसंगत: तर्कगम्य तर्काधीन तर्कसङ्गत
तर्काधिष्ठित: तर्कगम्य तर्काधीन तर्कसङ्गत
तलम: पातलो पात्लो
तल्लख: तीक्ष्ण तीव्र कुशाग्र प्रखर तेज अकुण्ठ अकुंठित अकुन्ठित विषम
तल्लीन: तल्लीन अनुरत निमग्न लीन तन्मय मग्न मगन दत्तचित्त लिप्त रत निरत अनुरक्त अनुसंरक्त अभिनिविष्ट
तसा: त्यस्तो
तहानलेला: तिर्खाएको प्यासा तिर्खा_लागेको
तांत्रिक: प्रविधि तकनीक_विषयक प्राविधिक
तांबडा: रातो लाल रोहित
ताजा: आलो साजी ताजा
ताजे: ताजा
ताठर: गर्विलो गर्वी अभिमानी अहङ्कारी घमण्डी अनम्य अनमनीय कठोर दृढ
तातडीचा: त्वरित
तात्कालिक: तत्कालिन तत्कालिक
तात्पर्याविरुद्ध: अनभिमत
तात्पुरता: अस्थायी
तापलेला: तातो गरम
तापलेले: तातो गर्मी उष्ण
ताबडतोबीचा: त्वरित तत्कालिक
ताब्यात_असलेला: अधीनस्थ अधीन मातहत अधस्तन अमुख्य अधिकृत
ताब्यातील: अधिकृत
तामिळ: तमिल
तालेवार: धनाढ्य धनी धनवान
तितका: त्यत्रो त्यत्रो_औधी
तितुका: त्यत्रो त्यत्रो_औधी
तिप्पट: तीनगुणा तीन_गुणा
तिबेटचा: तिब्बती
तिबेटी: तिब्बती तिब्बती तिब्बती
तिमाही: त्रैमासिक तीनमहिने
तिरंगा: त्रिरङ्ग तीनरङ्ग
तिरका: टेढो तेर्छो बाङ्गो
तिरपा: टेढो तेर्छो बाङ्गो
तिरस्कृत: तिरस्कृत अनादृत अनादरित उपेक्षित
तिसरा: तेस्रो तृतीय
तिसावा: तीसौँ
तीक्ष्ण: तिखो तिखो धारिलो साह्रै_लाग्ने धारिलो धार_भएको
तीन: तीन त्रय ३
तीव्र: चर्को तीव्र कडा
तीस: तीस त्रिस
तुच्छ: नगण्य यस्तो-उस्तो अगण्य अनुदात्त
तुटका: लङ्गडो लँगडो खँजाहा खोरन्डो
तुटण्याजोगा: खण्डनीय खंडनीय भंजनीय
तुरुंगाचा: हवालती
तुरूंगात_ठेवलेला: हवालती
तुर्क: तुर्की तुर्क तुरकीस्थान_वासी
तुर्कस्तानी: तुर्की तुर्क तुरकीस्थान_वासी
तुर्की: तुर्की तुर्की तुर्की तुर्क तुरकीस्थान_वासी
तुलनात्मक: तुलनात्मक
तुष्ट: तृप्त तुष्ट सन्तुष्ट संतुष्ट अघाएको
तृतीय: तेस्रो तृतीय
तृप्त: तृप्त तुष्ट सन्तुष्ट संतुष्ट अघाएको
तेजःपुंज: तेजोमण्डित तेजपूर्ण कान्तिमान जाज्वल्यमान प्रकाशमान दिव्य चम्किलो तेजस्वी ओजस्वी तेजवन्त तेजवान कान्तिवान्
तेजवंत: तेजोमण्डित तेजपूर्ण कान्तिमान जाज्वल्यमान प्रकाशमान दिव्य चम्किलो
तेजवान: तेजोमण्डित तेजपूर्ण कान्तिमान जाज्वल्यमान प्रकाशमान दिव्य चम्किलो
तेजस: तेजोमण्डित तेजपूर्ण कान्तिमान जाज्वल्यमान प्रकाशमान दिव्य चम्किलो प्रकाशित उज्यालो चहकिलो
तेजस्वी: तेजोमण्डित तेजपूर्ण कान्तिमान जाज्वल्यमान प्रकाशमान दिव्य चम्किलो तेजस्वी ओजस्वी तेजवन्त तेजवान कान्तिवान् प्रकाशपूर्ण दीप्तिपूर्ण प्रकाशमान आलोकित ज्योतित
तेजाने_युक्त: प्रकाशित उज्यालो चहकिलो
तेजाबी: तेजाबी
तेजोमय: तेजोमण्डित तेजपूर्ण कान्तिमान जाज्वल्यमान प्रकाशमान दिव्य चम्किलो प्रकाशित उज्यालो चहकिलो
तेजोहीन: रगतहीन निस्तेज आभाहीन कांतिहीन ओजहीन प्रभाहीन बेरौनक अप्रभ प्रभारहित श्रीहत
तेरा: तेइस
तेरावा: तेह्रौं १३_औं 13_औ
तेलकट: तेलिया स्निगध चिप्लो तेलिया तेल_भएको
तेलकटी: तेलिया तेल_भएको
तेलगट: तेलिया तेल_भएको
तेलगू: तेलगु तेलेगु तेलुगु तेलगु तेलुगु
तेलविषयक: तेलिया चिप्लो चिल्लो स्निग्ध
तेलाचा: तेलिया चिप्लो चिल्लो स्निग्ध
तेलाविषयीचा: तेलिया चिप्लो चिल्लो स्निग्ध
तेलाशी_संबंधित: तेलिया चिप्लो चिल्लो स्निग्ध
तेलासंबंधीचा: तेलिया चिप्लो चिल्लो स्निग्ध
तेलुगू: तेलगु तेलेगु तेलुगु तेलगु तेलुगु तेलगु तेलुगु
तेलूगू: तेलगु तेलुगु
तेवढा: त्यत्रो त्यत्रो_औधी
तेविसावा: तेइसौँ
तेहेतिसावा: तेत्तीसौँ
तेहेतीस: तेत्तीस
तोंडपाठ: कण्ठस्थ मुखाग्र
तोंडफटाल्या: प्रलापी कुरौटे अतिवक्ता
तोंडबडव्या: प्रलापी कुरौटे अतिवक्ता
तोंडी: मौखिक अन्तर्वार्ता
तोडीचा: समकक्ष समतुल्य एक_समान तुल्य सदृश्य समान बराबर समान तुल्य
तोतरा: तोते तोते
तोषक: रमाइलो आनन्दप्रद आनन्दप्रद आनन्द-दायक आह्लादक सुखप्रद खुशनुमा प्रसन्नतादायक आनंददायक आनन्ददायक आनन्ददायी आनन्दकारी आनंदकारी आह्लादी अनंद अनन्द नंदक नन्दक रमन रमण
तौलनिक: तुलनात्मक
त्यागी: त्यागी सन्न्यासी वैरागी जोगी भिक्षु
त्याज्य: मना मना_गरिएको निषिद्ध वर्जित प्रतिबन्धित प्रतिबंधित निषेधित वर्ज्य व्याहत त्याज्य त्याजनीय परित्याज्य तजनीय हेय वर्ज्य
त्रयस्थ: तटस्थ निरपेक्ष उदासीन पक्षपातरहित अपक्षपाती निर्पेक्ष अनपेक्ष
त्रयोदश: तेइस
त्रस्त: पीडित ग्रस्त ग्रसित व्यथित उत्पीड़ित पीड़ित त्रसित
त्रिकोणी: त्रिभुजाकार
त्रेचाळिसावा: त्रिचालीसौँ
त्रेचाळीस: त्रिचालीस
त्रेपन्न: त्रिपन्न त्रिपन ५३
त्रेपन्नावा: त्रिपन्नौं ५३औं
त्रेसष्ट: तिरसट्ठी त्रिसठ
त्रेसष्टावा: तिरसट्ठीऔं
त्रैमासिक: त्रैमासिक तीनमहिने
त्र्याऐंशी: तिरासी
त्र्याण्णव: तिरानब्बे
त्र्याण्णवावा: तिरानब्बेऔं
त्र्याहत्तर: त्रिहत्तर
त्र्याहत्तरावा: त्रिहत्तरौं
थंड: चिसो ठन्डा चिसो ठण्डा चिसो शीतल ठण्डा अनुष्ण चिसो
थकलेला: थाकेको थकित क्लान्त क्लांत परिश्रांत
थकवा_आणणारा: थकाइ
थकविणारा: थकाइ
थरथरणारा: थर्किइरहेको कम्पित कम्पायमान
थरयुक्त: परतदार स्तरयुक्त स्तरित
थांबलेला: रोकिएको बन्द_भएको थामिएको
थांबवता_न_येण्याजोगा: अबाध्य अरोक
थाई: थाई साइमिस सायमिस थाई साइमिस सायमिस थाई थाइल्यान्डी
थुलथुलीत: गाढा
थोटा: उत्तरी
थोडका: कम्ती अलिकति अल्प
थोडा: कम्ती अलिकति अल्प अलिकति केही थोरै
थोडाथोडका: कम्ती अलिकति अल्प
थोडासा: कम्ती अलिकति अल्प
थोर: महान ठुला श्रेष्ठ
थोरला: जेठा ज्येष्ठ ठुला
दंग: तल्लीन अनुरत निमग्न लीन तन्मय मग्न मगन दत्तचित्त लिप्त रत निरत अनुरक्त अनुसंरक्त अभिनिविष्ट
दंगेखोर: लडाइ झगडा मारामार काटाकाट
दंडनीय: दण्ड_पाउने
दंडित: दण्डित सजायप्राप्‍त
दंत_विषयक: दन्त्य
दंताळ: दाँते दँतुर दंतुर दन्तुर
दंताळा: दाँते दँतुर दंतुर दन्तुर
दंतुर: दाँते दँतुर दंतुर दन्तुर
दंत्य: दन्त्य
दक्ष: सचेत सावधान सतर्क
दक्षिणावर्त: दक्षिणावर्त दक्षिणतिर
दक्षिणावर्ती: दक्षिणावर्त दक्षिणतिर
दगडधोंड्यांचा: सङ्गीन पत्थर_निर्मित
दणकट: दरो बलियो कठरो सारो
दणगट: पोटिलो खँदिलो भरिलो मोटो दह्रो;
दत्तक: धर्मपुत्र
दन्त्य: दन्त्य
दमट: भिजेको
दमदार: जोशीलो जोशपूर्ण
दमलेला: थाकेको थकित क्लान्त क्लांत परिश्रांत
दमविणारा: थकाइ
दमित: दामित थिचिएका हेपिएका पिसिएका
दयार्द्र: द्रवित द्रवीभूत दयार्द्र दयालु कृपालु दयावन
दयाळू: द्रवित द्रवीभूत दयार्द्र दयालु कृपालु दयावन
दयावान: दयालु कृपालु दयावन
दयाशील: दयालु कृपालु दयावन
दरबारी: दरबारिया
दरमाही: मासिक महिनाको
दरावंत: दयालु कृपालु दयावन
दरिद्री: निर्धन गरीब दरिद्र
दर्पी: अभिमानी अहङ्कारी घमण्डी
दर्शनविषयक: दर्शनशास्त्रीय दार्शनिक
दर्शनशास्त्रविषयक: दर्शनशास्त्रीय दार्शनिक
दर्शनशास्त्राचा: दर्शनशास्त्रीय दार्शनिक
दर्शनशास्त्राबाबतचा: दर्शनशास्त्रीय दार्शनिक
दर्शनशास्त्राविषयीचा: दर्शनशास्त्रीय दार्शनिक
दर्शनशास्त्राशी_संबंधित: दर्शनशास्त्रीय दार्शनिक
दर्शनशास्त्रासंबंधीचा: दर्शनशास्त्रीय दार्शनिक
दर्शनशास्त्रीय: दर्शनशास्त्रीय दार्शनिक
दर्शनाचा: दर्शनशास्त्रीय दार्शनिक
दर्शनाबाबतचा: दर्शनशास्त्रीय दार्शनिक
दर्शनाविषयीचा: दर्शनशास्त्रीय दार्शनिक
दर्शनाशी_संबंधित: दर्शनशास्त्रीय दार्शनिक
दर्शनासंबंधीचा: दर्शनशास्त्रीय दार्शनिक
दलित: पददलित पदाक्रान्त दलित पाददलित थिचिएका कुल्चिएका पेलिएका हेपिएका दलित
दशम: दस दश दसौँ दशौँ
दहा: दस १० 10
दहावा: दस दश दसौँ दशौँ
दांडगा: चकचके चञ्‍चल चुलबुले
दाखवलेला: प्रदर्शित देखाइएको प्रदर्शन_गरिएको
दाट: बाक्लो सघन घना गहन सङ्घात घनिष्ठ आत्मीय अन्तरङ्ग अन्तरंग गाढा अनन्य अभिन्न प्रगाढ अङ्गरङ्गी अन्तरंगी इष्ट अन्यतम
दाणेदार: कनिका मोटो
दाता: दानी दाता दानशील
दातेरी: दाँते
दानवीर: दानी दाता दानशील
दानशील: दानी दाता दानशील
दानशूर: दानी दाता दानशील
दारुडा: रक्स्याहा जँड्याहा रक्स्याहा जँड्याहा
दारुड्या: रक्स्याहा जँड्याहा रक्स्याहा जँड्याहा
दारूबाज: रक्स्याहा जँड्याहा रक्स्याहा जँड्याहा
दार्शनिक: दार्शनिक तत्वज्ञानी दर्शनशास्त्रीय दार्शनिक
दिखाऊ: देखावटी बनावटी बोक्रे बनौटी घोरेलको देखावटी नकली बनावटी बनौटी कृत्रिम अप्रकृत अयाथार्थिक
दिग्गज: दिग्गज
दिलेले: दिइएको प्रदत्त
दिवंगत: मरेको मृत
दिवाणी: दीवानी
दिवाळखोर: दिवालिया दीवालिया टाट_उल्टेको
दिव्य: दिव्य
दिशाहीन: दिग्भ्रमित दिशाहीन
दिसण्यात_सुंदर: मनोरम मनोहर सुन्दर
दीड: डेढ
दीप्तिमान: तेजोमण्डित तेजपूर्ण कान्तिमान जाज्वल्यमान प्रकाशमान दिव्य चम्किलो प्रकाशपूर्ण दीप्तिपूर्ण प्रकाशमान आलोकित ज्योतित
दीर्घजीवी: चिरञ्जीव चिरञ्जीवी चिरजीवी दीर्घजीवी दीर्घायु आयुष्मान चिरायु
दीर्घदर्शी: दूरदर्शी अग्रसोची दीर्घप्रज्ञ दीर्घदर्शी
दीर्घदृष्टी: दूरदर्शी अग्रसोची दीर्घप्रज्ञ दीर्घदर्शी
दीर्घायु: चिरञ्जीव चिरञ्जीवी चिरजीवी दीर्घजीवी दीर्घायु आयुष्मान चिरायु
दुःखकारक: दुखद दुखदायी दुखप्रद
दुःखद: दुखद दुखदायी दुखप्रद
दुःखदायक: दुखद दुखदायी दुखप्रद
दुःखमय: दुखमय दुखद दुखपूर्ण कष्टपूर्ण
दुःखरहित: शोकहीन अवसादहीन अशोक विशोक
दुःखित: शोकपूर्ण शोकाकुल शोकग्रस्त दुखी पीड़ित व्यथित दुःखी आर्त दुखित पीडित ग्रस्त ग्रसित व्यथित
दुःखी: शोकपूर्ण शोकाकुल शोकग्रस्त दुखी पीड़ित व्यथित दुःखी आर्त दुखित पीडित ग्रस्त ग्रसित व्यथित
दुखणाईत: रोगी बिमारी बिरामी पन्थे रुग्न
दुखणेकरी: रोगी बिमारी बिरामी पन्थे रुग्न
दुतर्फा: दुईतर्फे दुईतर्फा
दुतोंडा: दुइमुखे दुइमुखे दुइजिब्रे
दुतोंडी: दुईमुखे दुइटा_मुख_भएको
दुतोंड्या: दुईमुखे दुइटा_मुख_भएको
दुधड: दुधालु
दुधार: दोधारे
दुधारी: दोधारे
दुधाळू: दुधालु
दुपट: दुई_गुणा
दुप्पट: दुई_गुणा
दुबळा: कमजोर दुर्बल अशक्‍त
दुभती: दुधालु
दुय्यम: अप्रधान अप्रमुख आनुषङ्गिक गौण अमुख्य
दुरंगी: दुई_रङ्गी
दुराकलनीय: अबुझ
दुराग्रही: दुराग्रही
दुराचरणी: दुष्कर्मी अकृत्यकारी अपकर्मी खल अकर्मी
दुराचारी: दुष्कर्मी अकृत्यकारी अपकर्मी खल अकर्मी
दुरापास्त: असम्भव असंभव नघट्नु_पर्ने असंभावित
दुरुस्त: राम्रो ठीकठाक‍
दुर्गंधयुक्त: दुर्गंधपूर्ण दुर्गंधयुक्त दुर्गंधित
दुर्गम: कठिन दुर्गम अगम्य अगम दुरूह दुर्गम्य अगत आगम
दुर्गुणी: दुर्गुणी बैगुनी अगुणी अपगुणी
दुर्जन: दुष्ट दुर्जन अधम खल शठ हरामी पाजी अमति कुमति पामर अशील असज्जन असाधु असित दुष्कर्मी अकृत्यकारी अपकर्मी खल अकर्मी
दुर्ज्ञेय: दुर्बोध्य अति_गूढ दुरूह गम्भीर अप्ठ्यारो जटिल गाह्रो
दुर्दम्य: अदम्य
दुर्दैवी: दुर्भाग्यशाली अभागी भाग्यहीन
दुर्बल: मन्द मंद अप्रबल निस्तेज कुण्ठित कुंठित कमजोर दुर्बल अशक्‍त
दुर्बळ: मन्द मंद अप्रबल निस्तेज कुण्ठित कुंठित
दुर्बोध: दुर्ग्राह्य दुर्ग्रह दुर्ग्राही दुर्ज्ञेय दुर्बोध
दुर्लक्षित: उपेक्षित
दुश्चित: उद्विग्न हताश_भएको डराएको
दुष्कर: दुष्कर दुःसाध्य दुःखसाध्य कष्‍टसाध्य
दुष्कर्मी: दुष्कर्मी अकृत्यकारी अपकर्मी खल अकर्मी
दुष्ट: दुष्ट दुर्जन अधम खल शठ हरामी पाजी अमति कुमति पामर अशील असज्जन असाधु असित
दुष्प्राप्य: दुर्ग्राह्य दुर्ग्रह दुर्ग्राही
दुसरा: अरू अर्को दोस्रो द्वितीय पराई बिरानो परचक्री अन्य अर्को इतर अर्कै
दुसर्‍याचा: उपोष्णकटिबन्धीय उपोष्णकटिबंधीय
दुसाहसी: दुस्साहसी ढीठ दुःसाहसी
दुस्तर: अपारगम्य अगम्य अपार दुस्तर दुष्पार्य अगम
दुहेरी: दोहोरो
दूधपिता: दुधेबालक दुधमुखे दूधखाने
दूरचा: दूर दूरवर्ती दूरस्थ
दूरदर्शी: दूरदर्शी अग्रसोची दीर्घप्रज्ञ दीर्घदर्शी
दूरस्थ: दूर दूरवर्ती दूरस्थ
दूषित: दूषित दोषयुक्त ख़राब
दृग्गोचर: दृश्यमान दृश्य दृष्टिगोचर चाक्षुष देखिने
दृढ: अविचलित अडिग अविचल स्थिर थिर दृढ अचल अविचल निश्चल गतिहीन अविचलित अटल दृढ़ अटल अडिग अविचल स्थिर कायम घनिष्ठ आत्मीय अन्तरङ्ग अन्तरंग गाढा अनन्य अभिन्न प्रगाढ अङ्गरङ्गी अन्तरंगी इष्ट अन्यतम
दृश्यमान: दृश्यमान दृश्य दृष्टिगोचर चाक्षुष देखिने
दृष्टिगोचर: दृश्यमान दृश्य दृष्टिगोचर चाक्षुष देखिने
दृष्टिहीन: अन्धो नेत्रहीन
देखणा: राम्रो सुन्दर
देण्याजोगा: देय दाय प्रदेय दातव्य
देदीप्यमान: तेजोमण्डित तेजपूर्ण कान्तिमान जाज्वल्यमान प्रकाशमान दिव्य चम्किलो प्रकाशित उज्यालो चहकिलो
देय: बकाया एरियार दातव्य दाय
देवतेला_अर्पित: देवदत्त
देवतेला_अर्पिलेला: देवदत्त
देवतेला_वाहिलेला: देवदत्त
देवदत्त: देवदत्त
देवार्पित: देवदत्त
देशभक्त: किनेको
देशांतर्गत: अन्तर्देशीय देशान्तर्गत
देशातल्या_देशात: अन्तर्देशीय देशान्तर्गत
देशी: स्वदेशीय देशी देसी स्वदेशी देशीय देशज देशीय देशी
देशीय: देशीय देशी
देहधारी: शरीरी अङ्गधारी अङ्गी तनुधारी सदेही सशरीरी शरीरधारी देहवान
देहरहित: अशरीरी अशारीरिक विदेह अशरीरी अकाय शरीरहीन अगात्र अतनु अदेह शरीरविहीन अपाङ्ग अपिण्डी पिण्डरहित
दैनिक: दैनिक प्रत्येक_दिन
दैवप्रधान: प्रारब्धाधीन नियति_अधीन पूर्व_निश्चित विधिवश
दैववश: प्रारब्धाधीन नियति_अधीन पूर्व_निश्चित विधिवश
दैववादी: भाग्यवादी प्रारब्धवादी दैववादी
दैवाधीन: प्रारब्धाधीन नियति_अधीन पूर्व_निश्चित विधिवश
दैवानुरोधी: प्रारब्धाधीन नियति_अधीन पूर्व_निश्चित विधिवश
दैवानुसारी: प्रारब्धाधीन नियति_अधीन पूर्व_निश्चित विधिवश
दैवी: ईश्वरीय ईश्वरी दैवी परमेश्वरी
दोन: दुई
दोषमुक्त: रिहा आरोप_मुक्‍त
दोषी: अपराधी दोषी कसुरवार
द्रव: तरल द्रव
द्रवित: द्रवित द्रवीभूत
द्रव्यहीन: निर्धन गरीब दरिद्र
द्राव्य: घोलिने_खालको विलय_हुने_खालको
द्वाड: चकचके चञ्‍चल चुलबुले
द्वितीय: दोस्रो द्वितीय
द्वीपकल्पाची: प्रायद्वीपीय
द्वीपकल्पीय: प्रायद्वीपीय
द्वीपीय: द्वीपी द्वीपीय
द्वेषपूर्ण: ईर्ष्यापूर्ण आरिसे द्वेषपूर्ण साविद्वेष सासूय विद्वेशपूर्ण वक्र
धट्टाकट्टा: बलियो दह्रो मोटो
धन: धनात्मक
धनवंत: धनाढ्य धनी धनवान
धनवान: धनाढ्य धनी धनवान
धनाढ्य: धनाढ्य धनी धनवान
धनात्मक: धनात्मक
धनिक: धनाढ्य धनी धनवान
धनी: धनी धनवान
धर्मनिरपेक्ष: धर्मनिरपेक्ष
धर्मपरायण: धार्मिक धर्मशील धर्मी धर्मनिष्ठ
धर्मशील: धार्मिक धर्मशील धर्मी धर्मनिष्ठ
धर्मांध: धर्मान्ध
धर्मातीत: धर्मनिरपेक्ष
धर्मार्थ: धर्मार्थ धर्मका_निम्ति पुण्यका_लागि
धवल: श्वेत सेतो शुक्ल
धष्टपुष्ट: बलियो दह्रो मोटो
धाकटा: कान्छो कनिष्ठ साना_भाइ भाइ
धाडलेला: पठाउनु_भएको प्रेषित
धाडशी: वीर बहादुर सुरो पराक्रमी पुरूषार्थी पौरखी
धाडसी: निडर अभय निर्भय निर्भीक बेडर भयहीन निर्भीत अपभय अपभीति निःशंक अपशंक अभीत अभीरु साहसी हिम्मती बहादुर
धातुविषयक: धात्वीय धात्विक
धारदार: धारिलो धार_भएको
धारी: धारी धारण_गर्ने ग्रहण_गर्ने
धार्जिणा: अनुकूल अनुसार अनुरूप मुताबिक
धार्मिक: धार्मिक धर्मीय धार्मिक धर्मशील धर्मी धर्मनिष्ठ
धावणारा: अभिद्रुत
धावत_असलेला: अभिद्रुत
धिप्पाड: महाकाय अतिकाय बृहत्काय विशालकाय भीमकाय विकराल
धिराचा: धैर्यशील धैर्यवान धीर
धीट: निडर अभय निर्भय निर्भीक बेडर भयहीन निर्भीत अपभय अपभीति निःशंक अपशंक अभीत अभीरु साहसी हिम्मती बहादुर
धीमा: मन्द बिस्तारो मन्थर मन्द ढिलो सुस्त
धीराचा: स्थिरचित्त शान्त स्थिर प्रशान्त अचञ्चल प्रशान्त
धुकट: धमिलो अस्पष्ट
धुरकट: धमिलो अस्पष्ट
धुळमय: धुस्रोफुस्रो धूलधूसरित
धूर्त: धोकाबाज बेइमानी_गर्ने धूर्त कपटी छली छक्याउने
धूळ_लागलेला: धुस्रोफुस्रो
धूळीत_माखलेला: धुस्रोफुस्रो
धूसर: धमिलो अस्पष्ट
धृष्ट: धृष्ट उच्छृङ्खल ढीठ निडर उद्धत
धैर्यवान: धैर्यशील धैर्यवान धीर
धोकेबाज: धोकाबाज बेइमानी_गर्ने धूर्त कपटी छली
ध्यानमग्न: ध्यानमग्न ध्याननिष्ठ तपस्यारत
ध्यानस्थ: ध्यानमग्न ध्याननिष्ठ तपस्यारत
ध्वनिक्षेपित: प्रसारित
न_आलेला: अनागत अप्राप्त नआएको
न_आवडलेला: मन_नपर्दो अप्रिय अनभीष्ठ अनभिमत अमनोनीत
न_उमललेला: अपुष्पित अविकसित मुकुलित अस्मित
न_कपलेला: नकाटेको अनुच्छिन्न अखण्डित
न_कळलेला: नबुझेका
न_कापलेला: नकाटेको अनुच्छिन्न अखण्डित
न_केलेला: नगरिएको अकृत
न_खाण्याजोगा: अखाद्य अभोज्य अभोज
न_जोखलेला: अतुल्य अतुलनीय
न_तुटणारा: अटुट भञ्जनशील अभञ्जनीय
न_तोललेला: अतुल्य अतुलनीय
न_नमलेला: अडिग अनत अनमित
न_नांगरलेला: बाँझो अजोत
न_परतणारा: अपरावर्ती
न_पोहोचलेला: अनागत अप्राप्त नआएको
न_प्राप्त_झालेला: अप्राप्त
न_फुललेला: अपुष्पित अविकसित मुकुलित अस्मित
न_बरसणारा: नझर्ने
न_बहरलेला: अपुष्पित अविकसित मुकुलित अस्मित
न_मस्तवलेला: अप्रमाद अभ्रान्त
न_मापलेला: अमापित अपरिमापित अपरिमित नमापिएको नजोखिएको
न_मोजलेला: अनगन्ती अगणित
न_मोडणारा: भञ्जनशील अभञ्जनीय
न_रंगविलेला: सादा
न_लोटलेला: अव्यतीत अगत अविगत
न_सांगण्याजोगा: अकथनीय अकथ्य अकथ अव्यक्तव्य अवाच्य
न_सुटलेला: असमाधानित नसुल्झिएको
नंगा: नाङ्गो नग्न निर्वस्त्र
नंतरचा: परवर्ती
नऊ: नौ ९ 9
नऊपट: नौ_गुना नौगुणा
नकली: खोटो नकली
नकल्या: देखासिकी नक्कल अनुकृति
नक्कल्या: देखासिकी नक्कल अनुकृति
नक्की: निश्‍चयात्मक पक्का
नक्षीदार: बुनेको
नखराळ: ढर्रे स्वाङे
नखरेबाज: ढर्रे स्वाङे
नखरेल: ढर्रे स्वाङे
नगण्य: नगण्य यस्तो-उस्तो अगण्य अनुदात्त
नगरवासी: सहरी नगरवासी नगर_निवासी नगर-वासी नगर-निवासी नगरनिवासी नगरवासी शहराती नागर अग्राम्य
नगरविषयक: सहरको नगरको
नगराचा: सहरको नगरको
नगराबाबतचा: सहरको नगरको
नगराविषयीचा: सहरको नगरको
नगराशी_संबंधित: सहरको नगरको
नगरासंबंधीचा: सहरको नगरको
नग्न: नाङ्गो नग्न निर्वस्त्र
नजीकचा: निकटस्थ छेउको निकटको समिपको निकटवर्ती समीपी सन्निकट समीपवर्ती समीपस्थ
नटलेला: अलङ्कृत अलंकृत आभूषित भूषित सज्जित विभूषित अलंकारिक अलंकारपूर्ण अभिलमंडित अभिलमण्डित
नटवलेला: अलङ्कृत अलंकृत आभूषित भूषित सज्जित विभूषित अलंकारिक अलंकारपूर्ण अभिलमंडित अभिलमण्डित
नपुंसक: नामर्द नपुंसक पौरुषहीन पुरषत्वहीन वीर्यहीन अपौरुष अपुरुष शंड
नफा_मिळालेला: लाभान्वित लाभ_प्राप्तकर्ता
नभोगामी: नभचर नभश्‍चर अकासगामी
नम्र: निरभिमानी अनभिमानी अभिमानरहित गर्वहीन दर्पहीन अदम्भी अदर्पी निरहङ्कारी अहङ्कारहीन दम्भहीन निरहङ्कर निरहङ्कृत सीधा अनमद अहङ्काररहित गर्वरहित मदशून्य अमानी अभिमानशून्य अमत्त घमण्डरहित विनम्र नम्र विनयी अवनमित नमित
नर: नर
नरभक्षक: नरभक्षी मनुष्यभक्षी मान्छेखाने
नरम: नरम कमलो कोमल
नव: नयाँ नौलो नवीन हालैको
नवखा: सिकारू काँचो कच्चा नव_प्रशिक्षित नयाँ असिद्ध अनभ्यस्त अपक्व अपरिपक्क अनुभवहीन काँचो कच्चा अल्हरे स्वाँठ
नववा: नवौँ नवम
नवशिका: सिकारू काँचो कच्चा नव_प्रशिक्षित नयाँ असिद्ध अनभ्यस्त अपक्व अपरिपक्क
नवा: सिकारू काँचो कच्चा नव_प्रशिक्षित नयाँ असिद्ध अनभ्यस्त अपक्व अपरिपक्क नयाँ नौलो नवीन हालैको अनुभवहीन काँचो कच्चा अल्हरे स्वाँठ
नवीन: सिकारू काँचो कच्चा नव_प्रशिक्षित नयाँ असिद्ध अनभ्यस्त अपक्व अपरिपक्क नयाँ नौलो नवीन हालैको
नव्याण्णवावा: उनान्सय निरानब्बे
नव्वद: नब्बे
नव्वदावा: नब्बेऔं
नशाखोर: नशाबाज
नशाबाज: नशाबाज
नशीबवान: सौभाग्यशाली भाग्यवान भाग्यशाली
नशीला: मत्त मस्त
नश्वर: नश्वर अशाश्वत क्षणजीवी क्षयशील नाशवान भंगुर विनाशी अनित्य मेटिने नाशुक अनित
नष्ट: नष्ट चौपट तहस-नहस ध्वस्त समाप्त बरबाद बर्बाद ध्वंसित अपध्वस्त विनष्ट निकंदन चकनाचुर
नाखूश: अप्रसन्न नाराज रुष्ट खिन्न अप्रतीत
नागडा: नाङ्गो नग्न निर्वस्त्र
नागडाउघडा: नाङ्गो नग्न निर्वस्त्र
नागर: सहरी नगरवासी नगर_निवासी नगर-वासी नगर-निवासी नगरनिवासी नगरवासी शहराती नागर अग्राम्य सहरको नगरको
नागरी: सहरको नगरको
नागवा: नाङ्गो नग्न निर्वस्त्र
नाजूक: नाजुक कमजोर दुर्बल निम्छरो
नाटकी: देखावटी नकली बनावटी बनौटी कृत्रिम अप्रकृत अयाथार्थिक नाटकीय
नाटकीय: नाटकीय
नाट्यपूर्ण: नाटकीय
नाट्यमय: नाटकीय
नाट्यविषयक: नाटकीय
नाणावलेला: प्रसिद्ध प्रख्यात ख्याति_प्राप्‍त
नाथहीन: अनाथ टुहुरो
नादार: दिवालिया दीवालिया टाट_उल्टेको
नादुरुस्त: क्षतिग्रस्त
नाना: अनेक कैयौं विविध नाना एकाधिक अनेकानेक तमाम
नापसंत: मन_नपर्दो अप्रिय अनभीष्ठ अनभिमत अमनोनीत अप्रिय अप्रीतिकर नमिठो नचाहिँदो
नापास: अनुत्तीर्ण फेल
नापीक: बाँझो अनुर्वर
नामंजूर: अस्वीकृत नामंजूर सहमतिहीन सहमति_अप्राप्त
नाममात्र: तथाकथित नाम_मात्रको
नामवंत: प्रसिद्ध प्रख्यात ख्याति_प्राप्‍त
नामशेष: नष्ट चौपट तहस-नहस ध्वस्त समाप्त बरबाद बर्बाद ध्वंसित अपध्वस्त विनष्ट निकंदन चकनाचुर
नामांकित: प्रसिद्ध प्रख्यात ख्याति_प्राप्‍त नामङ्कित मनोनीत
नारंगी: सुन्तले नारङ्गी
नाराज: अप्रसन्न नाराज रुष्ट खिन्न अप्रतीत
नारिंगी: सुन्तले नारङ्गी
नार्वेजियन: नर्वेजियन
नालायक: अयोग्य अनुपयुक्त नालायक ना-लायक अनलायक अपारग अप्रभु अयथा अयुक्त अयुक्तरूप अयोग कुपात्र अपात्र अनधिकारी अभाजन
नावडता: मन_नपर्दो अप्रिय अनभीष्ठ अनभिमत अमनोनीत अप्रिय अप्रीतिकर नमिठो नचाहिँदो
नावाजलेला: प्रसिद्ध प्रख्यात ख्याति_प्राप्‍त
नाशवंत: नश्वर अशाश्वत क्षणजीवी क्षयशील नाशवान भंगुर विनाशी अनित्य मेटिने नाशुक अनित
नासका: कुहिएको गलेको सडेको
निंदक: निन्दक अपवादक अपवादिक अपवादी आक्षेपी आक्षेपक अभिसन्धक
निंदनीय: निन्दनीय निंदनीय निद्य निंदात्मक
निंदात्मक: निन्दात्मक
निंदेने_युक्त: निन्दात्मक
निंदेवर_आधारित: निन्दात्मक
निंद्य: निन्दनीय निंदनीय निद्य निंदात्मक
निःकपट: निष्कपट विश्‍वासी
निःशंक: निश्शङ्क अनाशङ्कित आशङ्काहीन संशयहीन निश्शंक अनाशंकित आशंकाहीन असन्दिग्ध संदेहहीन असन्दिग्ध सन्देहहीन
निःशब्द: सुनसान निस्तब्ध चकमन्न
निःशस्त्र: शस्त्रहीन निहत्था निरस्त्र
निःशुल्क: निःशुल्क मुफ्त निशुल्क
निःसंकट: निरापद आपत्तिरहित निर्विघ्न सुरक्षित
निःसंकोच: नि
निःसंकोची: निसङ्कोची निर्धक्क
निःसंदिग्ध: असन्दिग्ध संदेहहीन असन्दिग्ध सन्देहहीन
निःसंदेह: असन्दिग्ध संदेहहीन असन्दिग्ध सन्देहहीन
निःसंदेह_असणारा: सन्देहहीन शङ्काहीन
निःसंशायात्मक: सन्देहहीन शङ्काहीन
निःसत्त्व: निस्सार खोखला निसार साररहित सत्वहीन निःसत्व
निकटवर्ती: निकटस्थ छेउको निकटको समिपको निकटवर्ती समीपी सन्निकट समीपवर्ती समीपस्थ
निकामी: अकर्मण्य निकम्मा अयोग्य
निकृष्ट: घटिया निकृष्ट नीच अधम क्षुद्र निकृष्टतम अधमाधम तुच्छातितुच्छ
निके: राम्रो शुद्ध चोखो असल
निकोप: स्वस्थ्य निरोगी
निखर्व: नील
निगर्वी: निरभिमानी अनभिमानी अभिमानरहित गर्वहीन दर्पहीन अदम्भी अदर्पी निरहङ्कारी अहङ्कारहीन दम्भहीन निरहङ्कर निरहङ्कृत सीधा अनमद अहङ्काररहित गर्वरहित मदशून्य अमानी अभिमानशून्य अमत्त घमण्डरहित
निग्रही: अनुरोधी आग्रही अनुरोधक
निघालेला: हिँडेका
निजलेला: निद्रामग्न सुतेको निद्रित निद्रागत स्वप्निल सुप्त सुप्तविग्रह सुप्तस्थ
निडर: निडर अभय निर्भय निर्भीक बेडर भयहीन निर्भीत अपभय अपभीति निःशंक अपशंक अभीत अभीरु चकचके चुलबुले उदण्ड ऊछृङ्खल
नितांतरम्य: रमणीय रम्य रमणीक
नित्य: अमर अक्षय अनश्वर शाश्वत अक्षुण्ण अक्षुण अनष्ट अविनाशी अविनासी अक्षय्य अच्युत अभङ्ग अनाश अनाश्य अनाशवान अभङ्गुर अखय अक्षुण्य
निद्राकांत: निदाएको निद्रालु निद्राग्रस्त
निद्राकुल: निदाएको निद्रालु निद्राग्रस्त
निद्राग्रस्त: निदाएको निद्रालु निद्राग्रस्त
निद्रातुर: निदाएको निद्रालु निद्राग्रस्त
निद्राधीन: निद्रामग्न सुतेको निद्रित निद्रागत स्वप्निल सुप्त सुप्तविग्रह सुप्तस्थ
निद्रान्वित: निदाएको निद्रालु निद्राग्रस्त
निद्रामग्न: निद्रामग्न सुतेको निद्रित निद्रागत स्वप्निल सुप्त सुप्तविग्रह सुप्तस्थ
निद्रालु: निदाएको निद्रालु निद्राग्रस्त
निद्राळू: निदाएको निद्रालु निद्राग्रस्त
निद्राशील: निदाएको निद्रालु निद्राग्रस्त
निद्रित: निद्रामग्न सुतेको निद्रित निद्रागत स्वप्निल सुप्त सुप्तविग्रह सुप्तस्थ
निद्रिस्त: निद्रामग्न सुतेको निद्रित निद्रागत स्वप्निल सुप्त सुप्तविग्रह सुप्तस्थ
निधडा: साहसी हिम्मती बहादुर
निनावी: बेनामी गुमनाम
निपुण: सिपालु प्रवीण निपुण पारङ्गत दक्ष माहिर अभ्यस्त कुशल होशियार पक्का सिद्धहस्त शातिर पटु पका निष्णात परिपक्व कार्यकुशल विचक्षण अभिज्ञ अभ्यासी आप्त
निबिड: सघन घना गहन सङ्घात
निमंत्रित: निमन्त्रित आमनत्रित निम्त्याइएको बोलाइएको निम्तो_गरिएको
निमकहराम: कृतघ्न अकृतज्ञ
निमग्न: तल्लीन अनुरत निमग्न लीन तन्मय मग्न मगन दत्तचित्त लिप्त रत निरत अनुरक्त अनुसंरक्त अभिनिविष्ट
निमसरकारी: अर्द्धसरकारी अर्धसरकारी अर्द्धशासकीय अर्धशासकीय
निमुळता: साँघुरो साँगुरो साङ्ग्रो
निम्न: निम्न तल्लो
निम्मा: आधा अर्द्ध पचास_प्रतिशत अर्ध अद्ध
नियंत्रित: नियन्त्रित
नियत: निश्चित निर्धारित नियत नियमित ठिक निर्दिष्ट निर्धारित सीमित नियत
नियमबद्ध: नियमी नेमी नियम_पालक आत्मानुशासी नियमित नियमबद्ध
नियमरहित: अनियमित नियमरहित बेफाइदा
नियुक्त: नियुक्त तैनाथ नियोजित
नियोजित: व्यवस्थित प्रबन्धित विन्यस्त ठिक
निरंकुश: निरङ्कुश स्वेच्छाचारी अप्रतिबन्धित मनमोजी मनमौजी स्वच्छन्द अत्याचारी अन्यव्रत अप्रतिबद्ध अबद्ध
निरंतर: अनवरत लगातार निरन्तर
निरक्षर: अशिक्षित अनपढ निरक्षर
निरपराध: निर्दोष बेकसुर निरपराध निरपराधी अपराधहीन अदोष अनपराध अनपराधी
निरपराधी: निर्दोष बेकसुर निरपराध निरपराधी अपराधहीन अदोष अनपराध अनपराधी
निरपवाद: निरपवाद
निरपेक्ष: निष्काम निरपेक्ष
निरभिमानी: निरभिमानी अनभिमानी अभिमानरहित गर्वहीन दर्पहीन अदम्भी अदर्पी निरहङ्कारी अहङ्कारहीन दम्भहीन निरहङ्कर निरहङ्कृत सीधा अनमद अहङ्काररहित गर्वरहित मदशून्य अमानी अभिमानशून्य अमत्त घमण्डरहित
निरभ्र: स्वच्छ मेघहीन निरभ्र अनभ्र मेघरहित अनाकाश अमेघ
निरर्थक: अर्थहीन निरर्थक निष्फल असफल विफल व्यर्थ निरर्थक
निरर्थकमग्न: नचाहिँदो वाहियात अनुचित निरर्थक अनर्थक अर्थहीन अनुचित अर्थरहित निरर्थक
निरलस: जावगरिलो मिहिनेती परिश्रमी_आलस्यहीन
निरवधि: अनन्त असमाप्य अन्त्यहीन अनंत अंतहीन
निरवधिक: अनन्त असमाप्य अन्त्यहीन अनंत अंतहीन
निरवयव: निराकार अमूर्त निरङ्कार आकारविहीन अनवाय अनवय निरवयव अनाकार अपिरच्छन्न अमूर्त्त अमूर्त्ति अमूर्ति आकृतिहीन अमूर्तमान अमूर्तिमान अमूर्त्तिमान मूर्तिरहित अरूप अरूपक
निरस: अरोचक अरुचिकर नीरस रसहीन रुचिहीन फीका असार
निरहंकारी: निरभिमानी अनभिमानी अभिमानरहित गर्वहीन दर्पहीन अदम्भी अदर्पी निरहङ्कारी अहङ्कारहीन दम्भहीन निरहङ्कर निरहङ्कृत सीधा अनमद अहङ्काररहित गर्वरहित मदशून्य अमानी अभिमानशून्य अमत्त घमण्डरहित
निराकांक्ष: इच्छाहीन अकाम आकाङ्क्षाहीन निष्काम अनभिलाषा
निराकार: निराकार अमूर्त निरङ्कार आकारविहीन अनवाय अनवय निरवयव अनाकार अपिरच्छन्न अमूर्त्त अमूर्त्ति अमूर्ति आकृतिहीन अमूर्तमान अमूर्तिमान अमूर्त्तिमान मूर्तिरहित अरूप अरूपक
निरागस: नावालक निरीह
निराधार: टुहुरो अनाथ यतीम लावारिस असहाय निस्सहाय बेसहारा निराश्रित निराश्रय अनाश्रित आश्रयहीन अपाश्रय निरवलम्ब अवलम्बहीन अवलम्बनहीन  अनवस्थित अनाथ निरवलम्ब अनाश्रित निःसहाय निराधार अप्रामाणिक तथ्यहीन आधारहीन सारहीन निर्मूल यथार्थहीन अनाधार आधाररहित निराश्रित अनाश्रित आश्रयहीन अपाश्रय निराश्रय निराधार पराश्रित पराश्रय पराधीन निराश्रित
निरानर्थ: निरापद आपत्तिरहित निर्विघ्न सुरक्षित
निरापद: निरापद आपत्तिरहित निर्विघ्न सुरक्षित
निरामय: स्वस्थ्य निरोगी
निराळा: विभाजित विभक्त अलग अलग छुट्टै पृथक् फरक
निरावलंब: स्वावलम्बी आत्मावलम्बी
निराश: हताश निराश खिन्न
निराश्रित: टुहुरो अनाथ यतीम लावारिस निराश्रित अनाश्रित आश्रयहीन अपाश्रय निराश्रय पराश्रित पराश्रय पराधीन निराश्रित
निरिच्छ: इच्छाहीन अकाम आकाङ्क्षाहीन निष्काम अनभिलाषा अनिच्छुक अनभिलाषी निस्पृही अनिच्छु निराकाङ्क्षी अभिलाषारहित
निरुंद: साँघुरो साँगुरो साङ्ग्रो
निरुत्साही: स्फूर्तिहीन अस्फूर्त उत्साहहीन अनुत्साही निरुत्साह हतोत्साहित निरुत्साहित
निरुद्योगी: अकर्मण्य निकम्मा बेकार फालतू अकर्मा नालायक ना-लायक अनलायक_नालायक ना-लायक उद्यमहीन पुरुषार्थहीन अपरिश्रमी अनुद्यमी अप्रयत्‍न अप्रयास अयत्‍न यत्‍नरहित उद्योगहीन
निरुपयोगी: अनुपयोगी अनावश्यक उपयोगहीन निरर्थक व्यर्थ फालतू रद्दी अनर्थक
निरुपाई: अनुपाय
निरुपाय: अनुपाय विकल्पहीन उपायहीन निरुपाय विवश अनन्यगति अनन्यगतिक
निरुपायी: अनुपाय
निरूपणीय: अवर्णनीय अकथनीय वर्णनातीत शब्दातीत अकथ अकथ्य अनभिधेय अनिर्वचनीय अनिर्वाच्य
निरोगी: स्वस्थ्य निरोगी
निर्गुण: अशरीरी अशारीरिक
निर्गृण: क्रूर निर्दय कठोर निर्दयी निष्ठुर नृशंस करुणाहीन दयारहित दयाहीन उग्र करुणाविहीन अदयालु
निर्जन: निर्जन एकान्त सुनसान जनशून्य
निर्जल: निर्जलीय जलविहीन निर्जला निर्जल
निर्जला: निर्जलीय जलविहीन निर्जला निर्जल
निर्जीव: निर्जीव निष्प्राण अजीवित जीवनहीन अजीव अप्राण अप्राणी
निर्णायक: निर्णायक
निर्णीत: निर्णीत निर्णय_गरिएको
निर्दय: क्रूर निर्दय कठोर निर्दयी निष्ठुर नृशंस करुणाहीन दयारहित दयाहीन उग्र करुणाविहीन अदयालु
निर्दयी: क्रूर निर्दय कठोर निर्दयी निष्ठुर नृशंस करुणाहीन दयारहित दयाहीन उग्र करुणाविहीन अदयालु
निर्दिष्ट: निर्देशित निर्दिष्ट
निर्दोष: निर्दोष बेकसुर निरपराध निरपराधी अपराधहीन अदोष अनपराध अनपराधी
निर्दोषी: निर्दोष बेकसुर निरपराध निरपराधी अपराधहीन अदोष अनपराध अनपराधी
निर्धन: निर्धन गरीब दरिद्र
निर्धारित: निश्चित निर्धारित नियत नियमित ठिक निर्दिष्ट निर्धारित सीमित नियत
निर्धास्त: निश्शङ्क अनाशङ्कित आशङ्काहीन संशयहीन निश्शंक अनाशंकित आशंकाहीन
निर्नायकीय: अराजक
निर्बल: कमजोर दुर्बल अशक्‍त
निर्बुद्ध: मूर्ख अज्ञानी बुद्धु ज्ञानहीन अज्ञानपूर्ण
निर्भय: निडर अभय निर्भय निर्भीक बेडर भयहीन निर्भीत अपभय अपभीति निःशंक अपशंक अभीत अभीरु
निर्भीड: अक्खड
निर्भेळ: राम्रो शुद्ध चोखो असल
निर्भ्रांत: निश्शङ्क अनाशङ्कित आशङ्काहीन संशयहीन निश्शंक अनाशंकित आशंकाहीन असन्दिग्ध संदेहहीन असन्दिग्ध सन्देहहीन
निर्मत्सर: ईर्ष्याहीन द्वेषहीन अद्वेषी आरिसहीन
निर्मल: पवित्र शुद्ध निर्मल सफा
निर्मळ: पवित्र शुद्ध निर्मल सफा
निर्मित: निर्मित रचित विरचित सृष्ट कृत सर्जित सृजित संरचित पर्णीत प्रकृत प्रणीत
निर्मेघ: स्वच्छ मेघहीन निरभ्र अनभ्र मेघरहित अनाकाश अमेघ
निर्मोही: निठुरी निर्मोही निर्मम अमोही
निर्यातक: निर्यातक
निर्यातकरी: निर्यातक
निर्यातीत: निर्यात_गरेको पठाएको
निर्लज्ज: निर्लज्ज लज्जाहीन छाडा
निर्लोभी: निस्पृह निर्लोभ लोभहीन लालचहीन
निर्वस्त्र: नाङ्गो नग्न निर्वस्त्र
निर्वासित: उजाडिएको सुनसान निर्जन शरणार्थी रेफ्युजी
निर्विघ्न: निरापद आपत्तिरहित निर्विघ्न सुरक्षित
निर्विवाद: निर्विवाद
निर्व्यसनी: निर्व्यसनी अव्यसनी
निलाजरा: निर्लज्ज लज्जाहीन छाडा
निळा: नीलो
निवडक: छानेको छुट्याएको पन्छाएको
निवडण्यास_अयोग्य: नचुनिएको अनिर्वाच्य नछानिएको
निवडलेला: मनोनीत रोजिएक चुनिएको छानिएको
निवडून_आलेला: निर्वाचित चुनिएको
निवारक: निवारक रोक्‍ने हटाउने नाशक
निवासी: आवासयुक्त गृहयुक्त आवासिक घरबारयुक्त घरबारी
निवृत्तीवेतनविषयक: अनुवृत्ति आनुवृत्तिक आनुवृत्तिक
निवृत्तीवेतनाविषयीचा: अनुवृत्ति आनुवृत्तिक आनुवृत्तिक
निवृत्तीवेतनाशी_संबंधित: अनुवृत्ति आनुवृत्तिक आनुवृत्तिक
निवृत्तीवेतनासंबंधीचा: अनुवृत्ति आनुवृत्तिक आनुवृत्तिक
निशाचर: निशाचर रात्रिचर
निश्चल: स्थिर थिर दृढ अचल अविचल निश्चल गतिहीन अविचलित अटल अचेत चेतना_नभएको होस_गुमेको सुद्धी_हराएको बेहोस
निश्चिंत: निश्चिन्त चिन्तारहित चिन्ताहीन चिन्तामुक्त
निश्चित: निश्चित निर्धारित नियत नियमित ठिक निर्दिष्ट निश्‍चयात्मक पक्का निर्धारित सीमित नियत दुविधाहीन दुबिधाहीन सन्देहहीन संशयहीन सङ्कल्पित
निषिद्ध: मना मना_गरिएको निषिद्ध वर्जित प्रतिबन्धित प्रतिबंधित निषेधित वर्ज्य व्याहत
निषेधित: मना मना_गरिएको निषिद्ध वर्जित प्रतिबन्धित प्रतिबंधित निषेधित वर्ज्य व्याहत
निष्कंटक: कण्टकहीन अकण्टक शूलहीन
निष्कपट: सोझो सीधा सरल सीधा-सादा
निष्कपटी: सोझो सीधा सरल सीधा-सादा
निष्काम: कामहीन वासनाहीन निष्काम निर्मम
निष्कारण: बिनासित्ति अकारण
निष्काळजी: बेपरवाह बेपरवा बिन्दास अचिन्त
निष्क्रिय: निष्क्रिय असक्रिय सुप्‍त
निष्क्रीय: अल्छी सुस्त ढिलो
निष्ठावान: निष्ठावान आस्थावान भक्ति_भावापन्न
निष्ठाहीन: निष्ठाहीन
निष्ठुर: क्रूर निर्दय कठोर निर्दयी निष्ठुर नृशंस करुणाहीन दयारहित दयाहीन उग्र करुणाविहीन अदयालु
निष्णात: सिपालु प्रवीण निपुण पारङ्गत दक्ष माहिर अभ्यस्त कुशल होशियार पक्का सिद्धहस्त शातिर पटु पका निष्णात परिपक्व कार्यकुशल विचक्षण अभिज्ञ अभ्यासी आप्त
निष्पक्ष: तटस्थ निरपेक्ष उदासीन पक्षपातरहित अपक्षपाती निर्पेक्ष अनपेक्ष
निष्पक्षपाती: तटस्थ निरपेक्ष उदासीन पक्षपातरहित अपक्षपाती निर्पेक्ष अनपेक्ष पक्षपातहीन भेदभावहीन निष्पक्ष
निष्पर्ण: पातहीन पत्रहीन निपात
निष्पाप: पापहीन निष्पाप पापरहित निष्कलङ्क
निष्प्रभ: रगतहीन निस्तेज आभाहीन कांतिहीन ओजहीन प्रभाहीन बेरौनक अप्रभ प्रभारहित श्रीहत
निष्फळ: अनुपयोगी अनावश्यक उपयोगहीन निरर्थक व्यर्थ फालतू रद्दी अनर्थक निष्फल असफल विफल व्यर्थ निरर्थक
निसंकोची: निसङ्कोची निर्धक्क
निसरडा: चिप्लो
निसुगा: निर्लज्ज लज्जाहीन छाडा
निस्तेज: म्लान न्याउरो न्यास्रो रगतहीन निस्तेज आभाहीन कांतिहीन ओजहीन प्रभाहीन बेरौनक अप्रभ प्रभारहित श्रीहत
निस्तेजस्क: म्लान न्याउरो न्यास्रो
निस्वार्थ: निस्वार्थ स्वार्थहीन
निस्संकोची: निसङ्कोची निर्धक्क
निस्सीम: असीम अनंत अनन्त अनादि अपरंपार अपरम्पार अपरिमित अपार असीमित अगाध अमित अनंता अनन्ता अनन्त्य अनंत्य अनधिक अनवधि अनिर्दिष्ट अपरिच्छिन्न अप्रमाण अबाध सीमारहित अमर्याद अमात्र मात्रारहित अमान अमाप अमित
निहित: निहित गर्भित राखिएको स्थापित दिइएको सुम्पिएको हुलिएको कोचिएको रहेको
नीच: लफङ्गो फटाहा लुच्चा बदमास दुष्ट
नीट_होणारा: फिट ठीक फिट ठीक
नीतिमान: विनयी नम्र
नीतियुक्त: नैतिकतापूर्ण नीतिपूर्ण नैतिक उचित सही
नीरव: सुनसान निस्तब्ध चकमन्न
नीरस: रसहीन बेरस सुखा शुष्क नीरस अरोचक अरुचिकर नीरस रसहीन रुचिहीन फीका असार
नूतन: नयाँ नौलो नवीन हालैको
नेक: शुद्ध_मन
नेटका: सुडौल सुगठित बान्की_परेको
नेत्रहीन: अन्धो नेत्रहीन
नेपाळी: नेपाली नेपाली
नेभळा: काँतर कायर काथर डरछेरुवा भीरु साहसहीन नामर्द हुपहारा पानीमरुवा पानीआन्द्रे
नेमका: ठीक उचित सठीक
नेमस्त: नियुक्त तैनाथ नियोजित
नेस्तनाबूत: नष्ट चौपट तहस-नहस ध्वस्त समाप्त बरबाद बर्बाद ध्वंसित अपध्वस्त विनष्ट निकंदन
नेस्तनाबूद: नष्ट चौपट तहस-नहस ध्वस्त समाप्त बरबाद बर्बाद ध्वंसित अपध्वस्त विनष्ट निकंदन
नेस्तानाबूद: चकनाचुर
नैतिक: नैतिकतापूर्ण नीतिपूर्ण नैतिक उचित सही
नैसर्गिक: प्राकृतिक नैसर्गिक प्राकृत अकृत्रिम प्रकृत स्वाभाविक स्वभावगत
नॉर्वेजियन: नर्वेजियन
न्यायनिष्ठ: न्याय_कर्ता न्यायी
न्यायपूर्ण: न्यायपूर्ण न्यायसङ्गत न्यायोचित
न्यायविषयक: न्याय_विषयक अदालती न्यायिक
न्यायसंगत: न्यायपूर्ण न्यायसङ्गत न्यायोचित
न्यायसंबंधी: न्याय_विषयक अदालती न्यायिक
न्यायी: न्याय_कर्ता न्यायी
न्यायोचित: न्यायपूर्ण न्यायसङ्गत न्यायोचित
न्यारा: अलग छुट्टै पृथक् फरक
पंच-: पाँच पाँचौँ पञ्च ५ 5
पंचविसावा: पच्चीसौँ
पंचवीस: पच्चीस
पंचाऐंशी: पचासी ८५ 85
पंचाण्णव: पन्चान्नब्बे ९५ 95
पंचाण्णवावा: पन्चानब्बेऔं
पंचावन्न: पचपन्न
पंचाहत्तर: भर्‍याङ लिस्नु खुड्किलो
पंचाहत्तरावा: पचहत्तरौं
पंचेचाळिसावा: पैंतालिसौं पैंताल्लीसौं ४५औं
पंचेचाळीस: पैँतालीस ४५
पंच्याऐंशीवा: पचासीऔं
पंच्याशीवा: पचासीऔं
पंजाबी: पन्जाबी पन्जाबी पन्जाबी
पंडित: विद्वान् ज्ञानी प्राज्ञ पण्डित विज्ञ
पंडिता: विदुषी प्राज्ञी
पंधरा: पन्ध्र १५
पंधरावा: पन्ध्रौँ १५_औं 15_औं
पंध्रावा: पन्ध्रौँ १५_औं 15_औं
पक्का: निश्‍चयात्मक पक्का अटुट दरो बलियो कठरो सारो
पक्की: स्थायी स्थाइ घोर गहिरो
पक्व: पाकेको
पक्षपाती: पक्षधर पक्षपाती समर्थक अनुमोदक पक्षपातपूर्ण भेदभावपूर्ण
पचलेला: पचेको हजम_भएको
पचवलेला: अधिग्रहीत अधिकृत अधिगत
पटाईत: सिपालु प्रवीण निपुण पारङ्गत दक्ष माहिर अभ्यस्त कुशल होशियार पक्का सिद्धहस्त शातिर पटु पका निष्णात परिपक्व कार्यकुशल विचक्षण अभिज्ञ अभ्यासी आप्त
पठनीय: पठनीय सुपाठ्य पाठ्य पठ्य अध्ययनीय अध्येतव्य अध्येय
पठारी: पठारी
पडका: भत्केको ढस्केको कोल्टिएको
पडकी: ध्वस्त बिग्रेको भत्केको नष्‍टभ्रष्‍ट
पडीक: बाँझो अनुर्वर
पडीत: बाँझो अनुर्वर
पतित: अवनत अधोगत अधोपतित झरेको पतित अनुपतित अपकृष्ट अपभ्रंशित पापी अधम अनाचारी पतित पातकी नीच पापकर्मी पापात्मा अधर्मी अधर्मिष्ट अधार्मिक म्लेच्छ अपकृष्ट कुमार्गी अपमार्गी अपाचारी दुष्ट भ्रष्ट पतित दूषित
पत्करलेला: अङ्गीकृत स्वकृत परिग्रहीत गृहीत स्वीकृत स्वाङ्गीकृत अभ्युपगत
पथभ्रष्ट: भ्रष्ट पतित दूषित
पथ्य_पाळणारा: संयमी नियमी संयमशील
पथ्याने_राहणारा: संयमी नियमी संयमशील
पदच्युत: निलम्बित निलंबित पदच्युत बरखास्त बरख्वास्त अपदस्थ अनुलंबित अनुलम्बित
पददलित: पददलित पदाक्रान्त दलित पाददलित थिचिएका कुल्चिएका पेलिएका हेपिएका
पदस्थ: पदस्थ
पद्म: पद्म
पन्नास: पचास ५० 50
पन्नास_टक्का: आधा अर्द्ध पचास_प्रतिशत अर्ध अद्ध
पन्नासावा: पचासौँ
परका: पराई बिरानो परचक्री उपोष्णकटिबन्धीय उपोष्णकटिबंधीय
परकीय: पराइ परजनीय अरूको अन्य_को परकीय अर्काको
परक्याचा: उपोष्णकटिबन्धीय उपोष्णकटिबंधीय
परजीवी: अन्यासक्त
परतंत्र: पराधीन गुलाम परतन्त्र अधीन अन्याधीन
परतलेले: भुटेको भुटेका
परतीचा: आउने फर्किने आउने फर्किने
परतीविषयक: आउने फर्किने
परतीविषयीचा: आउने फर्किने
परतीशी_संबंधित: आउने फर्किने
परतीसंबंधीचा: आउने फर्किने
परदेशी: विदेशी परदेशी परदेसी बिदेसी गैरमुल्की विलायती अन्यदेशीय अन्यराष्ट्रीय
परम: परम
परलोकातला: परलौकिक अलौकिक परलोकिय दिव्यलोक आधिदैविक आमुष्मिक
परवश: पराधीन गुलाम परतन्त्र अधीन अन्याधीन
परवानगी_मिळालेला: स्वीकृत अनुमति_दत्त अनुमति_प्रदत्त
परस्पर: पारस्परिक आपसी
परस्वाधीन: पराधीन गुलाम परतन्त्र अधीन अन्याधीन
पराक्रमी: पराक्रमी वीर विक्रमी
पराजित: पराजित परास्त अपध्वस्त
पराधीन: पराधीन गुलाम परतन्त्र अधीन अन्याधीन
पराभूत: पराजित परास्त अपध्वस्त
परावलंबी: परावलम्बी परावलम्बी आश्रित पराश्रयी पराश्रित परावलम्बित अनुजीवी परावलम्बिनी परावलंबिनी आश्रिता पराश्रयिता परावलंबिन परावलम्बिन
परासक्त: अन्यासक्त
परिचारक: स्याहारसुसार हेरचाह
परिचित: परिचित चिनेजानेको जानपहिचान_भएको परिचय_भएको अभिज्ञात पूर्व_परिचित
परिणामकारक: प्रभावशाली प्रभावकारी
परिणित: विवाहित बिहे_भएको परिणीत
परित्यक्त: त्यागेको परित्यक्‍त त्यक्‍त
परिधानीय: परिधानयोग्य
परिधेय: परिधानयोग्य
परिपक्व: परिपक्व अनुभवी कार्यकुशल प्रवीण प्रौढ
परिपूर्ण: परिपूर्ण भरिएको अभिपूर्ण पूर्ण
परिमेय: गणनीय गण्य
परिवर्तनशील: परिवर्तनशील परिवर्तनीय परिवर्ती बदलिँदो
परिवर्तनीय: परिवर्तनशील परिवर्तनीय परिवर्ती बदलिँदो
परिश्रमी: परिश्रमी मेहनती उद्यमी कर्मशील पुरूषार्थी
परिष्कृत: परिष्कृत परिमार्जित संस्कृत
परीक्षित: परीक्षित अनुभूत
परोक्ष: दक्षिणी दक्खिनी
परोपकारी: परोपकारी परमार्थी परहितैषी परकाजी
पर्यायवाची: पर्यायवाची पर्याय पर्यायवाचक समानार्थी समानार्थक
पर्यायी: वैकल्पिक विकल्पयुक्त विकल्पी ऐच्छिक
पळणारा: अभिद्रुत
पळत_असलेला: अभिद्रुत
पळपटा: पलायनशील अपक्रमी
पळपट्या: पलायनशील अपक्रमी
पळपुटा: पलायनशील अपक्रमी
पळपुट्या: पलायनशील अपक्रमी
पवित्र: पवित्र पावन पुण्य पुनीत शुद्ध पवित्र शुद्ध निर्मल सफा
पश्चिम: पश्‍चिमी पच्छिमी
पश्चिमी: पश्‍चिमी पच्छिमी
पसंतीचा: मनपर्दो प्रिय रुचिकर अभीष्ट
पसरलेला: प्रसारित
पसरवलेला: प्रसारित
पस्तावणारा: पश्चात्तापी
पस्तिसावा: पैतीसौँ
पस्तीस: पैँतीस ३५
पहाडी: पहाडी पर्वत-वासी पर्वत_वासी पर्वतीय पर्वती पहाडी पर्वतीय पर्वती
पहिला: पहिलो प्रथम
पांगळा: लङ्गडो लंगडो खोरन्डो
पांगूळ: लङ्गडो लंगडो खोरन्डो
पांचट: पानी_हालेको पनिया
पांढरा: श्वेत सेतो शुक्ल
पाकिस्तानी: पाकिस्तानी
पागल: पागल पगला बौलाहा बौलाहा बहुला पागल
पाच: पाँच पाँचौँ पञ्च ५ 5
पाच_पट: पाँचगुणा
पाचवा: पाँचौं पञ्चम
पाजी: लफङ्गो फटाहा लुच्चा बदमास दुष्ट
पाठ: कण्ठस्थ मुखाग्र
पाठचा: साना_भाइ भाइ
पाठभेदविषयक: क्षेपक
पाठभेदाविषयीचा: क्षेपक
पाठभेदाशी_संबंधित: क्षेपक
पाठभेदासंबंधीचा: क्षेपक
पाठभेदीय: क्षेपक
पाठवलेला: पठाइएको
पाठवलेले: पठाउनु_भएको प्रेषित
पाठीमागचा: पछिल्लो पश्च पश्चस्थ
पाठीराखा: पक्षधर पक्षपाती समर्थक अनुमोदक
पाडलेला: झरेको खसेको झरुवा
पाणिनीय: पाणिनीय पाणिनिसम्बन्धी
पाणीदार: तेजोमण्डित तेजपूर्ण कान्तिमान जाज्वल्यमान प्रकाशमान दिव्य चम्किलो
पाण्याचा: पानीमा_बस्ने जलीय
पातकी: पापी अधम अनाचारी पतित पातकी नीच पापकर्मी पापात्मा अधर्मी अधर्मिष्ट अधार्मिक म्लेच्छ अपकृष्ट कुमार्गी अपमार्गी अपाचारी दुष्ट
पातळ: पातलो पातलो पात्लो तरल द्रव
पाताळयंत्री: धोकाबाज बेइमानी_गर्ने धूर्त कपटी छली
पात्र: योग्य उपयुक्‍त समर्थ सक्षम खाइलाग्दो योग्य उपयुक्‍त लायक
पादचारी: पदचर पदचारी पादचारी पैदल हिँड्दै_गरेको पदस्थ
पापकर्मी: पापी अधम अनाचारी पतित पातकी नीच पापकर्मी पापात्मा अधर्मी अधर्मिष्ट अधार्मिक म्लेच्छ अपकृष्ट कुमार्गी अपमार्गी अपाचारी दुष्ट
पापी: पापी अधम अनाचारी पतित पातकी नीच पापकर्मी पापात्मा अधर्मी अधर्मिष्ट अधार्मिक म्लेच्छ अपकृष्ट कुमार्गी अपमार्गी अपाचारी दुष्ट
पामर: नगण्य यस्तो-उस्तो अगण्य अनुदात्त
पायमोडका: लङ्गडो लँगडो खँजाहा खोरन्डो
पाया_पडणारा: अनुशयी
पारंगत: सिपालु प्रवीण निपुण पारङ्गत दक्ष माहिर अभ्यस्त कुशल होशियार पक्का सिद्धहस्त शातिर पटु पका निष्णात परिपक्व कार्यकुशल विचक्षण अभिज्ञ अभ्यासी आप्त
पारदर्शक: पारदर्शक पारदर्शी
पारलौकिक: परलौकिक अलौकिक परलोकिय दिव्यलोक आधिदैविक आमुष्मिक
पारावार_नसलेला: अवर्णनीय अवर्ण्य
पार्थिव: पार्थिव
पालथा: उल्टो अधोमुख
पालनकर्ता: पालनकर्ता पालनहार
पाळीव: पालतु घरपाला घरेलु घरैया
पाव: पाउ
पावन: पवित्र पावन पुण्य पुनीत शुद्ध
पावसाळी: वर्षा_काल झरी वर्खा
पाशवी: अमानवीय अमानुषिक पाशविक पशुवत
पाश्चात्त्य: पाश्‍चात्य पश्‍चिमी
पाश्चिमात्य: पाश्‍चात्य पश्‍चिमी
पाषाणहृदयी: क्रूर निर्दय कठोर निर्दयी निष्ठुर नृशंस करुणाहीन दयारहित दयाहीन उग्र करुणाविहीन अदयालु
पास: उत्तीर्ण पास
पासष्टावा: पैंसट्ठीऔं
पासष्ठ: पैँसट्ठी ६५
पाहिलेला: अवलोकित दृष्टिगत विलोकित
पिकलेला: पाकेको
पिढीजात: आनुवंशिक वंशागत वंशानुक्रमिक पैतृक आनुवांशिक अनुवांशिक पुर्ख्यौली
पिण्यायोग्य: पेय
पिवळा: पहेँलो पीत
पिसा: पागल पगला बौलाहा बौलाहा बहुला पागल
पीडित: दुखी पीड़ित व्यथित दुःखी आर्त दुखित पीडित ग्रस्त ग्रसित व्यथित प्रताडित पिटिएको चुटिएको
पीडीत: उत्पीड़ित पीड़ित त्रसित
पीत: पहेँलो पीत
पीळदार: पोटिलो खँदिलो भरिलो मोटो दह्रो;
पुढचा: आगामी भविष्य_कालीन सम्भावित भविष्णु भाविता भावी भव्य अगत्तर भवितव्य अनागत अघिल्लो अग्र अग्रवर्ती अग्रिम पूर्व सामुन्नेको सामुको अघिल्लो अगिल्लो
पुढारलेला: प्रगत अग्रगत
पुढारी: प्रधान अग्रगण्य प्रमुख मुख्य वरिष्ठ श्रेष्ठ अगुआ मुखिया अग्रणी
पुढील: आगामी भविष्य_कालीन सम्भावित भविष्णु भाविता भावी भव्य अगत्तर भवितव्य अनागत अघिल्लो अग्र अग्रवर्ती अग्रिम पूर्व सामुन्नेको सामुको आउँदो आगामी भावी आउनेवाला आइन्दा अघिल्लो अगिल्लो
पुनरुक्त: पुनरुक्त पुनरावृत्त
पुनर्नियुक्त: बहाल पुनर्नियुक्त
पुरषी: पुरुषको_जस्तो मर्दाना
पुरातन: प्राचीन पूराकालीन पूरातन पुराना प्राक्कालीन आदिम प्राच्य आदिकालीन
पुराव्याने_सिद्ध_न_होणारा: अप्रमाणित
पुरुषी: पुरुषको_जस्तो मर्दाना
पुरेपूर: सारा सबै पूरा सम्पूर्ण
पुरेसा: पर्याप्त काफी यथेष्ट चाहिएजति मनग्य पर्याप्‍त प्रशस्त
पुरोगामी: अग्रगामी अग्रनी प्रगत अग्रगत
पुलकित: रोमान्चित खुसी पुलकित
पुळचट: काँतर कायर काथर डरछेरुवा भीरु साहसहीन नामर्द हुपहारा पानीमरुवा पानीआन्द्रे
पुष्कळ: अत्यधिक धेरै औधि प्रचुर अत्याधिक अनेक कैयौं विविध नाना एकाधिक अनेकानेक तमाम भारी भीषण घनघोर अत्याधिक
पुष्पित: पुष्पित कुसुमित पुष्पयुक्त प्रफुल्ल
पुसट: धमिलो अस्पष्ट
पूजनीय: पूजनीय पूजा_गर्न_योग्य पुज्नुपर्ने उपासनीय उपास्य अर्चनीय पूज्य वन्दना_गर्न_योग्यवन्दनीय वन्द्य आराध्य आराधनीय स्तुत्य अभिवन्दनीय वरेण्य
पूजार्ह: पूजनीय पूजा_गर्न_योग्य पुज्नुपर्ने उपासनीय उपास्य अर्चनीय पूज्य वन्दना_गर्न_योग्यवन्दनीय वन्द्य आराध्य आराधनीय स्तुत्य अभिवन्दनीय वरेण्य
पूजिलेला: अभिनन्दित अभिनंदित वंदित
पूजेकरिता_न_वापरण्याजोगा: अपूज्य अपूजनीय
पूजेकरिता_न_वाहण्याजोगा: अपूज्य अपूजनीय
पूजेकरिता_वापरण्याजोगा_नसलेला: अपूज्य अपूजनीय
पूजेकरिता_वाहण्याजोगा_नसलेला: अपूज्य अपूजनीय
पूजेत_न_वापरण्याजोगा: अपूज्य अपूजनीय
पूजेत_न_वाहण्याजोगा: अपूज्य अपूजनीय
पूजेत_वापरण्याजोगा_नसलेला: अपूज्य अपूजनीय
पूजेत_वाहण्याजोगा_नसलेला: अपूज्य अपूजनीय
पूजेसाठी_न_वापरण्याजोगा: अपूज्य अपूजनीय
पूजेसाठी_न_वाहण्याजोगा: अपूज्य अपूजनीय
पूजेसाठी_वापरण्याजोगा_नसलेला: अपूज्य अपूजनीय
पूजेसाठी_वाहण्याजोगा_नसलेला: अपूज्य अपूजनीय
पूज्य: पूजनीय पूजा_गर्न_योग्य पुज्नुपर्ने उपासनीय उपास्य अर्चनीय पूज्य वन्दना_गर्न_योग्यवन्दनीय वन्द्य आराध्य आराधनीय स्तुत्य अभिवन्दनीय वरेण्य
पूरक: पूरक सम्पूरक
पूरग्रस्त: बाढग्रस्त बाढपीडित
पूर्ण: सारा सबै पूरा सम्पूर्ण
पूर्णपणे_प्रभावित: अभिभूत ओतप्रोत ओत-प्रोत अभिपन्न अभिप्लुत
पूर्व: पूर्वी पूर्वीय
पूर्व_परिचित: अभिज्ञात पूर्व_परिचित
पूर्वकालीन: बितेको भूतकालीन अतीत_कालीन पूर्व_कालीन भूत_कालीन
पूर्वीचा: प्राचीन पुरानो पूर्व-कालीन
पृच्छित: जिज्ञासित जान्न_खोजिएको
पृथक्: अलग छुट्टै पृथक् फरक
पृष्ठांकित: पृष्ठाङ्कित
पेच_असलेला: पेच_भएको पेचताल
पेय: पेय
पेशीय: अभिन्यास
पैतृक: पैत्रिक पुर्ख्यौली पुश्तैनी पैतृक पैत्रिक
पैत्तिक: पैत्तिक पैत्त
पोकळ: खोक्रो ध्वान्द्रो निराधार अप्रामाणिक तथ्यहीन आधारहीन सारहीन निर्मूल यथार्थहीन अनाधार आधाररहित
पोरकट: नानीहरूको_जस्तो
पोरका: टुहुरो अनाथ यतीम लावारिस
पोरवयाचा: अवयस्क नाबालिग अल्पवयस्क अप्रौढ़ अप्राप्तयौवन
पोरसवदा: अवयस्क नाबालिग अल्पवयस्क अप्रौढ़ अप्राप्तयौवन
पोर्तुगीज: पुर्तगाली पुर्तगाली
पोलंडी: पोलिस पोल्यान्डी
पोलिश: पोलिस
पोशिंदा: पालनकर्ता पालनहार
पोषक: पौष्टिक पुष्टिकारक शक्तिवर्धक
पोसलेला: पोषित सम्वर्धित पुष्ट सम्बर्द्धित
पौष्टिक: पौष्टिक पुष्टिकारक शक्तिवर्धक
प्यायलेला: मात्तिएको उन्मत्त उद्धत मदमत्त मदान्ध धुत धुत्त
प्रकट: अगोपनीय अगोप्य प्रकट्य कथ्य प्रकाश्य
प्रकाशक: प्रकाशक द्योतक
प्रकाशमय: तेजोमण्डित तेजपूर्ण कान्तिमान जाज्वल्यमान प्रकाशमान दिव्य चम्किलो
प्रकाशमान: तेजोमण्डित तेजपूर्ण कान्तिमान जाज्वल्यमान प्रकाशमान दिव्य चम्किलो प्रकाशित उज्यालो चहकिलो
प्रकाशित: प्रकाशित
प्रक्षोभक: उत्तेजक उत्तेजनाप्रद भडकाउ भडकदार
प्रखर: तीक्ष्ण तीव्र कुशाग्र प्रखर तेज अकुण्ठ अकुंठित अकुन्ठित विषम
प्रख्यात: प्रसिद्ध प्रख्यात ख्याति_प्राप्‍त
प्रगत: प्रगत अग्रगत
प्रगतिपर: उन्नतिकारी उत्कर्षकारी उन्नायक उन्नतकारी
प्रगती_करणारा: प्रगति_गर्ने प्रगति_कर्ता अग्रगामी अग्रदर्शी
प्रचंड: अत्यधिक धेरै औधि प्रचुर अत्याधिक अवर्णनीय अवर्ण्य भारी भीषण घनघोर अत्याधिक
प्रचारित: प्रचारित
प्रजासत्ताक: प्रजातन्त्रीय प्रजातान्त्रिक जनतान्त्रिक प्रजातान्त्रिक गणतान्त्रिक लोकतानत्रिक
प्रतिकार_न_करणारा: अप्रतिकार
प्रतिकारशून्य: अप्रतिघात
प्रतिकूल: विपरीत प्रतिकूल खिलाफ
प्रतिगामी: प्रतिगामी पश्चगामी पश्चगङ्ता
प्रतिपाद्य: प्रतिपाद्य अभिधेय निचोड निष्कर्ष
प्रतिबंधित: कम्प्युको सङ्गणकीय
प्रतिभाशून्य: निर्बुद्धि;_हतप्रभ।
प्रतिषिद्ध: मना मना_गरिएको निषिद्ध वर्जित प्रतिबन्धित प्रतिबंधित निषेधित वर्ज्य व्याहत
प्रतिष्ठा_नसलेला: अप्रतिष्ठित अप्रतिष्ठ प्रतिष्ठारहित अमर्याद
प्रतिष्ठित: प्रतिष्ठित अग्रगण्य इज्जतदार गणमान्य नामी सम्मानित मान्य माननीय गौरवान्वित सम्भ्रान्त संभ्रांत सम्ब्रांत अजीज अपचायित सुर्खरू विशिष्ट विशेष
प्रतिस्पर्धी: प्रतिद्वन्द्वी प्रतिस्पर्धी प्रतियोगी स्पर्धी
प्रत्यक्ष: प्रत्यक्ष साक्षात् साक्षात
प्रत्यारोपित: प्रत्यारोपित प्रतिरोपित
प्रत्येक: प्रत्येक सबै
प्रथम: पहिलो प्रथम
प्रदर्शनीय: दर्शनीय प्रदर्शनीय
प्रदर्शित: प्रदर्शित प्रदर्शित देखाइएको प्रदर्शन_गरिएको
प्रदूषित: दूषित दोषयुक्त ख़राब
प्रधान: मुख्य प्रधान मूल
प्रफुल्ल: आलो ताजा
प्रफुल्लित: प्रसन्न खुसी खुश आनन्दित पुलकित हर्षित विह्वल आह्लादित प्रफुल्ल परितुष्ट प्रफुल्लित प्रफुलित उल्लसित उल्लासित उल्लासी आनन्दी विनोदित पुलकित तुष्ट
प्रबल: प्रबल प्रचण्ड उत्कट उग्र तेज कडा
प्रबळ: प्रबल प्रचण्ड उत्कट उग्र तेज कडा
प्रभावशाली: प्रभावशाल प्रभावशील प्रभावशाली प्रभावकारी
प्रभावशाली_असलेला: प्रभावशाली प्रभावकारी
प्रभावित: प्रभावित
प्रभावी: मार्ने प्रभावशाली प्रभावकारी
प्रभाहीन: रगतहीन निस्तेज आभाहीन कांतिहीन ओजहीन प्रभाहीन बेरौनक अप्रभ प्रभारहित श्रीहत
प्रमाणशीर: सुडौल सुगठित बान्की_परेको
प्रमाणित: सत्यापित प्रमाणित प्रमाणित प्रमाणीकृत प्रमाणिकरण
प्रमाणित_न_करता_येणारा: अप्रमाणित
प्रमुख: मूल खास मुख्य प्रमुख प्रधान
प्रमुदित: प्रसन्न खुसी खुश आनन्दित पुलकित हर्षित विह्वल आह्लादित प्रफुल्ल परितुष्ट प्रफुल्लित प्रफुलित उल्लसित उल्लासित उल्लासी आनन्दी विनोदित पुलकित तुष्ट
प्रयत्नवंत: प्रयत्नशील प्रयासशील प्रयासी प्रयत्नी प्रयत्नवान उद्यमी उद्यमशील उद्योगी
प्रयत्नवान: प्रयत्नशील प्रयासशील प्रयासी प्रयत्नी प्रयत्नवान उद्यमी उद्यमशील उद्योगी
प्रयत्नशील: प्रयत्नशील प्रयासशील प्रयासी प्रयत्नी प्रयत्नवान उद्यमी उद्यमशील उद्योगी
प्रवाही: प्रवाहित बग्दो प्रवाहशील प्रवाहमय गतिशील गतिमान प्रवाही परिष्यन्दी
प्रविष्ट: प्रविष्ट आगत प्रवेशित अभिनिवेशित
प्रवीण: सिपालु प्रवीण निपुण पारङ्गत दक्ष माहिर अभ्यस्त कुशल होशियार पक्का सिद्धहस्त शातिर पटु पका निष्णात परिपक्व कार्यकुशल विचक्षण अभिज्ञ अभ्यासी आप्त
प्रशंसक: प्रशंसक प्रशंसी
प्रशंसनीय: प्रशंसनीय स्तुत्य धन्य धन्न प्रशंस्य श्लाघ्य श्लाघनीय सराहनीय प्रशस्त अभिनन्दनीय अभिवन्दनीय
प्रशंसलेला: प्रशंसित अभिनन्दित चर्चित
प्रशंसापात्र: प्रशंसनीय स्तुत्य धन्य धन्न प्रशंस्य श्लाघ्य श्लाघनीय सराहनीय प्रशस्त अभिनन्दनीय अभिवन्दनीय
प्रशंसित: प्रशंसित अभिनन्दित चर्चित
प्रशस्त: भव्य ठुलो सानदार विशाल
प्रशांत: शान्त शांत प्रशान्त निरुद्विग्न अविकल अव्याकुल प्रशांत निभृत अनाकुल अव्यग्र विश्रब्ध
प्रशासकीय: प्रशासनिक
प्रशासित: शासित प्रशासित
प्रशिक्षित: प्रशिक्षित तालिमे
प्रसंगानुचित: अप्रासङ्गिक अप्रासाङ्गिक
प्रसंगानुसार: सामयिक समयोचित समयानुकूल अवसरानुकूल अवसरोचित कालोचित
प्रसन्न: प्रसन्न खुसी खुश आनन्दित पुलकित हर्षित विह्वल आह्लादित प्रफुल्ल परितुष्ट प्रफुल्लित प्रफुलित उल्लसित उल्लासित उल्लासी आनन्दी विनोदित पुलकित तुष्ट
प्रसन्नचित्त: पुरै पूर्ण पक्का प्रसन्नचित्त
प्रसन्नमुख: प्रसन्नमुख प्रसन्नवदन
प्रसन्नवदन: प्रसन्नमुख प्रसन्नवदन
प्रसारित: प्रसारित
प्रसिद्ध: प्रसिद्ध प्रख्यात ख्याति_प्राप्‍त
प्रस्तुत: प्रस्तावित
प्रांतिक: प्रान्तीय क्षेत्रीय_प्रादेशिक
प्रांतीय: प्रान्तीय क्षेत्रीय_प्रादेशिक
प्राकृत: अविकृत नबिग्रेको
प्राकृतिक: प्राकृतिक नैसर्गिक प्राकृत अकृत्रिम प्रकृत
प्राचीन: प्राचीन पूराकालीन पूरातन पुराना प्राक्कालीन आदिम प्राच्य आदिकालीन
प्राथमिक: मूल खास मुख्य प्रमुख प्रधान प्रारम्भिक आरम्भिक आरंभिक प्राथमिक प्रारंभिक पूर्व
प्राप्त: उपलब्ध प्राप्त लब्ध अधिगत अर्जित कमाएको
प्रामाणिक: निष्कपट विश्‍वासी विश्वासिलो विश्वसनीय विश्वासपात्र विश्वस्त विश्वासी पत्याउरो
प्रायोजित: प्रायोजित
प्रारंभिक: प्रारम्भिक आरम्भिक आरंभिक प्राथमिक प्रारंभिक पूर्व
प्रार्थनीय: प्रार्थनीय प्रार्थना_गर्न_योग्य याचनीय वन्दनीय
प्रासंगिक: प्रासङ्गिक प्रसङ्ग-सम्बन्धी
प्रिय: प्रिय प्यारो मन-पर्ने मनपर्दो प्रिय रुचिकर अभीष्ट
प्रेमळ: स्नेही दयालु
प्रेमासक्त: प्रेमासक्त अनुरक्त अनुरागी आसक्त लसपसिएको
प्रेरणादायक: प्रेरणादायक प्रेरणात्मक प्रेरणास्पद प्रेरणाजन्य
प्रेरित: प्रेरित
प्रेषित: पठाउनु_भएको प्रेषित
प्रोटेस्टंट: प्रोटेस्टेन्ट
प्रौढ: वयस्क प्रौढ बालिग
फक्कड: उचित उपयुक्‍त ठिक
फटकळ: मुखाले चोथाले थुतुने दुर्मुखा
फरडा: सिपालु प्रवीण निपुण पारङ्गत दक्ष माहिर अभ्यस्त कुशल होशियार पक्का सिद्धहस्त शातिर पटु पका निष्णात परिपक्व कार्यकुशल विचक्षण अभिज्ञ अभ्यासी आप्त
फर्डा: उत्तम उत्कृष्ट अनमोल श्रेष्ठ प्रशस्त
फर्मास: उत्तम उत्कृष्ट अनमोल श्रेष्ठ प्रशस्त
फलदायी: लाभदायक लाभप्रद लाभकर लाभकारी लाभजनक गुणकारी उपयोगी हितकारी अर्थकर
फलद्रूप: लाभदायक लाभप्रद लाभकर लाभकारी लाभजनक गुणकारी उपयोगी हितकारी अर्थकर
फलप्रद: लाभदायक लाभप्रद लाभकर लाभकारी लाभजनक गुणकारी उपयोगी हितकारी अर्थकर फलदायक फलप्रद फलदायी
फलहीन: अफल फलहीन फलरहित फलविहीन_फल_नभएको निष्फल
फळ_देणारा: फल_भएको
फळदार: फल_लागेका फल_भएका
फळांनी_लगडलेले: फल_लागेका फल_भएका
फसलेला: उल्झिनु उल्झनु
फसव्या: छक्याउने
फाटका: दुब्लो सिकुटे खिनाउटे च्यातिएको फाटेको जीर्ण
फाटकातुटका: थोत्रो झुत्रो पुरानो फाटेको
फायदेशीर: अनुकूल अनुसार अनुरूप मुताबिक लाभदायक लाभप्रद लाभकर लाभकारी लाभजनक गुणकारी उपयोगी हितकारी अर्थकर कल्याणकारी मङ्गलकारी कल्याणप्रद मङ्गलकारक मङ्गलदायक मङ्गलप्रद हितकारी हितकर हितकारक कल्याणमय अनुकूल
फार: अत्यधिक धेरै औधि प्रचुर अत्याधिक भारी भीषण घनघोर अत्याधिक
फावला: खाली अव्यस्त
फिकट: रगतहीन निस्तेज आभाहीन कांतिहीन ओजहीन प्रभाहीन बेरौनक अप्रभ प्रभारहित श्रीहत
फिकट_पिवळ्या_रंगाचा: वासन्ती बसन्ती
फिका: म्लान न्याउरो न्यास्रो फिका खल्लो फुस्रो रगतहीन निस्तेज आभाहीन कांतिहीन ओजहीन प्रभाहीन बेरौनक अप्रभ प्रभारहित श्रीहत
फिक्कट: फिका खल्लो
फिक्का: म्लान न्याउरो न्यास्रो फिका खल्लो
फितुर: विद्रोही क्रान्तिकारी
फिदा: आसक्त मुग्ध मोहित
फिनिश: फिनल्यान्डी
फिनी: फिनल्यान्डी फिनिस
फुकट: निःशुल्क मुफ्त निशुल्क
फुटकर: खुद्रा_सामान फुटकर_सामान
फुटकळ: छिटपुट छुटपुट छिट-पुट छुट-पुट हल्का-फुल्का खुद्रा_सामान फुटकर_सामान
फेकलेला: अधिक्षिप्त
फेडलेला: चुकता_गरिएको तिरिएको भुगतानकृत
फैलवलेला: प्रसारित
फोल: अर्थहीन निरर्थक
फौजी: फौजी
फ्रेंच: फ्रान्सेली फ्रान्सीसी फ्रेन्च फ्रान्सेली फ्रान्सिसी फ्रेन्च
बंगाली: बङ्गाली बङ्गाली बङ्गाली
बंजारा: बन्जारा घुमन्ते
बंड: चकचके चञ्‍चल चुलबुले
बंद: बन्द
बंधनमुक्त: उन्मुक्‍त खुला मुक्‍त स्वतन्त्र
बंधमुक्त: उन्मुक्‍त खुला मुक्‍त स्वतन्त्र
बखतर्‍या: कवचधारी कवची
बखळ: अत्यधिक धेरै औधि प्रचुर अत्याधिक भारी भीषण घनघोर अत्याधिक
बडतर्फ: निलम्बित निलंबित पदच्युत बरखास्त बरख्वास्त अपदस्थ अनुलंबित अनुलम्बित
बडबड्या: बिरेनुन कालो_नुन पादे_नुन
बडा: प्रसिद्ध प्रख्यात ख्याति_प्राप्‍त
बत्तिसावा: बत्तीसौँ
बत्तीस: बत्तीस
बदनाम: कुख्यात बदनाम दुर्नाम लाञ्छित कलङ्कित कलुषित दागी बदनामी
बदमाश: लफङ्गो फटाहा लुच्चा बदमास दुष्ट
बदली: स्थानापन्न अर्काको_ठाउँमा_आएको सट्टामा_आएको अर्काका_पदमा_सरुवा_भई_आएको
बदली_झालेला: सरुवा स्थानान्तरित
बद्ध: आबद्ध निबद्ध बद्ध बाँधिएको अमुक्त अनुबद्ध पाबन्द अपिबद्ध अपिनद्ध
बधिर: बहिरो बैह्रो बधिर
बनारसी: बनारसी
बरड: बाँझो अनुर्वर
बरबाद: नष्ट चौपट तहस-नहस ध्वस्त समाप्त बरबाद बर्बाद ध्वंसित अपध्वस्त विनष्ट निकंदन चकनाचुर
बरा: सामान्य आम साधारण कामचलाउ अविशिष्ट
बरेच: अनेक कैयौं विविध नाना एकाधिक अनेकानेक तमाम
बरोबर_सैन्य_नसलेला: सेनारहित अदल
बरोबरीचा: समकक्ष समतुल्य एक_समान तुल्य सदृश्य समान
बर्फाच्छादित: बरफिलो ज्यादै_चिसो अति_ठन्डा बरफ_भएको
बर्फाळ: बरफिलो ज्यादै_चिसो अति_ठन्डा बरफ_भएको
बलात्कारी: बलात्कारी बलात्कार_कर्ता
बळकावलेला: अधिग्रहीत अधिकृत अधिगत
बसलेला: आसीन विराजमान बसेका उपविष्ट
बहात्तर: बहत्तर ७२
बहादूर: वीर बहादुर सुरो पराक्रमी पुरूषार्थी पौरखी
बहाद्दर: वीर बहादुर सुरो पराक्रमी पुरूषार्थी पौरखी साहसी हिम्मती बहादुर
बहिरा: बहिरो बैह्रो बधिर
बहिर्मुख: बहिर्मुखी बहिर्भिमुखी
बहिष्कृत: राजनीतिज्ञ राजनीतिशास्त्रज्ञ राजनीतिशास्त्रविद् राजनीतिशास्त्री राजनीति_शास्त्री बहिष्कृत खारिज
बहुकार्यक: कर्मनिष्ठ कर्मठ कर्मी
बहुत: अत्यधिक धेरै औधि प्रचुर अत्याधिक भारी भीषण घनघोर अत्याधिक
बहुमूल्य: बहुमूल्य मूल्यवान अमूल्य अनमोल दामी
बहुमोल: बहुमूल्य मूल्यवान अमूल्य अनमोल दामी
बहुमोली: बहुमूल्य मूल्यवान अमूल्य अनमोल दामी
बहुसंख्य: बहुसङ्ख्यक बहुसङ्ख्य
बांगला: बङ्गाली
बांधेसूद: सुडौल सुगठित बान्की_परेको
बाकी: उब्रेको बचेको बचेखुचेको रहल शेष बाँकी
बाताड्या: बकबके
बारका: साना_भाइ भाइ
बारा: बाह्र १२
बारावा: बाह्रौं १२_औं 12_औं
बारीक: सानो मसिनो दुब्लो सिकुटे खिनाउटे मिही मसिनो दुब्लो लुते क्षीण
बारीकसारीक: खुद्रा_सामान फुटकर_सामान
बालिश: नानीहरूको_जस्तो
बालीश: बचकना बचकाना
बाळबोध: बोध्य बोधगम्य अक्लिष्ट सजिलो सरल सुगम सुबोध
बावन्नावा: बाउन्नौं
बावळट: मूर्ख अज्ञानी बुद्धु ज्ञानहीन अज्ञानपूर्ण
बावळा: मूर्ख अज्ञानी बुद्धु ज्ञानहीन अज्ञानपूर्ण
बासष्टावा: बैसट्ठीऔं
बाहेर_पडलेला: निस्केको
बाहेरचा: पराई बिरानो परचक्री बाह्य बहिरङ्ग बाहिरी
बाहेरील: बाह्य बहिरङ्ग बाहिरी
बाह्य: बाहिरी बाहिरको बाह्य बहिरङ्ग बाहिरी
बिकट: कठिन दुर्गम अगम्य अगम दुरूह दुर्गम्य अगत आगम
बिगडलेला: अकृत
बिघडलेला: क्षतिग्रस्त
बिनचिखलाचा: अपङ्किल पङ्करहित
बिनजोडाचा: बेजोड अजोड़
बिनडोक: मूर्ख अज्ञानी बुद्धु ज्ञानहीन अज्ञानपूर्ण
बिनतारी: बेतार
बिनपगारी: अवैतनिक बेतन_रहित
बिनबुडाचा: पिँध_नभएको
बिनविषारी: विषहीन
बुजरा: सङ्कोची सङ्कोच_मान्ने लाज_मान्ने
बुटका: पुडके होचो
बुडगा: वृद्ध बूढ़ो बुढ़ो वरिष्ठ बुजुर्ग वयोवृद्ध उम्रदराज
बुद्धिग्राह्य: तर्कगम्य तर्काधीन तर्कसङ्गत
बुद्धिजीवी: बुद्धिजीवी
बुद्धिमंत: बुद्धिमानी ज्ञानी प्राज्ञ समझदार दिमागदार दिमागी बुझक्की मेधावी
बुद्धिमान: बुद्धिमानी ज्ञानी प्राज्ञ समझदार दिमागदार दिमागी बुझक्की मेधावी
बुद्धिवान: बुद्धिमानी ज्ञानी प्राज्ञ समझदार दिमागदार दिमागी बुझक्की मेधावी
बेअक्कल: मूर्ख अज्ञानी बुद्धु ज्ञानहीन अज्ञानपूर्ण
बेअक्कली: मूर्ख अज्ञानी बुद्धु ज्ञानहीन अज्ञानपूर्ण
बेईमान: कृतघ्न अकृतज्ञ
बेकार: बेरोजगार बेइलमी जीविकाहीन
बेघर: आवासहीन आश्रयहीन गृहहीन गृहविहीन बेघर बेघरवार
बेचव: स्वादहीन बेस्वाद नीरस फीका अस्वादिष्ट अनास्वाद खल्लो नमिठो
बेचाळिसावा: बयालीसौँ
बेचाळीस: बयालीस
बेचैन: उद्विग्न हताश_भएको डराएको
बेजोड: अनुपम अतुलनीय अद्वितीय असाधारण बेजोड न्यारो अप्रतिम अद्वैत एकल सर्वोकृष्ट अनुत्तम उपमारहित अनुपमित अनुपमेय अपूर्व अप्रतिमान अप्रतिरूप अभूत
बेडर: निडर अभय निर्भय निर्भीक बेडर भयहीन निर्भीत अपभय अपभीति निःशंक अपशंक अभीत अभीरु चकचके चुलबुले उदण्ड ऊछृङ्खल
बेडौल: कुगठित कुडौल बान्की_नपरेको
बेढब: कुगठित कुडौल बान्की_नपरेको
बेताचा: निर्धारित सीमित नियत
बेदाण्याची: किसमिसे किसमिसी
बेदान्याची: किसमिसे किसमिसी
बेधडक: निडर अभय निर्भय निर्भीक बेडर भयहीन निर्भीत अपभय अपभीति निःशंक अपशंक अभीत अभीरु
बेपर्वा: बेपरवाह बेपरवा बिन्दास अचिन्त
बेफिकीर: बेपरवाह बेपरवा बिन्दास अचिन्त
बेबंद: निरङ्कुश स्वेच्छाचारी अप्रतिबन्धित मनमोजी मनमौजी स्वच्छन्द अत्याचारी अन्यव्रत अप्रतिबद्ध अबद्ध
बेमुदत: अवधिहीन
बेमुरवत: असभ्य दुर्जन दुर्छे
बेमुरवती: असभ्य दुर्जन दुर्छे
बेमुर्वत: असभ्य दुर्जन दुर्छे
बेमुर्वती: असभ्य दुर्जन दुर्छे
बेरोजगार: बेरोजगार बेइलमी जीविकाहीन
बेलगाम: निरङ्कुश स्वेच्छाचारी अप्रतिबन्धित मनमोजी मनमौजी स्वच्छन्द अत्याचारी अन्यव्रत अप्रतिबद्ध अबद्ध बेलगाम
बेलगामी: बेलगाम
बेलोरशियन: बेलरसी बेलरसी
बेलोरशियाई: बेलरसी
बेल्जियन: बेल्जियमी बेल्जियन
बेल्जियमी: बेल्जियमी
बेवडा: रक्स्याहा जँड्याहा रक्स्याहा जँड्याहा
बेवारशी: टुहुरो अनाथ यतीम लावारिस
बेशरम: निर्लज्ज लज्जाहीन छाडा
बेशुद्ध: बेहोस मूर्च्छित मूर्छित अचेत चेतनाहीन चेतनाशुन्य अचेतन चेतनारहित ज्ञानशून्य संज्ञाशून्य संज्ञाहीन निश्चेष्ट अचेष्ट अचैतन्य
बेसावध: असावधान लापरवाह हेलचेक्राइँ अचेत असजग अनचित अमनोयोगी
बेसूर: बेसुरिलो स्वरहीन
बेहोष: बेहोस मूर्च्छित मूर्छित अचेत चेतनाहीन चेतनाशुन्य अचेतन चेतनारहित ज्ञानशून्य संज्ञाशून्य संज्ञाहीन निश्चेष्ट अचेष्ट अचैतन्य
बोजड: भारी गरुङ्गो वजनदार
बोथट: भुत्ते बोधो नलाग्ने
बोबडा: तोते
बोलका: बिरेनुन कालो_नुन पादे_नुन
बोलघेवडा: बिरेनुन कालो_नुन पादे_नुन
बोलता: मुखरित मुखर
बोलिव्हियन: बोलिवियाली बोलिवियाई बोलिविआई
बोसनियाई: बोसनियाई बोसनियाई
बौद्ध: बौद्ध_धर्मावलम्बी बौद्ध
ब्याऐंशी: बयासी
ब्याण्णवावा: बयानब्बेऔं
ब्रह्णदेशी: बर्मी बर्मे म्यानमारी बर्मी म्यानमारी बर्मेली
ब्रह्मदेशाचा: बर्मी बर्मे म्यानमारी बर्मी म्यानमारी बर्मेली
ब्रह्मदेशीचा: बर्मी बर्मे म्यानमारी बर्मी म्यानमारी बर्मेली
ब्रह्मदेशीय: बर्मी बर्मे म्यानमारी बर्मी म्यानमारी बर्मेली
ब्रह्मी: बर्मी बर्मे म्यानमारी बर्मी म्यानमारी बर्मेली बर्मी म्यानमारी
ब्रिटनचा: ब्रिटिस अङ्ग्रेजी
ब्रिटनी: ब्रिटिस अङ्ग्रेजी
ब्रिटीश: ब्रिटिस अङ्ग्रेजी
भंकस: उटपट्याङ फाल्टु नचाँहिदो अनावश्यक रद्दी
भक्कम: दरो बलियो कठरो सारो
भक्तिपूर्ण: भक्‍तिपूर्ण
भक्ष्य: खाद्य भोज्य आहार्य ग्राह्य भक्ष्य अशनीय
भटकणारा: घुमक्कड घुमन्ते पर्यटनप्रिय यायावर घुम्ने भ्रमणशील भ्रमणीय अतिचारी अध्वगामी गश्ती भ्रमणप्रेमी भ्रमण-प्रेमी
भटका: बन्जारा घुमन्ते
भटक्या: घुमक्कड घुमन्ते पर्यटनप्रिय यायावर घुम्ने भ्रमणशील भ्रमणीय अतिचारी अध्वगामी गश्ती भ्रमणप्रेमी भ्रमण-प्रेमी
भडक: चहकिलो चम्किलो टलकदार
भडकवणारा: उत्तेजक उत्तेजनाप्रद भडकाउ भडकदार
भद्र: सज्जन भद्र भलादमी सुजन शीलवान सद्गुणी सुप्रतीक
भयंकर: प्रचण्ड डरलाग्दो भयानक विकट रौद्र_रूप
भयकारक: प्रचण्ड डरलाग्दो भयानक विकट रौद्र_रूप
भयकारी: प्रचण्ड डरलाग्दो भयानक विकट रौद्र_रूप
भयग्रस्त: आतङ्कित त्रस्त सन्त्रस्त
भयपूर्ण: प्रचण्ड डरलाग्दो भयानक विकट रौद्र_रूप
भयभीत: आतङ्कित त्रस्त सन्त्रस्त
भयरहित: निडर अभय निर्भय निर्भीक बेडर भयहीन निर्भीत अपभय अपभीति निःशंक अपशंक अभीत अभीरु
भयसान: प्रचण्ड डरलाग्दो भयानक विकट रौद्र_रूप
भयाकुल: आतङ्कित त्रस्त सन्त्रस्त
भयाण: प्रचण्ड डरलाग्दो भयानक विकट रौद्र_रूप
भयातुर: आतङ्कित त्रस्त सन्त्रस्त
भयानक: प्रचण्ड डरलाग्दो भयानक विकट रौद्र_रूप
भयावह: प्रचण्ड डरलाग्दो भयानक विकट रौद्र_रूप
भयोत्पादक: प्रचण्ड डरलाग्दो भयानक विकट रौद्र_रूप
भरदार: पोटिलो खँदिलो भरिलो मोटो दह्रो;
भरपूर: अत्यधिक धेरै औधि प्रचुर अत्याधिक भरपूर सम्पूर्ण सकेसम्म भारी भीषण घनघोर अत्याधिक
भरमसाट: अत्यधिक धेरै औधि प्रचुर अत्याधिक भारी भीषण घनघोर अत्याधिक
भरमसाठ: अत्यधिक धेरै औधि प्रचुर अत्याधिक भारी भीषण घनघोर अत्याधिक
भरलेला: भरिएको भरपूर परिपूर्ण भरिएको अभिपूर्ण पूर्ण भरिएको भरि
भलता: असम्बन्धित असम्बद्ध सम्बन्धरहित अनन्वित अप्रसङ्ग असम्बन्धित असम्बद्ध सम्बन्धरहित अमेल अयुक्त अत्यधिक धेरै औधि प्रचुर अत्याधिक भारी भीषण घनघोर अत्याधिक
भला: राम्रो सही_मान्छे गतिलो
भला_मोठा: भारी
भविष्यकालीन: आगामी भविष्य_कालीन सम्भावित भविष्णु भाविता भावी भव्य अगत्तर भवितव्य अनागत
भविष्यकाळात_होणारा: शाब्दिक शब्द
भविष्यातील: आगामी भविष्य_कालीन सम्भावित भविष्णु भाविता भावी भव्य अगत्तर भवितव्य अनागत
भव्य: भव्य ठुलो सानदार विशाल
भांडकुदळ: झगडालु खटपटे लडाकु कलहप्रिय कलहकारी कर्कश कर्कशा रिसाहा उग्रा झगडालु चण्डी चण्डिका
भांडखोर: कर्कशा रिसाहा उग्रा झगडालु चण्डी चण्डिका
भागलेला: थाकेको थकित क्लान्त क्लांत परिश्रांत
भाग्यवंत: सौभाग्यशाली भाग्यवान भाग्यशाली
भाग्यवान: सौभाग्यशाली भाग्यवान भाग्यशाली
भाग्यशाली: सौभाग्यशाली भाग्यवान भाग्यशाली
भाग्यहीन: दुर्भाग्यशाली अभागी भाग्यहीन
भाजलेले: भुटेको भुटेका
भामटा: छक्याउने
भारतीय: भारतीय हिन्दुस्थानी
भाराभर: अत्यधिक धेरै औधि प्रचुर अत्याधिक भारी भीषण घनघोर अत्याधिक
भारी: भारी गरुङ्गो वजनदार अत्यधिक धेरै औधि प्रचुर अत्याधिक भारी भीषण घनघोर अत्याधिक
भावनापूर्ण: भावपूर्ण मार्मिक भावनात्मक भावनापूर्ण भावात्मक मर्मस्पर्शी हृदयस्पर्शी
भावनाप्रधान: जोशीलो जोशपूर्ण
भावपूर्ण: भावपूर्ण मार्मिक भावनात्मक भावनापूर्ण भावात्मक मर्मस्पर्शी हृदयस्पर्शी
भावी: आगामी भविष्य_कालीन सम्भावित भविष्णु भाविता भावी भव्य अगत्तर भवितव्य अनागत
भाषांतरित: अनूदित अनुवादित अनुदित भाषांतरित भाषान्तरित
भाषाविषयक: भाषिक
भाषिक: भाषिक
भाषीय: भाषिक
भिकार: घटिया निकृष्ट नीच अधम क्षुद्र निकृष्टतम अधमाधम तुच्छातितुच्छ
भिजलेला: लतपत रगतपच्छे
भिडस्त: सङ्कोची सङ्कोच_मान्ने लाज_मान्ने
भित्रा: काँतर कायर काथर डरछेरुवा भीरु साहसहीन नामर्द हुपहारा पानीमरुवा पानीआन्द्रे
भिन्न: अलग छुट्टै पृथक् फरक
भिन्नदेशीय: विदेशी परदेशी परदेसी बिदेसी गैरमुल्की विलायती अन्यदेशीय अन्यराष्ट्रीय
भीतिप्रद: प्रचण्ड डरलाग्दो भयानक विकट रौद्र_रूप
भीतीदायक: प्रचण्ड डरलाग्दो भयानक विकट रौद्र_रूप
भीमकाय: महाकाय अतिकाय बृहत्काय विशालकाय भीमकाय विकराल
भीरु: काँतर कायर काथर डरछेरुवा भीरु साहसहीन नामर्द हुपहारा पानीमरुवा पानीआन्द्रे
भीषण: प्रचण्ड डरलाग्दो भयानक विकट रौद्र_रूप
भुकाळ: घिचुवा खन्चुवा घिचासे पेटु
भुकाळू: घिचुवा खन्चुवा घिचासे पेटु
भुकेजलेला: भोको भोकाएको
भुकेला: भोको भोकाएको
भुकेलेला: भोको भोकाएको
भुक्कड: घटिया निकृष्ट नीच अधम क्षुद्र निकृष्टतम अधमाधम तुच्छातितुच्छ
भुसभुशीत: बुरबुरे
भूगोलाचा: भौगोलिक भू-गोलीय भूगोलीय
भूचर: थलचर धरातली स्थलीय
भूतकालीन: बितेको भूतकालीन अतीत_कालीन पूर्व_कालीन भूत_कालीन
भूताचा: भूत_विषयक
भूतानी: भुटानी भुटानी भुटानी
भूमिगत: भूमिगत भूमिगत
भेंसूर: प्रचण्ड डरलाग्दो भयानक विकट रौद्र_रूप
भेकड: काँतर कायर काथर डरछेरुवा भीरु साहसहीन नामर्द हुपहारा पानीमरुवा पानीआन्द्रे
भेदक: प्वाल_पार्ने भेदक वेधक भेदकारी छेड्ने चिर्ने
भेदलेला: भेदकारी
भेदित: भेदकारी
भेद्य: वेध्य भेद्य वेधनीय भेदनीय छेडेको भेदगरेको
भेसळीचे: अशुद्ध मिलावट मिसिएको अपमिश्रित
भेसूंड: प्रचण्ड डरलाग्दो भयानक विकट रौद्र_रूप
भेसूड: प्रचण्ड डरलाग्दो भयानक विकट रौद्र_रूप
भेसूर: प्रचण्ड डरलाग्दो भयानक विकट रौद्र_रूप
भोज्य: खाद्य भोज्य आहार्य ग्राह्य भक्ष्य अशनीय
भोट: मूर्ख अज्ञानी बुद्धु ज्ञानहीन अज्ञानपूर्ण
भोळा: सोझो सीधा सरल सीधा-सादा
भौगोलिक: भौगोलिक भू-गोलीय भूगोलीय
भौतिक: जड अचैतन्य जडत्वयुक्त स्थूल अजैव भौतिक अचेतन चेतनारहित अजीव अनात्म आत्मारहित
भ्याड: काँतर कायर काथर डरछेरुवा भीरु साहसहीन नामर्द हुपहारा पानीमरुवा पानीआन्द्रे
भ्यायलेला: आतङ्कित त्रस्त सन्त्रस्त
भ्यालेला: आतङ्कित त्रस्त सन्त्रस्त
भ्रमरहित: अभ्रमित भ्रमरहित अभ्रान्त अभरम अप्रमाद भ्रान्तिशून्य
भ्रमिष्ट: सम्भ्रान्त बौलाहा बहुला पागल
भ्रष्ट: पतित च्युत बिग्रेको विकृत भ्रष्ट पतित दूषित
भ्रष्टाचारी: भ्रष्टाचारी
भ्रष्टित: पतित च्युत बिग्रेको विकृत
भ्रांतिरहित: अभ्रमित भ्रमरहित अभ्रान्त अभरम अप्रमाद भ्रान्तिशून्य
मंजुरी_मिळालेला: स्वीकृत अनुमति_प्राप्त अनुमतिप्राप्त
मंजूर: स्वीकृत मन्जुर सहमति_प्राप्त अभ्युपगत
मंजूर_झालेला: स्वीकृत अनुमति_प्राप्त अनुमतिप्राप्त
मंजूरीप्राप्त: स्वीकृत मन्जुर सहमति_प्राप्त अभ्युपगत
मंद: मूर्ख अज्ञानी बुद्धु मन्द बिस्तारो मन्थर भुत्ते बोधो नलाग्ने मन्द मंद अप्रबल निस्तेज कुण्ठित कुंठित अल्छी सुस्त ढिलो ज्ञानहीन अज्ञानपूर्ण मन्द ढिलो सुस्त
मंदगती: मन्द बिस्तारो मन्थर मन्द ढिलो सुस्त
मंदमती: मन्दमति मन्दबुद्धि
मंदावलेला: अपटु
मऊ: नरम कमलो कोमल
मखमली: मखमली
मग्न: तल्लीन अनुरत निमग्न लीन तन्मय मग्न मगन दत्तचित्त लिप्त रत निरत अनुरक्त अनुसंरक्त अभिनिविष्ट
मग्रूर: गर्विलो गर्वी अभिमानी अहङ्कारी घमण्डी
मजबूत: पोटिलो खँदिलो भरिलो मोटो दह्रो; दरो बलियो कठरो सारो
मजादार: रोचक रमाइलो मजाको रङ्गीन
मजेदार: रोचक रमाइलो मजाको रङ्गीन
मठ्ठ: मूर्ख अज्ञानी बुद्धु ज्ञानहीन अज्ञानपूर्ण
मणिपुरी: मणिपुरी मणिपुरी मणिपुरी
मतलबी: स्वार्थी मतलबी स्वार्थपर तनपोषक अपस्वार्थी अपरता स्वार्थपरायण
मतविहीन: असहमत असम्मत अमत
मत्सरहीन: ईर्ष्याहीन द्वेषहीन अद्वेषी आरिसहीन
मत्सरी: ईर्ष्यालु इखालु
मदमस्त: मत्त मस्त
मद्यपी: रक्स्याहा जँड्याहा रक्स्याहा जँड्याहा
मधला: माइलो
मधुर: गुलियो मिठो
मधुरभाषी: प्रियभाषी प्रियवादी प्रियंवद
मध्य: मध्यवर्ती मध्यस्थित मध्य मध्यम
मध्यम: सामान्य आम साधारण कामचलाउ अविशिष्ट
मध्यवर्ती: मध्यवर्ती मध्यस्थित मध्य मध्यम
मननशील: मननशील चिन्तनशील विचारशील।
मनपसंत: मनपर्दो प्रिय रुचिकर अभीष्ट
मनमाना: मनमौजी अलमस्त
मनमिळाऊ: मिलनसार मिल्दो
मनमोहक: आकर्षक मनोहर राम्रो सुन्दर
मनाजोगा: मनमौजी अलमस्त
मनुष्यविहीन: निर्जन एकान्त सुनसान जनशून्य
मनोगत: मनोगत मनोद्भव
मनोरंजक: मनोरञ्जक मनोरञ्जनपूर्ण आनन्दप्रद आमोद-प्रमोदपूर्ण
मनोविकारतज्ञ: मनोविज्ञान मनोविज्ञानी
मनोहर: रमणीय रम्य रमणीक
मनोहारी: रमणीय रम्य रमणीक हृदयग्राही सुन्दर रुचिकर
मरणाधीन: मरणासन्न मुमूर्ष
मरणासन्न: मरणासन्न मुमूर्ष
मरणोत्तर: मरणोत्तर मरिसकेपछि मृत्यु_पछि
मराठी: मराठी मराठी
मरूस्थलीय: मरुभूमि
मर्मज्ञ: मर्मज्ञ मार्मिक
मर्मवेत्ता: मर्मज्ञ मार्मिक
मर्मस्पर्शी: भावपूर्ण मार्मिक भावनात्मक भावनापूर्ण भावात्मक मर्मस्पर्शी हृदयस्पर्शी
मर्यादित: ससीम परिसीमित सीमित
मलयाळम्: मलयाली मलयालम
मलिन: मैलो फहोर अशुद्ध
मलूल: म्लान न्याउरो न्यास्रो
मश्गुल: तल्लीन अनुरत निमग्न लीन तन्मय मग्न मगन दत्तचित्त लिप्त रत निरत अनुरक्त अनुसंरक्त अभिनिविष्ट
मसीही: ईसा_विषयक ईसाई मसीही
महत्त्वपूर्ण: महत्त्वपूर्ण महत्त्वपूर्ण बहूमूल्य अहम ठुलो अर्थपूर्ण
महत्त्वाकांक्षी: महत्त्वाकाङ्क्षी उच्चाकाङ्क्षी महत्त्वाकांक्षी उच्चाकांक्षी
महाकाय: महाकाय अतिकाय बृहत्काय विशालकाय भीमकाय विकराल
महाग: महँगो मङ्गो दामी मूल्यवान
महागडा: महँगो मङ्गो दामी मूल्यवान
महाद्वीपीय: महाद्वीपीय
महान: महान ठुला श्रेष्ठ
महानगरीय: महान्गरीय
महापातकी: महापापी पापाधम महानीच पापिष्ठ
महापापी: महापापी पापाधम महानीच पापिष्ठ
महाबळी: महाबली शक्‍तिशाली
महामूर्ख: महामुर्ख बुद्धिहीन
महाराष्ट्रीय: मराठी मराठी महाराष्ट्री
महाराष्ट्रीयन: मराठी महाराष्ट्री
महावीर: महावीर_महाबीर
मांसरहित: निरामिष अनामिष
मांसाहारी: मांसाहारी मांसभक्षी
माखलेला: लतपत रगतपच्छे
मागचा: पछिल्लो पश्च पश्चस्थ
मागला: पछिल्लो पश्च पश्चस्थ
मागील: पछिल्लो पश्च पश्चस्थ
मागे_पडलेला: पछाडिएको प्रतिगत पश्चगत
मागे_राहिलेला: पछाडिएको प्रतिगत पश्चगत
माघार_न_घेणारा: अनिवर्ती अपरावर्ती
माजी: भूतपूर्व पूर्व अयथापूर्व
माझे: आफ्नो निजी
माणूसघाणा: अमिलनसार बाउँठे एकलकाटे
मातबर: प्रतिष्ठित अग्रगण्य इज्जतदार गणमान्य नामी सम्मानित मान्य माननीय गौरवान्वित सम्भ्रान्त संभ्रांत सम्ब्रांत अजीज अपचायित सुर्खरू विशिष्ट विशेष
मातब्बर: प्रतिष्ठित अग्रगण्य इज्जतदार गणमान्य नामी सम्मानित मान्य माननीय गौरवान्वित सम्भ्रान्त संभ्रांत सम्ब्रांत अजीज अपचायित सुर्खरू विशिष्ट विशेष
मादक: मत्त मस्त
मादा: पोथी
मादी: पोथी
माध्यमिक: माध्यमिक
माननीय: प्रतिष्ठित अग्रगण्य इज्जतदार गणमान्य नामी सम्मानित मान्य माननीय गौरवान्वित सम्भ्रान्त संभ्रांत सम्ब्रांत अजीज अपचायित सुर्खरू विशिष्ट विशेष आदरणीय सम्माननीय समादरणीय सम्मान्य मान्य माननीय
मानवनिर्मित: मानवकृत मानव-रचित मानव-कृत मानवनिर्मित मानव-निर्मित मानव_निर्मित कृत्रिम
मानवी: मानवीय पौरुषेय मानुषिक मानवी
मानवीय: मानवीय पौरुषेय मानुषिक मानवी
मानसिक: मानसिक मनः दिमागी
मान्य: स्वीकृत मान्य अनुमोदित
मान्यता_मिळालेला: स्वीकृत अनुमति_प्राप्त अनुमतिप्राप्त
मान्यताप्राप्त: स्वीकृत मान्य अनुमोदित
मान्यात_प्राप्त_झालेला: स्वीकृत अनुमति_प्राप्त अनुमतिप्राप्त
मापनीय: मापनीय नापनीय
मापशीर: फिट ठीक
मापाचा: फिट ठीक
माफक: उचित समुचित उपयुक्त ठिक सही निर्धारित सीमित नियत
मामुली: नगण्य यस्तो-उस्तो अगण्य अनुदात्त
मामे: माइज्यू_सासू
मायाळू: स्नेही दयालु
मारक: मारक घातक
मारण्यास_अयोग्य: अबध्य अबधार्ह
मारण्यास_योग्य: वध्य मार्न_लायक मार्नुपर्ने
मारवाडी: मारवाडी मारवाडी
मारू_नये_असा: अबध्य अबधार्ह
मालिकेतील_लगतचा: धारावाहिक धारावाही धाराप्रवाह निरन्तर एकोहोरो
मावळलेला: अस्तगत अस्त डुब्दो
मावस: सानिमाको_छोरो_भाइ
मासिक: मासिक महिनाको मासिक महिनावारी
माहित: थाहा ज्ञात विदित अवगत विज्ञात अवबुद्ध परिचित
माहितगार: सिपालु प्रवीण ज्ञानी जान्ने
माहितीचा: परिचित चिनेजानेको जानपहिचान_भएको परिचय_भएको
मिचकावणारा: अनिद्रा जाग्राम
मिचक्या: अनिद्रा जाग्राम
मिचमिच्या: अनिद्रा जाग्राम
मितभाषी: अल्पभाषी मितभाषी अल्पवादी
मितव्ययी: मितव्ययी
मिताहारी: अल्पाहारी अल्पहारी अल्पभोजी मिताहारी स्वल्पाहारी
मित्र_नसलेला: मित्रहीन बन्धुरहित अबन्धु बन्धुरहित मित्ररहित बंधुहीन बन्धुहीन
मित्रहीन: मित्रहीन बन्धुरहित अबन्धु बन्धुरहित मित्ररहित बंधुहीन बन्धुहीन
मिथ्या: मिथ्या झुटो असत्य ढाँट झूट
मियादी: सावधि अवधियुक्त सावधिक
मिळमिळीत: स्वादहीन बेस्वाद नीरस फीका अस्वादिष्ट अनास्वाद खल्लो नमिठो
मिळलेला: उपलब्ध प्राप्त लब्ध अधिगत
मिळवलेला: अर्जित कमाएको
मिश्र: मिश्र मिश्रित सम्मिश्रित
मिश्रित: अशुद्ध मिलावट मिसिएको अपमिश्रित मिश्र मिश्रित सम्मिश्रित
मुंजा: संस्कृत
मुंज्या: संस्कृत
मुंबईकर: बम्बेली मुम्बेली बम्बइया मुम्बइया
मुंबईचा: बम्बेली बम्बइया मुम्बइया
मुका: लाटो ग्वागे अबोला अपुष्पित अविकसित मुकुलित अस्मित
मुक्त: उन्मुक्‍त खुला मुक्‍त स्वतन्त्र
मुखपाठ: कण्ठस्थ मुखाग्र
मुखर: बिरेनुन कालो_नुन पादे_नुन
मुखस्तंभ: अल्पभाषी मितभाषी अल्पवादी
मुखोद्गत: कण्ठस्थ मुखाग्र
मुख्य: मुख्य प्रधान मूल मूल खास मुख्य प्रमुख प्रधान
मुग्ध: मोहित मुग्ध
मुदती: सावधि अवधियुक्त सावधिक
मुदित: प्रसन्न खुसी खुश आनन्दित पुलकित हर्षित विह्वल आह्लादित प्रफुल्ल परितुष्ट प्रफुल्लित प्रफुलित उल्लसित उल्लासित उल्लासी आनन्दी विनोदित पुलकित तुष्ट
मुबलक: अत्यधिक धेरै औधि प्रचुर अत्याधिक भारी भीषण घनघोर अत्याधिक
मुर्छित: बेहोस मूर्च्छित मूर्छित अचेत चेतनाहीन चेतनाशुन्य अचेतन चेतनारहित ज्ञानशून्य संज्ञाशून्य संज्ञाहीन निश्चेष्ट अचेष्ट अचैतन्य
मुलायम: नरम कमलो कोमल
मूढ: मूर्ख अज्ञानी बुद्धु ज्ञानहीन अज्ञानपूर्ण
मूर्ख: मूर्ख अज्ञानी बुद्धु ज्ञानहीन अज्ञानपूर्ण
मूर्खशिरोमणी: महामुर्ख बुद्धिहीन
मूळ-: मुख्य प्रधान मूल
मूळ_स्वरूपातील: अविकृत नबिग्रेको
मृत: मृत मरेको मृत
मृत्यूरहित: अमर मृत्यु_कालजयी चिरञ्जीवी
मृदुल: नरम कमलो कोमल
मृदू: नरम कमलो कोमल
मॅसिडोनियन: मकदुनियाई मेसीडोनियाई मकदुनियाई मेसिडोनियाई
मेंदवी: दिमागी
मेंदूचा: दिमागी
मेंदूविषयक: दिमागी
मेंदूविषयीचा: दिमागी
मेंदूशी_संबंधित: दिमागी
मेंदूसंबंधीचा: दिमागी
मेघरहित: स्वच्छ मेघहीन निरभ्र अनभ्र मेघरहित अनाकाश अमेघ
मेघहीन: स्वच्छ मेघहीन निरभ्र अनभ्र मेघरहित अनाकाश अमेघ
मेणाचा: मैन मइन
मेणासारखी: मैनका मैनले_बनेका
मेलेला: मरेको मृत
मेहनती: परिश्रमी मेहनती उद्यमी कर्मशील पुरूषार्थी
मैंद: अल्छी सुस्त ढिलो
मॉल्डेव्हियन: मोल्डोवाई मोलडोवाई मोल्डोवाई मोलडोवाई
मोकळा: उन्मुक्‍त खुला मुक्‍त स्वतन्त्र रिक्त खाली रित्तो शून्य खाली अव्यस्त
मोजका: कम्ती अलिकति अल्प निर्धारित सीमित नियत
मोठा: महान ठुला श्रेष्ठ जेठा ज्येष्ठ ठुला लामो टाढा
मोठे_केलेला: परिवर्द्धित
मोड_आलेला: अङ्कुरित उम्रिएको
मोडकळीस_आलेला: जीर्ण पुरानो थोत्रो भाँचिएको
मोप: अत्यधिक धेरै औधि प्रचुर अत्याधिक भारी भीषण घनघोर अत्याधिक
मोफत: निःशुल्क मुफ्त निशुल्क
मोसमी: मौसमी
मोहक: आकर्षक मनोहर राम्रो सुन्दर मोहनी मोहिनी
मोहवणारा: मोहनी मोहिनी
मोहित: आसक्त मुग्ध मोहित मोहित मुग्ध
मौखिक: मौखिक अन्तर्वार्ता
मौजेचा: रोचक रमाइलो मजाको रङ्गीन
मौल्यवान: बहुमूल्य मूल्यवान अमूल्य अनमोल दामी महँगो मङ्गो दामी मूल्यवान
म्यानमारी: बर्मी बर्मे म्यानमारी
म्यान्मारी: बर्मी म्यानमारी बर्मेली
म्लान: म्लान न्याउरो न्यास्रो रगतहीन निस्तेज आभाहीन कांतिहीन ओजहीन प्रभाहीन बेरौनक अप्रभ प्रभारहित श्रीहत
म्हातारा: वृद्ध बूढ़ो बुढ़ो वरिष्ठ बुजुर्ग वयोवृद्ध उम्रदराज
यथायोग्य: उचित समुचित उपयुक्त ठिक सही
यथार्थ: वास्तविक यथार्थ साँचो सही असली वास्तव अकाल्पनिक अकल्पित प्रकृत प्राकृतिक साँचो सत्य यथार्थ
यथोचित: यथोचित यथायोग्य समुचित
यशस्वी: उत्तीर्ण पास सफल सिद्ध
यहूदी: यहुदी हिब्रु इब्रानी इबरानी
यांत्रिक: यन्त्र_चालित यान्त्रिक स्वचालित यंत्र-संचालित
युक्रेनियन: युक्रेनी युक्रेनी
युनानी: युनानी ग्रिक
यूरेशियाई: युरेसियाई
येडा: पागल पगला बौलाहा बौलाहा बहुला पागल
योग्य: योग्य उपयुक्‍त समर्थ सक्षम खाइलाग्दो उचित उपयुक्‍त ठिक उचित समुचित उपयुक्त ठिक सही योग्य उपयुक्‍त लायक अन्वर्थ
योजिलेला: सङ्कल्पित
योद्धा: रणवीर युद्धवीर
रंक: निर्धन गरीब दरिद्र
रंगलेला: रङ्गीन रङ्गीचङ्गी
रंगवलेला: रङ्गीन रङ्गीचङ्गी
रंगहीन: रङ्गहीन
रंगांचा: रङ्गीबिरङ्गी रङ्गीचङ्गी रङ्गारङ्ग
रंगांध: वर्णान्ध वर्णान्धताले_पीडित
रंगारंग: रङ्गारङ्ग रङ्गीबिरङ्गी रङ्गबिरङ्ग रङ्गीचङ्गी
रंगीत: रङ्गीबिरङ्गी रङ्गीचङ्गी रङ्गारङ्ग
रंजक: रमाइलो आनन्दप्रद आनन्दप्रद आनन्द-दायक आह्लादक सुखप्रद खुशनुमा प्रसन्नतादायक आनंददायक आनन्ददायक आनन्ददायी आनन्दकारी आनंदकारी आह्लादी अनंद अनन्द नंदक नन्दक रमन रमण
रंजलेला: पीडित ग्रस्त ग्रसित व्यथित
रक्त_पिणारा: डरलाग्दा
रक्तविषयक: खुनी खुनी
रक्तविहिन: रक्तहीन रुधिरहीन
रक्तहीन: रक्तहीन रुधिरहीन
रक्ताचा: खुनी खुनी
रक्ताविषयीचा: खुनी खुनी
रक्ताशी_संबंधित: खुनी खुनी
रक्तासंबंधीचा: खुनी खुनी
रक्ती: खुनी खुनी
रक्षक: रक्षक रक्षा_कर्ता अभिरक्षक रक्षी वार्डन परिरक्षक रक्षात्मक
रक्षणकर्ता: रक्षक रक्षा_कर्ता अभिरक्षक रक्षी वार्डन परिरक्षक
रक्षात्मक: रक्षात्मक
रक्षित: रक्षित संरक्षित
रखरखीत: सुक्खा सुकेको निर्जल अजल जलहीन जलरहित
रगड: अत्यधिक धेरै औधि प्रचुर अत्याधिक भारी भीषण घनघोर अत्याधिक
रग्गड: अत्यधिक धेरै औधि प्रचुर अत्याधिक अनगन्ती थुप्रो भारी भीषण घनघोर अत्याधिक
रचनाकार: सृजनकर्ता सर्जक सृजक रचयिता स्रष्टा
रचलेला: निर्मित रचित विरचित सृष्ट कृत सर्जित सृजित संरचित पर्णीत प्रकृत प्रणीत
रचित: निर्मित रचित विरचित सृष्ट कृत सर्जित सृजित संरचित पर्णीत प्रकृत प्रणीत
रजस्वला: रजस्वला ऋतुमती रजवती पुष्पवती
रटाळ: अरोचक अरुचिकर नीरस रसहीन रुचिहीन फीका असार
रत: तल्लीन अनुरत निमग्न लीन तन्मय मग्न मगन दत्तचित्त लिप्त रत निरत अनुरक्त अनुसंरक्त अभिनिविष्ट
रमणीय: रमणीय रम्य रमणीक
रममाण: तल्लीन अनुरत निमग्न लीन तन्मय मग्न मगन दत्तचित्त लिप्त रत निरत अनुरक्त अनुसंरक्त अभिनिविष्ट
रम्य: रमणीय रम्य रमणीक
रवाना: पठाइएको
रवाळ: कनिका मोटो
रशियन: रूसी
रशियाई: रूसी रशियन
रशियायी: रूसी
रसदार: रसिलो रसपूर्ण सरस रसवन्त रसवान
रसपूर्ण: रसिलो रसपूर्ण सरस रसवन्त रसवान
रसभरित: रसिलो रसपूर्ण सरस रसवन्त रसवान
रसरशीत: रसिलो रसपूर्ण सरस रसवन्त रसवान
रसहीन: रसहीन बेरस सुखा शुष्क नीरस
रसाळ: रसिलो रसपूर्ण सरस रसवन्त रसवान रसभएको रसिलो झोलभएको
रसिक: रसिक हँस्यौली विनोदी ठट्यौली
रस्त्यासारखा: हिडने
रहस्यमय: रहस्यपूर्ण रहस्यमय रहस्यात्मक गूढ
राक्षसी: अमानवीय अमानुषिक पाशविक पशुवत
राखलेला: आरक्षित व्याससिद्ध धृत निभृत
राखीव: आरक्षित व्याससिद्ध
रागावलेला: रिसाएको झोकिएको क्रुद्ध
राजकीय: राजकीय राज्य_विषयको राजनैतिक राजनीतिक राजनीति_विषयक राजनयिक
राजस्थानी: राजस्थानी
राजेशाही: धाकिलो धाके
राज्यविषयक: राजकीय राज्य_विषयको
रात्रिंचर: निशाचर रात्रिचर
रानटी: वन्य जङ्गली आरण्य आरण्यक जङ्गली वन्य बनैया
रानातील: जङ्गली वन्य बनैया
राष्ट्रीय: स्वदेशीय देशी देसी स्वदेशी देशीय देशज राष्ट्रीय
रासायनिक: रासायनिक रसायनिक
राहिलेला: रहल शेष बाँकी
रिकामटेकडा: अकर्मण्य निकम्मा बेकार फालतू अकर्मा नालायक ना-लायक अनलायक_नालायक ना-लायक
रिकामा: खोक्रो ध्वान्द्रो रिक्त खाली रित्तो शून्य खाली अव्यस्त
रिक्त: रिक्त खाली रित्तो शून्य
रिता: खोक्रो ध्वान्द्रो रिक्त खाली रित्तो शून्य
रिमझिम: सिमसिमे
रुंद: फराक चौडा विस्तीर्ण
रुकार_मिळालेला: स्वीकृत अनुमति_प्राप्त अनुमतिप्राप्त
रुग्णाईत: रोगी बिमारी बिरामी पन्थे रुग्न
रुचकर: स्वादिष्ट मिठो स्वादिष्ठ राम्रो रुचिकर मनपर्दो
रुष्ट: अप्रसन्न नाराज रुष्ट खिन्न अप्रतीत
रूआंडन: रवान्डी रवान्डाई रवान्डी रवान्डाई
रूआंडाचा: रवान्डी रवान्डाई
रूक्ष: सुक्खा सुकेको निर्जल अजल जलहीन जलरहित
रूढिवादी: रूढिवादी
रूपवान: राम्रो सुन्दर
रूपांतरित: रूपान्तरित
रूमानियन: रुमानियाई रोमानियाई
रूमानियाई: रुमानियाई रोमानियाई रोमानियम रुमानियन
रेखीव: सुडौल सुगठित बान्की_परेको
रेडिमेड: तयार
रेताड: बालुवा_भएको
रेशमी: रेसमी सिल्की रेसमी
रोगग्रस्त: रोगी बिमारी बिरामी पन्थे रुग्न
रोगट: रोगी बिमारी बिरामी पन्थे रुग्न
रोगमुक्त: स्वस्थ्य निरोगी
रोड: दुब्लो सिकुटे खिनाउटे हड्डीछाला अस्थिमय दुब्लो लुते क्षीण
रोडावलेला: हड्डीछाला अस्थिमय
रोधलेला: बन्द थुनिएको रोकिएको
रोमहर्षक: रोमाञ्चकारी रोमाञ्चक
रोमहर्षित: रोमान्चित खुसी पुलकित
रोमांचक: रोमाञ्चकारी रोमाञ्चक
रोमांचित: रोमान्चित रोमान्चित खुसी पुलकित
लंगडा: लङ्गडो लंगडो खोरन्डो
लंपट: कामुक विलासी विषयी भोगी कामचारी इन्द्रियलोलुप
लकी: सौभाग्यशाली भाग्यवान भाग्यशाली
लक्षणीय: विचारणीय विचार्य चिन्तनीय चिंतनीय चिंत्य अनुशीलनीय विचारणीय लक्ष्य अभिलक्ष्य
लक्षावधी: लाखौ
लक्ष्यगामी: लक्ष्यवेधी लक्ष्यानुगामी
लक्ष्यवेधी: लक्ष्यवेधी लक्ष्यानुगामी
लक्सेंबर्गचा: लक्समबर्गी
लज्जतदार: स्वादिष्ट मिठो स्वादिष्ठ राम्रो
लज्जाशील: लजालु लज्जाशील
लज्जास्पद: लाजमर्दो लज्जाजनक लज्जाजन्य लज्जाप्रद
लज्जाहीन: निर्लज्ज लज्जाहीन छाडा
लज्जित: लज्जित
लट्टू: आसक्त मुग्ध मोहित
लठ्ठ: मोटो बलियो स्थुलकाय
लढवय्या: रणवीर युद्धवीर
लफंगा: लफङ्गो फटाहा लुच्चा बदमास दुष्ट छक्याउने
लबाड: लफङ्गो फटाहा लुच्चा बदमास दुष्ट छक्याउने
लवका: लचिलो लचकदार नम्य नमनीय विनम्य सुनम्य
लवकीरा: लचिलो लचकदार नम्य नमनीय विनम्य सुनम्य
लवचीक: लचिलो लचकदार नम्य नमनीय विनम्य सुनम्य
लवलवीत: लचिलो लचकदार नम्य नमनीय विनम्य सुनम्य
लवलेला: निहुरिएको नत
लष्करी: सैन्य सेना फौजी
लहरी: अशान्त अशांत चंचल अस्थिरचित्त उत्कंठित उत्कण्ठित विचलित अस्थिर अनुपशांत अनेकांत अनेकान्त क्षुब्ध
लहान: अवयस्क नाबालिग अल्पवयस्क अप्रौढ़ अप्राप्तयौवन साना_भाइ भाइ भुराभुरि केटाकेटी नानी शिशु बच्चा
लहान-सहान: छिटपुट छुटपुट छिट-पुट छुट-पुट हल्का-फुल्का
लहान_मुलांचा: बचकना बचकाना
लहानसहान: खुद्रा_सामान फुटकर_सामान
लांब: लामो ठुलो लामो टाढा
लांबचा: दूर दूरवर्ती दूरस्थ
लाओ: लाओ लाओ लाओसियन
लाखो: लाखौ
लागलेला: जुटेको लागेको_कार्यरत
लागू: लागु
लाचार: विवश बाध्य लाचार
लाजट: लजालु लज्जाशील
लाजरा: लजालु लज्जाशील
लाजराबुजरा: लजालु लज्जाशील
लाजवट: लजालु लज्जाशील
लाजाळू: लजालु लज्जाशील
लाटलेला: अधिग्रहीत अधिकृत अधिगत पच हजम हडप
लाडका: प्यारो प्रिय
लापट: खुकुलो ढीला
लाभकारी: लाभदायक लाभप्रद लाभकर लाभकारी लाभजनक गुणकारी उपयोगी हितकारी अर्थकर
लाभदायक: लाभदायक लाभप्रद लाभकर लाभकारी लाभजनक गुणकारी उपयोगी हितकारी अर्थकर कल्याणकारी मङ्गलकारी कल्याणप्रद मङ्गलकारक मङ्गलदायक मङ्गलप्रद हितकारी हितकर हितकारक कल्याणमय अनुकूल
लायक: योग्य उपयुक्‍त समर्थ सक्षम खाइलाग्दो योग्य उपयुक्‍त लायक
लाल: रातो लाल रोहित
लालची: लोभी लालची चुइयाँ कन्जुस
लावलेला: बन्द
लिखित: लिखित लिपिबद्ध अङ्कित लेखिएको
लिथ्युएनियन: लिथुनियाई लिथुनियाई
लिहिण्याजोगा: उल्लेखनीय उल्लेख_गर्ने_योग्‍य
लिहिलेला: लिखित लिपिबद्ध अङ्कित लेखिएको
लुकडा: दुब्लो सिकुटे खिनाउटे दुब्लो लुते क्षीण
लुच्चा: लफङ्गो फटाहा लुच्चा बदमास दुष्ट छक्याउने
लुप्त: विलुप्त लुप्त गायब अदृश्य अदिष्ट अन्तर्हित अंतर्हित
लुब्ध: आसक्त मुग्ध मोहित
लुला: कमजोर लुलो शिथिल
लुळा: कमजोर लुलो शिथिल
लॅटव्हियन: लातवियाई लातवियन लातवियाई लातवियन
लेखनीय: उल्लेखनीय उल्लेख_गर्ने_योग्‍य
लेखी: लिखित लिपिबद्ध अङ्कित लेखिएको
लेख्य: उल्लेखनीय उल्लेख_गर्ने_योग्‍य
लेट: लातवियाई लातवियन
लेट्सबुर्झ: लक्समबर्गी
लैंगिक: लैङ्गिक लिङ्गीय
लोकविलक्षण: विलक्षण अद्भुत अनौठो अचम्भको विचित्र आश्चर्यजनक आश्चर्यभूत अभूतपूर्व अपूर्व
लोकशाही: प्रजातन्त्रीय प्रजातान्त्रिक जनतान्त्रिक
लोकोत्तर: विलक्षण अद्भुत अनौठो अचम्भको विचित्र आश्चर्यजनक आश्चर्यभूत अभूतपूर्व अपूर्व
लोकोपकारी: लोकोपकारी लोक_हितैषी
लोखंडी: फलामे
लोणीयुक्त: मखानको
लोण्याचा: मखानको
लोपलेला: विलुप्त लुप्त गायब अदृश्य अदिष्ट अन्तर्हित अंतर्हित
लोभी: लोभी लालची चुइयाँ कन्जुस
लोलुप: आसक्त मुग्ध मोहित
लौकिक: इहलौकिक सांसारिक लौकिक
वंदनीय: वन्दनीय पुजनीय
वंदिलेला: अभिनन्दित अभिनंदित वंदित
वंशपरंपरागत: आनुवंशिक वंशागत वंशानुक्रमिक पैतृक आनुवांशिक अनुवांशिक पुर्ख्यौली
वक्तशीर: समय_पालक
वक्र: टेढो तेर्छो बाङ्गो
वजन_न_केलेला: अतुल्य अतुलनीय
वजनदार: भारी गरुङ्गो वजनदार
वडील: जेठा ज्येष्ठ ठुला
वणजारा: बन्जारा घुमन्ते
वत्सल: स्नेही दयालु वत्सल स्नेही वत्सल स्नेही
वधनीय: वध्य मार्न_लायक मार्नुपर्ने
वधार्ह: वध्य मार्न_लायक मार्नुपर्ने
वध्य: वध्य मार्न_लायक मार्नुपर्ने
वन्य: वन्य जङ्गली आरण्य आरण्यक
वन्यतापूर्ण: जङ्गली वन_भएको
वयस्कर: वृद्ध बूढ़ो बुढ़ो वरिष्ठ बुजुर्ग वयोवृद्ध उम्रदराज
वयात_सर्वात_लहान: कान्छो कनिष्ठ
वयोवृद्ध: वृद्ध बूढ़ो बुढ़ो वरिष्ठ बुजुर्ग वयोवृद्ध उम्रदराज
वरकरणी: देखावटी बनावटी बोक्रे बनौटी घोरेलको
वरचा: उचो उच्च
वरपांगी: देखावटी बनावटी बोक्रे बनौटी घोरेलको
वरिष्ठ: कनिष्ठा
वरील: बाहिरी बाहिरको
वर्ज्य: मना मना_गरिएको निषिद्ध वर्जित प्रतिबन्धित प्रतिबंधित निषेधित वर्ज्य व्याहत
वर्णन_करण्याजोगा: वर्णनीय कथनीय वर्ण्य अभिधेय
वर्णन_करण्यायोग्य: वर्णनीय कथनीय वर्ण्य अभिधेय
वर्णन_करण्यालायक: वर्णनीय कथनीय वर्ण्य अभिधेय
वर्णनीय: वर्णनीय कथनीय वर्ण्य अभिधेय
वर्णावा_असा: वर्णनीय कथनीय वर्ण्य अभिधेय
वर्तमान: वर्तमान अभूत हाल आधुनिक अद्यतन आजको अर्वाचीन अधुनातन नया अप्राचीन अकालातीत अपूरातन अपूर्वकालीन नवीन अपूराण साम्प्रतिक
वर्तमानकालविषयक: वर्तमानकालीन सामयिक आधुनिक वर्तमान हाल
वर्तमानकालाचा: वर्तमानकालीन सामयिक आधुनिक वर्तमान हाल
वर्तमानकालाबाबतचा: वर्तमानकालीन सामयिक आधुनिक वर्तमान हाल
वर्तमानकालाविषयीचा: वर्तमानकालीन सामयिक आधुनिक वर्तमान हाल
वर्तमानकालासंबंधीचा: वर्तमानकालीन सामयिक आधुनिक वर्तमान हाल
वर्तमानकालीन: वर्तमानकालीन सामयिक आधुनिक वर्तमान हाल
वर्तमानकाळविषयक: वर्तमानकालीन सामयिक आधुनिक वर्तमान हाल
वर्तमानकाळाचा: वर्तमानकालीन सामयिक आधुनिक वर्तमान हाल
वर्तमानकाळाबाबतचा: वर्तमानकालीन सामयिक आधुनिक वर्तमान हाल
वर्तमानकाळाविषयीचा: वर्तमानकालीन सामयिक आधुनिक वर्तमान हाल
वर्तमानकाळासंबंधीचा: वर्तमानकालीन सामयिक आधुनिक वर्तमान हाल
वर्तुळ: गोलो वृत्ताकार गोलाकार
वर्तुळाकार: गोलो वृत्ताकार गोलाकार बाटुलो गोलो डोलो डल्लो गोल
वर्तुळाकृती: गोलो वृत्ताकार गोलाकार
वर्धक: वर्धक वर्धयिता वर्द्धक वृद्धिकर वृद्धिकारी पोषक संवर्द्धक संवर्धक
वळणदार: घुमाउरो बाङ्गो-टिङ्गो घुमेको
वश: अधीनस्थ अधीन मातहत अधस्तन अमुख्य
वश_असलेला: अधीनस्थ अधीन मातहत अधस्तन अमुख्य
वसलेला: आवासित अध्युष्ट
वसाहतीशी_संबंधित: औपनिवेशिक उपनिवेशिक
वस्तुनिष्ठ: वस्तुनिष्ठ
वस्त्र_घातलेला: वस्त्रधारी वस्त्र-धारी
वस्त्रहीन: नाङ्गो नग्न निर्वस्त्र
वस्त्रालंकार_धारण_करणारा: वेशित भूषित सज्जित
वांछित: प्रत्याशित प्रयाशानुकूल यथावांछित आशानुकूल इच्छित अभिलषित अभिलाषित अभीष्ट आकाङ्क्षित वाञ्छित इष्ट अपेक्षित अभिप्रेत मनोवाञ्छित वाञ्छनीय कमनीय अनुकाङ्क्षित अभिकाङ्क्षित अभिमत अभिवांछित अभिवाञ्छित अभीप्सित
वांड: चकचके चञ्‍चल चुलबुले
वाईट: असभ्य अभद्र अशिष्ट घटिया निकृष्ट नीच अधम क्षुद्र नराम्रो खराब निकृष्ट अनुचित निकृष्टतम अधमाधम तुच्छातितुच्छ
वाईटतर: खराब रद्दी नजाती
वाकडा: टेढो तेर्छो बाङ्गो बाङ्गोटिङ्गो बाङ्गो वक्र अप्रत्यक्ष परोक्ष
वाकडातिकडा: बाङ्गोटिङ्गो बाङ्गो वक्र
वाकबगार: सिपालु प्रवीण निपुण पारङ्गत दक्ष माहिर अभ्यस्त कुशल होशियार पक्का सिद्धहस्त शातिर पटु पका निष्णात परिपक्व कार्यकुशल विचक्षण अभिज्ञ अभ्यासी आप्त
वाकलेला: निहुरिएको नत
वाक्चतुर: वाक्पटु
वाक्पटू: वाक्पटु
वाखाणण्याजोगे: प्रशंसनीय स्तुत्य धन्य धन्न प्रशंस्य श्लाघ्य श्लाघनीय सराहनीय प्रशस्त अभिनन्दनीय अभिवन्दनीय
वाचण्याजोगा: पठनीय सुपाठ्य पाठ्य पठ्य अध्ययनीय अध्येतव्य अध्येय
वाचण्याजोगा_नसलेला: अपठनीय अपठ्य अपाठ्य
वाचनीय: पठनीय पाठ्य पठ्य पठनीय सुपाठ्य पाठ्य पठ्य अध्ययनीय अध्येतव्य अध्येय
वाचलेला: पढेको
वाचाळ: बिरेनुन कालो_नुन पादे_नुन
वाचिक: मौखिक अन्तर्वार्ता
वाट_चुकलेला: भड्केको मार्गच्युत
वाटोळा: बाटुलो गोलो डोलो डल्लो गोल
वाढणारा: वर्धक वर्धयिता वर्द्धक वृद्धिकर वृद्धिकारी पोषक संवर्द्धक संवर्धक
वाढलेला: वृद्धियुक्त अधिरूढ
वाढवलेला: परिवर्द्धित परिवर्द्धित
वातानुकूलक: वातानुकुलक
वातानुकूलित: वातानुकूलित
वात्रट: चकचके चञ्‍चल चुलबुले
वाद_नसलेला: निर्विवाद
वादग्रस्त: विवादित विवादास्पद विवादग्रस्त
वापरलेला: प्रयुक्त व्यवहृत उपभुक्त
वामनमूर्ती: पुडके होचो
वायफळ: अर्थहीन निरर्थक
वार्षिक: वार्षिक प्रतिवर्ष वर्षेनी
वालुकामय: बालुवा_भएको
वाळकुडा: दुब्लो सिकुटे खिनाउटे
वाळके: सुकेको सुक्खा
वाळक्या: ओइलाएको
वाळलेला: दुब्लो सिकुटे खिनाउटे हड्डीछाला अस्थिमय सुकेको सुक्खा दुब्लो लुते क्षीण
वाळवंटीय: मरुभूमि
वाळीत_टाकलेला: बहिष्कृत खारिज
वाशेरा: दुर्गंधपूर्ण दुर्गंधयुक्त दुर्गंधित
वाशेळा: दुर्गंधपूर्ण दुर्गंधयुक्त दुर्गंधित
वासकट: दुर्गंधपूर्ण दुर्गंधयुक्त दुर्गंधित
वासट: दुर्गंधपूर्ण दुर्गंधयुक्त दुर्गंधित
वासनाहीन: कामहीन वासनाहीन निष्काम निर्मम
वासाहसिक: औपनिवेशिक उपनिवेशिक
वास्तव: वास्तविक यथार्थ साँचो सही असली वास्तव अकाल्पनिक अकल्पित प्रकृत प्राकृतिक साँचो सत्य यथार्थ
वास्तवातला: वास्तविक यथार्थ साँचो सही असली वास्तव अकाल्पनिक अकल्पित प्रकृत प्राकृतिक
वास्तवातील: वास्तविक यथार्थ साँचो सही असली वास्तव अकाल्पनिक अकल्पित प्रकृत प्राकृतिक
वास्तविक: वास्तविक यथार्थ साँचो सही असली वास्तव अकाल्पनिक अकल्पित प्रकृत प्राकृतिक
वाहक: वाहक बोक्ने चालक
वाहता: प्रवाहित बग्दो प्रवाहशील प्रवाहमय गतिशील गतिमान प्रवाही परिष्यन्दी
वाहिनी: वाहिका वाहिनी वाही
वाह्यात: चकचके चञ्‍चल चुलबुले अश्लील कामुकतापूर्ण
विकट: प्रचण्ड डरलाग्दो भयानक विकट रौद्र_रूप
विकत_घेतलेला: किनेको
विकलांग: विकलाङ्ग अपाहिज अंगहीन अपंग अपाहज निपंग
विकसनशील: प्रगतिशील उन्नतशील विकासशील उन्नतिशील उत्थानशील अभ्युत्थायी
विकसित: विकसित उन्नत प्रोन्नत सुविकसित अभ्युत्थित अभ्युदित पुष्पित फुलेको कुसुमित खिला प्रफुल्लित प्रफुलित स्मित विकसित
विकासपर: उन्नतिकारी उत्कर्षकारी उन्नायक उन्नतकारी
विखरलेला: छरिएको फिँजरिएको
विखुरलेला: छरिएको फिँजरिएको
विखुरलेली: छरिएको छ्यान्नब्यान्न छरपुष्ट
विख्यात: प्रसिद्ध प्रख्यात ख्याति_प्राप्‍त
विचलित: विचलित हटेको
विचार_न_करण्याजोगा: अविचारणीय अचिन्तनीय अविचार्य
विचारणीय: विचारणीय विचार्य चिन्तनीय चिंतनीय चिंत्य अनुशीलनीय विचारणीय लक्ष्य अभिलक्ष्य
विचारपूर्ण: विचारपूर्ण विचारात्मक युक्तिपूर्ण
विचारशील: विचारशील विचारवान मननशील दीर्घदर्शी
विचारशून्य: अविवेकी विवेकहीन अबोध अबुझ विचारहीन सतही हल्का
विचारी: विचारशील विचारवान मननशील दीर्घदर्शी
विचार्य: विचारणीय विचार्य चिन्तनीय चिंतनीय चिंत्य अनुशीलनीय विचारणीय लक्ष्य अभिलक्ष्य
विजन: निर्जन एकान्त सुनसान जनशून्य
विजयी: विजेता विजयी
विजातीय: विजातीय परजातीय भिन्न_जातीय विजाति अर्को_जातिको
विजेचा: विद्युत
विजेता: विजेता विजयी
विजेसंबंधीचा: विद्युत
विजोड: बेमेल अनमेल अजोड अमेल
विज्ञात: थाहा ज्ञात विदित अवगत विज्ञात अवबुद्ध परिचित
विज्ञानसंगत: विज्ञान_सङ्गत विज्ञानानुकूल
वित्तीय: आर्थिक वित्तीय रुपिया
विदारक: विदारक
विदित: थाहा ज्ञात विदित अवगत विज्ञात अवबुद्ध परिचित
विदुषी: विदुषी प्राज्ञी
विदेशी: विदेशी परदेशी परदेसी बिदेसी गैरमुल्की विलायती अन्यदेशीय अन्यराष्ट्रीय
विदेह: अशरीरी अशारीरिक विदेह अशरीरी अकाय शरीरहीन अगात्र अतनु अदेह शरीरविहीन अपाङ्ग अपिण्डी पिण्डरहित
विद्यालयीन: स्कुली विद्यालयी विद्यालयीय
विद्युताचा: विद्युत
विद्राव्य: घोलिने_खालको विलय_हुने_खालको
विद्वान: विद्वान् ज्ञानी प्राज्ञ पण्डित विज्ञ
विधायक: रचनात्मक सृजनात्मक
विध्वंसक: नाशक नाशी विनाशी विनाशक
विनम्र: विनम्र नम्र विनयी
विनयशील: निरभिमानी अनभिमानी अभिमानरहित गर्वहीन दर्पहीन अदम्भी अदर्पी निरहङ्कारी अहङ्कारहीन दम्भहीन निरहङ्कर निरहङ्कृत सीधा अनमद अहङ्काररहित गर्वरहित मदशून्य अमानी अभिमानशून्य अमत्त घमण्डरहित विनम्र नम्र विनयी
विनयी: निरभिमानी अनभिमानी अभिमानरहित गर्वहीन दर्पहीन अदम्भी अदर्पी निरहङ्कारी अहङ्कारहीन दम्भहीन निरहङ्कर निरहङ्कृत सीधा अनमद अहङ्काररहित गर्वरहित मदशून्य अमानी अभिमानशून्य अमत्त घमण्डरहित विनम्र नम्र विनयी
विनाआहारी: निराहार अनाहार
विनाकारण: बिनासित्ति अकारण
विनामूल्य: निःशुल्क मुफ्त निशुल्क
विनाशक: नाशक नाशी विनाशी विनाशक
विनाशकारी: नाशक नाशी विनाशी विनाशक
विनाशुल्क: निःशुल्क मुफ्त निशुल्क
विनीत: विनम्र नम्र विनयी
विनोदी: हँस्यौली विनोदी ठट्यौली
विपरीत: विपरीत उल्टो विरुद्ध विपरीत प्रतिकूल खिलाफ
विपुल: अत्यधिक धेरै औधि प्रचुर अत्याधिक भारी भीषण घनघोर अत्याधिक
विभक्त: विभाजित विभक्त अलग
विभागित: विभाजित विभक्त अलग
विभागीय: विभागीय
विभिन्न: अलग छुट्टै पृथक् फरक
विभूषित: अलङ्कृत अलंकृत आभूषित भूषित सज्जित विभूषित अलंकारिक अलंकारपूर्ण अभिलमंडित अभिलमण्डित
विमनस्क: उद्विग्न हताश_भएको डराएको
विमुक्त: उन्मुक्‍त खुला मुक्‍त स्वतन्त्र
विरक्त: अनासक्त अलिप्त निर्लिप्त मायारहित मायाशून्य अमुग्ध विरक्त विमुख बैरागी वैरागी विरागी सन्यासी सन्यासी सन्नासी रागहीन
विरचित: निर्मित रचित विरचित सृष्ट कृत सर्जित सृजित संरचित पर्णीत प्रकृत प्रणीत
विरल: असघन अघन
विरळ: असघन अघन
विरागी: अनासक्त अलिप्त निर्लिप्त मायारहित मायाशून्य अमुग्ध विरक्त विमुख बैरागी वैरागी विरागी सन्यासी सन्यासी सन्नासी रागहीन
विराजमान: आसीन विराजमान बसेका उपविष्ट
विरुद्ध: विपरीत उल्टो विरुद्ध
विरोधक: विरोधी विरोधक
विरोधात्मक: विरोधात्मक
विरोधित: अपकृत
विरोधी: विरोधी विपक्षी प्रतिपक्षी विरोधी विरोधक
विलक्षण: विलक्षण अद्भुत अनौठो अचम्भको विचित्र आश्चर्यजनक आश्चर्यभूत अभूतपूर्व अपूर्व चमत्कारी चमत्कारपूर्ण चामत्कारिक तिलस्मी
विलोभनीय: रमणीय रम्य रमणीक
विवक्षित: विशिष्ट
विवश: विवश बाध्य लाचार
विवस्त्र: नाङ्गो नग्न निर्वस्त्र
विवादस्पद_नसलेला: निर्विवाद
विवादास्पद: विवादास्पद
विवाद्य: विवादित विवादास्पद विवादग्रस्त
विवाहित: विवाहित बिहे_भएको परिणीत
विविध: अनेक कैयौं विविध नाना एकाधिक अनेकानेक तमाम
विवेकवंत: विवेकी विवेकवान विवेकशील
विवेकशून्य: अविवेकी विवेकहीन अबोध अबुझ
विवेकी: विवेकी विवेकवान विवेकशील
विशारद: सिपालु प्रवीण निपुण पारङ्गत दक्ष माहिर अभ्यस्त कुशल होशियार पक्का सिद्धहस्त शातिर पटु पका निष्णात परिपक्व कार्यकुशल विचक्षण अभिज्ञ अभ्यासी आप्त
विशाल: विस्तृत लामो
विशालकाय: महाकाय अतिकाय बृहत्काय विशालकाय भीमकाय विकराल
विशिष्ट: विशिष्ट
विशुद्ध: अमिश्रित विशुद्ध अमिश्र
विशेष: विशेष खास खासा असामान्य असाधारण खास विशेष यस्तो-उस्तो जस्तो-त्यस्तो अपसामान्य स्पेसल
विश्वविख्यात: विश्वविख्यात जगत_प्रसिद्ध विश्वप्रसिद्ध
विश्वविजयी: विश्व_विजेता जगजयी दिग्विजयी विश्वविजयी
विश्वव्यापी: विश्वव्यापी विश्वव्याप्त
विश्वसनीय: विश्वासिलो विश्वसनीय विश्वासपात्र विश्वस्त विश्वासी पत्याउरो
विश्वास_करणारा: विश्वासी भरोसी विश्वास_कर्ता विश्वासशील विश्वास_गर्ने पत्यारिलो
विश्वास_ठेवणारा: विश्वासी भरोसी विश्वास_कर्ता विश्वासशील विश्वास_गर्ने पत्यारिलो
विश्वासपात्र: विश्वासिलो विश्वसनीय विश्वासपात्र विश्वस्त विश्वासी पत्याउरो
विश्वासार्ह: विश्वासिलो विश्वसनीय विश्वासपात्र विश्वस्त विश्वासी पत्याउरो
विश्वासू: विश्वासिलो विश्वसनीय विश्वासपात्र विश्वस्त विश्वासी पत्याउरो
विषण्ण: उद्विग्न हताश_भएको डराएको
विषम: विपरीत प्रतिकूल खिलाफ
विषयक: विषयक सम्बन्धीय सम्बन्धी अनुषंगी अन्वयी अबाध
विषयी: कामुक विलासी विषयी भोगी कामचारी इन्द्रियलोलुप
विषादरहित: शोकहीन अवसादहीन अशोक विशोक
विषारी: विषालु विषधर
विसंगत: असम्बन्धित असम्बद्ध सम्बन्धरहित अनन्वित अप्रसङ्ग असम्बन्धित असम्बद्ध सम्बन्धरहित अमेल अयुक्त बेमेल अनमेल अजोड अमेल
विसरभोळा: बिर्सुवी
विसरभोळ्या: बिर्सुवी
विसराळू: बिर्सुवी
विसावा: बीसौं
विस्कळीत: अव्यवस्थित व्यवस्थाहीन लथालिङ्ग छरप्रस्ट
विस्तारित: विस्तारित विस्तृत अभिवृद्ध
विस्तीर्ण: फराक चौडा विस्तीर्ण
विस्तृत: विस्तृत लामो फराक चौडा विस्तीर्ण
विस्फोटक: विस्फोटक विस्फोटकारी
विस्मयजनक: चमत्कारी चमत्कारपूर्ण चामत्कारिक तिलस्मी
विहित: विहित विहित अनिषिद्ध अप्रतिबन्धित अप्रतिबंधित अवर्जित निषेधहीन अटोक अप्रतिसिद्ध अबाध
वीतराग: अनासक्त अलिप्त निर्लिप्त मायारहित मायाशून्य अमुग्ध
वीर: वीर बहादुर सुरो पराक्रमी पुरूषार्थी पौरखी रणवीर युद्धवीर
वीस: बीस 20
वृद्ध: वृद्ध बूढ़ो बुढ़ो वरिष्ठ बुजुर्ग वयोवृद्ध उम्रदराज बुढ़ी बूढ़ी वृद्धा वयोबृद्धा
वृद्धिकारक: उन्नतिकारी उत्कर्षकारी उन्नायक उन्नतकारी
वेगळा: विभाजित विभक्त अलग अलग छुट्टै पृथक् फरक
वेगवान: द्रुतगामी तीव्रगामी
वेगवेगळा: अलग छुट्टै पृथक् फरक
वेचक: छानेको छुट्याएको पन्छाएको
वेडा: पागल पगला बौलाहा बौलाहा बहुला पागल
वेडापिसा: पागल पगला बौलाहा
वेडावाकडा: बाङ्गोटिङ्गो बाङ्गो वक्र
वेलबुट्टीचा: बुनेको
वेलबुट्टीदार: बुनेको
वैकल्पिक: वैकल्पिक विकल्पयुक्त विकल्पी ऐच्छिक
वैचारिक: वैचारिक विचार_विषयको
वैज्ञानिक: वैज्ञानिक
वैदिक: वैदिक वेदीय
वैध: वैध कानूनी ऐन_अनुसार
वैफल्यग्रस्त: लज्जित कुण्ठित
वैभवी: धाकिलो धाके
वैयक्तिक: निजी आफ्नो स्वकीय स्वायत्त आत्म वैयक्तिक व्यक्तिगत निजी आफ्नो व्यक्तिगत
वैराण: वनस्पतिहीन शस्यहीन
वैवाहिक: वैवाहिक बिहे_सम्बन्धी
व्यक्तिगत: निजी आफ्नो स्वकीय स्वायत्त आत्म वैयक्तिक व्यक्तिगत निजी आफ्नो व्यक्तिगत
व्यग्र: व्यस्त लगनशील बेफुर्सद
व्यतिरिक्त: अतिरिक्‍त बाहेक
व्यथित: दुखी पीड़ित व्यथित दुःखी आर्त दुखित
व्यभिचारी: व्यभिचारी कामुक दुश्चरित
व्यर्थ: अनुपयोगी अनावश्यक उपयोगहीन निरर्थक व्यर्थ फालतू रद्दी अनर्थक अर्थहीन निरर्थक बिनासित्ति अकारण
व्यवच्छेदक: भेदक छेड्ने प्वाल_पार्ने चिर्ने निर्धारक
व्यवस्था_लावलेला: व्यवस्थित प्रबन्धित विन्यस्त ठिक
व्यवस्थित: फिट
व्यवस्थित_बसणारा: फिट ठीक
व्यवहरज्ञानशून्य: अव्यवहारिक व्यवहार_अकुशल
व्यवहारकुशल: व्यवहार_कुशल व्यवहारी दुनियादार
व्यवहारदक्ष: व्यवहार_कुशल व्यवहारी दुनियादार
व्यवहारनिपुण: व्यवहार_कुशल व्यवहारी दुनियादार
व्यवहारशून्य: अव्यवहारिक व्यवहार_अकुशल
व्यवहारी: व्यवहार_कुशल व्यवहारी दुनियादार
व्याख्या_केलेले: परिभाषित
व्याधिग्रस्त: रोगी बिमारी बिरामी पन्थे रुग्न
व्यापलेले: आच्छादित ढाकिएको आवृत्त आवृत अपिबद्ध अपिनद्ध अपिहित आच्छन्न
व्यापून_राहिलेला: व्यापी व्याप्‍त
व्याप्त_असलेला: व्यापी व्याप्‍त
व्यावसायिक: व्यापारिक वाणिज्यिक व्यवसायिक
व्यासंगी: विद्वान् ज्ञानी प्राज्ञ पण्डित विज्ञ
शंकारहित: निश्शङ्क अनाशङ्कित आशङ्काहीन संशयहीन निश्शंक अनाशंकित आशंकाहीन
शंकाळू: शङ्कालु दोधारे संशयी
शंकित: आशङ्कित आशङ्कापूर्ण आशंकित आशंकापूर्ण सशङ्कित शङ्कित शङ्का आशङ्की
शंकू: शङ्ख
शंकेखोर: शङ्कालु दोधारे संशयी
शंख: मूर्ख अज्ञानी बुद्धु शङ्ख ज्ञानहीन अज्ञानपूर्ण महामुर्ख बुद्धिहीन
शंखाचा: शाङ्खिक शाङ्खिक
शंभर: सय सयकडा १००
शंभरावा: सयौं १००औं
शक्तिवान: सक्षम क्षमतावान सामर्थ्यवान क्षमताशाली सामर्थी सशक्त
शक्य: सम्भव संभव संभावनीय संभावित संभाव्य सम्भव सम्भावनीय सम्भावित सम्भाव्य
शत-: सय सयकडा १००
शतावधी: सयौँ सयकडौँ
शत्रू_असलेला: शत्रुपूर्ण सशत्रु
शत्रूभावयुक्त: सराप हाय
शब्दातीत: अवर्णनीय अकथनीय वर्णनातीत शब्दातीत अकथ अकथ्य अनभिधेय अनिर्वचनीय अनिर्वाच्य
शरणागत: शरणागत
शरणापन्न: शरणागत
शरमिंदा: लज्जित
शस्त्रधारी: सशस्त्र शस्त्रधारी
शस्त्रहीन: शस्त्रहीन निहत्था निरस्त्र
शहरविषयक: सहरको नगरको
शहराचा: सहरको नगरको
शहराविषयीचा: सहरको नगरको
शहराशी_संबंधित: सहरको नगरको
शहरासंबंधीचा: सहरको नगरको
शहरी: सहरी नगरवासी नगर_निवासी नगर-वासी नगर-निवासी नगरनिवासी नगरवासी शहराती नागर अग्राम्य सहरको नगरको
शहाणा: विवेकी विवेकवान विवेकशील
शहाण्णव: छयानब्बे
शहाण्णवावा: छयानब्बेऔं
शांत: गम्भीर शान्त धीर चिसो ठण्डा स्थिरचित्त शान्त स्थिर प्रशान्त अचञ्चल प्रशान्त सौम्य कोमल_स्वभावी सौम शान्त शांत प्रशान्त निरुद्विग्न अविकल अव्याकुल प्रशांत निभृत अनाकुल अव्यग्र विश्रब्ध शान्त शीतल ठण्डा
शांतिपूर्ण: शान्तिपूर्ण
शांतिमय: शान्तिपूर्ण
शाऐंशी: छयासी
शाकाहारी: निरामिष अनामिष शाकाहारी घाँस_खाने
शानदार: भव्य ठुलो सानदार विशाल
शाबीत: सिद्ध प्रमाणित साबित
शामक: प्रशामक शमक शान्तिकर शामक
शारीरिक: सारीरिक दैहिक कायिक
शालीन: सभ्य भद्र सुशील शिष्ट
शालेय: स्कुली विद्यालयी विद्यालयीय
शाश्वत: अमर अक्षय अनश्वर शाश्वत अक्षुण्ण अक्षुण अनष्ट अविनाशी अविनासी अक्षय्य अच्युत अभङ्ग अनाश अनाश्य अनाशवान अभङ्गुर अखय अक्षुण्य शाश्वत नित्य अविनाशी सनातन चिरस्थायी चिरस्था‍इ चिर-स्थायी चिर-स्थाइ अविनासी कालातीत अकाल अखीन अच्युत अनंत अनन्त अनाशी अयोनि अरिष्ट अमिट नमेटिने
शासकीय: प्रशासनिक
शासित: शासित प्रशासित
शास्त्रीय: शास्त्रीय वैज्ञानिक
शाहत्तर: छहत्तर
शाही: शाही
शिंगेवाला: सिङयुक्त सीङ्गदार विषाणी शृंगयुक्त शृंगी सींगी
शिकारी: सिकारी व्याधा सिकारी
शिक्षित: शिक्षित साक्षर प्राज्ञ पढे-लेखेको
शिडशिडीत: दुब्लो सिकुटे खिनाउटे
शिणलेला: थाकेको थकित क्लान्त क्लांत परिश्रांत
शिथिल: कमजोर लुलो शिथिल
शिफारसित: अनुशंसित
शिरलेला: प्रविष्ट आगत प्रवेशित अभिनिवेशित
शिल्लक: उब्रेको बचेको बचेखुचेको
शिळा: बासी पुरानो
शिळेपाका: बासी पुरानो
शिवलेला: अनुस्यूत
शिवाय: अतिरिक्‍त बाहेक
शिष्ट: सभ्य भद्र सुशील शिष्ट
शिस्तबद्ध: नियमी नेमी नियम_पालक आत्मानुशासी
शीत: चिसो शीतल ठण्डा अनुष्ण शीतल चिसो ठण्डा
शीतल: चिसो शीतल ठण्डा अनुष्ण
शीलवंत: चरित्रवान सच्चरित्र
शीलवान: चरित्रवान सच्चरित्र
शुद्ध: राम्रो शुद्ध चोखो असल खारिएको असली शुद्ध राम्रो खोटहीन विशुद्ध शुद्ध_सही
शुभचिंतक: हितैषी शुभचिन्तक शुभाकाङ्क्षी
शुभ्र: श्वेत सेतो शुक्ल
शुष्क: सुक्खा सुकेको निर्जल अजल जलहीन जलरहित
शून्याहारी: निराहार अनाहार
शूर: वीर बहादुर सुरो पराक्रमी पुरूषार्थी पौरखी
शृंगवान: सिङयुक्त सीङ्गदार विषाणी शृंगयुक्त शृंगी सींगी
शेकडो: सयौँ सयकडौँ
शेकलेले: भुटेको भुटेका
शेचाळीस: छयालीस
शेण_मिसळलेला: गोबरे गोबरी गोब्रे
शेण_लागलेला: गोबरे
शेपाळ: पुच्छर_भएको
शेलका: छानेको छुट्याएको पन्छाएको
शेळपट: काँतर कायर काथर डरछेरुवा भीरु साहसहीन नामर्द हुपहारा पानीमरुवा पानीआन्द्रे
शेवटचा: अन्तिम अंतिम आखिरी अन्त्य अंत्य
शेहेचाळीस: छयालीस
शैक्षणिक: शैक्षिक तालिमी इलमी
शोकग्रस्त: शोकपूर्ण शोकाकुल शोकग्रस्त शोकहीन अवसादहीन अशोक विशोक
शोकरहित: शोकहीन अवसादहीन अशोक विशोक
शोकहीन: शोकहीन अवसादहीन अशोक विशोक
शोकाकुल: शोकपूर्ण शोकाकुल शोकग्रस्त
शोकाक्रांत: शोकहीन अवसादहीन अशोक विशोक
शोकी: सौखिन सोखी सोखिन
शोधक: शोधकर्ता अनुसन्धान_कर्ता
शोधित: शोधित
शोभायमान: तेजोमण्डित तेजपूर्ण कान्तिमान जाज्वल्यमान प्रकाशमान दिव्य चम्किलो
शोषलेला: सोसित
शोषून_घेतलेला: सोसित
शौकीन: सौखिन सोखी सोखिन
श्रद्धाळू: श्रद्धालु
श्रमविकल: थाकेको थकित क्लान्त क्लांत परिश्रांत
श्रमी: परिश्रमी मेहनती उद्यमी कर्मशील पुरूषार्थी
श्रीमंत: धनाढ्य धनी धनवान
श्रीलंकाई: सिंहली श्रीलङ्काई
श्रीलंकाविषयक: सिंहली श्रीलङ्काई
श्रीलंकी: सिंहली श्रीलङ्काई सिंहली सिंहल
श्रीलंकीय: सिंहली श्रीलङ्काई
श्रीलंकेचा: सिंहली श्रीलङ्काई
श्रीलंकेविषयीचा: सिंहली श्रीलङ्काई
श्रीलंकेशी_संबंधित: सिंहली श्रीलङ्काई
श्रीलंकेसंबंधीचा: सिंहली श्रीलङ्काई
श्रेयस्कर: कल्याणकारी मङ्गलकारी कल्याणप्रद मङ्गलकारक मङ्गलदायक मङ्गलप्रद हितकारी हितकर हितकारक कल्याणमय अनुकूल उत्तम उचित श्रेष्ठ
श्रेष्ठ: महान ठुला श्रेष्ठ
श्लील: श्लील श्रील
श्वेत: श्वेत सेतो शुक्ल
षंढ: नामर्द नपुंसक पौरुषहीन पुरषत्वहीन वीर्यहीन अपौरुष अपुरुष शंड
संकलित: सङ्ग्रहित सञ्चित सङ्गृहीत सङ्कलित सङ्हृत उपचित
संकल्पित: सङ्कल्पित
संकुचित: खुम्चिएको संकुचित निकुंचित निकुञ्चित सङ्कुचित अनुदार
संकोची: लजालु लज्जाशील सङ्कोची सङ्कोच_मान्ने लाज_मान्ने
संक्षिप्त: संक्षिप्‍त
संगणकीकरण_झालेला: कम्प्युटरीकृत
संगणकीकृत: कम्प्युटरीकृत कम्प्युटरीकृत
संग्रहणीय: सङ्ग्रहणीय सङ्ग्रहम_गर्ने_योग्य
संग्रहित: सङ्ग्रहित सञ्चित सङ्गृहीत सङ्कलित सङ्हृत उपचित
संग्राह्य: सङ्ग्रहणीय सङ्ग्रहम_गर्ने_योग्य
संघटित: सङ्घटित सङ्गठित
संघीय: सङ्घीय
संतप्त: रिसाएको झोकिएको क्रुद्ध धेरै_क्रुद्ध अत्युग्र
संतापलेला: रिसाएको झोकिएको क्रुद्ध धेरै_क्रुद्ध अत्युग्र
संतुलित: सन्तुलित
संतुष्ट: तृप्त तुष्ट सन्तुष्ट संतुष्ट अघाएको
संतोषजनक: सन्तोषप्रद सन्तोषजनक आनन्द
संथ: मन्द बिस्तारो मन्थर मन्द ढिलो सुस्त
संथगती: मन्द बिस्तारो मन्थर मन्द ढिलो सुस्त
संदेहहीन: सन्देहहीन शङ्काहीन
संधिसाधू: अवसरवादी
संपन्न: परिपूर्ण भरिएको अभिपूर्ण पूर्ण
संपादित: अर्जित कमाएको
संपूर्ण: सारा सबै पूरा सम्पूर्ण जम्मा सारा सबै समस्त सम्पूर्ण तमाम
संबंधित: सम्बन्धित सम्बद्ध संबंधित
संबंधी: विषयक सम्बन्धीय सम्बन्धी अनुषंगी अन्वयी अबाध
संबद्ध: सम्बन्धित सम्बद्ध संबंधित
संबोधक: सम्बोधक
संबोधित: सम्बोधित सम्बोध्य
संभवनीय: सम्भव संभव संभावनीय संभावित संभाव्य सम्भव सम्भावनीय सम्भावित सम्भाव्य
संभावित: सम्भव संभव संभावनीय संभावित संभाव्य सम्भव सम्भावनीय सम्भावित सम्भाव्य प्रतिष्ठित अग्रगण्य इज्जतदार गणमान्य नामी सम्मानित मान्य माननीय गौरवान्वित सम्भ्रान्त संभ्रांत सम्ब्रांत अजीज अपचायित सुर्खरू विशिष्ट विशेष
संभाव्य: सम्भव संभव संभावनीय संभावित संभाव्य सम्भव सम्भावनीय सम्भावित सम्भाव्य
संभोगी: सम्भोगी
संभ्रमित: भ्रममा भ्रान्त
संभ्रांत: सम्भ्रान्त
संमत: पारित पास
संमत_न_झालेला: अपारित अस्वीकृत नामञ्जुर
संमति_मिळालेला: स्वीकृत अनुमति_प्राप्त अनुमतिप्राप्त
संमती_मिळालेला: स्वीकृत अनुमति_प्राप्त अनुमतिप्राप्त
संमिश्रित: मिश्र मिश्रित सम्मिश्रित
संयत: मर्यादित संयत संयमित
संयमित: संयमित संयमित
संयमी: संयत निग्रही
संरक्षित: रक्षित संरक्षित
संलग्न: संलग्न सम्बद्ध अनुलग्न
संविधानीय: संवैधानिक वैधानिक
संशयखोर: शङ्कालु दोधारे संशयी
संशयित: सन्दिग्ध संदिग्ध सन्देहास्पद संदेहास्पद
संशयी: शङ्कालु दोधारे संशयी
संसर्गजन्य: सङक्रामक सञ्चारी
संस्कृत: संस्कृत
संस्थापित: संस्थापित अधिष्ठित अधिष्ठापित स्थापित
संस्मरणीय: स्मरणीय अविस्मरणीय
संहारक: नाशक नाशी विनाशी विनाशक
सकाम: इच्छापूर्ण अभिलाषापूर्ण कामनापूर्ण सकाम
सकारात्मक: सकारात्मक स्वीकारात्मक
सक्षम: योग्य उपयुक्‍त समर्थ सक्षम खाइलाग्दो सक्षम क्षमतावान सामर्थ्यवान क्षमताशाली सामर्थी सशक्त
सखोल: अथाह अगाध अपार अगाध्य अनवगाह अनवगाह्य अगाह
सख्खा: सहोदर सहोदरा एकोदर सगर्भ सगर्भ्य
सगळा: जम्मा सारा सबै समस्त सम्पूर्ण तमाम
सघन: सघन घना गहन सङ्घात
सचिंत: चिन्तित चिंतित चिन्तायुक्त चिन्ताग्रस्त
सचेतन: जिउँदो नमरेको जीवित प्राणवान् प्रण_भएको चेतनायुक्त चेतन संज्ञायुक्त
सचोटीचा: विश्वासिलो विश्वसनीय विश्वासपात्र विश्वस्त विश्वासी पत्याउरो
सच्चरित्र: चरित्रवान सच्चरित्र
सच्छिद्र: छिद्रयुक्त रन्ध्रयुक्त रन्ध्रयुक्त सछिद्र दुलोयुक्त जालीदार
सच्छील: चरित्रवान सच्चरित्र
सछिद्र: छिद्रयुक्त रन्ध्रयुक्त रन्ध्रयुक्त सछिद्र दुलोयुक्त
सजग: सचेत सावधान सतर्क
सजलेला: अलङ्कृत अलंकृत आभूषित भूषित सज्जित विभूषित अलंकारिक अलंकारपूर्ण अभिलमंडित अभिलमण्डित
सजवलेला: अलङ्कृत अलंकृत आभूषित भूषित सज्जित विभूषित अलंकारिक अलंकारपूर्ण अभिलमंडित अभिलमण्डित
सजातीय: सजातीय समवर्गीय सजाति स्वजातीय स्वजाति
सजावटी: सजाउने
सजीव: जिउँदो नमरेको जीवित प्राणवान् प्रण_भएको
सज्ज: तयार तत्पर उद्यत्
सज्जड: अत्यधिक धेरै औधि प्रचुर अत्याधिक भारी भीषण घनघोर अत्याधिक
सज्जन: सज्जन भद्र भलादमी सुजन शीलवान सद्गुणी सुप्रतीक
सटरफटर: खुद्रा_सामान फुटकर_सामान
सटिनी: अतलसी
सडका: कुहिएको गलेको सडेको
सडसडीत: दुब्लो सिकुटे खिनाउटे
सडा: एक्लो एक्लै परिवारहीन कुटुम्बहीन
सडाधस: परिवारहीन कुटुम्बहीन
सडाफटिंग: परिवारहीन कुटुम्बहीन
सडेधोस: परिवारहीन कुटुम्बहीन
सतत_अभ्यास_करण्याजोगा: अनुशीलनकारी अनुशीलनीय
सतरा: सत्र सत्रह सप्तदश १७ 17
सतरावा: सत्रौं १७औं 17औं
सतर्क: सचेत सावधान सतर्क
सतावणूकग्रस्त: प्रताडित पिटिएको चुटिएको
सतावलेला: प्रताडित पिटिएको चुटिएको
सतेज: तेजोमण्डित तेजपूर्ण कान्तिमान जाज्वल्यमान प्रकाशमान दिव्य चम्किलो
सत्कारित: सत्कृत सत्कार_गरिएको
सत्कृत: सत्कृत सत्कार_गरिएको
सत्तर: सत्तर
सत्तरावा: सत्तरीऔं
सत्तारूढ: सत्तारूढ सत्ताधारी सत्तारुढ
सत्तावन: सन्ताउन सन्ताउन्न ५७
सत्तावनावा: सन्ताउन्नौं
सत्तावन्न: सन्ताउन सन्ताउन्न ५७
सत्तावन्नावा: सन्ताउन्नौं
सत्तावीस: सत्ताइस २७
सत्तेचाळिसावा: सतचालीसौँ
सत्त्याण्णव: सन्तानब्बे
सत्त्याण्णवावा: सन्त्तानब्बेऔं
सत्त्वरहित: सत्वहीन निःसत्व
सत्त्वहीन: सत्वहीन निःसत्व
सत्पात्र: सुपात्र सत्पात्र सत्पात्र राम्रो_पात्र
सत्प्रवृत्त: सज्जन भद्र भलादमी सुजन शीलवान सद्गुणी सुप्रतीक शुद्ध_मन
सत्य: साँचो सत्य यथार्थ
सत्यवक्ता: सत्यवादी सत्यवान
सत्यवचनी: सत्यवादी सत्यवान
सत्यवादी: सत्यवादी सत्यवान
सत्याचरणी: सत्यवती
सत्याहत्तर: सतहत्तर
सदतिसावा: सैँतीसौँ
सदतीस: सैँतीस
सदय: द्रवित द्रवीभूत दयार्द्र
सदर: प्रस्तावित
सदरहू: प्रस्तावित
सदवर्तनी: सद्व्यवहारी
सदा_अपयशी: अजसी अयशस्वी अकीर्तिमान्
सदा_अयशस्वी: अजसी अयशस्वी अकीर्तिमान्
सदाचारी: चरित्रवान सच्चरित्र
सदुसष्ट: सतसट्ठी
सदुसष्टावा: सतसट्ठीऔं
सदृश: समान तुल्य सदृश बराबर
सदृश्य: समान तुल्य सदृश बराबर
सद्गुणी: सद्‍गुणी गुणी गुणवन्त गुणवान गुणशाली
सद्यःकालीन: आधुनिक अद्यतन आजको अर्वाचीन अधुनातन नया अप्राचीन अकालातीत अपूरातन अपूर्वकालीन नवीन अपूराण साम्प्रतिक
सद्यकालविषयक: वर्तमानकालीन सामयिक आधुनिक वर्तमान हाल
सद्यकालाचा: वर्तमानकालीन सामयिक आधुनिक वर्तमान हाल
सद्यकालाबाबतचा: वर्तमानकालीन सामयिक आधुनिक वर्तमान हाल
सद्यकालाविषयीचा: वर्तमानकालीन सामयिक आधुनिक वर्तमान हाल
सद्यकालासंबंधीचा: वर्तमानकालीन सामयिक आधुनिक वर्तमान हाल
सद्यकालीन: वर्तमानकालीन सामयिक आधुनिक वर्तमान हाल
सद्यकाळविषयक: वर्तमानकालीन सामयिक आधुनिक वर्तमान हाल
सद्यकाळाचा: वर्तमानकालीन सामयिक आधुनिक वर्तमान हाल
सद्यकाळाबाबतचा: वर्तमानकालीन सामयिक आधुनिक वर्तमान हाल
सद्यकाळाविषयीचा: वर्तमानकालीन सामयिक आधुनिक वर्तमान हाल
सद्यकाळासंबंधीचा: वर्तमानकालीन सामयिक आधुनिक वर्तमान हाल
सद्वर्तनी: सौम्य सुशील सुजान अभिविनीत सज्जन भद्र भलादमी सुजन शीलवान सद्गुणी सुप्रतीक
सधन: धनाढ्य धनी धनवान
सध्याचा: वर्तमानकालीन सामयिक आधुनिक वर्तमान हाल वर्तमानकालीन सामयिक आधुनिक वर्तमान हाल
सध्याबाबतचा: वर्तमानकालीन सामयिक आधुनिक वर्तमान हाल
सध्याविषयीचा: वर्तमानकालीन सामयिक आधुनिक वर्तमान हाल
सध्यासंबंधीचा: वर्तमानकालीन सामयिक आधुनिक वर्तमान हाल
सनसनाटीखोर: सनसनीदार सनसनीखेज
सन्माननीय: प्रतिष्ठित अग्रगण्य इज्जतदार गणमान्य नामी सम्मानित मान्य माननीय गौरवान्वित सम्भ्रान्त संभ्रांत सम्ब्रांत अजीज अपचायित सुर्खरू विशिष्ट विशेष आदरणीय सम्माननीय समादरणीय सम्मान्य मान्य माननीय
सन्मानित: अलङ्कृत अलंकृत उपाधित विभूषित
सपक: अरोचक अरुचिकर नीरस रसहीन रुचिहीन फीका असार स्वादहीन बेस्वाद नीरस फीका अस्वादिष्ट अनास्वाद खल्लो नमिठो
सपर्ण: पातभएका पाते पर्णी
सपाट: सोझो सीधा समतल समथर
सप्त: सात ७ 7
सप्तम: सातौँ सात
सफल: उत्तीर्ण पास सफल सिद्ध
सफळ: सफल सिद्ध
सफेत: श्वेत सेतो शुक्ल
सफेद: श्वेत सेतो शुक्ल
सबंध: सम्पूर्ण जम्मै सारा सबै पूरा सम्पूर्ण जम्मा सारा सबै समस्त सम्पूर्ण तमाम
सबंधीत: विषयक सम्बन्धीय सम्बन्धी अनुषंगी अन्वयी अबाध
सभ्य: सभ्य भद्र सुशील शिष्ट
सम: समान तुल्य सदृश बराबर
समंजस: विवेकी विवेकवान विवेकशील
समकक्ष: समकक्ष समतुल्य एक_समान तुल्य सदृश्य समान
समकालीन: समसामयिक
समग्र: सारा सबै पूरा सम्पूर्ण जम्मा सारा सबै समस्त सम्पूर्ण तमाम
समतल: समतल समथर
समतोल: सन्तुलित
समदर्शी: समदर्शी
समन्वयित: समन्वित
समयानुसार: सामयिक समयोचित समयानुकूल अवसरानुकूल अवसरोचित कालोचित
समयोचित: सामयिक समयोचित समयानुकूल अवसरानुकूल अवसरोचित कालोचित
समरूप: प्रतिरूपी अनुरूपी समरूपी एकनासे समान तुल्य
समर्थ: योग्य उपयुक्‍त समर्थ सक्षम खाइलाग्दो सक्षम क्षमतावान सामर्थ्यवान क्षमताशाली सामर्थी सशक्त
समर्थित: समर्थित अनुमोदित
समर्पक: अन्वर्थ
समर्पित: समर्पित
समस्त: जम्मा सारा सबै समस्त सम्पूर्ण तमाम
समांतर: समानान्तर समान्तर
समागत: समागत सङ्गमित
समाजवादी: समाजवादी
समाधान्य: समाधान्य समाधेय
समान: समान तुल्य सदृश बराबर एकनासे समान तुल्य
समानार्थी: पर्यायवाची पर्याय पर्यायवाचक समानार्थी समानार्थक
समाप्त: समाप्त सम्पूर्ण निष्पादित पूरा सम्पादित संपादित पूर्ण सम्पन्न संपन्न सम्पन्न
समाविष्ट: समाविष्ट समाहित अङ्गभूत समन्वित
समाहित: समाविष्ट समाहित अङ्गभूत समन्वित
समुद्री: समुद्री समुद्री समुद्रीय
समुद्रीय: समुद्री समुद्री समुद्रीय
समृद्ध: धनाढ्य धनी धनवान
समृद्धीप्रद: समृद्धिप्रद ऐश्वर्यप्रद समृद्धिदायक ऐश्वर्यप्रदायक
समोर_असलेला: समागत सङ्गमित
समोर_आलेला: समागत सङ्गमित
समोर_उपस्थित_झालेला: समागत सङ्गमित
समोर_उभा_राहिलेला: समागत सङ्गमित
समोर_येऊन_पोहोचलेला: समागत सङ्गमित
समोरचा: अघिल्लो अग्र अग्रवर्ती अग्रिम पूर्व सामुन्नेको सामुको
समोरील: अघिल्लो अग्र अग्रवर्ती अग्रिम पूर्व सामुन्नेको सामुको
सयुक्तिक: तर्कगम्य तर्काधीन तर्कसङ्गत
सरपटणारा: घिस्रिने सरीसृप सर्पी
सरल: सजिलो सरल सहज
सरळ: सोझो सीधा सोझो सीधा सरल सीधा-सादा
सरीसृप: घिस्रिने सरीसृप सर्पी
सर्जक: सृजनकर्ता सर्जक सृजक रचयिता स्रष्टा
सर्जनकर्ता: सृजनकर्ता सर्जक सृजक रचयिता स्रष्टा
सर्जनकार: सृजनकर्ता सर्जक सृजक रचयिता स्रष्टा
सर्व: सर्वसामान्य सर्व_सामान्य सर्वसाधारण सर्व_साधारण जम्मा सारा सबै समस्त सम्पूर्ण तमाम
सर्वगुणसंपन्न: सर्वगुण_सम्पन्न सर्वगुणी
सर्वज्ञ: सर्वज्ञ सर्ववेत्ता
सर्वराष्ट्रीय: सार्वभौमिक सार्वभौम सार्वदेशिक सर्वदेशीय सार्वजनी
सर्ववेत्ता: सर्वज्ञ सर्ववेत्ता
सर्वव्यापक: सर्वव्यापी सर्वव्यापक सर्वव्याप्‍त
सर्वव्यापी: सर्वव्यापी सर्वव्यापक सर्वव्याप्‍त
सर्वशक्तिमान: सर्वशक्‍तिमान सर्वशक्‍तिशाली
सर्वश्रुत: सर्वसंज्ञात सर्वज्ञात सर्वजनविदित
सर्वश्रेष्ठ: सर्वोत्तम सर्वश्रेष्ठ अन्यतम सर्वोत्कृष्ट
सर्वसत्ताधारी: सर्वशक्‍तिमान सर्वशक्‍तिशाली
सर्वसमर्थ: सर्वशक्‍तिमान सर्वशक्‍तिशाली
सर्वसाधारण: सर्वसामान्य सर्व_सामान्य सर्वसामान्य सर्व_सामान्य सर्वसाधारण सर्व_साधारण
सर्वसामान्य: सर्वसामान्य सर्व_सामान्य सर्वसामान्य सर्व_सामान्य सर्वसाधारण सर्व_साधारण
सर्वांगीण: सर्वाङ्गीन
सर्वात_लहान: कनिष्ठ कान्छो कान्छी कान्छो कनिष्ठ
सर्वाधिक: अधिकतम सर्वाधिक सबैभन्दा_बढी
सर्वोच्च: उच्च माथिल्लो
सर्वोत्कृष्ट: सर्वोत्तम सर्वश्रेष्ठ अन्यतम सर्वोत्कृष्ट
सलग: सम्पूर्ण जम्मै बेजोड अजोड़
सलील: सजिलो सरल सहज
सवा: सवा
सवाष्ण: सधवा सधुवा
सव्य: देब्रे बायाँ बाउँ बाम
सव्वा: सवा
सव्विसावा: छब्बीसौँ
सव्वीस: छब्बीस
सशत्रू: शत्रुपूर्ण सशत्रु
सशस्त्र: सशस्त्र शस्त्रधारी
सशुल्क: सशुल्क
सश्रम: सश्रम
सस्तन: स्तनपायी योनिज
सहज: सजिलो सरल सहज
सहप्रवासी: सहयात्री सहगामी
सहस्र: हजार
सहस्रावधी: हजारौँ
सहा: छ ६
सहानुभूती_बाळगणारा: सहानुभूतिशील
सहापट: छगुना छगुणा छःगुणा
सहामाही: छ_महिने अर्ध_वार्षिक षटमासिक
सहावा: छैठौं छ_नम्बर षष्टम
सहासष्ट: छयसट्ठी
सहासष्टावा: छैसट्ठीऔं
सही_न_केलेला: अहस्ताक्षरित हस्ताक्षर_नगरिएको
सहृदयी: दयालु कृपालु दयावन
सांकेतिक: साङ्केतिक
सांगण्याजोगा: भनिने कथनीय कथ्य वाच्य अभिभाष्य वक्तव्य वर्णनीय कथनीय वर्ण्य अभिधेय
सांगण्यायोग्य: वर्णनीय कथनीय वर्ण्य अभिधेय
सांगण्यालायक: वर्णनीय कथनीय वर्ण्य अभिधेय
सांगावा_असा: वर्णनीय कथनीय वर्ण्य अभिधेय
सांपत्तिक: साम्पत्तिक सम्पत्तिसम्बन्धी धनमालको
सांपत्तीक: आर्थिक वित्तीय रुपिया
सांप्रदायिक: साम्प्रदायिक साम्प्रदायिक
सांविधानिक: संवैधानिक वैधानिक
सांसारिक: इहलौकिक सांसारिक लौकिक
सांस्कृतिक: सांस्कृतिक संस्कृति-सम्बन्धी
साकार: साकार आकारयुक्त आकारवान मूर्तिमान मूर्तिमान् साक्षात् साक्षात
साक्षर: शिक्षित साक्षर प्राज्ञ पढे-लेखेको
सागरी: समुद्री समुद्री समुद्रीय
सागरीय: समुद्री समुद्रीय
साजेसा: उचित उपयुक्‍त ठिक
साठ: साठी ६०
साठवलेला: धृत निभृत
साठवलेले: सङ्ग्रहित सञ्चित सङ्गृहीत सङ्कलित सङ्हृत उपचित
साडे: साढे
सात: सात ७ 7
सातवा: सातौँ सात
साद्यन्त: सारा सबै पूरा सम्पूर्ण
साधा: सामान्य साधारण सादा सरल सोझो सीधा सरल सीधा-सादा सादा
साधाभोळा: सोझो सीधा सरल सीधा-सादा
साधारण: सर्वसामान्य सर्व_सामान्य सामान्य आम साधारण कामचलाउ अविशिष्ट
साधे: अनलङ्कृत नसजिएको अमण्डित अलङ्कारहीन अविभूषित
साध्य: चिकित्स्य साध्य
सानंद: आनन्दपूर्ण आनन्दमय उल्लासपूर्ण सानन्द
सानुकूल: अनुकूल अनुसार अनुरूप मुताबिक
सापेक्ष: आपेक्षिक सापेक्ष
साप्ताहिक: साप्ताहिक
साफ: स्पष्ट प्रष्ट सफा छर्लङ्ग उज्ज्वल उज्जवल सफा स्वच्छ असन्दिग्ध संदेहहीन असन्दिग्ध सन्देहहीन पवित्र शुद्ध निर्मल सफा
साभिलाष: इच्छापूर्ण अभिलाषापूर्ण कामनापूर्ण सकाम
सामंजस्यपूर्ण: सामञ्जस्यपूर्ण मेलपूर्ण
सामयिक: सामयिक अवसरीय कालिक
सामर्थ्यवंत: सक्षम क्षमतावान सामर्थ्यवान क्षमताशाली सामर्थी सशक्त
सामर्थ्यवान: सक्षम क्षमतावान सामर्थ्यवान क्षमताशाली सामर्थी सशक्त
सामाजिक: सामाजिक
सामान्य: सर्वसामान्य सर्व_सामान्य सामान्य आम साधारण कामचलाउ अविशिष्ट
सामुद्रिक: समुद्री समुद्रीय
साम्यवादविषयक: साम्यवादी कम्युनिस्ट
साम्यवादाविषयीचा: साम्यवादी कम्युनिस्ट
साम्यवादाशी_संबंधित: साम्यवादी कम्युनिस्ट
साम्यवादासंबंधीचा: साम्यवादी कम्युनिस्ट
साम्यवादी: साम्यवादी समानतावादी कम्युनिस्ट साम्यवादी कम्युनिस्ट
सारखा: समान तुल्य सदृश बराबर समकक्ष समतुल्य एक_समान तुल्य सदृश्य समान एकनासे समान तुल्य जस्तो
सारा: जम्मा सारा सबै समस्त सम्पूर्ण तमाम
सार्वजनिक: सामूहिक आम सार्वजनिक सामुदायिक सामान्य सर्वजनीन
सालस: निष्कपट विश्‍वासी
सालीना: वार्षिक प्रतिवर्ष वर्षेनी
साळसूद: निष्कपट विश्‍वासी
सावत्र: सौतेलो सौता_तिरको
सावध: सचेत सावधान सतर्क
सावधान: सचेत सावधान सतर्क
सावली_देणारा: छायाँ_भएको ओझेल_परेको
साशंक: आशङ्कित आशङ्कापूर्ण आशंकित आशंकापूर्ण सशङ्कित शङ्कित शङ्का आशङ्की
साहजिक: स्वाभाविक सहज प्राकृतिक प्राकृत नैसर्गिक अकृत्रिम प्रकृत
साहसी: निडर अभय निर्भय निर्भीक बेडर भयहीन निर्भीत अपभय अपभीति निःशंक अपशंक अभीत अभीरु वीर बहादुर सुरो पराक्रमी पुरूषार्थी पौरखी साहसी हिम्मती बहादुर
साहाय्यक: सहयोगी मदतगार सहायक
साहित्यिक: साहित्यिक
सिंधी: सिन्धी सिन्धी सिन्धवासी सैन्धव सिन्धव
सिंहली: सिंहली
सिद्ध: सिद्ध प्रमाणित साबित
सीमांकित: ससीम परिसीमित सीमित सीमित सीमाबद्ध सीमायुक्त
सीमित: ससीम परिसीमित सीमित निर्धारित सीमित नियत सीमित सीमाबद्ध सीमायुक्त
सुंदर: सुडौल सुगठित बान्की_परेको राम्रो सुन्दर
सुंदर_वर्णाचा: सुनौला
सुंदरवर्णी: सुनौला
सुकर: सजिलो सरल सहज
सुकलेले: सुकेको सुक्खा ओइलाएको
सुखकर: सुखद सुखदायक सुखकारी सुखदायी सुखप्रद
सुखकारक: रमाइलो आनन्दप्रद आनन्दप्रद आनन्द-दायक आह्लादक सुखप्रद खुशनुमा प्रसन्नतादायक आनंददायक आनन्ददायक आनन्ददायी आनन्दकारी आनंदकारी आह्लादी अनंद अनन्द नंदक नन्दक रमन रमण
सुखद: रमाइलो आनन्दप्रद आनन्दप्रद आनन्द-दायक आह्लादक सुखप्रद खुशनुमा प्रसन्नतादायक आनंददायक आनन्ददायक आनन्ददायी आनन्दकारी आनंदकारी आह्लादी अनंद अनन्द नंदक नन्दक रमन रमण सुखद सुखदायक सुखकारी सुखदायी सुखप्रद
सुखदायक: रमाइलो आनन्दप्रद आनन्दप्रद आनन्द-दायक आह्लादक सुखप्रद खुशनुमा प्रसन्नतादायक आनंददायक आनन्ददायक आनन्ददायी आनन्दकारी आनंदकारी आह्लादी अनंद अनन्द नंदक नन्दक रमन रमण सुखद सुखदायक सुखकारी सुखदायी सुखप्रद
सुखदायी: रमाइलो आनन्दप्रद आनन्दप्रद आनन्द-दायक आह्लादक सुखप्रद खुशनुमा प्रसन्नतादायक आनंददायक आनन्ददायक आनन्ददायी आनन्दकारी आनंदकारी आह्लादी अनंद अनन्द नंदक नन्दक रमन रमण
सुखप्रद: रमाइलो आनन्दप्रद आनन्दप्रद आनन्द-दायक आह्लादक सुखप्रद खुशनुमा प्रसन्नतादायक आनंददायक आनन्ददायक आनन्ददायी आनन्दकारी आनंदकारी आह्लादी अनंद अनन्द नंदक नन्दक रमन रमण सुखद सुखदायक सुखकारी सुखदायी सुखप्रद
सुखावह: सुखद सुखदायक सुखकारी सुखदायी सुखप्रद
सुखी: सुखी सुखमय आनन्दी मङ्गलमय
सुख्यात: सुप्रसिद्ध सुविख्यात सुख्यात अभिविख्यात अभिविश्रुत
सुगंधिक: सुवासित अनुवासित
सुगंधित: सुवासित अनुवासित
सुगम: सजिलो सरल सहज बोध्य बोधगम्य अक्लिष्ट सजिलो सरल सुगम सुबोध सुगम सुगम्य
सुगम्य: सुगम सुगम्य
सुग्राही: सुग्राही
सुग्राह्य: सुग्राह्य सुग्राही
सुघड: सुडौल सुगठित बान्की_परेको
सुटलेला: समाधानित सुल्झिएको हल_भएको टुङ्गिएको
सुटा: असंयुक्‍त पृथक छुट्टै भिन्दै
सुडौल: सुडौल सुगठित बान्की_परेको
सुढाळ: सुडौल सुगठित बान्की_परेको
सुती: सुती
सुदूर: दूर दूरवर्ती दूरस्थ
सुदेव: सौभाग्यशाली भाग्यवान भाग्यशाली
सुदैवी: सौभाग्यशाली भाग्यवान भाग्यशाली
सुनसान: निर्जन एकान्त सुनसान जनशून्य
सुनसान_नसलेला: एकान्तरहित सुनसानहीन एकान्तहीन
सुनियत: सुनिश्‍चित सुनिर्धारित
सुनिर्धारित: सुनिश्‍चित सुनिर्धारित
सुनिवारणीय: सुनिवार्य
सुनिवार्य: सुनिवार्य
सुनिश्चित: सुनिश्‍चित सुनिर्धारित
सुन्न: लठेब्रो चिसो ठन्डा
सुप्त: निद्रामग्न सुतेको निद्रित निद्रागत स्वप्निल सुप्त सुप्तविग्रह सुप्तस्थ
सुप्रसिद्ध: प्रसिद्ध प्रख्यात ख्याति_प्राप्‍त सुप्रसिद्ध सुविख्यात सुख्यात अभिविख्यात अभिविश्रुत
सुबक: सुडौल सुगठित बान्की_परेको
सुबोध: बोध्य बोधगम्य अक्लिष्ट सजिलो सरल सुगम सुबोध
सुरक्षित: सुरक्षित निरापद रक्षित संरक्षित सुरक्षित निरापद
सुरम्य: रमणीय रम्य रमणीक
सुरस: स्वादिष्ट मिठो स्वादिष्ठ राम्रो
सुरू_केलेला: चालित परिचालित प्रचालित
सुरेख: सुडौल सुगठित बान्की_परेको राम्रो सुन्दर
सुलट: सिधा सीधा उत्तानो सोझो
सुलभ: सजिलो सरल सहज सुलभ सुप्राप्य सुलब्ध सहज_प्राप्य
सुवर्णाचा: स्वर्ण_निर्मित सुन
सुवर्णातला: स्वर्ण_निर्मित सुन
सुवर्णातील: स्वर्ण_निर्मित सुन
सुवर्णी: सुनौला
सुवाच्य: पठनीय पाठ्य पठ्य
सुवासित: सुवासित अनुवासित
सुवासिनी: सधवा सधुवा
सुविख्यात: प्रसिद्ध प्रख्यात ख्याति_प्राप्‍त सुप्रसिद्ध सुविख्यात सुख्यात अभिविख्यात अभिविश्रुत
सुविद्य: विद्वान् ज्ञानी प्राज्ञ पण्डित विज्ञ
सुव्यवस्थित: सुव्यवस्थित सुविन्यस्त सुप्रबन्धित
सुशिक्षित: सुशिक्षित
सुशील: सौम्य सुशील सुजान अभिविनीत
सुशोभित: अलङ्कृत अलंकृत आभूषित भूषित सज्जित विभूषित अलंकारिक अलंकारपूर्ण अभिलमंडित अभिलमण्डित सुसज्जित
सुसंगत: उचित उपयुक्‍त ठिक
सुसंस्कृत: सुसंस्कृत
सुस्त: अल्छी सुस्त ढिलो
सुस्पष्ट: स्पष्ट प्रष्ट सफा छर्लङ्ग
सुस्वभावी: सौम्य सुशील सुजान अभिविनीत सद्व्यवहारी
सूक्ष्म: कठिन गाह्रो अप्ठयारो मुस्किल कडा कठोर साह्रो
सूक्ष्मदर्शी: सूक्ष्मदर्शी
सूक्ष्मदृष्टीचा: सूक्ष्मदर्शी
सूक्ष्मद्रष्टा: सूक्ष्मदर्शी
सूचित: सूचित ज्ञापित
सूड_न_घेणारा: अप्रतिकारी
सूर्याचा: प्राकृतिक
सृजक: सृजनकर्ता सर्जक सृजक रचयिता स्रष्टा
सृजनकर्ता: सृजनकर्ता सर्जक सृजक रचयिता स्रष्टा
सृजनकार: सृजनकर्ता सर्जक सृजक रचयिता स्रष्टा
सॅटिनी: अतलसी
सॅटीनचा: अतलसी
सेवक: सेवी
सेवनीय: सेवनीय सेव्य सेवित
सेवित: सेवित सेव्य
सैद्धांतिक: सैद्धान्तिक सिद्धान्तको सिद्धान्तसम्बन्धी।
सैल: खुकुलो ढीला खुकुलो ढीला
सोईस्कर: सुविधाजनक सुविधापूर्ण सजिलो
सोडून: अतिरिक्‍त बाहेक
सोनेरी: सुनौलो स्वर्णिम हिरण्मय हैम सुवर्णीय सुवर्ण स्वर्ण सुनौला स्वर्णिम
सोन्याचा: स्वर्ण_निर्मित सुन
सोन्यातला: स्वर्ण_निर्मित सुन
सोन्यातील: स्वर्ण_निर्मित सुन
सोपा: सजिलो सरल सहज बोध्य बोधगम्य अक्लिष्ट सजिलो सरल सुगम सुबोध
सोयीस्कर: सुविधाजनक सुविधापूर्ण सजिलो
सोल्हास: आनन्दपूर्ण आनन्दमय उल्लासपूर्ण सानन्द
सोळा: सोह्र सोर
सोळावा: सोह्रौं १६औं 16औं
सौंदर्यपर: सौन्दर्यात्मक_सौन्दर्यपरक सौन्दर्य_बोधक
सौंदर्यात्मक: सौन्दर्यात्मक_सौन्दर्यपरक सौन्दर्य_बोधक
सौभाग्यवती: सधवा सधुवा
सौम्य: सानो मसिनो सौम्य कोमल_स्वभावी सौम
स्टोनियाई: स्टोनियाई स्टोनियाई
स्तंभित: अचेत चेतना_नभएको होस_गुमेको सुद्धी_हराएको बेहोस
स्तब्ध: अचेत चेतना_नभएको होस_गुमेको सुद्धी_हराएको बेहोस
स्तरयुक्त: परतदार स्तरयुक्त स्तरित
स्तिमित: मन्द बिस्तारो मन्थर
स्तुत्य: प्रशंसनीय स्तुत्य धन्य धन्न प्रशंस्य श्लाघ्य श्लाघनीय सराहनीय प्रशस्त अभिनन्दनीय अभिवन्दनीय
स्थलांतरित: विस्थापित स्थानच्युत
स्थानच्युत: विस्थापित स्थानच्युत
स्थानभ्रष्ट: विचलित हटेको
स्थानांतरित: सरुवा स्थानान्तरित
स्थानापन्न: आसीन विराजमान बसेका उपविष्ट
स्थापित: संस्थापित अधिष्ठित अधिष्ठापित स्थापित
स्थायी: अमिट नमेटिने स्थायी
स्थावर: अचल गतिहीन स्थावर अग अगतिक अचर अचल स्थावर
स्थित: स्थित अधिष्ठित अवस्थित
स्थिर: गतिहीन स्थिर अचल अचल गतिहीन स्थावर अग अगतिक अचर गम्भीर शान्त धीर स्थिर थिर दृढ अचल अविचल निश्चल गतिहीन अविचलित अटल स्थिरचित्त शान्त स्थिर प्रशान्त अचञ्चल प्रशान्त अचल स्थावर अप्रवाहित जमेको प्रवाहहीन स्थिर गतिहीन
स्थिरचर: चराचर चलाचल चल_अचल
स्थिरचित्त: स्थिरचित्त शान्त स्थिर प्रशान्त अचञ्चल प्रशान्त
स्थूल: मोटो बलियो स्थुलकाय
स्नातकोत्तर: स्नातकोत्तर पोस्ट्-ग्रेजुएट
स्निग्ध: तेलिया चिप्लो चिल्लो स्निग्ध
स्नेहशील: स्नेही दयालु
स्नेहाळ: स्नेही दयालु
स्नेहाळू: स्नेही दयालु
स्पष्ट: स्पष्ट प्रष्ट सफा छर्लङ्ग स्पष्ट प्रस्ट छर्लङ्ग छ्याङ्ग असन्दिग्ध संदेहहीन असन्दिग्ध सन्देहहीन
स्पष्ट_केलेले: परिभाषित
स्पष्टवक्ता: मुखाले चोथाले थुतुने दुर्मुखा अक्खड
स्पृश्य: स्पृश्‍य स्पर्श_गर्न_योग्य छुन_सकिने छुवाछूत_चल्ने
स्पृहणीय: प्रशंसनीय स्तुत्य धन्य धन्न प्रशंस्य श्लाघ्य श्लाघनीय सराहनीय प्रशस्त अभिनन्दनीय अभिवन्दनीय
स्पॅनिश: स्पेनी स्पेनिया
स्पेनी: स्पेनी स्पेनिस
स्फटिकासारखा: बिल्लौरी
स्फटिकी: बिल्लौरी
स्फोटक: विस्फोटक विस्फोटकारी
स्मरणीय: स्मरणीय अविस्मरणीय
स्रष्टा: सृजनकर्ता सर्जक सृजक रचयिता स्रष्टा
स्लाव्ह: स्लोवाकी
स्लाव्हिक: स्लोवाकी
स्लोव्हाक: स्लोवाकी
स्लोव्हेनियाई: स्लोवेनियाई स्लोवेनियाई
स्वकीय: स्वजनीय आत्मजनीय
स्वच्छ: स्पष्ट प्रष्ट सफा छर्लङ्ग स्वच्छ मेघहीन निरभ्र अनभ्र मेघरहित अनाकाश अमेघ उज्ज्वल उज्जवल सफा स्वच्छ असन्दिग्ध संदेहहीन असन्दिग्ध सन्देहहीन पवित्र शुद्ध निर्मल सफा
स्वच्छंद: स्वच्छन्द स्वतन्त्र स्वाधीन
स्वच्छंदी: स्वच्छन्द स्वतन्त्र स्वाधीन
स्वतंत्र: स्वतन्त्र स्वाधीन आजाद अनन्याश्रित अनधीन अनिर्बन्ध निर्दल निर्दलीय स्वच्छन्द स्वतन्त्र स्वाधीन
स्वतःकरता: स्वेच्छार्थ
स्वतःसाठी: स्वेच्छार्थ
स्वदेशी: स्वदेशीय देशी देसी स्वदेशी देशीय देशज
स्वपक्षीय: स्वपक्षीय अपना स्वपक्षी
स्वयंचलित: यन्त्र_चालित यान्त्रिक स्वचालित यंत्र-संचालित
स्वयंपूर्ण: आत्मनिर्भर स्वनिर्भर
स्वरचित: मौलिक स्वकृत स्वरचित मूल अननुकृत
स्वरयुक्त: स्वरित
स्वरित: स्वरित
स्वर्गीय: स्वर्गीय स्वर्गिक दिव्य वैकुन्ठीय
स्वर्ग्य: स्वर्गीय स्वर्गिक दिव्य वैकुन्ठीय
स्वसंपादित: स्वार्जित स्वोपार्जित स्वयधिगत स्वयमर्जित
स्वस्त: सस्तो कममूल्य सस्तो सस्ता
स्वांतःसुखाय: स्वेच्छार्थ
स्वादिष्ट: स्वादिष्ट मिठो स्वादिष्ठ राम्रो
स्वाधीन: अधीनस्थ अधीन मातहत अधस्तन अमुख्य
स्वाभाविक: स्वाभाविक सहज प्राकृतिक प्राकृत नैसर्गिक अकृत्रिम प्रकृत स्वाभाविक स्वभावगत
स्वाभिमानशून्य: स्वाभिमानहीन अस्वाभिमानी
स्वायत्त: स्वायत्त
स्वार्थी: स्वार्थी मतलबी स्वार्थपर तनपोषक अपस्वार्थी अपरता स्वार्थपरायण
स्वावलंबिनी: स्वावलम्बिनी स्वावलंबिनी आत्मावलम्बिनी आत्मावलंबिनी
स्वावलंबी: स्वावलम्बी आत्मावलम्बी
स्वावलंबी_स्त्री: स्वावलम्बिनी स्वावलंबिनी आत्मावलम्बिनी आत्मावलंबिनी
स्वास्थ्यकर: स्वास्थ्यप्रद आरोग्यप्रद निरोगकर
स्वास्थ्यदायी: स्वास्थ्यप्रद आरोग्यप्रद निरोगकर
स्वास्थ्यनाशक: कुपथ्य अपथ्य अहितकर
स्वास्थ्यप्रद: स्वास्थ्यप्रद आरोग्यप्रद निरोगकर
स्वाहिली: स्वाहिली स्वाहिली किस्वाहिली
स्वाहिलीविषयक: स्वाहिली
स्वाहिलीविषयीचा: स्वाहिली
स्वाहिलीशी_संबंधित: स्वाहिली
स्वाहिलीसंबंधीचा: स्वाहिली
स्वीकालरेला: अङ्गीकृत स्वकृत परिग्रहीत गृहीत स्वीकृत स्वाङ्गीकृत अभ्युपगत
स्वीकृत: स्वीकृत मान्य अनुमोदित
स्वीकृती_मिळालेला: स्वीकृत अनुमति_प्राप्त अनुमतिप्राप्त
स्वीडिश: स्विडिस स्विडिस
स्वीय: निजी आफ्नो स्वकीय स्वायत्त आत्म
स्वेच्छाचारी: स्वच्छन्द स्वतन्त्र स्वाधीन
हक्कदार: अधिकारी अधिकार_प्राप्त अधिकारयुक्त अधिकारिक हकदार अधिकारक
हजर: उपस्थित हाजिर विद्यमान प्रस्तुत
हजरजबाबी: हाजिरजवाफ प्रत्युत्पन्नमति
हजार: हजार
हजारो: हजारौँ
हटवादी: दुराग्रही
हट्टी: हठी जिद्धी जिद्दीवाल दुराग्रही
हडकलेला: अति_क्षीणकाय
हडकुळा: दुब्लो सिकुटे खिनाउटे दुब्लो लुते क्षीण अति_क्षीणकाय
हडक्या: अति_क्षीणकाय
हडपलेला: अधिग्रहीत अधिकृत अधिगत
हत: मृत हत मुर्दा
हतबल: विवश बाध्य लाचार
हतभाग्य: दुर्भाग्यशाली अभागी भाग्यहीन
हताश: हताश निराश खिन्न
हत्यारबंद: सशस्त्र शस्त्रधारी
हरामखोर: कृतघ्न अकृतज्ञ साह्रै_दुष्ट हरामी दुर्जन
हर्षौल्हासित: हर्षित
हलकट: लफङ्गो फटाहा लुच्चा बदमास दुष्ट साह्रै_दुष्ट हरामी दुर्जन
हलका: हलुको हलुङ्गो हल्का घटिया निकृष्ट नीच अधम क्षुद्र सुपाच्य सहज_पाच्य हल्का पथ्य निकृष्टतम अधमाधम तुच्छातितुच्छ
हलक्या_पिवळ्या_रंगाचा: वासन्ती बसन्ती
हलगर्जी: बेपरवाह बेपरवा बिन्दास अचिन्त
हल्लीचा: वर्तमानकालीन सामयिक आधुनिक वर्तमान हाल
हळू: मन्द बिस्तारो मन्थर सानो मसिनो मन्द ढिलो सुस्त
हवेशीर: हावा_आउने हावा_चल्ने
हसतमुख: हँसिलो हँसैया हाँसेको हाँसिरहेको हँसिलो
हसरा: हँसिलो हँसैया हाँसेको हाँसिरहेको हँसिलो
हस्तलिखित: हस्तलिखित हातले_लेखेका
हस्तांतरित: हस्तान्तरित
हाजिर: उपस्थित हाजिर विद्यमान प्रस्तुत
हाडकुळा: हड्डीछाला अस्थिमय
हाडाचा: अस्थिमय अस्थिनिर्मित अस्थि_निर्मित
हात_नसलेला: उत्तरी
हातखंडा: सिपालु प्रवीण निपुण पारङ्गत दक्ष माहिर अभ्यस्त कुशल होशियार पक्का सिद्धहस्त शातिर पटु पका निष्णात परिपक्व कार्यकुशल विचक्षण अभिज्ञ अभ्यासी आप्त
हानिकारक: हानिकारक क्षतिकारी हानिकर हानिप्रद अनर्थकारी क्षतिकर
हानिप्रद: हानिकारक क्षतिकारी हानिकर हानिप्रद अनर्थकारी क्षतिकर
हानीग्रस्त: अपहेलित
हारलेला: पराजित परास्त अपध्वस्त
हास्यकारक: हास्य
हिंदी: हिन्दी
हिंदुस्थानी: भारतीय हिन्दुस्थानी
हिंसक: हिंसक आततायी बर्बर घातक नृशंस हिंस्रक हिंसात्मक घातक बर्बर नृशंस
हिंसात्मक: हिंस्रक हिंसात्मक घातक बर्बर नृशंस
हिणकट: अशुद्ध मिलावट मिसिएको अपमिश्रित
हिणकस: अशुद्ध मिलावट मिसिएको अपमिश्रित
हितकर: कल्याणकारी मङ्गलकारी कल्याणप्रद मङ्गलकारक मङ्गलदायक मङ्गलप्रद हितकारी हितकर हितकारक कल्याणमय अनुकूल
हितकारक: कल्याणकारी मङ्गलकारी कल्याणप्रद मङ्गलकारक मङ्गलदायक मङ्गलप्रद हितकारी हितकर हितकारक कल्याणमय अनुकूल
हितचिंतक: हितैषी शुभचिन्तक शुभाकाङ्क्षी
हितैषी: हितैषी शुभचिन्तक शुभाकाङ्क्षी
हिमज: हिउँमा_बस्ने हिउँको
हिम्मतवान: साहसी हिम्मती बहादुर
हिरवा: हरियो
हिरवागार: हरियो-परियो हरियाली हरिया-परिया
हिवाळी: शीतकालीन शिशिर_ऋतु
हीन: घटिया निकृष्ट नीच अधम क्षुद्र निकृष्टतम अधमाधम तुच्छातितुच्छ
हीनकुळी: अकुलीन पानी_नचल्ने अछुत निम्न_वंशीय
हुडकलेला: शोधित
हुबेहूब: प्रतिरूपी अनुरूपी समरूपी हुबहु हु-ब-हु जस्ताको_त्यस्तै
हुशार: सिपालु प्रवीण निपुण पारङ्गत दक्ष माहिर अभ्यस्त कुशल होशियार पक्का सिद्धहस्त शातिर पटु पका निष्णात परिपक्व कार्यकुशल विचक्षण अभिज्ञ अभ्यासी आप्त चलाख चतुर बुद्धिमान
हुषार: बुद्धिमानी ज्ञानी प्राज्ञ समझदार दिमागदार दिमागी बुझक्की मेधावी
हृदयद्रावक: हृदय-विदारक मार्मिक मर्मभेदी मर्मघाती मर्मान्तिक
हृदयविदारक: हृदय-विदारक मार्मिक मर्मभेदी मर्मघाती मर्मान्तिक
हृदयशून्य: क्रूर निर्दय कठोर निर्दयी निष्ठुर नृशंस करुणाहीन दयारहित दयाहीन उग्र करुणाविहीन अदयालु
हृदयस्पर्शी: भावपूर्ण मार्मिक भावनात्मक भावनापूर्ण भावात्मक मर्मस्पर्शी हृदयस्पर्शी
हेकट: दुराग्रही
हेकेखोर: दुराग्रही
हैदराबादी: हैदराबादी
होकार_मिळालेला: स्वीकृत अनुमति_प्राप्त अनुमतिप्राप्त
होकारात्मक: सकारात्मक स्वीकारात्मक
हौशी: सौखिन सोखी सोखिन
