अग्लो_हुनु: ওঠা উঠা তৈরি_করা বানা গাঁথা তোলা
अघाउनु: তৃপ্ত_করা পরিতৃপ্ত_করা
अघिबढ्नु: এগোনো আগে_যাওয়া অগ্রসর_হওয়া চলা
अटाउनु: রাখা ধরা ভরা আঁটা পোরা পূর্ণ_করা
अडिनु: থামা থামা
अड्याउनु: বজায়_রাখা টেঁকানো বাঁচানো
अढकिनु: নিয়োগ_করা শপথ_বা_চুক্তি_দ্বারা_আবদ্ধ_হওয়া অংশগ্রহণ_করা বিজড়িত_থাকা চালানো চালু_থাকা পরিচালনা_করা
अत्तालिनु: ভাঙা দুর্বল_হওয়া হতাশ_হওয়া আশাহত_হওয়া
अधिक_हुनु: বাড়া বৃদ্ধি_পাওয়া বেড়ে_ওঠা
अधिकार_गर्नु: হাতানো কবজা_করা ছিনিয়ে_নেওয়া
अधिसङ्ख्य: অধীন_হওয়া
अनुभव_गर्नु: অনুভব_করা উপলব্ধি_করা অভিঞ্জতা_লাভ_করা
अनुभव_हुनु: লাগা মনে_হওয়া অনুভব_করা বোধ_হওয়া টের_পাওয়া মালুম_হওয়া
अन्वेषण_गर्नु: খোঁজা তল্লাশ_করা অনুসন্ধান_করা সন্ধান_করা পাত্তা_করা ঢ়ুড়া
अभिमत_व्यक्त_गर्नु: বলা কওয়া ভাষণ_দেওয়া বক্তব্য_রাখা বিবৃতি_দেওয়া বক্তৃতা_দেওয়া
अभिमानी_बनाउनु: তোলা চড়া বাড়া ওঠা উঠা তোল্লা_দেওয়া
अभिसारन_गर्नु: চড়া চাঁটা থাপ্পর_মারা থাবড়া চাঁটি_মারা চাপড়_মারা
अभ्यस्त_पार्नु: বসা পাকা পাকানো জমা জমানো অভ্যস্থ_করা
अर्पण_गर्नु: চড়ানো অর্পণ_করা নিবেদন_করা অর্ঘ্য_প্রদান_করা
अर्पित_हुनु: চড়া চড়ানো অর্পণ_করা
अलमलिनु: কোনো_বিশেষ_গন্তব্য_ছাড়া_হাঁটা কোনো_উদ্দেশ্য_ছাড়া_ঘুরে_বেড়ানো
अलमारी: বাছা আলাদা_করা পৃথক_করা
अल्झाउनु: ফাঁসানো ফাঁসিয়ে_দেওয়া
अल्झिनु: ফাঁসা
अवरुद्ध_हुनु: নিয়োগ_করা শপথ_বা_চুক্তি_দ্বারা_আবদ্ধ_হওয়া অংশগ্রহণ_করা বিজড়িত_থাকা চালানো চালু_থাকা পরিচালনা_করা
आँक्‍नु: টানা আঁকা আকার_বানানো
आँखा_खोल्नु: চোখ_মেলা উন্মীলন উন্মেষ উন্মেষণ
आइपुग्नु: পৌছ পৌছা পৌছনো
आउनु: পৌছা পৌছানো আসা হাজির_হওয়া উপস্থিত_হওয়া ফেরা ফিরে_আসা আসা প্রত্যবর্তন_করা আসা শুরু_হওয়া আরম্ভ_হওয়া সূচনা_হওয়া লাগা আসা পাওয়া উপভোগ_করা আসা পাওয়া লাভ_করা জোটা মেলা পড়া অবস্থান_করা পড়া আসা নাক_গলানো কথা_বলা হস্তক্ষেপ_করা
आकर्षित_गर्नु: টানা টান_মারা খেঁচা
आगमन_हुनु: আসা শুরু_হওয়া আরম্ভ_হওয়া সূচনা_হওয়া
आत्तिनु: ভাঙা দুর্বল_হওয়া হতাশ_হওয়া আশাহত_হওয়া
आधिपत्य_जमाउनु: হাতানো কবজা_করা ছিনিয়ে_নেওয়া
आरम्भ: আরম্ভ_করা প্রবর্তন শুরু সূচনা
आरम्भ_गर्नु: আরম্ভ_করা শুরু_করা সূচনা_করা অবতারণা_করা আরম্ভ_করা শুরু_করা ভুমিকা_দেওয়া বেরনো বের_হওয়া
आरम्भ_हुनु: খোলা খুলে_যাওয়া চালু_হওয়া প্রচলিত_হওয়া
आरोहण_गर्नु: চড়া ওঠা আরোহণ_করা
आलमारी: বাছা আলাদা_করা পৃথক_করা
आविष्कार_गर्नु: বেরনো আবিষ্কার_করা আবিষ্কৃত_করা খুঁজে_বের_করা
आविस्कार_गर्नु: বের_করা আবিষ্কার_করা
आसन_ग्रहन_गर्नु: বসা আসন_গ্রহন_করা বিরাজমান_হওয়া
इख्‍याउनु: ঈর্ষা_করানো জ্বালানো
इन्तजाम_गर्नु: সর্বরাহ_করা গতি ব্যবস্হা সুরাহা
उकास्नु: চড়া উত্তেজিত_করা উসকানো প্ররোচনা_দেওয়া ভড়কানো পথভ্রষ্ট_করা ভুল_পথে_পরিচালিত_করা ছেড়ে_দেওয়া
उक्लनु: চড়া ওঠা আরোহণ_করা চড়া উত্তরণ_করা চড়া পদন্নোতি_হওয়া বৃদ্ধি_পাওয়া
उघार्नु: খোলা সরানো হাটানো মুক্ত_করা উন্মুক্ত_করা
उघ्रनु: খুলে_ফেলা উদ্ঘাটন_করা মুক্ত_করা
उघ्रिनु: খুলে_ফেলা উদ্ঘাটন_করা মুক্ত_করা
उचाल्नु: ওঠা উঠা তোলা উত্তোলন_করা ওঠা উঠা তোলা উত্তোলন_করা তোলা চড়া বাড়া ওঠা উঠা তোল্লা_দেওয়া তোলা চড়া বাড়া ওঠা উঠা তোল্লা_দেওয়া পাত্তা_দেওয়া
उजाड_हुनु: নষ্ট_করা ধ্বংস_করা বিধ্বস্ত_করা বরবাদ_করা পয়মাল_করা বিনাশ_করা
उठनु: দাঁড়া খাড়া_হওয়া উঠা দণ্ডায়মান_হওয়া ওঠা উঠা তৈরি_করা বানা গাঁথা তোলা ওঠা উঠা সরা চড়া যাওয়া গমন_করা মনে_হওয়া ওঠা উঠা আসা ভাবা তোলা ওঠা উঠা গোচরে_আসা
उठाउनु: তোলা লেখা অন্তর্ভূক্ত_করা লিপিবদ্ধ_করা রদ_করা ওঠা উঠা মেটানো তোলা দূরীকরণ_করা উচ্ছেদ_করা নির্মূল_করা ওঠা উঠা তোলা উত্তোলন_করা ওঠা উঠা তোলা উত্তোলন_করা ওঠা উঠা সরা তোলা হটা স্থানচ্যূত_করা জাগানো ওঠা উঠা ঘুম_ভাঙা নকল_করা কপি_করা নামানো কাজে_লাগা খরচ_করা ব্যয়_করা খরচা_করা আরম্ভ_করা শুরু_করা ভুমিকা_দেওয়া বেরনো বের_হওয়া
उठ्नु: ওঠা উঠা জাগা ঘুম_ভাঙা নিদ্রাভঙ্গ_হওয়া চোখ_মেলা রদ_করা ওঠা উঠা দূরীকরণ_করা নির্মূল_করা ভাঙা বন্ধ_হওয়া শেষ_হওয়া থামা বিরত_হওয়া
उडनु: ওড়া উড়া উড্ডয়ন_করা ওড়া উড়া উড্ডয়ন_করা ওড়া উড়া উড্ডয়ন_করা
उडाउनु: ওড়া উড়া উড্ডয়ন_করা ওড়া উড়া উড্ডয়ন_করা ওড়া উড়া উড়িয়ে_দেওয়া ওড়া উড়া ছড়া ওড়া পতপত_করা দোলা আন্দোলিত_হওয়া রটা চাউর_করা পাঁচকান_করা ওড়া ছড়া বলা রাষ্ট্র্_করা
उड्नु: ওড়া উড়া উড্ডয়ন_করা উড়া জোরে_চলা স্পিডে_চলা উড়ে_যাওয়া হাওয়া_হওয়া গায়েব_হওয়া বেপাত্তা_হওয়া অদৃশ্য_হওয়া নিরুদ্দেশ_হওয়া ওঠা উঠা ফ্যাকাসে_হওয়া
उत्पन्न_गर्नु: জন্ম_দেওয়া
उत्पन्न_हुनु: উৎপাদন_করা উৎপন্ন_করা বেরোনো নির্গমন_হওয়া নির্গত_হওয়া
उत्सव_मनाउनु: কোন_ব্যক্তি_বা_ঘটনাকে_স্মরনীয়_করে_রাখা দাগ মার্কা
उदय_हुनु: ওঠা উদিত_হওয়া বেরোনো
उधार्नु: আলগা_করা বেরনো বের_করা খোলা
उध्रिनु: আলগা_হওয়া বেরনো বের_হওয়া খোলা
उन्नत_गर्नु: বাড়া বাড়ানো
उपभोग_गर्नु: খাওয়া পান_করা নেওয়া নেয়া সেবন_করা
उपयोग_गर्नु: ব্যবহার_করা
उपयोगमा_आउनु: চলা কাজে_লাগা সক্রিয়_থাকা ব্যবহার_হওয়া
उपस्थित_हुनु: ঢোকা ঢুকা আসা ভেতরে_আসা দাখিল_হওয়া প্রবেশ_করা প্রবিষ্ট_হওয়া
उफ्रिनु: লাফিয়ে_উঠা লাফ_দেওয়া লাফিয়ে_উঠা লাফ_দেওয়া
उब्जाउनु: উৎপাদন_করা উৎপন্ন_করা
उब्जिनु: উৎপাদন_করা উৎপন্ন_করা
उभिनु: দাঁড়া খাড়া_হওয়া উঠা দণ্ডায়মান_হওয়া
उमाल्नु: বাষ্পিত_হওয়া জ্বলা ফোটা ফোটানো
उम्कनु: পালানো চম্পট_দেওয়া দৌড়ানো ছোটা পালিয়ে_যাওয়া
उम्रिनु: উৎপাদন_করা উৎপন্ন_করা ফোটা লাগা আসা প্রস্ফুটিত_হওয়া বিকশিত_হওয়া লাগা বাঁচা দাঁড়ানো বেরনো উত্পন্ন_হওয়া
उराल्नु: পথভ্রষ্ট_করা ভুল_পথে_পরিচালিত_করা
उल्टिनु: উলটা_হওয়া পাল্টে_যাওয়া উলটানো পাল্টানো উলটানো পাল্টানো গর্ভপাত_হওয়া
ओइलिनु: ম্লান_হওয়া শুকিয়ে_যাওয়া বিষন্ন_হওয়া
ओच्छ्याउनु: বিছানো ঢালা
ओर्लिनु: নামা ছাড়া কমা
कटकटाउनु: পড়া নির্ভর_করা
कम्‍नु: বাকি_থাকা
कराउनु: কুহু_রব কুহরণ কূজন বলা ডাকা
कर्म_गर्नु: করা কাজ_করা কার্য_করা
कस्नु: বাঁধা চড়া
काट्नु: কাটা চেরা কর্তন_করা বিভাজন_করা অংশ_করা টুকরো_করা খন্ড_করা কুচি_করা ব্যবচ্ছেদ_করা কাটা কাটা আলাদা_করা পৃথক_করা কাটা কেটে_ফেলা ছাঁটা বাদ_দেওয়া বিচ্ছিন_করা
कात्नु: সুতো_কাটা
काम_गर्नु: করা কাজ_করা কার্য_করা চলা কাজে_লাগা সক্রিয়_থাকা ব্যবহার_হওয়া
कार्य_गर्नु: করা কাজ_করা কার্য_করা
किटकिटाउनु: পড়া নির্ভর_করা
किन्नु: কেনা ক্রয়_করা নেওয়া
किरायामा_लिनु: ভাড়া_করা ভাড়া_নেওয়া
कुटनु: কোটা গুঁড়োনো গুঁড়ো_করা চূর্ণ_করা মার_খাওয়া পিটুনি_খাওয়া
कुटाइ_खानु: মার_খাওয়া পিটুনি_খাওয়া
कुटिनु: মার_খাওয়া পিটুনি_খাওয়া
कुट्नु: মারা পেটা ঠেঙানো
कुदाउनु: লাফ_মারানো লাফ_দেওয়ানো তাড়া_করা ধাওয়া_করা পশ্চাধাবন_করা
कुद्नु: কোনো_বিশেষ_গন্তব্য_ছাড়া_হাঁটা কোনো_উদ্দেশ্য_ছাড়া_ঘুরে_বেড়ানো
कुद्‍नु: উড়া জোরে_চলা স্পিডে_চলা ছোটা দৌড়ানো ধাওয়া বেগে_যাওয়া ধেয়ে_যাওয়া
कुरा_गर्नु: বলা কওয়া বাক্যালাপ_করা কথোপকথন_করা কথাবার্তা_বলা বলা কওয়া বাধা_দেওয়া বাগড়া_দেওয়া ব্যাঘাত_সৃষ্টি_করা
कुराकानि_गर्नु: বলা কওয়া বাক্যালাপ_করা কথোপকথন_করা কথাবার্তা_বলা
कुलेलम_ठोक्नु: পালানো পালিয়ে_যাওয়া ভাগা ভেগে_পড়া কেটে_পড়া চম্পট_দেওয়া পিটটান_দেওয়া পৃষ্ঠপ্রদর্শন_করা
कुहू_कुहू_गर्नु: কুহু_রব কুহরণ কূজন
केलाउनु: বাছা বাছাই_করা নির্বাচন_করা পরিষ্কার_করা
कोप्चो_पार्नु: পৌছা পৌছল আসা হাজির_হওয়া উপস্থিত_হওয়া
खतम_हुनु: ভাঙা বন্ধ_হওয়া শেষ_হওয়া থামা বিরত_হওয়া
खत्तम_हुनु: রদ_করা ওঠা উঠা দূরীকরণ_করা নির্মূল_করা
खनाउनु: ঢালা রাখা
खनिनु: চড়া দেওয়া দান_করা নিবেদন_করা অর্ঘ্যপ্রদান_করা
खराब_गर्नु: বিগড়ানো বিগড়নো খারাপ_করা বারোটা_বাজানো নষ্ট_করা বিগড়ানো বিগড়নো খারাপ_করা বারোটা_বাজানো নষ্ট_করা বিগড়ানো বিগড়নো খারাপ_করা বারোটা_বাজানো নষ্ট_করা বিগড়ানো বিগড়নো খারাপ_করা বারোটা_বাজানো নষ্ট_করা
खर्च_गर्नु: কাজে_লাগা খরচ_করা ব্যয়_করা খরচা_করা
खर्च_हुनु: লাগা খরচ_হওয়া ব্যয়_হওয়া
खसाउनु: ফেলা ফেলে_দেওয়া পড়া পড়ে_যাওয়া
खस्नु: পড়া পতিত_হওয়া পড়া
खान_दिनु: খাওয়ানো ভোজন_করানো
खाना_पकाउनु: রান্না_করা প্রস্তুত_করা আয়োজন_করা তৈরী_করা
खानु: কাটা কামড়ানো দংশন_করা দাঁত_ফোটানো বেঁধানো বিঁধানো বিদ্ধ_করা কর্তন_করা টুকরো_করা খন্ড_করা খাওয়া ভোজন_করা আহার_করা পান_করা খাওয়া সেবন_করা খাওয়া গেলা_করা গ্রাস_করা হজম_করা ধরা খাওয়া খেয়ে_যাওয়া খাওয়া পান_করা নেওয়া নেয়া সেবন_করা চড়া টানা সেবন_করা পান_করা খাওয়া খারাপ_করা নষ্ট_করা খাওয়া ধরা হওয়া গ্রাস_করা খাওয়া শোষা টেনে_নেওয়া নষ্ট_করা বরবাদ_করা খাওয়া চাপা লুকানো হজমকরা
खिच्नु: তোলা নেওয়া ফোটা ফুটে_ওঠা আঁকাঁ
खुइलिनु: ওঠা উঠা ফ্যাকাসে_হওয়া
खुर्किनु: ছাড়ানো ছোলা চাঁচা
खुला_हुनु: খোলা মুক্ত_করা উন্মুক্ত_করা উন্মোচন_করা স্বাধীন_করা
खुल्‍नु: খুলে_ফেলা উদ্ঘাটন_করা মুক্ত_করা
खुवाउनु: খাওয়ানো ভোজন_করানো
खुसी_हुनु: উচ্ছসিত_হওয়া আনন্দে_ভরে_যাওয়া মত্ত_হওয়া
खुस्काउनु: আলগা_করা বেরনো বের_করা খোলা
खुस्किनु: আলগা_হওয়া বেরনো বের_হওয়া খোলা খোলা মুক্ত_করা উন্মুক্ত_করা উন্মোচন_করা স্বাধীন_করা খোলা খুলে_যাওয়া খসা পড়া ভাঙা আলাদা_হওয়া বিচ্ছিন্ন_হওয়া পৃথক_হওয়া খন্ডিত_হওয়া খোলা খুলে_যাওয়া বেরোনো পৃথক_হওয়া আলাদা_হওয়া
खेदाउँदै: তাড়া_করা ধাওয়া_করা পশ্চাধাবন_করা
खेदाउनु: যানবাহন_চালানো বহিষ্কার_করা বের_করে_দেওয়া তাড়িয়ে_দেওয়া দূর_করে_দেওয়া
खोजतलास_गर्नु: খোঁজা তল্লাশ_করা অনুসন্ধান_করা সন্ধান_করা পাত্তা_করা ঢ়ুড়া
खोजी_गर्नु: খোঁজা তল্লাশ_করা অনুসন্ধান_করা সন্ধান_করা পাত্তা_করা ঢ়ুড়া
खोजेर_निकाल्नु: বেরনো আবিষ্কার_করা আবিষ্কৃত_করা খুঁজে_বের_করা
खोज्नु: খোঁজা তল্লাশ_করা অনুসন্ধান_করা সন্ধান_করা পাত্তা_করা ঢ়ুড়া
खोलिनु: খোলা খুলে_যাওয়া চালু_হওয়া প্রচলিত_হওয়া খুলে_ফেলা উদ্ঘাটন_করা মুক্ত_করা খোলা খুলে_যাওয়া খসা পড়া খোলা বার_হওয়া ফাঁস_করা বার_করা সামনে_আসা শুরু আরম্ভ_হওয়া
खोल्नु: খোলা উন্মুক্ত_করা চালু_করা খোলা বের_করা আলাদা_করা আলগা_করা বেরনো বের_করা খোলা
खोल्‍नु: খোলা সরানো হাটানো মুক্ত_করা উন্মুক্ত_করা খোলা মুক্ত_করা উন্মুক্ত_করা খোলা বলা প্রকাশ_করা ব্যক্ত_করা উন্মোচন_করা খোলা শুরু_করা আরম্ভ_করা খোলা আরম্ভ_করা চালু_করা শুরু_করা খোলা আলাদা_করা
खोसिनु: বেরোনো বেরিয়ে_যাওয়া ফসকে_যাওয়া চলা চলে_যাওয়া
ख्याल_गर्नु: দেখা নজর_করা খেয়াল_রাখা লক্ষ্য_করা
गजब_हुनु: জমা সরগরম_হওয়া উপভোগ্য_হওয়া
गत्वरित_गर्नु: চলানা চালিত_করা চালূ_করা
गफ_गर्नु: বলা কওয়া বাক্যালাপ_করা কথোপকথন_করা কথাবার্তা_বলা হাঁকা
गमन_गर्नु: যাওয়া চলা প্রস্থান_করা গমন_করা যাত্রা_করা
गर्नु: করা লেগে_থাকা করা পারা উতরে_যাওয়া
गल्नु: ক্লান্ত_হওয়া কষ্ট_পাওয়া ব্যথা_পাওয়া যন্ত্রণা_হওয়া
गाउनु: গান_করা গান_গাওয়া
गाडनु: ঢোকা ঢোকানো গাড়া পোতা
गाता_लगाउनु: মোড়া মুড়া মুড়ানো মোড়ানো
गायबहुनु: উড়ে_যাওয়া হাওয়া_হওয়া গায়েব_হওয়া বেপাত্তা_হওয়া অদৃশ্য_হওয়া নিরুদ্দেশ_হওয়া
गिर्नु: ঝড়া পড়া
गीत_गाउनु: গান_করা গান_গাওয়া
गुम्नु: উড়ে_যাওয়া হাওয়া_হওয়া গায়েব_হওয়া বেপাত্তা_হওয়া অদৃশ্য_হওয়া নিরুদ্দেশ_হওয়া
गोद्‍नु: মারা পেটা ঠেঙানো
ग्रहण_गर्नु: নেওয়া নেয়া গ্রহন_করা নেওয়া নেয়া ভার_নেওয়া গ্রহন_করা
घटाउनु: বাদ_দেওয়া ছাঁটাই_করা ছাঁটা কাটিয়ে_দেওয়া বহিস্কার_করা
घटित_हुनु: ঘটনা ঘটিত_হওয়া
घट्नु: ঘটনা ঘটিত_হওয়া চরতার্থ_হওয়া ঘটনা
घट्‍नु: বাকি_থাকা
घिस्याउनु: লাগা
घिस्र्याउनु: টান_দেওয়া টানা
घुमाउनु: ঘুরা ঘোরা ঘোরানো পাক_খাওয়া ঘোরা বাঁকা ঘোরা হাঁটা বেড়ানো ঘোরা বেড়ানো ঘোরানো প্রবৃত্ত_করা চলা নাচানো নাড়ানো ঘোরানো
घुम्नु: ঘুরে_যাওয়া দিক_বদলানো কোনো_বিশেষ_গন্তব্য_ছাড়া_হাঁটা কোনো_উদ্দেশ্য_ছাড়া_ঘুরে_বেড়ানো
घेरामा_पार्नु: পরিবেষ্টন_করা বেড় আবৃত জড়ানো বেষ্ট
घेर्नु: পরিবেষ্টন_করা বেড় আবৃত জড়ানো বেষ্ট
घोच्नु: চোট_লাগানো ঘা_লাগানো আঘাত_করা
घोत्लिनु: ফাঁসা
घोप्टिनु: উলটো_করা উপুড়_করা উপুড়_হওয়া গুঁজা গোঁজা
घोप्‍नु: চোট_লাগানো ঘা_লাগানো আঘাত_করা
घोलिनु: মিশা মেশা মিশে_যাওয়া মিশ্রিত_হওয়া গুলে_যাওয়া
ङ्याक्नु: টেপা চাপা
चडाउनु: চড়া চাপা তোলা ওঠা উঠা তোলা চড়া বাড়া ওঠা উঠা তোল্লা_দেওয়া পাত্তা_দেওয়া
चड्नु: চড়া উত্তরণ_করা
चढनु: তোলা লেখা অন্তর্ভূক্ত_করা লিপিবদ্ধ_করা চড়া ওঠা আরোহণ_করা চড়া চড়ে_যাওয়া উঁচু_হওয়া বাড়া বেড়ে_যাওয়া ওঠা চড়া চড়ানো ভরা চড়া ঘনিয়ে_আসা চড়া উপযুক্ত_হওয়া ওঠা উঠা সরা চড়া যাওয়া গমন_করা চড়া চড়ানো অর্পণ_করা চড়া উপরে_ওঠা উর্ধগামী_হওয়া চড়া পদন্নোতি_হওয়া বৃদ্ধি_পাওয়া
चढाउनु: চড়া চড়ানো চাপানো চড়ানো অর্পণ_করা নিবেদন_করা অর্ঘ্য_প্রদান_করা লেখা লিপিবদ্ধ_করা টোকা নোট_করা চড়া ভরা বোঝাই_করা রাখা চাপা সওয়ারি_করা বসা চড়া তোলা ওঠা উঠা চড়া ওঠা উঠা তোলা চড়া বাড়া ওঠা উঠা তোল্লা_দেওয়া চড়া উর্দ্ধে_ওঠা চড়ানো লাগা প্রলেপ_দেওয়া লেপা মাখা পোঁচ_দেওয়া আস্তর_দেওয়া
चरितार्थ_हुनु: চরতার্থ_হওয়া ঘটনা
चलाउनु: চলানা চালিত_করা চালূ_করা ছোঁড়া নিক্ষেপ_করা প্রয়োগ_করা চালানো খোলা উন্মুক্ত_করা চালু_করা যানবাহন_চালানো চালনা চালানো চালন চালু_করা রটা চাউর_করা পাঁচকান_করা ওড়া ছড়া বলা রাষ্ট্র্_করা আরম্ভ_করা শুরু_করা ভুমিকা_দেওয়া বেরনো বের_হওয়া
चल्नु: বওয়া চলা চলা বহা বয়ে_চলা টেঁকা বাঁচা চলা বজায়_থাকা গতিতে_থাকা ঘটা চলা জারি_রাখা টেঁকা টিঁকে_থাকা চলা স্থায়ী_হওয়া চলা কাজে_লাগা সক্রিয়_থাকা ব্যবহার_হওয়া এগোনো আগে_যাওয়া অগ্রসর_হওয়া চলা চলা প্রতিপত্তি_থাকা আধিপত্য_থাকা
चल्‍नु: চল চলা চালু_হওয়া প্রচলন_হওয়া চলা পারা সমর্থ_হওয়া
चाट्नु: খাওয়া খারাপ_করা নষ্ট_করা
चालित_गर्नु: চলানা চালিত_করা চালূ_করা
चालु_हुनु: খোলা খুলে_যাওয়া চালু_হওয়া প্রচলিত_হওয়া
चालू_गर्नु: চলানা চালিত_করা চালূ_করা
चिनो_लगाउनु: টুকা টোকা
चिन्तन_गर्नु: চিন্তা_করা বিচার_করা বিবেচনা_করা ভাবা
चिन्नु: বোঝা জানা চেনা চিনতে_পারা বুঝতে_পারা উপলবদ্ধি_করা
चिराउनु: সরে_যাওয়া
चिर्न_लगाउनु: সরে_যাওয়া
चुक्ता_गर्नु: শোধ_করা মেটানো মিটিয়ে_দেওয়া চুকিয়ে_দেওয়া চুকানো ফেরত_দেওয়া
चुनाव_गर्नु: বাছা বাছে_নেওয়া নির্বাচিত_করা
चुप्पा: চুম্বন_করা চুমা_দেওয়া চুমু_খাওয়া
चुम्बन: চুম্বন_করা চুমা_দেওয়া চুমু_খাওয়া
चुस्नु: চোসা শুষা শোষা শোষণ_করা নিষ্পেষণ_করা চুষা চোষা
चुहाउनु: চুয়ানো চুয়া চুয়ে_পড়া চোয়ানো চোয়া
चुहुनु: টপ_টপ_করে_পড়া পড়া চুঁইয়ে_পড়া বার_হওয়া ক্ষরণ_হওয়া নিঃসরণ_হওয়া বেরোনো বওয়া গড়ানো
चोइट्याउनु: টুকরো_করা ভাঙ্গা কাটা
चोर्नु: চুরি_করা অপহরণ_করা হাতানো চুরি_করা টোকা জালিয়াতি_করা নিয়ে_নেওয়া
च्याउनु: দেখা লক্ষ্য_রাখা নজর_করা
च्यातिनु: আলগা_হওয়া বেরনো বের_হওয়া খোলা
च्यापिनु: চাপা
च्याप्नु: টেপা চাপা
छ: থাকা
छचल्काउनु: ছলকানো চলকানো
छचल्किनु: ছলকানো চলকানো উচ্ছলানো
छनबिन_गर्नु: বাছা বাছাই_করা নির্বাচন_করা পরিষ্কার_করা
छरिनु: ওড়া উড়া উড্ডয়ন_করা
छल्नु: ঠকানো
छाँटिनु: রোগা_হওয়া কৃশ_হওয়া ক্ষীণ_হওয়া
छाँट्नु: কাটা কাটা কেটে_ফেলা ছাঁটা বাদ_দেওয়া বিচ্ছিন_করা ছাঁটা ছাটা কাটা জাহির_করা প্রকাশ_করা
छाँट्‍नु: বাদ_দেওয়া ছাঁটাই_করা ছাঁটা কাটিয়ে_দেওয়া বহিস্কার_করা
छाड़िदिनु: খোলা ছাড়া স্বাধীন_করা মুক্ত_করা উন্মুক্ত_করা
छाडिदिनु: ছাড়া দোষ_মুক্ত_করা অপরাধ_মুক্ত_করা রেহাই_করা খালাস_করা
छान्नु: বাছা বাছাই_করা নির্বাচন_করা পরিষ্কার_করা বাছা বাছে_নেওয়া নির্বাচিত_করা বেছে_নেওয়া আলাদা_করা নির্বাচন_করা বের_করা পছন্দ_করা বাদ_দেওয়া ছাঁটাই_করা ছাঁটা কাটিয়ে_দেওয়া বহিস্কার_করা
छाप_लगाउनु: মুদ্রণ_করা সীলমোহর_লাগানো মোহর_লাগানো ছাপ_মারা
छाप्नु: ছাপা ছাপানো ছাপানো মুদ্রণ_করা
छिंक्नु: হাঁচা হাঁচি_আসা হাঁচি_দেওয়া
छिनाउनु: খোদাই_করা
छुटाउनु: ছেড়ে_দেওয়া
छुट्टिनु: ফাটা ফুটা চিড়_খাওয়া খোলা খুলে_যাওয়া বেরোনো পৃথক_হওয়া আলাদা_হওয়া বেরনো বের_করা আলাদা_হওয়া পৃথক_হওয়া
छुट्टीहुनु: শেষ_হওয়া ছুটি_হওয়া সমাপ্ত_হওয়া সাঙ্গ_হওয়া
छुट्नु: খোলা মুক্ত_করা উন্মুক্ত_করা উন্মোচন_করা স্বাধীন_করা চলা চলে_যাওয়া বেরোনো শেষ_হওয়া ছুটি_হওয়া সমাপ্ত_হওয়া সাঙ্গ_হওয়া ছাড়া বাদ_পড়া থেকে_যাওয়া ছাড়া ছাড়া_পাওয়া বেরোনো মুক্ত_হওয়া রেহাই_পাওয়া নামা ছাড়া কমা বেরোনো বেরিয়ে_যাওয়া ফসকে_যাওয়া চলা চলে_যাওয়া
छुट्याउनु: ওড়া উড়া উড়িয়ে_দেওয়া
छुनु: লাগা স্পর্শ_করা ঠেকা ছোঁয়া
छेक्नु: পরিবেষ্টন_করা বেড় আবৃত জড়ানো বেষ্ট
छेड्नु: চোট_লাগানো ঘা_লাগানো আঘাত_করা ছেদনা ছেদকরনা বেধনা ভেদনা সালনা ছালনা
छोडनु: ছাড়া ত্যাগ_করা পরিহার_করা বর্জন_করা পরিত্যাগ_করা ছাড়া তাড়া ধাওয়া পিছু_লাগা বাদ_দেওয়া ছাড়া সঁপা দেওয়া অর্পণ_করা ছাড়া বাঁচানো রাখা জমা জমানো জমিয়ে_রাখা
छोडाउनु: ছাড়া ছাড়ান ছাড়ানো ছাড়া ছাড়ি ছাড়ানো
छोडिनु: চলা চলে_যাওয়া বেরোনো ছাড়া বাদ_পড়া থেকে_যাওয়া
छोड्नु: ছোঁড়া নিক্ষেপ_করা প্রয়োগ_করা চালানো ছাড়া ত্যাগ_করা বর্জন_করা পরিত্যাগ_করা পরিহার_করা প্রত্যাখ্যান_করা হটা ছাড়া যাওয়া গমন_করা রওনা_দেওয়া প্রস্থান_করা
छोपाउनु: সরানো
जगाउनु: জাগানো ওঠা উঠা ঘুম_ভাঙা
जडनु: লাগা বসা
जतन_गर्नु: সামলানো
जनाउनु: বলা জানা জানানো
जन्म_दिनु: জন্ম_দেওয়া
जन्म_लिनु: জন্মানো জন্মলাভ_করা আসা ভূমিষ্ঠ_হওয়া প্রসূত_হওয়া
जन्माउनु: জন্ম_দেওয়া জন্মানো প্রসব_করা
जन्मिनु: জন্মানো জন্মলাভ_করা আসা ভূমিষ্ঠ_হওয়া প্রসূত_হওয়া
जमाउनु: স্থান_দেওয়া প্রতিষ্ঠা_করা যায়গা_দেওয়া বসানো পটানো রাজী_করা ঠিক_করা নির্দিষ্ট_করা
जम्नु: জমা কঠিন_হওয়া ঘনীভূত_হওয়া গাঢ়_হওয়া শক্ত_হওয়া ঘন_হওয়া জমাট_বাঁধা জমা জড়ো_হওয়া একত্র_হওয়া একত্রিত_হওয়া সমবেত_হওয়া জমা বাড়া চলা বৃদ্ধি_পাওয়া উন্নতি_করা বসা লাগা বসে_যাওয়া
जम्‍नु: জমা আস্তরণ_পড়া পরত_পড়া প্রলেপ_পড়া বসে_যাওয়া
जलनु: পুড়া পোড়া জ্বলা
जलाउनु: জ্বালা জ্বালানো প্রজ্জ্বলিত_করা প্রদীপন_করা
जल्नु: জ্বলা
जाँच्नु: পরখ_করা যাচা পরীক্ষা_করা বিচার_করা খতিয়ে_দেখা যাচা যাচাই_করা পরীক্ষা_করা
जाग्नु: বেরনো উত্পন্ন_হওয়া
जानु: বওয়া চলা যাওয়া চলা প্রস্থান_করা গমন_করা যাত্রা_করা কাটানো অতিবাহিত_করা বেরনো বেরিয়ে_যাওয়া
जान्नु: জানা জ্ঞাত_হওয়া বোঝা জ্ঞান_থাকা অবহিত_থাকা পরিচিত_থাকা
जारी_गर्नु: বেরনো বের_হওয়া
जारी_रहनु: গতিতে_থাকা ঘটা চলা জারি_রাখা
जिउनु: বাঁচা জীবনযাবনকরা জীবনধারনকরা অস্তিত্ববজায়রাখা জীবিতথাকা
जिम्मा_लाउनु: সঁপা দেওয়া অর্পণ_করা ছাড়া
जीवित_रहनु: বাঁচা জীবনযাবনকরা জীবনধারনকরা অস্তিত্ববজায়রাখা জীবিতথাকা
जो_गर्नु: বাঁচানো রাখা জমা জমানো জমিয়ে_রাখা
जोगाउनु: সামলা সামলানো রোধ_করা সামলা সামলানো সংবরা সংবরণ_করা বাঁচানো রাখা জমা জমানো জমিয়ে_রাখা
जोगिनु: বেঁচে_যাওয়া বাঁচা বেঁচে_যাওয়া রক্ষা_পাওয়া পরিত্রাণ_পাওয়া ত্রাণ_পাওয়া সামলা সামলানো বাচা বাচানো
जोडनु: জোড়া_দেওয়া যুক্ত_করা বন্ধন_তৈরি_করা
जोडिनु: লাগা জোড়া আটকা যুক্ত_করা সাঁটা
जोड्नु: জোড়া সাঁটা সাটাঁনো যুক্ত_করা লাগানো আঁটা
झक-झक_गर्नु: বাড়া বেড়ে_যাওয়া
झडकार्नु: ঝাড়ানো
झर्नु: ঝড়া পড়া ধসা বসা টপ_টপ_করে_পড়া পড়া চুঁইয়ে_পড়া বার_হওয়া ক্ষরণ_হওয়া নিঃসরণ_হওয়া পড়া পতিত_হওয়া জলপ্রপাতের_মত_নেমে_আসা ভাঙা আলাদা_হওয়া বিচ্ছিন্ন_হওয়া পৃথক_হওয়া খন্ডিত_হওয়া কম_পড়া ঘাটতি_হওয়া অভাব_হওয়া টান_পড়া বাকি_থাকা পড়া
झाप_हान्नु: লাফিয়ে_উঠা লাফ_দেওয়া
झार्नु: ঝাড়া ফেলা ফেলে_দেওয়া পড়া পড়ে_যাওয়া
झिकाउनु: ছেড়ে_দেওয়া
झिक्नु: টানা টান_মারা খেঁচা বেরনো বেরতে_থাকা নির্গত_হওয়া নিসৃতঃ_হওয়া বের_করা টানা
झिट्नु: সেচ_করা সেচন_করা জলসেচন_করা
झिम्कीनु: পলক_ফেলা
झुक्किनु: কোনো_বিশেষ_গন্তব্য_ছাড়া_হাঁটা কোনো_উদ্দেশ্য_ছাড়া_ঘুরে_বেড়ানো
झुक्नु: দাব চাপা দাবানো
झुक्याउनु: ঠকানো
झुल्किनु: ওঠা উদিত_হওয়া বেরোনো
टङ्कन_गर्नु: ছাপানো মুদ্রণ_করা
टाँक_लगाउनु: জোড়া পট্টি_দেওয়া টাঁকা টাঁক_দেওয়া তাপ্পি_মারা তালি_দেওয়া লাগানো
टाँसिनु: লাগা জোড়া আটকা যুক্ত_করা সাঁটা জমা আস্তরণ_পড়া পরত_পড়া প্রলেপ_পড়া বসে_যাওয়া লাগা স্পর্শ_করা ঠেকা ছোঁয়া চড়া চড়ানো উপর্য্যুপরি_লাগানো বসা লাগা বসে_যাওয়া
टाँस्नु: জোড়া সাঁটা সাটাঁনো যুক্ত_করা লাগানো আঁটা লাগা বসা
टाङनु: বজায়_রাখা টেঁকানো বাঁচানো
टापटिप_गर्नु: চুরি_করা অপহরণ_করা হাতানো
टिक्नु: টেঁকা বাঁচা চলা বজায়_থাকা টেঁকা টিঁকে_থাকা চলা স্থায়ী_হওয়া
टिप्नु: ছেঁড়া ছিন্ন_করা তোলা ছিঁড়া
टिप्‍नु: নকল_করা কপি_করা নামানো
टुक्रा_गर्नु: টুকরো_করা ভাঙ্গা কাটা
टुक्रा_पार्नु: কাটা চেরা কর্তন_করা বিভাজন_করা অংশ_করা টুকরো_করা খন্ড_করা কুচি_করা ব্যবচ্ছেদ_করা
टुक्रिनु: ফাটা ফুটা চিড়_খাওয়া টুকরো_হওয়া ভেঙে_যাওয়া খণ্ডিত_হওয়া
टुक्र्याउनु: কাটা চেরা কর্তন_করা বিভাজন_করা অংশ_করা টুকরো_করা খন্ড_করা কুচি_করা ব্যবচ্ছেদ_করা খোদাই_করা
टुङ्गो_लाग्नु: জমা আটকে_পড়া বসে_যাওয়া
टुटनु: কম_পড়া ঘাটতি_হওয়া অভাব_হওয়া টান_পড়া
टुट्नु: টুকরো_হওয়া ভেঙে_যাওয়া খণ্ডিত_হওয়া কষ্ট_পাওয়া ব্যথা_পাওয়া যন্ত্রণা_হওয়া ভাঙা নষ্ট_হওয়া ছেদ_পড়া শেষ_হওয়া ভাঙা ধ্বংস_হওয়া বিনষ্ট_হওয়া ভাঙা টুকরো_বা_চুর্ন_করা ভেঙে_যাওয়া
टेकाउनु: বজায়_রাখা টেঁকানো বাঁচানো
टोक्नु: কাটা কামড়ানো দংশন_করা দাঁত_ফোটানো বেঁধানো বিঁধানো বিদ্ধ_করা কর্তন_করা টুকরো_করা খন্ড_করা কাটা কামড়া কামড়ানো দংশন_করা ছোবল_মারা ঠোকা খিটখিট_করা পিছনে_লাগা খিচখিচ_করা বলা খিটিমিটি_করা
ठग्नु: ঠকানো লোটা লোটন লুটে_নেওয়া খরচ_করান
ठान्नु: মনে_করা ভাবা বোঝা অনুভব_করা উপলব্ধি_করা অভিঞ্জতা_লাভ_করা
ठिक_हुनु: চরতার্থ_হওয়া ঘটনা পটা পাকা_হওয়া ঠিক_হওয়া স্থির_করা
ठीकहुनु: আঁটা ফিট_করা হওয়া বসা ঠিক_হওয়া
ठुलो_पार्नु: চড়া ওঠা উঠা তোলা
ठुलो_हुनु: বাড়া বৃদ্ধি_পাওয়া বাড়ানো
ठेल्‍नु: দেওয়া লাগা আরোপ_করা চাপানো
डगनु: অদৃঢ় টলয়মান
डगमगाउनु: অদৃঢ় টলয়মান
डडनु: পুড়া পোড়া জ্বলা
डढनु: জ্বলা
डराउनु: দাবানো
डस्‍नु: কাটা কামড়া কামড়ানো দংশন_করা ছোবল_মারা
डुब्नु_आत्मविस्मृत_हुनु: নিমজ্জিত_হওয়া ডোবানো মজ্জিত_করা নিমগ্ন_করা
डुलाउनु: ঘুরা ঘোরা ঘোরানো পাক_খাওয়া ঘোরা হাঁটা বেড়ানো ঘোরা বেড়ানো
डुल्नु: কোনো_বিশেষ_গন্তব্য_ছাড়া_হাঁটা কোনো_উদ্দেশ্য_ছাড়া_ঘুরে_বেড়ানো
डूब्नु: ডুবে_যাওয়া বসে_যাওয়া নষ্ট_হওয়া
डेरा_लिनु: ভাড়া_করা ভাড়া_নেওয়া
डोल्नु: দোলানো দোলা আন্দোলিত_করা
ढकाउनु: সরানো
ढल्नु: ভেঙে_পড়া ভূপাতিত_হওয়া
ढाकछोप_गर्नु: চাপা চেপে_দেওয়া
तताउनु: বাষ্পিত_হওয়া জ্বলা ফোটা ফোটানো
तन्काउनु: টান_দেওয়া টানা
तय_हुनु: পটা পাকা_হওয়া ঠিক_হওয়া স্থির_করা
तयार_हुनु: বানানো নির্মাণ_করা ওঠা উঠা তৈরি_হওয়া বানানো গাঁথা তোলা
तलास_गर्नु: খোঁজা তল্লাশ_করা অনুসন্ধান_করা সন্ধান_করা পাত্তা_করা ঢ়ুড়া
तल्लीन_होना: নিমজ্জিত_হওয়া ডোবানো মজ্জিত_করা নিমগ্ন_করা
ताछ्नु: ছাড়ানো ছোলা চাঁচা
ताते_गर्नु: ঠুমকি ঠুমুক ঠমক
तान्नु: টান_দেওয়া টানা টানা টান_মারা খেঁচা চড়া উর্দ্ধে_ওঠা লাগা
तिर्नु: শোধ_করা মেটানো মিটিয়ে_দেওয়া চুকিয়ে_দেওয়া চুকানো ফেরত_দেওয়া
तिर्मिराउँछन्: ধাঁধানো ধাঁধা_লাগা ঝলসানো
तुहिनु: গর্ভপাত_হওয়া
तृप्त_हुनु: তৃপ্ত_করা পরিতৃপ্ত_করা
तोपनु: চাপিয়ে_দেওয়া জোর_করা জরিমানা_দেওয়ানো ধরা প্রতারণা আরোপ_দেওয়া
त्याग्नु: ছাড়া ত্যাগ_করা পরিহার_করা বর্জন_করা পরিত্যাগ_করা ছাড়া ত্যাগ_করা বর্জন_করা পরিত্যাগ_করা পরিহার_করা প্রত্যাখ্যান_করা
थकाइमार्नु_आराम_गर्नु: শুয়ে_পড়া
थपिदिनु: চাপিয়ে_দেওয়া জোর_করা জরিমানা_দেওয়ানো ধরা প্রতারণা আরোপ_দেওয়া
थपिनु: বাড়া বৃদ্ধি_পাওয়া বেড়ে_ওঠা
थाक्नु: ক্লান্ত_হওয়া
थामिनु: নিয়োগ_করা শপথ_বা_চুক্তি_দ্বারা_আবদ্ধ_হওয়া অংশগ্রহণ_করা বিজড়িত_থাকা চালানো চালু_থাকা পরিচালনা_করা থামা থামা
थालनी: আরম্ভ_করা প্রবর্তন শুরু সূচনা
थाल्नु: আরম্ভ_করা শুরু_করা সূচনা_করা অবতারণা_করা
थाहा_पाउनु: জানা জ্ঞাত_হওয়া বোঝা জ্ঞান_থাকা অবহিত_থাকা পরিচিত_থাকা লাগা মনে_হওয়া টের_পাওয়া মালুম_হওয়া
थाहा_हुनु: বুঝা বোঁঝা জানা লাগা মনে_হওয়া টের_পাওয়া মালুম_হওয়া লাগা মনে_হওয়া অনুভব_করা বোধ_হওয়া টের_পাওয়া মালুম_হওয়া
थिचिनु: বসে_যাওয়া চেপে_যাওয়া দেবে_যাওয়া দাবা ধ্বসা দেবে_যাওযা ধ্বসে_পড়া
थिच्नु: টেপা চাপ_দেওয়া দাবা দাবানো টেপা টেপা চাপা
थिच्‍नु: চাপা চাপ_দেওয়া টেপা টিপে_দেওয়া
थुत्‍नु: টান_দেওয়া টানা
थुन्नु: পরিবেষ্টন_করা বেড় আবৃত জড়ানো বেষ্ট
थुपार्नु: চাপিয়ে_দেওয়া জোর_করা জরিমানা_দেওয়ানো ধরা প্রতারণা আরোপ_দেওয়া
थोपर्नु: ঘাড়ে_চাপানো দেওয়া
दबाउनु: চাপা চাপ_দেওয়া টেপা টিপে_দেওয়া টেপা চাপা দমিয়ে_দেওয়া রোখা চাপা হারানো চাপা চেপে_দেওয়া ঢোকা ঢোকানো গাড়া পোতা থামা থামানো চাপা শান্ত_রাখা রাখা রেখে_দেওয়া আটকানো চেপে_রাখা চাপা টেপা চাপা
दबिनु: বসে_যাওয়া চেপে_যাওয়া দেবে_যাওয়া দাবা ধ্বসা দেবে_যাওযা ধ্বসে_পড়া চাপা
दब्नु: দাবানো দমানো দাব চাপা দাবানো
दर्कार: পড়া
दर्शन_गर्नु: দেখা তাকা তাকানো লক্ষ্য_করা নিরীক্ষণ_করা
दल्नु: লাগানো মাখানো
दाग_लगाउनु: টুকা টোকা
दान_गर्नु: দান_করা দান_দেওয়া
दान_दिनु: দান_করা দান_দেওয়া
दाम_बढनु: চড়া বাড়া আকাশচুম্বি_হওয়া
दिनु: দান_করা দান_দেওয়া দেওয়া প্রদান_করা ভাড়া_দেওয়া কেরায়া_দেওয়া রেন্ট_দেওয়া
दुर्बल_हुनु: ভাঙা দুর্বল_হওয়া অশক্ত_হওয়া ক্ষীণ_হওয়া বলহীন_হওয়া কমজোরি_হওয়া
दुलो_पार्नु: ছেদনা ছেদকরনা বেধনা ভেদনা সালনা ছালনা
दुहुनु: দোয়া দোয়ানো দোহন_করা
देखाउनु: দেখান দেখানো প্রদর্শন_করা দৃষ্টিগোচর_করা দৃশ্যমান_করা প্রকাশ_করা বলা নির্দেশিত_করা দেখা দেখানো দেখা দেখানো দেখা দেখানো দেখা দেখানো
देख्‍नु: দেখা পরখ_করা যাচাই_করা পরীক্ষা_করা নিরীক্ষা_করা দেখা বোধ_করা লক্ষ্য_করা
देहावसान_हुनु: মরা মারা_যাওয়া প্রাণ_হারান পরোলোকগমন_করা প্রাণত্যাগ_করা
दौडनु: ছোটা দৌড়ানো ধাওয়া বেগে_যাওয়া ধেয়ে_যাওয়া
दौडाउनु: লাফ_মারানো লাফ_দেওয়ানো তাড়া_করা ধাওয়া_করা পশ্চাধাবন_করা
धकेल्नु: দেওয়া লাগা আরোপ_করা চাপানো
धपाउनु: যানবাহন_চালানো
धसिनु: ধসা বসা
धारण_गर्नु: পড়া পরিধান_করা পড়া লাগা নেওয়া ধারণ_করা
धुइनु: পরিষ্কার_করা কাচা ধোয়া ধৌত_করা ধোয়া কাচা ধুয়া ধৌত_করা
धुनु: ধোয়া পরিষ্কার_করা কাচা
धुवाँ_खानु: ভাবা চিন্তা_করা চিন্তাভাবনা_করা বিচার_করা অনুসন্ধান_করা
धेरै_हुनु: চড়া চড়ে_যাওয়া উঁচু_হওয়া বাড়া বেড়ে_যাওয়া ওঠা
ध्यान_दिनु: দেখা নজর_করা খেয়াল_রাখা লক্ষ্য_করা
ध्वनि_निस्किनु: প্রতিধ্বনি_করা প্রতিধ্বনিত_করা বার_বার_ধ্বনিত_প্রতিধ্বনিত_হওয়া;
ध्वस्त_हुनु: নষ্ট_করা ধ্বংস_করা বিধ্বস্ত_করা বরবাদ_করা পয়মাল_করা বিনাশ_করা
नकल_गर्नु: নকল_করা কপি_করা নামানো
नघाउनु: ঝাপ_দেওয়ানো ঝাপ_মারানো
नछाउनु: নাচানো নাড়ানো ঘোরানো
नजर_राख्‍नु: দেখা নজর_করা খেয়াল_রাখা লক্ষ্য_করা
नपाउनु: বঞ্চিত_হওয়া না_পারা
नष्ट_हुनु: নষ্ট_করা ধ্বংস_করা বিধ্বস্ত_করা বরবাদ_করা পয়মাল_করা বিনাশ_করা
नाघ्न_लगाउनु: ঝাপ_দেওয়ানো ঝাপ_মারানো
निकालनु: বেরনো আবিষ্কার_করা আবিষ্কৃত_করা খুঁজে_বের_করা
निकालिदिनु: সরা হটা অপসরণ_করা তাড়ানো দূর_করা
निकाल्नु: ছেড়ে_দেওয়া বৃহত্তর_হওয়া বেরনো বের_হওয়া বের_করা বের_করা আবিষ্কার_করা আরম্ভ_করা শুরু_করা ভুমিকা_দেওয়া বেরনো বের_হওয়া বহিষ্কার_করা বের_করে_দেওয়া তাড়িয়ে_দেওয়া দূর_করে_দেওয়া বেরনো এগনো বেরিয়ে_যাওয়া পার_হওয়া টেক্কা_দেওয়া টপকে_যাওয়া বেরনো বের_করে_দেওয়া বহিষ্কার_করা বরখাস্ত_করা তাড়িয়ে_দেওয়া বেরনো বের_হওয়া বেরনো বের_করা বের_করা তুলে_আনা
निकाल्नु_फेला_पार्नु: বেরনো বের_করা পাকড়ানো
निकाल्‍नु: বেরনো বেরতে_থাকা নির্গত_হওয়া নিসৃতঃ_হওয়া বেরনো বের_হওয়া নিয়ে_যাওয়া
निक्लिनु: যাওয়া চলা প্রস্থান_করা গমন_করা যাত্রা_করা ওঠা উঠা মোছা চলা তোলা বেরোনো বেরোতে_থাকা বেরিয়ে_আসা বেরনো বেরিয়ে_আসা
निचोर्नु: টেপা চাপ_দেওয়া দাবা দাবানো
निधन_हुनु: মরা মারা_যাওয়া প্রাণ_হারান পরোলোকগমন_করা প্রাণত্যাগ_করা
निफन्नु: কাটা বাছা বাদ_দেওয়া পরিষ্কার_করা ছাঁটা
निभाउनु: নেভানো বোজানো নেভানো নিভানো নেবানো নিবানো নির্বাপিত_করা নিবিয়ে_দেওয়া
निभ्नु: নেভানো বোজানো
निभ्‍नु: নেভানো
निमोठ्नु: টেপা চাপা
नियन्त्रणमा_लिनु: হাতানো কবজা_করা ছিনিয়ে_নেওয়া
निर्वाचित_गर्नु: বাছা বাছে_নেওয়া নির্বাচিত_করা
निल्नु: পান_করা খাওয়া সেবন_করা খাওয়া গেলা_করা গ্রাস_করা হজম_করা
निवास_गर्नु: থাকা বাস_করা বসবাস_করা থাকা বাস_করা বসবাস_করা
निस्कनु: ওঠা উদিত_হওয়া বেরোনো বেরোনো নির্গমন_হওয়া নির্গত_হওয়া বেরনো বের_করা আলাদা_হওয়া পৃথক_হওয়া বলা বের_করা প্রকাশ_করা ফোটা ফোটানো উচ্চারণ_করা
निस्किनु: চুঁইয়ে_পড়া বার_হওয়া ক্ষরণ_হওয়া নিঃসরণ_হওয়া বেরোনো বওয়া গড়ানো ওঠা উঠা হওয়া পড়া বেরোনো ছাড়া ছাড়া_পাওয়া বেরোনো মুক্ত_হওয়া রেহাই_পাওয়া বেরনো বেরিয়ে_আসা নির্গত_হওয়া বেরনো প্রকাশ_পাওয়া মুক্তি_পাওয়া বেরোনো বেরোতে_থাকা বেরিয়ে_আসা বেরনো বেরিয়ে_আসা বেরনো বের_করা বেরনো চলা কাটানো অতিবাহিত_করা বেরনো বেরিয়ে_যাওয়া
निहुरिनु: দাব চাপা দাবানো
पकडनु: ধরা
पकाउनु: রান্না_করা প্রস্তুত_করা আয়োজন_করা তৈরী_করা
पक्का_गर्नु: পটানো রাজী_করা ঠিক_করা নির্দিষ্ট_করা
पक्का_हुनु: পটা পাকা_হওয়া ঠিক_হওয়া স্থির_করা
पचाउनु: হজম_করা পরিপাক_করা ভোগ_করা সহ্য_করা কষ্ট_পাওয়া
पटाउना: পটানো রাজী_করা ঠিক_করা নির্দিষ্ট_করা
पटाउनु: পটা পটানো
पटिनु: পটা পটানো বনানো
पठाउनु: পাঠা পাঠানো প্রেরণ_করা রওনা_করা
पडकाउनु: পোড়া জ্বলা ফাটা
पदयात्रा_गर्नु: চলা হাটা গমন_করা যাওয়া কদম_ফেলা
परित्याग_गर्नु: ছাড়া ত্যাগ_করা পরিহার_করা বর্জন_করা পরিত্যাগ_করা
परीक्षण_गर्नु: পরখ_করা যাচা পরীক্ষা_করা বিচার_করা খতিয়ে_দেখা যাচা যাচাই_করা পরীক্ষা_করা
पर्गेल्नु: পরখ_করা যাচা পরীক্ষা_করা বিচার_করা খতিয়ে_দেখা
पर्नु: হয় হন পড়া পতিত_হওয়া পড়া অবস্থান_করা পড়া নেওয়া লাগা পাওয়া পড়া পতিত_হওয়া পড়া প্রবিষ্ট_হওয়া পড়া চিন্তা_করা মাথায়_ঘোরা ভাবা পড়া
पलाउनु: ফোটা লাগা আসা প্রস্ফুটিত_হওয়া বিকশিত_হওয়া
पलायन_हुनु: পালানো চম্পট_দেওয়া দৌড়ানো ছোটা পালিয়ে_যাওয়া
पल्टिनु: উলটা_হওয়া পাল্টে_যাওয়া উলটানো পাল্টানো উলটানো পাল্টানো
पस्नु: ঢোকা ঢুকা আসা ভেতরে_আসা দাখিল_হওয়া প্রবেশ_করা প্রবিষ্ট_হওয়া
पाइनु: জমা সঞ্চিত_হওয়া জমাট_বাঁধা স্তূপীকৃত_হওয়া
पाउनु: জন্ম_দেওয়া
पाक्नु: ফাটা
पाप्त_गर्नु: পাওয়া প্রাপ্ত_করা
पार_गर्नु: বেরনো এগনো বেরিয়ে_যাওয়া পার_হওয়া টেক্কা_দেওয়া টপকে_যাওয়া
पार्नु: ফাঁসানো ফাঁসিয়ে_দেওয়া
पालन_गर्नु: কোন_ব্যক্তি_বা_ঘটনাকে_স্মরনীয়_করে_রাখা দাগ মার্কা
पिउनु: খাওয়া শোষা টেনে_নেওয়া চাপা লুকানো হজমকরা
पिट्नु: মারা পেটা ঠেঙানো
पिन्नुु: কোটা গুঁড়োনো গুঁড়ো_করা চূর্ণ_করা
पिस्नु: কোটা গুঁড়োনো গুঁড়ো_করা চূর্ণ_করা
पीडा_बुझ्नु: বুঝা বোঁঝা জানা
पुग्नु: পৌছা পৌছানো আসা হাজির_হওয়া উপস্থিত_হওয়া লাগা আঘাত_লাগা চোট_লাগা আসা ঠেকা পৌঁছানো ছড়িয়ে_যাওয়া ছড়িয়ে_পড়া বিস্তৃত_হওয়া পৌঁছ পৌঁছা পৌঁছোনো পৌঁছ পৌঁছা পৌঁছোনো পৌছ পৌছা পৌছনো পৌছ পৌছা পৌছনো যথেষ্ট_হওয়া পর্যাপ্ত_হওয়া ভরে_যাওয়া
पुराउनु: যথেষ্ট_হওয়া পর্যাপ্ত_হওয়া ভরে_যাওয়া
पुर्नु: ভরা ভরাট_করা ভরাট_করা পূর্ণ_করা ভর্তি_করা বন্ধ_করা
पुर्याउनु: পার_করা ছাড়া পৌছানো পাঠানো প্রেরণ_করা
पुष्पित_गर्नु: ফোটানো বিকশিত_করা প্রস্ফুটিত_করা পুষ্পিত_করা কুসুমিত_করা
पृथक_हुनु: বেরনো বের_করা আলাদা_হওয়া পৃথক_হওয়া
पोखिनु: পড়া
पोलिनु: পুড়া পোড়া জ্বলা
प्रकट_हुनु: বেরোনো নির্গমন_হওয়া নির্গত_হওয়া
प्रकाशित_हुनु: বেরনো প্রকাশ_পাওয়া মুক্তি_পাওয়া
प्रचलित_हुनु: চল চলা চালু_হওয়া প্রচলন_হওয়া
प्रतिद्वन्द्विता_गर्नु: প্রতিদ্বন্দ্বিতা_করা যুঝা যোঝা যুঝা লড়া যুদ্ধ প্রতিদ্বন্দ্বিতা বিবাদ মারামারি লাঠালাঠি যুদ্ধ দ্বন্দ্ব বিবাদ
प्रतिध्वनित_हुनु: প্রতিধ্বনি_করা প্রতিধ্বনিত_করা বার_বার_ধ্বনিত_প্রতিধ্বনিত_হওয়া;
प्रदर्शन_गर्नु: দেখান দেখানো প্রদর্শন_করা দৃষ্টিগোচর_করা দৃশ্যমান_করা প্রকাশ_করা
प्रदान_गर्नु: দেওয়া প্রদান_করা
प्रबन्ध_गर्नु: সর্বরাহ_করা গতি ব্যবস্হা সুরাহা
प्रयोग_गर्नु: ব্যবহার_করা
प्रवाहित_हुनु: বওয়া বয়ে_চলা বয়ে_যাওয়া নির্গত_হওয়া প্রবাহিত_হওয়া
प्रवेश_गर्नु: ঢোকা ঢুকা আসা ভেতরে_আসা দাখিল_হওয়া প্রবেশ_করা প্রবিষ্ট_হওয়া
प्रशंसा_गर्नु: প্রশংসা_করা সুখ্যাতি_করা তারিফ_করা স্তুতি_করা বন্দনা_করা
प्रस्थान_गर्नु: চলা হাটা গমন_করা যাওয়া কদম_ফেলা যাওয়া চলা প্রস্থান_করা গমন_করা যাত্রা_করা
प्रस्फुटित_हुनु: ফোটা ফুটে_ওঠা খোলা বিকশিত_হওয়া প্রস্ফুটিত_হওয়া
प्राप्‍त_गर्नु: নেওয়া নেয়া ভার_নেওয়া গ্রহন_করা
प्रारम्भ: আরম্ভ_করা প্রবর্তন শুরু সূচনা
प्रेरण_गर्नु: পাঠা পাঠানো প্রেরণ_করা রওনা_করা
प्रेरित_गर्नु: খোলা বলা প্রকাশ_করা ব্যক্ত_করা উন্মোচন_করা খোলসা_করা
फँसाउनु: ফাঁসানো ফাঁসিয়ে_দেওয়া
फँस्नु: নিয়োগ_করা শপথ_বা_চুক্তি_দ্বারা_আবদ্ধ_হওয়া অংশগ্রহণ_করা বিজড়িত_থাকা চালানো চালু_থাকা পরিচালনা_করা
फकाउनु: পাণিপ্রার্থনা_করা প্রণয়_ভিক্ষা_করা লাভের_চেষ্টা_করা জয়ের_চেষ্টা_করা আদায়ের_চেষ্টা_করা
फडकिनु: ঝাপ_দেওয়ানো ঝাপ_মারানো
फरफराउनु: ওড়া উড়া উড্ডয়ন_করা
फर्कनु: ফেরা ফিরে_আসা আসা প্রত্যবর্তন_করা
फर्काउनु: ঘোরা বাঁকা ঘোরানো প্রবৃত্ত_করা চলা
फर्किनु: ঘুরে_যাওয়া দিক_বদলানো
फर्फराउनु: ফরফর_করা দোলানো দোলা আন্দোলিত_করা
फलाउनु: ফলানো জন্মানো
फाट्नु: ফাটা ভেঙে_যাওয়া ফুড়েঁ_ওঠা ভেদ_করা ছেদ_করা
फाम_हाल्नु: লাফিয়ে_উঠা লাফ_দেওয়া
फाल_हान्नु: লাফিয়ে_উঠা লাফ_দেওয়া
फिँजिनु: ছড়িয়ে_যাওয়া ছড়িয়ে_পড়া বিস্তৃত_হওয়া
फिर्ता_गर्नु: শোধ_করা মেটানো মিটিয়ে_দেওয়া চুকিয়ে_দেওয়া চুকানো ফেরত_দেওয়া
फिर्नु: ফেরা ফিরে_আসা আসা প্রত্যবর্তন_করা
फीका_पर्नु: ওঠা উঠা ফ্যাকাসে_হওয়া
फुकाउनु: খোলা বলা প্রকাশ_করা ব্যক্ত_করা উন্মোচন_করা
फुकाल्नु: খোলা মুক্ত_করা উন্মুক্ত_করা
फुकाल्‍नु: খোলা বের_করা আলাদা_করা
फुक्नु: ফূঁ_দেওয়া ফুঁকা ফোঁকা পোঁড়া জ্বলা জ্বালানো প্রজ্জ্বলিত_করা
फुक्‍नु: ফুঁ_দেওয়া ফুঁকা ফোঁকা ফুঁ_দেওয়া ফুঁকা ফোঁকা
फुटनु: ভাঙা টুকরো_বা_চুর্ন_করা ভেঙে_যাওয়া ফাটা ফেটে_যাওয়া বিস্ফোরণ_হওয়া ভেদ_করা ফাটা ভাঙা নষ্ট_হওয়া ফাটল_ধরা অমিল_হওয়া
फुट्नु: ফাটা ফুটা চিড়_খাওয়া টুকরো_হওয়া ভেঙে_যাওয়া খণ্ডিত_হওয়া ফাটা ভেঙে_যাওয়া ফুড়েঁ_ওঠা ভেদ_করা ছেদ_করা বলা বের_করা প্রকাশ_করা ফোটা ফোটানো উচ্চারণ_করা
फुर्ती_हुनु: উচ্ছসিত_হওয়া আনন্দে_ভরে_যাওয়া মত্ত_হওয়া
फुलाउनु: ফোটানো বিকশিত_করা প্রস্ফুটিত_করা পুষ্পিত_করা কুসুমিত_করা
फुल्नु: ফোটা ফুটে_ওঠা খোলা বিকশিত_হওয়া প্রস্ফুটিত_হওয়া ফোটা লাগা আসা প্রস্ফুটিত_হওয়া বিকশিত_হওয়া ফুলে_যাওয়া ফোলা ফুলে_ওঠা ফাঁপা স্ফীত_হওয়া
फुस्ल्याउनु: পথভ্রষ্ট_করা ভুল_পথে_পরিচালিত_করা পাণিপ্রার্থনা_করা প্রণয়_ভিক্ষা_করা লাভের_চেষ্টা_করা জয়ের_চেষ্টা_করা আদায়ের_চেষ্টা_করা
फैलाउनु: রটা চাউর_করা পাঁচকান_করা ওড়া ছড়া বলা রাষ্ট্র্_করা
फैलिनु: চড়া ঘনিয়ে_আসা ছড়িয়ে_যাওয়া ছড়িয়ে_পড়া বিস্তৃত_হওয়া
फ्याँक्नु: ফেলা ফেলে_দেওয়া পড়া পড়ে_যাওয়া
फ्याक्नु: ফেলা ফেলে_দেওয়া
बगेर_जानु: ভেসে_যাওয়া
बग्नु: ভেসে_যাওয়া বেরোনো বওয়া গড়ানো বওয়া বয়ে_চলা বয়ে_যাওয়া নির্গত_হওয়া প্রবাহিত_হওয়া
बचाउनु: বাঁচানো রাখা জমা জমানো জমিয়ে_রাখা
बच्‍नु: বাঁচা বেঁচে_যাওয়া রক্ষা_পাওয়া পরিত্রাণ_পাওয়া ত্রাণ_পাওয়া সামলা সামলানো বাচা বাচানো
बजाउनु: বাজা বাজানো
बज्नु: বলা শব্দ_করা আওয়াজ_করা
बटार्नु: মোলা মোড়া ঘোরা ঘোরানো
बडाँई_गर्नु: প্রশংসা_করা সুখ্যাতি_করা তারিফ_করা স্তুতি_করা বন্দনা_করা
बढनु: চড়া চড়ে_যাওয়া উঁচু_হওয়া বাড়া বেড়ে_যাওয়া ওঠা বাড়া বৃদ্ধি_পাওয়া বাড়ানো
बढाउनु: বাড়া বাডানো লম্বা_করা বাড়া বাড়ানো বৃদ্ধি_করা বাড়া বাড়ানো
बढार्नु: ঝাড়া
बढ्नु: বাড়া বৃদ্ধি_পাওয়া বেড়ে_ওঠা
बताउनु: বলা জানানো সুচিত_করা শিক্ষা_দেওয়া বলা নির্দেশিত_করা দেখা দেখানো বলা জানানো প্রকাশ_করা নেওয়া ফাঁস_করা ব্যক্ত_করা উল্লেখ_করা
बदलिनु: বদলী_হওয়া স্থানান্তরিত_হওয়া
बनाउनु: ছাপা ছাপানো টানা আঁকা আকার_বানানো
बनिएको_हुनु: অন্তর্ভুক্ত_করা অংশ_সহযোগে_গঠিত_হওয়া গঠিত_হওয়া
बनिनु: বানানো নির্মাণ_করা অন্তর্ভুক্ত_করা অংশ_সহযোগে_গঠিত_হওয়া গঠিত_হওয়া ওঠা উঠা তৈরি_হওয়া বানানো গাঁথা তোলা
बन्द_गर्नु: রদ_করা ওঠা উঠা মেটানো তোলা দূরীকরণ_করা উচ্ছেদ_করা নির্মূল_করা থামা থামানো বন্ধ_করা রোধ_করা উচ্ছেদ_করা নেভানো নিভানো নেবানো নিবানো নির্বাপিত_করা নিবিয়ে_দেওয়া
बन्द_हुनु: নিয়োগ_করা শপথ_বা_চুক্তি_দ্বারা_আবদ্ধ_হওয়া অংশগ্রহণ_করা বিজড়িত_থাকা চালানো চালু_থাকা পরিচালনা_করা নেভানো বোজানো ভাঙা বন্ধ_হওয়া থামা বিরত_হওয়া
बर्ताव_गर्नु: করা আচরণ_করা ব্যবহার_করা
बर्बाद_गर्नु: নষ্ট_করা বরবাদ_করা খাওয়া
बर्सिनु: জলপ্রপাতের_মত_নেমে_আসা
बसाउनु: চড়া চড়ানো চাপানো বসা বসানো বসিয়ে_দেওয়া বসা বসানো বহাল_করা অধিষ্ঠান_করা সওয়ারি_করা বসা চড়া চড়া চাপা তোলা ওঠা উঠা স্থান_দেওয়া প্রতিষ্ঠা_করা যায়গা_দেওয়া বসানো বসা লাগা
बसोबास_गर्नु: থাকা বাস_করা বসবাস_করা
बस्नु: বসা আসন_গ্রহন_করা বিরাজমান_হওয়া জমা আটকে_পড়া বসে_যাওয়া থাকা বাস_করা বসবাস_করা থাকা বসা চলে_যাওয়া বসা বসে_যাওয়া হটে_যাওয়া উঠিয়ে_নেওয়া সরে_যাওয়া বসে_থাকা বেকার_থাকা বেরোজগার_থাকা আশ্রয়_নেওয়া কাটানো থাকা পড়া পড়ে_থাকা থাকা বাস_করা বসবাস_করা বসা আবাদহওয়া বসা বসে_যাওয়া বসা লাগা বসে_যাওয়া
बहकाउनु: চড়া উত্তেজিত_করা উসকানো প্ররোচনা_দেওয়া ভড়কানো
बहनु: বওয়া বয়ে_চলা বয়ে_যাওয়া নির্গত_হওয়া প্রবাহিত_হওয়া
बहुसङ्खयक: অধীন_হওয়া
बाँकी_रहनु: বেঁচে_যাওয়া
बाँच्नु: বাঁচা জীবনযাবনকরা জীবনধারনকরা অস্তিত্ববজায়রাখা জীবিতথাকা
बाँड्नु: পরিবেশন_করা দেওয়া
बाँधिनु: ফাঁসা
बाच्नु: বেঁচে_যাওয়া
बाट्नु: বিলি_করা
बातचित_गर्नु: বলা কওয়া বাক্যালাপ_করা কথোপকথন_করা কথাবার্তা_বলা
बाधादिनु: আটকানো প্রতিহত_করা রোধ_করা
बाधित_हुनु: নিয়োগ_করা শপথ_বা_চুক্তি_দ্বারা_আবদ্ধ_হওয়া অংশগ্রহণ_করা বিজড়িত_থাকা চালানো চালু_থাকা পরিচালনা_করা
बानी_पार्नु: বসা পাকা পাকানো জমা জমানো অভ্যস্থ_করা
बाफ_बनिनु: বাষ্পিত_হওয়া জ্বলা
बाल्नु: ফুঁকা ফোঁকা পোঁড়া জ্বলা জ্বালানো প্রজ্জ্বলিত_করা জ্বালা জ্বালানো প্রজ্জ্বলিত_করা প্রদীপন_করা
बाहिर_आउनु: বেরনো বেরিয়ে_আসা নির্গত_হওয়া
बिउँझाउनु: কাজে_লাগা খরচ_করা ব্যয়_করা খরচা_করা
बिक्नु: বিক্রি_হওয়া বিকা উঠা বেরোনো বের_হওয়া চলা প্রতিপত্তি_থাকা আধিপত্য_থাকা
बिक्री_गर्नु: বেচা বিক্রয়_করা
बिक्री_हुनु: বিক্রি_হওয়া বিকা উঠা বেরোনো বের_হওয়া
बिगार्नु: বিগড়ানো বিগড়নো খারাপ_করা বারোটা_বাজানো নষ্ট_করা বিগড়ানো বিগড়নো খারাপ_করা বারোটা_বাজানো নষ্ট_করা বিগড়ানো বিগড়নো খারাপ_করা বারোটা_বাজানো নষ্ট_করা বিগড়ানো বিগড়নো খারাপ_করা বারোটা_বাজানো নষ্ট_করা বিগড়ানো বিগড়নো খারাপ_করা বারোটা_বাজানো নষ্ট_করা
बिग्रिनु: ডুবে_যাওয়া বসে_যাওয়া নষ্ট_হওয়া ভাঙা নষ্ট_হওয়া ছেদ_পড়া শেষ_হওয়া ভাঙা ধ্বংস_হওয়া বিনষ্ট_হওয়া
बिदाहुनु: শেষ_হওয়া ছুটি_হওয়া সমাপ্ত_হওয়া সাঙ্গ_হওয়া
बिराजनु: বসা আসন_গ্রহন_করা বিরাজমান_হওয়া
बिराजमान_हुनु: বসা আসন_গ্রহন_করা বিরাজমান_হওয়া
बिर्साउनु_घुमाउनु: ঘোরা ভোলানো
बुझाउनु: বোঝানো বুঝানো সমঝানো সমজানো বোধ_করানো বোঝা বোধগম্য_হওয়া বুঝতে_পারা বলা বোঝা বোঝানো
बुझ्नु: বুঝা বোঁঝা জানা বোঝা জানা চেনা চিনতে_পারা বুঝতে_পারা উপলবদ্ধি_করা
बुताउनु: নেভানো নিভানো নেবানো নিবানো নির্বাপিত_করা নিবিয়ে_দেওয়া
बुत्नु: নেভানো বোজানো
बुनाउनु: বসা বসানো আসনগ্রহণ_করানো বসতে_বলা
बुन्न_लगाउनु: বসা বসানো আসনগ্রহণ_করানো বসতে_বলা
बृद्दि_हुनु: বাড়া বৃদ্ধি_পাওয়া বেড়ে_ওঠা
बेइलमी_हुनु: বসে_থাকা বেকার_থাকা বেরোজগার_থাকা
बेचबिखान_गर्नु: বেচা বিক্রয়_করা
बेच्नु: বেচা বিক্রয়_করা
बेपत्ता_हुनु: পালানো চম্পট_দেওয়া দৌড়ানো ছোটা পালিয়ে_যাওয়া উড়ে_যাওয়া হাওয়া_হওয়া গায়েব_হওয়া বেপাত্তা_হওয়া অদৃশ্য_হওয়া নিরুদ্দেশ_হওয়া
बेरा_लाउनु: ওঠা তোলা গাঁথা তৈরি_করা নির্মাণ_করা রচনা_করা
बेरोजगार_रहनु: বসে_থাকা বেকার_থাকা বেরোজগার_থাকা
बेर्नु: ঘেরা ঘিরা
बोल्नु: বলা কওয়া ভাষণ_দেওয়া বক্তব্য_রাখা বিবৃতি_দেওয়া বক্তৃতা_দেওয়া বলা কওয়া বাক্যালাপ_করা কথোপকথন_করা কথাবার্তা_বলা বলা কওয়া শোনা খোঁটা_দেওয়া ঠেস_দেওয়া বাঁকা_কথা_বলা হাঁকা বলা কওয়া বাধা_দেওয়া বাগড়া_দেওয়া ব্যাঘাত_সৃষ্টি_করা বলা কওয়া উল্লেখ_করা উচ্চারণ_করা আওড়ানো নাম_জপা বলা জানানো প্রকাশ_করা নেওয়া ফাঁস_করা ব্যক্ত_করা উল্লেখ_করা বলা
बोल्‍नु: বলা ডাকা বলা কওয়া বাক্য_বিনিময়_করা বাক্যালাপ_করা
ब्युझनु: ওঠা উঠা জাগা ঘুম_ভাঙা নিদ্রাভঙ্গ_হওয়া চোখ_মেলা
ब्युझिनु: ওঠা উঠা জাগা ঘুম_ভাঙা নিদ্রাভঙ্গ_হওয়া চোখ_মেলা
भकभक_गर्नु: বসা বসিয়ে_দেওয়া নস্ট_করা ডকে_ওঠানো
भगाउनु: তাড়া_করা ধাওয়া_করা পশ্চাধাবন_করা
भडकाउनु: চড়া উত্তেজিত_করা উসকানো প্ররোচনা_দেওয়া ভড়কানো
भनाइ_राख्‍नु: বলা কওয়া ভাষণ_দেওয়া বক্তব্য_রাখা বিবৃতি_দেওয়া বক্তৃতা_দেওয়া
भनिनु: নাম_দেওয়া নামকরণ_করা
भन्नु: বলা কওয়া ভাষণ_দেওয়া বক্তব্য_রাখা বিবৃতি_দেওয়া বক্তৃতা_দেওয়া বলা জানা জানানো বলা জানানো সুচিত_করা শিক্ষা_দেওয়া বলা কওয়া শোনা খোঁটা_দেওয়া ঠেস_দেওয়া বাঁকা_কথা_বলা বলা নির্দেশিত_করা দেখা দেখানো বলা কথা_দেওয়া অঙ্গীকার_করা প্রতিশ্রুতি_দেওয়া জবান_দেওয়া বলা শোনা শোনানো বলা কওয়া ডাকা সম্বোধন_করা সম্ভাষণ_করা বলা শোনা আবৃত্তি_করা শোনানো বলা কওয়া উল্লেখ_করা উচ্চারণ_করা আওড়ানো নাম_জপা বলা জানানো প্রকাশ_করা নেওয়া ফাঁস_করা ব্যক্ত_করা উল্লেখ_করা
भयभीत_हुनु: দাবানো
भराइनु: চড়া চড়ানো ভরা
भराउनु: ভরা ভরাট_করা চড়া ভরা বোঝাই_করা রাখা চাপা
भरिनु: ভাড়া_দেওয়া কেরায়া_দেওয়া রেন্ট_দেওয়া বসা আবাদহওয়া ভরা পূর্ণ_করা ভরতি_করা পোরা
भाँच्नु: টুকরো_করা ভাঙ্গা কাটা
भाउ_बढनु: চড়া বাড়া আকাশচুম্বি_হওয়া
भाग्नु: পালানো চম্পট_দেওয়া দৌড়ানো ছোটা পালিয়ে_যাওয়া পালানো পালিয়ে_যাওয়া ভাগা ভেগে_পড়া কেটে_পড়া চম্পট_দেওয়া পিটটান_দেওয়া পৃষ্ঠপ্রদর্শন_করা
भाडा_गर्नु: করা নেওয়া
भाडामा_लिनु: ভাড়া_করা ভাড়া_নেওয়া
भारी_बोकाउनु: ঘাড়ে_চাপানো দেওয়া
भाषण_दिनु: বলা কওয়া ভাষণ_দেওয়া বক্তব্য_রাখা বিবৃতি_দেওয়া বক্তৃতা_দেওয়া
भिड्नु: প্রতিদ্বন্দ্বিতা_করা যুঝা যোঝা যুঝা লড়া যুদ্ধ প্রতিদ্বন্দ্বিতা বিবাদ মারামারি লাঠালাঠি যুদ্ধ দ্বন্দ্ব বিবাদ
भित्र_जानु: ঢোকা ঢুকা আসা ভেতরে_আসা দাখিল_হওয়া প্রবেশ_করা প্রবিষ্ট_হওয়া
भिन्दै_हुनु: খোলা খুলে_যাওয়া বেরোনো পৃথক_হওয়া আলাদা_হওয়া বেরনো বের_করা আলাদা_হওয়া পৃথক_হওয়া
भिर्नु: পড়া পরিধান_করা
भुल्नु: কোনো_বিশেষ_গন্তব্য_ছাড়া_হাঁটা কোনো_উদ্দেশ্য_ছাড়া_ঘুরে_বেড়ানো
भेट_गर्न_जानु: চড়া চাঁটা থাপ্পর_মারা থাবড়া চাঁটি_মারা চাপড়_মারা
भेटाइनु: জমা সঞ্চিত_হওয়া জমাট_বাঁধা স্তূপীকৃত_হওয়া
भेटाउनु: পৌছ পৌছা পৌছনো
भेटिनु: পড়া অবস্থান_করা
भेला_हुनु: জমা জড়ো_হওয়া একত্র_হওয়া একত্রিত_হওয়া সমবেত_হওয়া
भोग्‍नु: অনুভব_করা উপলব্ধি_করা অভিঞ্জতা_লাভ_করা
भोजन_गराउनु: খাওয়ানো ভোজন_করানো
भोजन_गर्नु: খাওয়া ভোজন_করা আহার_করা
भोजन_तयार_पार्नु: রান্না_করা প্রস্তুত_করা আয়োজন_করা তৈরী_করা
भौँतारिनु: কোনো_বিশেষ_গন্তব্য_ছাড়া_হাঁটা কোনো_উদ্দেশ্য_ছাড়া_ঘুরে_বেড়ানো
मच्चिनु: প্রবর্তন_করা আরম্ভ শুরু চালু সূচনা
मज्जको_हुनु: জমা সরগরম_হওয়া উপভোগ্য_হওয়া
मथ्नु: মন্থন_করা
मन_पराउनु: বেছে_নেওয়া আলাদা_করা নির্বাচন_করা বের_করা পছন্দ_করা
मनाउनु: পাণিপ্রার্থনা_করা প্রণয়_ভিক্ষা_করা লাভের_চেষ্টা_করা জয়ের_চেষ্টা_করা আদায়ের_চেষ্টা_করা
मनाही_गर्नु: আটকানো প্রতিহত_করা রোধ_করা
मर्नु: মরা মারা_যাওয়া প্রাণ_হারান পরোলোকগমন_করা প্রাণত্যাগ_করা নেভানো মরা মরে_যাওয়া হ্রাস_পাওয়া লুপ্ত_হওয়া মরা মরে_যাওয়া পরিশ্রম_করা কষ্ট_করা আউট_করা_বা_হওয়া কাটা
मस्त_हुनु: উচ্ছসিত_হওয়া আনন্দে_ভরে_যাওয়া মত্ত_হওয়া
मात्‍नु: চড়া টানা সেবন_করা পান_করা
मान्नु: মানা মান্য_করা মেনে_চলা স্বীকার_করা রাজী_হওয়া মনে_করা ভাবা বোঝা মানা সন্মান_করা মানা মানা বিশ্বাস_করা
मार्नु: খুন_করা মারা হত্যা_করা বধ_করা প্রাণ_নেওয়া সংহার_করা মার্ডার_করা
मिलन: সংযোজন_করা জোড়া_দেওয়া মিলিত_করা সংযোগ_করা বাঁধা মিলন_করা মেশা যোগ_করা
मिलन_हुनु: সংযোজন_করা জোড়া_দেওয়া মিলিত_করা সংযোগ_করা বাঁধা মিলন_করা মেশা যোগ_করা
मिलाप_हुनु: জমা বনাবনি_হওয়া মিলমিশ_হওয়া বনিবনা_হওয়া পটা মনের_মিল_হওয়া
मिल्नु: খোলা মেলা জাহির_করা সঙ্কোচ_ত্যাগ_করা চরতার্থ_হওয়া ঘটনা
मिसिनु: মিশা মেশা মিশে_যাওয়া মিশ্রিত_হওয়া গুলে_যাওয়া
मुक्‍त_गराउनु: ছাড়া দোষ_মুক্ত_করা অপরাধ_মুক্ত_করা রেহাই_করা খালাস_করা
मुक्‍त_गरिदिनु: খোলা ছাড়া স্বাধীন_করা মুক্ত_করা উন্মুক্ত_করা
मुक्‍त_हुनु: খোলা মুক্ত_করা উন্মুক্ত_করা উন্মোচন_করা স্বাধীন_করা
मुक्‍तहुनु: ছাড়া ছাড়া_পাওয়া বেরোনো মুক্ত_হওয়া রেহাই_পাওয়া
मुद्रण_गर्नु: ছাপানো মুদ্রণ_করা
मुसार्नु: মোলা মোড়া ঘোরা ঘোরানো
मूल्य_बढनु: চড়া বাড়া আকাশচুম্বি_হওয়া
मृत्यु_हुनु: মরা মারা_যাওয়া প্রাণ_হারান পরোলোকগমন_করা প্রাণত্যাগ_করা
मेटाउनु: ছাড়া ছাড়ি ছাড়ানো সরা হটা অপসরণ_করা তাড়ানো দূর_করা
मेटिनु: মরা মরে_যাওয়া হ্রাস_পাওয়া লুপ্ত_হওয়া
मेट्नु: ওঠা উঠা মোছা চলা তোলা
मेल_हुनु: জমা বনাবনি_হওয়া মিলমিশ_হওয়া বনিবনা_হওয়া পটা মনের_মিল_হওয়া
मोर्नु: লাগানো আটকানো বাঁধা জোড়া বসা মোড়া মুড়া মুড়ানো মোড়ানো
मोहनी_लाउनु: আকৃষ্ট_করা মুগ্ধ_করা
मोहर_लगाउनु: মুদ্রণ_করা সীলমোহর_লাগানো মোহর_লাগানো ছাপ_মারা
मोहित_पार्नु: আকৃষ্ট_করা মুগ্ধ_করা
म्वाइँ: চুম্বন_করা চুমা_দেওয়া চুমু_খাওয়া
युद्ध_गर्नु: লড়াই_করা যুদ্ধ_করা
रङ्गाऊनु: রং_করা রঙ_করা বর্ণন বর্ণনা রঞ্জা রঞ্জিত
रङ्नु: রং_করা রঙ_করা বর্ণন বর্ণনা রঞ্জা রঞ্জিত
रचना_गर्नु: গঠিত_হওয়া গড়ে_ওঠা রচনা_করা লেখা লিখা গ্রন্থন_করা
रच्नु: রচনা_করা লেখা লিখা গ্রন্থন_করা ষড়যন্ত্র_করা চক্রান্ত_করা সাট_করা
रमाइलो_हुनु: জমা সরগরম_হওয়া উপভোগ্য_হওয়া
रवाना_हुनु: যাওয়া চলা প্রস্থান_করা গমন_করা যাত্রা_করা
रहनु: টেঁকা টিঁকে_থাকা চলা স্থায়ী_হওয়া অবশিষ্ট_থাকা রয়ে_যাওয়া থেকে_যাওয়া থাকা থাকা ভালো_থাকা থাকা বাঁচা থেকে_যাওয়া রয়ে_যাওয়া
राख्नु: উপস্থাপন_করা উপস্থিত_করা রাখা পেশ_করা দাখিল_করা
राख्‍नु: চড়া চড়ানো চাপানো বসা বসানো বহাল_করা অধিষ্ঠান_করা রাখা পোষণ_করা পুষে_রাখা রাখা রক্ষণা-বেক্ষণ_করা বাঁচানো রাখা জমা জমানো জমিয়ে_রাখা
राजी_हुनु: স্বীকার_করা রাজী_হওয়া
राम्रो_हुनु: জমা সরগরম_হওয়া উপভোগ্য_হওয়া
रिँगाउनु: ঘুরা ঘোরা ঘোরানো পাক_খাওয়া
रिझाउनु: আকৃষ্ট_করা মুগ্ধ_করা
रिहा_हुनु: ছাড়া ছাড়া_পাওয়া বেরোনো মুক্ত_হওয়া রেহাই_পাওয়া
रुमलिनु: ফাঁসা
रोकिनु: নিয়োগ_করা শপথ_বা_চুক্তি_দ্বারা_আবদ্ধ_হওয়া অংশগ্রহণ_করা বিজড়িত_থাকা চালানো চালু_থাকা পরিচালনা_করা থামা দাঁড়া দাঁড়ানো ভাঙা বন্ধ_হওয়া থামা বিরত_হওয়া থামা ভাঙা নষ্ট_হওয়া ছেদ_পড়া
रोक्नु: রদ_করা ওঠা উঠা মেটানো তোলা দূরীকরণ_করা উচ্ছেদ_করা নির্মূল_করা আটকানো প্রতিহত_করা রোধ_করা থামা থামানো বন্ধ_করা রোধ_করা উচ্ছেদ_করা
रोक्‍नु: রাখা সংরক্ষা_করা সংরক্ষণ_করা
रोज्नु: বেছে_নেওয়া আলাদা_করা নির্বাচন_করা বের_করা পছন্দ_করা
रोप्‍नु: লাগা পোঁতা রোপন_করা রোয়া চারা_লাগান
लगाउनु: জোড়া সাঁটা সাটাঁনো যুক্ত_করা লাগানো আঁটা পড়া পরিধান_করা বিছানো ঢালা ছাড়া তাড়া ধাওয়া পিছু_লাগা লাগা বসা লাগানো মাখানো লাগানো আটকানো বাঁধা জোড়া বসা লাগা জোড়া মারা সেলাই_করা সাঁটা লাগা পোঁতা রোপন_করা রোয়া রাখা থামা লাগা ভেড়া ভিড়া কাজে_লাগা খরচ_করা ব্যয়_করা খরচা_করা পড়া লাগা নেওয়া ধারণ_করা লাগা মাখা প্রলেপ_দেওয়া লেপা দেওয়া লাগা আরোপ_করা চাপানো বসা লাগা
लट्ठ_पार्नु: নাচানো দোলানো
लडनु: ভেঙে_পড়া ভূপাতিত_হওয়া
लडाइँ_गर्नु: লড়াই_করা যুদ্ধ_করা
लड्नु: প্রতিদ্বন্দ্বিতা_করা যুঝা যোঝা যুঝা লড়া যুদ্ধ প্রতিদ্বন্দ্বিতা বিবাদ মারামারি লাঠালাঠি যুদ্ধ দ্বন্দ্ব বিবাদ পড়া পড়ে_থাকা
लागिरहनु: করা লেগে_থাকা
लाग्नु: লাগা খরচ_হওয়া ব্যয়_হওয়া চলা বহা বয়ে_চলা লাগা আঘাত_লাগা চোট_লাগা লাগা মনে_হওয়া অনুভব_করা বোধ_হওয়া টের_পাওয়া মালুম_হওয়া চড়া চড়ানো উপর্য্যুপরি_লাগানো পড়া পতিত_হওয়া পড়া প্রবিষ্ট_হওয়া পড়া বসা লাগা বসে_যাওয়া দাগ_লাগা ছোপ_পড়া ছাপ_পড়া
लाग्‍नु: লাগা মনে_হওয়া টের_পাওয়া মালুম_হওয়া আসা ঠেকা পৌঁছানো পড়া লাগা ধরা নেশা_ধরা
लाद्नु: ঘাড়ে_চাপানো দেওয়া
लानु: নেওয়া নেয়া
लामो_पार्नु: বাড়া বাডানো লম্বা_করা
लिनु: নেওয়া নেয়া গ্রহন_করা করা নেওয়া নেওয়া নেয়া ভার_নেওয়া গ্রহন_করা ধরা নেওয়া নেয়া ধরা নেওয়া নেয়া
लुकाउनु: চাপা চেপে_দেওয়া ঢোকা ঢোকানো গাড়া পোতা রাখা রেখে_দেওয়া আটকানো চেপে_রাখা চাপা
लुक्नु: দাবানো দমানো
लुटनु: লোটা লোটন লুটে_নেওয়া খরচ_করান
लुट्नु: আকৃষ্ট_করা মুগ্ধ_করা
लुट्‍नु: লুটা লুঠা লুন্ঠন_করা
लुते_हुनु: ভাঙা দুর্বল_হওয়া অশক্ত_হওয়া ক্ষীণ_হওয়া বলহীন_হওয়া কমজোরি_হওয়া
लेख्नु: রচনা_করা লেখা লিখা গ্রন্থন_করা
लेख्‍नु: লেখা লিপিবদ্ধ_করা টোকা নোট_করা
लेप_लगाउनु: লাগা মাখা প্রলেপ_দেওয়া লেপা
लोभ्याउनु: আকৃষ্ট_করা মুগ্ধ_করা
ल्याउनु: বসা রাখা স্বীকার_করা নিয়ে_আসা লাগা
वक्तव्य_दिनु: বলা কওয়া ভাষণ_দেওয়া বক্তব্য_রাখা বিবৃতি_দেওয়া বক্তৃতা_দেওয়া
वध_गर्नु: খুন_করা মারা হত্যা_করা বধ_করা প্রাণ_নেওয়া সংহার_করা মার্ডার_করা
वशमा_पार्नु: হাতানো কবজা_করা ছিনিয়ে_নেওয়া
वार्तालाप_गर्नु: বলা কওয়া বাক্যালাপ_করা কথোপকথন_করা কথাবার্তা_বলা
विकसित_गर्नु: বাড়া বাড়ানো
विचार_गर्नु: চিন্তা_করা বিচার_করা বিবেচনা_করা ভাবা
वितरण_गर्नु: পরিবেশন_করা দেওয়া
विश्राम_गर्नु: ঘুমানো নিদ্রিত_হওয়া ঘুমিয়ে_পড়া
विस्तृत_हुनु: ছড়িয়ে_যাওয়া ছড়িয়ে_পড়া বিস্তৃত_হওয়া
व्यय_हुनु: লাগা খরচ_হওয়া ব্যয়_হওয়া
व्यवस्था_गर्नु: সর্বরাহ_করা গতি ব্যবস্হা সুরাহা
व्यवहार_गर्नु: ব্যবহার_করা করা আচরণ_করা ব্যবহার_করা
व्यस्त_हुनु: লাগা নিযুক্ত_থাকা ব্যস্ত_থাকা লেগে_থাকা
शक्‍तिहीन_हुनु: ভাঙা দুর্বল_হওয়া অশক্ত_হওয়া ক্ষীণ_হওয়া বলহীন_হওয়া কমজোরি_হওয়া
शब्द_गर्नु: বলা শব্দ_করা আওয়াজ_করা
शान्न_गर्नु: থামা থামানো চাপা শান্ত_রাখা
शिक्षा_दिनु: শিক্ষা_দেওয়া
शिथिल_हुनु: ক্লান্ত_হওয়া
शोभान्वित_हुनु: শোভমান শোভাযুক্ত_হওয়া শোভাদানকারী শোভী শোভাদায়ক রাজিত বিরাজিত বিরাজমান
शोभायमान_हुनु: শোভমান শোভাযুক্ত_হওয়া শোভাদানকারী শোভী শোভাদায়ক রাজিত বিরাজিত বিরাজমান
शोभित_हुनु: শোভমান শোভাযুক্ত_হওয়া শোভাদানকারী শোভী শোভাদায়ক রাজিত বিরাজিত বিরাজমান
शोषण_गर्नु: শুষা শোষা শোষণ_করা নিষ্পেষণ_করা চুষা চোষা
श्रवण_गर्नु: শোনা শ্রবণ_করা
श्रीगणेश: আরম্ভ_করা প্রবর্তন শুরু সূচনা
सकिनु: রদ_করা ওঠা উঠা দূরীকরণ_করা নির্মূল_করা
सक्नु: কোনো_কিছু_করতে_পারা
सक्‍नु: কাজে_লাগা খরচ_করা ব্যয়_করা খরচা_করা
सङ्गम_हुनु: সংযোজন_করা জোড়া_দেওয়া মিলিত_করা সংযোগ_করা বাঁধা মিলন_করা মেশা যোগ_করা
सङ्ग्राम_गर्नु: লড়াই_করা যুদ্ধ_করা
सङ्लग्न_हुनु: লাগা জোড়া আটকা যুক্ত_করা সাঁটা
सजाउनु: সাজা সাজানো লাগা লাগানো ব্যবস্থা_করা
सजिसजाउ_गर्नु: সাজা সাজানো লাগা লাগানো ব্যবস্থা_করা
सन्तुष्ट_हुनु: তৃপ্ত_করা পরিতৃপ্ত_করা
सफा_गर्नु: ঝাড়া ধোয়া পরিষ্কার_করা কাচা
समात्‍नु: ধরা নেওয়া নেয়া ধরা
समाप्‍त_हुनु: রদ_করা ওঠা উঠা দূরীকরণ_করা নির্মূল_করা ভাঙা বন্ধ_হওয়া শেষ_হওয়া থামা বিরত_হওয়া
सम्झाउनु: বোঝানো বুঝানো সমঝানো সমজানো বোধ_করানো বুঝতে_পারা বলা বোঝা বোঝানো
सम्झिनु: মনে_করা ভাবা বোঝা
सम्भार_गर्नु: সামলানো
सम्याउनु: ভরাট_করা পূর্ণ_করা ভর্তি_করা বন্ধ_করা
सम्हालनु: সামলানো
सम्हालिनु: সামলা সামলানো বাচা বাচানো সামলা সামলানো রক্ষা
सम्हाल्नु: সামলা সামলানো রোধ_করা সামলা সামলানো সংবরা সংবরণ_করা সামলা সামলানো সংবরণ_করা রোধ_করা রক্ষা_করা উত্তীর্ণ__হওয়া সামলা সামলানো রক্ষা_করা
सम्हाल्‍नु: সামলানো
सल्काउनु: ফুঁকা ফোঁকা পোঁড়া জ্বলা জ্বালানো প্রজ্জ্বলিত_করা জ্বালা জ্বালানো প্রজ্জ্বলিত_করা প্রদীপন_করা
सहमत_हुनु: স্বীকার_করা রাজী_হওয়া
साँगुरो_पार्नु: পৌছা পৌছল আসা হাজির_হওয়া উপস্থিত_হওয়া
साँघुरो_पार्नु: পৌছা পৌছল আসা হাজির_হওয়া উপস্থিত_হওয়া
साँचो_हुनु: বেরনো প্রমাণিত_হওয়া
साङ्ग्रो_पार्नु: পৌছা পৌছল আসা হাজির_হওয়া উপস্থিত_হওয়া
साबित_हुनु: বেরনো প্রমাণিত_হওয়া
सार्नु: ঢালা রাখা
सिँचनु्: জল_দেওয়া সেচ_দেওয়া ভিজানো জলসিক্ত_করা
सिउँनु: সেলাই_করা
सिकाउनु: বোঝা বোধগম্য_হওয়া শিক্ষা_দেওয়া
सिलाउनु: সেলাই_করা
सुँइकुच्चा_ठोक्नु: পালানো চম্পট_দেওয়া দৌড়ানো ছোটা পালিয়ে_যাওয়া
सुइँकुच्चा_ठोक्‍नु: পালানো পালিয়ে_যাওয়া ভাগা ভেগে_পড়া কেটে_পড়া চম্পট_দেওয়া পিটটান_দেওয়া পৃষ্ঠপ্রদর্শন_করা
सुकाउनु: শুখানো শুষ্ক_করা
सुकेर_जानु: বাষ্পিত_হওয়া জ্বলা
सुत्‍नु: ঘুমানো নিদ্রিত_হওয়া ঘুমিয়ে_পড়া শুয়ে_পড়া পড়া পড়ে_থাকা
सुनाउनु: বলা জানা জানানো বলা কওয়া শোনা খোঁটা_দেওয়া ঠেস_দেওয়া বাঁকা_কথা_বলা বলা শোনা শোনানো বলা শোনা আবৃত্তি_করা শোনানো
सुन्निनु: ফুলে_যাওয়া
सुन्नु: শোনা শ্রবণ_করা
सुम्पनु: সঁপা দেওয়া অর্পণ_করা ছাড়া
सुम्पिनु: সঁপা দেওয়া অর্পণ_করা ছাড়া
सुरक्षित_राख्‍नु: সামলানো
सुरु: আরম্ভ_করা প্রবর্তন শুরু সূচনা
सुरु_हुनु: খোলা খুলে_যাওয়া চালু_হওয়া প্রচলিত_হওয়া
सूचना_दिनु: বলা জানানো সুচিত_করা
सृजना_गर्नु: গঠিত_হওয়া গড়ে_ওঠা
सृष्टि_गर्नु: গঠিত_হওয়া গড়ে_ওঠা
सेलाउनु: নেভানো
सेवन_गर्नु: খাওয়া পান_করা নেওয়া নেয়া সেবন_করা
सोच्नु: চিন্তা_করা বিচার_করা বিবেচনা_করা ভাবা
सोच्‍नु: মনে_করা ভাবা বোঝা
स्थानान्तरित_हुनु: বদলী_হওয়া স্থানান্তরিত_হওয়া
स्पर्ष_गर्नु: লাগা স্পর্শ_করা ঠেকা ছোঁয়া
स्वाट्ट_पार्नु: ভাবা চিন্তা_করা চিন্তাভাবনা_করা বিচার_করা অনুসন্ধান_করা
स्वीकार_गर्नु: স্বীকার_করা রাজী_হওয়া নেওয়া নেয়া ভার_নেওয়া গ্রহন_করা
स्वीकारनु: স্বীকার_করা রাজী_হওয়া
हजम_गर्नु: হজম_করা পরিপাক_করা ভোগ_করা সহ্য_করা কষ্ট_পাওয়া
हटनु: ছাড়া ত্যাগ_করা পরিহার_করা বর্জন_করা পরিত্যাগ_করা ওঠা উঠা মোছা চলা তোলা হটা ছাড়া যাওয়া গমন_করা রওনা_দেওয়া প্রস্থান_করা
हटाउनु: রদ_করা ওঠা উঠা মেটানো তোলা দূরীকরণ_করা উচ্ছেদ_করা নির্মূল_করা ওঠা উঠা সরা তোলা হটা স্থানচ্যূত_করা ছাড়া ছাড়ি ছাড়ানো সরা হটা অপসরণ_করা তাড়ানো দূর_করা
हट्नु: অদৃঢ় টলয়মান
हत्या_गर्नु: খুন_করা মারা হত্যা_করা বধ_করা প্রাণ_নেওয়া সংহার_করা মার্ডার_করা
हत्याउनु: হাতানো কবজা_করা ছিনিয়ে_নেওয়া
हराउनु: ফেলা ফেলে_দেওয়া পড়া পড়ে_যাওয়া চাপা হারানো উড়ে_যাওয়া হাওয়া_হওয়া গায়েব_হওয়া বেপাত্তা_হওয়া অদৃশ্য_হওয়া নিরুদ্দেশ_হওয়া মরা মরে_যাওয়া হ্রাস_পাওয়া লুপ্ত_হওয়া হারানো হারিয়ে_ফেলা হারিয়ে_যাওয়া খোয়ানো গায়েব_হওয়া মিলিয়ে_যাওয়া
हल्लाउनु: ছলকানো চলকানো ভাবাবেশে_ঘোরানো ভূতাবেশে_ঘোরানো নাড়ানো নড়ানো ঝাঁকানো ঝাঁকুনি_দেওয়া জোরে_নাড়া_দেওয়া ফরফর_করা
हल्लिनु: ছলকানো চলকানো উচ্ছলানো নড়া ঢলঢল_করা দোলানো দোলা আন্দোলিত_করা
हसुर्नु: খাওয়া ভোজন_করা আহার_করা
हाँकिनु: হাঁকা জাহির_করা প্রকাশ_করা
हाँक्नु: যানবাহন_চালানো
हाछ्यु: হাঁচা হাঁচি_আসা হাঁচি_দেওয়া
हात_पार्नु: হাতানো কবজা_করা ছিনিয়ে_নেওয়া
हान्नु: ছোঁড়া নিক্ষেপ_করা প্রয়োগ_করা চালানো চোট_লাগানো ঘা_লাগানো আঘাত_করা কথা_বলা বলা
हाम_फाल्नु: লাফিয়ে_উঠা লাফ_দেওয়া
हालिनु: তোলা লেখা অন্তর্ভূক্ত_করা লিপিবদ্ধ_করা
हाल्नु: দেয়া ঢালা ঢেলে_দেওয়া সেচ_করা সেচন_করা জলসেচন_করা ঢালা রাখা
हावा_खुवाउनु: ঘোরা হাঁটা বেড়ানো
हिँडनु: চলা হাটা গমন_করা যাওয়া কদম_ফেলা
हिँड्नु: যাওয়া চলা প্রস্থান_করা গমন_করা যাত্রা_করা
हिडाउँनु: চলানো হাঁটানো চালানো চালিত_করা
हिड्नु: হটা ছাড়া যাওয়া গমন_করা রওনা_দেওয়া প্রস্থান_করা
हिर्काउनु: মারা পেটা ঠেঙানো
हुँडल्नु: মন্থন_করা
हुत्याउनु: ফেলা ফেলে_দেওয়া
हुनु: হয় হন
हेर्नु: পরখ_করা যাচা পরীক্ষা_করা বিচার_করা খতিয়ে_দেখা দেখা তাকা তাকানো লক্ষ্য_করা নিরীক্ষণ_করা যাচা যাচাই_করা পরীক্ষা_করা দেখা লক্ষ্য_রাখা নজর_করা দেখা পরখ_করা যাচাই_করা পরীক্ষা_করা নিরীক্ষা_করা দেখা খোঁজা তালাশ_করা অনুসন্ধান_করা দেখা বোধ_করা লক্ষ্য_করা দেখা নজর_করা খেয়াল_রাখা লক্ষ্য_করা
